scaffold,start,end,length,method,type,type_start,type_end,overlap,overlap/length
ptg000004l,2601875,2602156,281,RepeatMasker,DNA,2601995,2602191,162,0.58
ptg000004l,2609283,2609563,280,RepeatMasker,DNA,2609398,2609598,166,0.59
ptg000017l,761000,761337,337,RepeatMasker,DNA,759872,762092,337,1.00
ptg000044l,1331386,1331666,280,RepeatMasker,DNA,1331148,1331414,28,0.10
ptg000044l,1331386,1331666,280,RepeatMasker,DNA,1331203,1331622,236,0.84
ptg000048l,2013678,2014005,327,RepeatMasker,DNA,2012833,2014788,327,1.00
ptg000057l,28435,28732,297,RepeatMasker,DNA,27789,29277,297,1.00
ptg000063l,193934,194230,296,RepeatMasker,DNA,194193,194454,38,0.13
ptg000080l,1768520,1768800,280,RepeatMasker,DNA,1768641,1768834,160,0.57
ptg000094l,2334780,2335065,285,RepeatMasker,DNA,2334970,2335225,96,0.34
ptg000100l,504952,505255,303,RepeatMasker,DNA,505158,505465,98,0.32
ptg000115l,784781,785063,282,RepeatMasker,DNA,784541,785391,282,1.00
ptg000120l,101323,101634,311,RepeatMasker,DNA,101612,101658,23,0.07
ptg000186l,5142868,5143191,323,RepeatMasker,DNA,5142834,5142925,57,0.18
ptg000186l,5142868,5143191,323,RepeatMasker,DNA,5143109,5143188,80,0.25
ptg000186l,5142868,5143191,323,RepeatMasker,DNA,5143135,5143277,57,0.18
ptg000186l,6901530,6901827,297,RepeatMasker,DNA,6901668,6901862,160,0.54
ptg000200l,3456621,3456898,277,RepeatMasker,DNA,3456733,3456957,166,0.60
ptg000206l,3423092,3423418,326,RepeatMasker,DNA,3423048,3423975,326,1.00
ptg000246l,398595,398896,301,RepeatMasker,DNA,398772,398975,125,0.42
ptg000261l,1373449,1373768,319,RepeatMasker,DNA,1373241,1373536,87,0.27
ptg000267l,4840661,4840966,305,RepeatMasker,DNA,4840707,4840931,225,0.74
ptg000276l,4478804,4479084,280,RepeatMasker,DNA,4478925,4479123,160,0.57
ptg000313l,1983259,1983549,290,RepeatMasker,DNA,1983048,1984939,290,1.00
ptg000315l,142016,142305,289,RepeatMasker,DNA,142218,143222,88,0.30
ptg000321l,992313,992619,306,RepeatMasker,DNA,992459,992661,161,0.53
ptg000331l,269748,270042,294,RepeatMasker,DNA,269240,269840,92,0.31
ptg000337l,15515567,15515866,299,RepeatMasker,DNA,15515263,15515902,299,1.00
ptg000360l,2370661,2370986,325,RepeatMasker,DNA,2370433,2372107,325,1.00
ptg000363l,3204290,3204562,272,RepeatMasker,DNA,3204380,3204501,122,0.45
ptg000363l,3204290,3204562,272,RepeatMasker,DNA,3204499,3204558,60,0.22
ptg000429l,1081040,1081332,292,RepeatMasker,DNA,1080242,1081133,93,0.32
ptg000462l,360539,360870,331,RepeatMasker,DNA,360687,360952,184,0.56
ptg000473l,1099124,1099403,279,RepeatMasker,DNA,1099238,1099446,166,0.59
ptg000480l,332530,332836,306,RepeatMasker,DNA,332722,332915,115,0.38
ptg000493l,3850249,3850529,280,RepeatMasker,DNA,3850350,3850412,63,0.23
ptg000515l,5208994,5209289,295,RepeatMasker,DNA,5208723,5209269,275,0.93
ptg000515l,5208994,5209289,295,RepeatMasker,DNA,5208798,5209357,295,1.00
ptg000515l,5961896,5962213,317,RepeatMasker,DNA,5962129,5962328,85,0.27
ptg000525l,831186,831466,280,RepeatMasker,DNA,831436,831625,31,0.11
ptg000532l,577773,578086,313,RepeatMasker,DNA,577637,578028,255,0.81
ptg000536l,1123813,1124140,327,RepeatMasker,DNA,1123520,1124356,327,1.00
ptg000540l,479694,479996,302,RepeatMasker,DNA,479869,479984,116,0.38
ptg000550l,2134878,2135144,266,RepeatMasker,DNA,2134775,2135254,266,1.00
ptg000568l,430635,430917,282,RepeatMasker,DNA,429353,430805,170,0.60
ptg000580l,1684982,1685311,329,RepeatMasker,DNA,1685074,1685713,238,0.72
ptg000580l,1684982,1685311,329,RepeatMasker,DNA,1685153,1685713,159,0.48
ptg000602l,1388880,1389200,320,RepeatMasker,DNA,1388164,1392100,320,1.00
ptg000605l,2177779,2178061,282,RepeatMasker,DNA,2177900,2178098,162,0.57
ptg000617l,238662,238957,295,RepeatMasker,DNA,238856,239007,102,0.35
ptg000627l,3298949,3299256,307,RepeatMasker,DNA,3298886,3299070,121,0.39
ptg000627l,3298949,3299256,307,RepeatMasker,DNA,3298921,3299155,206,0.67
ptg000632l,1171146,1171427,281,RepeatMasker,DNA,1170622,1171305,159,0.57
ptg000632l,1171146,1171427,281,RepeatMasker,DNA,1171123,1171333,187,0.67
ptg000632l,1171146,1171427,281,RepeatMasker,DNA,1171196,1171351,156,0.56
ptg000649l,84141,84454,313,RepeatMasker,DNA,84432,84478,23,0.07
ptg000661l,2306947,2307237,290,RepeatMasker,DNA,2304759,2307039,92,0.32
ptg000676l,2894474,2894758,284,RepeatMasker,DNA,2894548,2894637,90,0.32
ptg000689l,1893834,1894127,293,RepeatMasker,DNA,1893967,1894167,161,0.55
ptg000702l,828429,828708,279,RepeatMasker,DNA,828234,829850,279,1.00
ptg000703l,2243058,2243339,281,RepeatMasker,DNA,2243179,2243374,161,0.57
ptg000711l,3081214,3081538,324,RepeatMasker,DNA,3080684,3082343,324,1.00
ptg000719l,1613186,1613460,274,RepeatMasker,DNA,1613460,1613528,1,0.00
ptg000720l,751892,752194,302,RepeatMasker,DNA,751481,752333,302,1.00
ptg000722l,937003,937328,325,RepeatMasker,DNA,937187,937541,142,0.44
ptg000739l,7428288,7428627,339,RepeatMasker,DNA,7428444,7428657,184,0.54
ptg000776l,2616894,2617186,292,RepeatMasker,DNA,2616959,2617098,140,0.48
ptg000794l,484200,484488,288,RepeatMasker,DNA,484355,484559,134,0.47
ptg000797l,1301119,1301401,282,RepeatMasker,DNA,1301186,1301537,216,0.77
ptg000802l,5637472,5637762,290,RepeatMasker,DNA,5637703,5637758,56,0.19
ptg000806l,4722537,4722862,325,RepeatMasker,DNA,4722616,4722673,58,0.18
ptg000808l,3047654,3047948,294,RepeatMasker,DNA,3047602,3047777,123,0.42
ptg000808l,3047654,3047948,294,RepeatMasker,DNA,3047629,3047823,169,0.57
ptg000818l,2705482,2705786,304,RepeatMasker,DNA,2705753,2705932,34,0.11
ptg000837l,3691394,3691695,301,RepeatMasker,DNA,3691662,3691892,34,0.11
ptg000844l,7802516,7802802,286,RepeatMasker,DNA,7802769,7802832,34,0.12
ptg000874l,1525601,1525917,316,RepeatMasker,DNA,1525816,1525997,102,0.32
ptg000886l,5284406,5284704,298,RepeatMasker,DNA,5283751,5284546,140,0.47
ptg000900l,179682,179967,285,RepeatMasker,DNA,179907,179958,52,0.18
ptg000903l,479461,479783,322,RepeatMasker,DNA,479002,480740,322,1.00
ptg000915l,539859,540187,328,RepeatMasker,DNA,539828,540823,328,1.00
ptg000918l,549023,549337,314,RepeatMasker,DNA,549178,549463,160,0.51
ptg000929l,814013,814343,330,RepeatMasker,DNA,813833,814316,303,0.92
ptg000929l,814013,814343,330,RepeatMasker,DNA,813847,814226,213,0.65
ptg000929l,3538514,3538800,286,RepeatMasker,DNA,3538563,3538679,117,0.41
ptg000929l,3538514,3538800,286,RepeatMasker,DNA,3538708,3538850,93,0.33
ptg000934l,696769,697082,313,RepeatMasker,DNA,697060,697106,23,0.07
ptg000962l,625003,625284,281,RepeatMasker,DNA,625124,625328,161,0.57
ptg000986l,548148,548429,281,RepeatMasker,DNA,547909,548454,281,1.00
ptg000993l,96961,97241,280,RepeatMasker,DNA,95704,97015,54,0.19
ptg001001l,3512580,3512866,286,RepeatMasker,DNA,3512833,3513050,34,0.12
ptg001012l,359333,359646,313,RepeatMasker,DNA,359585,359642,58,0.19
ptg001019l,1471709,1471994,285,RepeatMasker,DNA,1471569,1471874,165,0.58
ptg001028l,2168455,2168723,268,RepeatMasker,DNA,2168722,2168778,2,0.01
ptg001029l,237597,237870,273,RepeatMasker,DNA,237618,237758,141,0.52
ptg001044l,2691442,2691722,280,RepeatMasker,DNA,2691442,2691500,58,0.21
ptg001077l,6611571,6611855,284,RepeatMasker,DNA,6611771,6612218,85,0.30
ptg001090l,180873,181141,268,RepeatMasker,DNA,180919,181050,132,0.49
ptg001099l,464886,465166,280,RepeatMasker,DNA,465007,465206,160,0.57
ptg001112l,1390806,1391088,282,RepeatMasker,DNA,1388582,1390899,93,0.33
ptg001135l,274523,274818,295,RepeatMasker,DNA,274251,274815,292,0.99
ptg001135l,274523,274818,295,RepeatMasker,DNA,274326,274889,295,1.00
ptg001140l,1793837,1794166,329,RepeatMasker,DNA,1793929,1794567,238,0.72
ptg001157l,333817,334121,304,RepeatMasker,DNA,334054,334304,68,0.22
ptg001161l,1051593,1051881,288,RepeatMasker,DNA,1051555,1051694,101,0.35
ptg001161l,1051593,1051881,288,RepeatMasker,DNA,1051753,1052546,129,0.45
ptg001182l,581131,581440,309,RepeatMasker,DNA,581280,581492,161,0.52
ptg001194l,1925611,1925935,324,RepeatMasker,DNA,1925762,1925963,174,0.54
ptg001197l,155375,155696,321,RepeatMasker,DNA,155588,155660,73,0.23
ptg001239l,47911,48231,320,RepeatMasker,DNA,46829,51119,320,1.00
ptg001244l,1063776,1064022,246,RepeatMasker,DNA,1063922,1064212,101,0.41
ptg001245l,1517522,1517816,294,RepeatMasker,DNA,1517656,1517861,161,0.55
ptg001273l,1558845,1559155,310,RepeatMasker,DNA,1558140,1559263,310,1.00
ptg001279l,4517455,4517737,282,RepeatMasker,DNA,4515264,4517546,91,0.32
ptg001291l,293720,293996,276,RepeatMasker,DNA,293582,296102,276,1.00
ptg001299l,199724,200048,324,RepeatMasker,DNA,199899,200233,150,0.46
ptg001303l,1311910,1312197,287,RepeatMasker,DNA,1312167,1312347,31,0.11
ptg001305l,1655177,1655478,301,RepeatMasker,DNA,1655299,1655510,180,0.60
ptg001310l,3757597,3757910,313,RepeatMasker,DNA,3757888,3757934,23,0.07
ptg001362l,897344,897624,280,RepeatMasker,DNA,897464,897666,161,0.58
ptg001362l,904503,904783,280,RepeatMasker,DNA,904623,904825,161,0.58
ptg001369l,432566,432892,326,RepeatMasker,DNA,432507,432814,248,0.76
ptg001370l,1550218,1550521,303,RepeatMasker,DNA,1548574,1550323,105,0.35
ptg001370l,1555609,1555912,303,RepeatMasker,DNA,1555551,1555714,105,0.35
ptg001371l,9564137,9564430,293,RepeatMasker,DNA,9563949,9564161,24,0.08
ptg001371l,9564137,9564430,293,RepeatMasker,DNA,9564028,9564190,53,0.18
ptg001379l,890743,891025,282,RepeatMasker,DNA,890785,890867,83,0.29
ptg001388l,448003,448302,299,RepeatMasker,DNA,448269,448487,34,0.11
ptg001389l,92518,92809,291,RepeatMasker,DNA,92289,92620,102,0.35
ptg001398l,2607888,2608189,301,RepeatMasker,DNA,2607818,2608840,301,1.00
ptg001409l,1099277,1099575,298,RepeatMasker,DNA,1099095,1099504,227,0.76
ptg001444l,1356231,1356551,320,RepeatMasker,DNA,1356446,1356630,106,0.33
ptg001444l,3070725,3071041,316,RepeatMasker,DNA,3070769,3070908,140,0.44
ptg001452l,613109,613398,289,RepeatMasker,DNA,612609,613191,82,0.28
ptg001468l,318325,318605,280,RepeatMasker,DNA,318445,318647,161,0.58
ptg001536l,2132145,2132426,281,RepeatMasker,DNA,2132210,2132562,217,0.77
ptg001543l,446043,446344,301,RepeatMasker,DNA,446309,446571,36,0.12
ptg001559l,931737,932059,322,RepeatMasker,DNA,931889,932060,171,0.53
ptg001560l,60841,61159,318,RepeatMasker,DNA,60992,61210,168,0.53
ptg001579l,4357593,4357903,310,RepeatMasker,DNA,4357884,4357927,20,0.06
ptg001583l,1398868,1399148,280,RepeatMasker,DNA,1398989,1399643,160,0.57
ptg001589l,885246,885547,301,RepeatMasker,DNA,884547,886055,301,1.00
ptg001631l,8011833,8012113,280,RepeatMasker,DNA,8011953,8012155,161,0.58
ptg001633l,509434,509749,315,RepeatMasker,DNA,509542,509749,208,0.66
ptg001633l,509434,509749,315,RepeatMasker,DNA,509618,509861,132,0.42
ptg001633l,509434,509749,315,RepeatMasker,DNA,509730,510101,20,0.06
ptg001639l,2541446,2541743,297,RepeatMasker,DNA,2541174,2541740,294,0.99
ptg001639l,2541446,2541743,297,RepeatMasker,DNA,2541249,2541814,297,1.00
ptg001642l,1662402,1662676,274,RepeatMasker,DNA,1662614,1662672,59,0.22
ptg001647l,1893544,1893848,304,RepeatMasker,DNA,1893663,1893960,186,0.61
ptg001664l,367032,367327,295,RepeatMasker,DNA,366760,367307,275,0.93
ptg001669l,2062538,2062847,309,RepeatMasker,DNA,2062467,2063292,309,1.00
ptg001671l,438106,438394,288,RepeatMasker,DNA,438052,438511,288,1.00
ptg001679l,726923,727242,319,RepeatMasker,DNA,726877,727887,319,1.00
ptg001695l,2583577,2583877,300,RepeatMasker,DNA,2583855,2583901,23,0.08
ptg001701l,3274595,3274905,310,RepeatMasker,DNA,3273425,3275187,310,1.00
ptg001722l,322366,322658,292,RepeatMasker,DNA,322052,323292,292,1.00
ptg001738l,912384,912689,305,RepeatMasker,DNA,912493,912719,197,0.65
ptg001742l,1746562,1746863,301,RepeatMasker,DNA,1746780,1746860,81,0.27
ptg001742l,1746562,1746863,301,RepeatMasker,DNA,1746789,1746860,72,0.24
ptg001755l,383442,383753,311,RepeatMasker,DNA,383636,383797,118,0.38
ptg001761l,151055,151337,282,RepeatMasker,DNA,151004,151411,282,1.00
ptg001773l,707774,708066,292,RepeatMasker,DNA,707698,707870,96,0.33
ptg001773l,2427379,2427689,310,RepeatMasker,DNA,2426659,2427487,108,0.35
ptg001786l,4472160,4472488,328,RepeatMasker,DNA,4472120,4473147,328,1.00
ptg001789l,2154752,2155039,287,RepeatMasker,DNA,2154516,2155004,252,0.88
ptg001815l,2511817,2512097,280,RepeatMasker,DNA,2511938,2512139,160,0.57
ptg001821l,4637502,4637792,290,RepeatMasker,DNA,4636604,4637593,91,0.31
ptg001821l,5067390,5067719,329,RepeatMasker,DNA,5067482,5068120,238,0.72
ptg001854l,3076131,3076430,299,RepeatMasker,DNA,3076374,3076460,57,0.19
ptg001880l,205474,205771,297,RepeatMasker,DNA,205626,205839,146,0.49
ptg001902l,1305347,1305660,313,RepeatMasker,DNA,1305638,1305684,23,0.07
ptg001906l,4120185,4120472,287,RepeatMasker,DNA,4120096,4121307,287,1.00
ptg001921l,626653,626918,265,RepeatMasker,DNA,626893,627083,26,0.10
ptg001931l,41974,42289,315,RepeatMasker,DNA,42165,42319,125,0.40
ptg001936l,631322,631649,327,RepeatMasker,DNA,631325,632283,325,0.99
ptg001961l,2667214,2667513,299,RepeatMasker,DNA,2667154,2667507,293,0.98
ptg001993l,755574,755904,330,RepeatMasker,DNA,755535,755583,9,0.03
ptg001993l,755574,755904,330,RepeatMasker,DNA,755568,756383,330,1.00
ptg002022l,4285662,4285981,319,RepeatMasker,DNA,4285786,4285920,135,0.42
ptg002030l,573853,574153,300,RepeatMasker,DNA,573982,574786,172,0.57
ptg002064l,1524460,1524771,311,RepeatMasker,DNA,1523607,1525030,311,1.00
ptg002068l,125197,125528,331,RepeatMasker,DNA,125235,125302,68,0.21
ptg002083l,2455435,2455757,322,RepeatMasker,DNA,2455405,2456415,322,1.00
ptg002087l,1466581,1466892,311,RepeatMasker,DNA,1466809,1467023,84,0.27
ptg002108l,888520,888811,291,RepeatMasker,DNA,888196,888601,81,0.28
ptg002114l,523330,523629,299,RepeatMasker,DNA,523596,523815,34,0.11
ptg002134l,119732,120013,281,RepeatMasker,DNA,119854,120046,160,0.57
ptg002141l,5728204,5728544,340,RepeatMasker,DNA,5727986,5728258,54,0.16
ptg002171l,1226101,1226382,281,RepeatMasker,DNA,1226224,1226426,159,0.57
ptg002191l,1060756,1061062,306,RepeatMasker,DNA,1060757,1060952,196,0.64
ptg002192l,1210387,1210680,293,RepeatMasker,DNA,1210647,1210856,34,0.12
ptg002224l,872694,872963,269,RepeatMasker,DNA,872800,872965,164,0.61
ptg002224l,872694,872963,269,RepeatMasker,DNA,872866,873117,98,0.36
ptg002225l,4583660,4583988,328,RepeatMasker,DNA,4583988,4584156,1,0.00
ptg002229l,542,859,317,RepeatMasker,DNA,837,883,23,0.07
ptg002243l,2060077,2060361,284,RepeatMasker,DNA,2060272,2060571,90,0.32
ptg002257l,2296901,2297211,310,RepeatMasker,DNA,2295701,2297133,232,0.75
ptg002260l,495090,495414,324,RepeatMasker,DNA,495354,495410,57,0.18
ptg002286l,197046,197340,294,RepeatMasker,DNA,197180,197391,161,0.55
ptg002297l,6153769,6154042,273,RepeatMasker,DNA,6154005,6154107,38,0.14
ptg002321l,1037322,1037614,292,RepeatMasker,DNA,1037592,1037636,23,0.08
ptg002353l,62311,62607,296,RepeatMasker,DNA,62505,62711,103,0.35
ptg002373l,1868800,1869090,290,RepeatMasker,DNA,1868173,1868909,109,0.38
ptg002390l,443153,443437,284,RepeatMasker,DNA,443002,443175,22,0.08
ptg002417l,4515063,4515351,288,RepeatMasker,DNA,4514655,4515306,243,0.84
ptg002434l,88890,89161,271,RepeatMasker,DNA,89105,89191,57,0.21
ptg002440l,172234,172524,290,RepeatMasker,DNA,172173,172377,143,0.49
ptg002451l,31563,31884,321,RepeatMasker,DNA,31527,31650,87,0.27
ptg002451l,31563,31884,321,RepeatMasker,DNA,31527,31670,107,0.33
ptg002451l,31563,31884,321,RepeatMasker,DNA,31802,31859,58,0.18
ptg002454l,3354706,3354985,279,RepeatMasker,DNA,3354919,3355167,67,0.24
ptg002472l,1497192,1497474,282,RepeatMasker,DNA,1497257,1497610,218,0.77
ptg002476l,996142,996427,285,RepeatMasker,DNA,993963,996233,91,0.32
ptg002506l,730024,730353,329,RepeatMasker,DNA,730116,730755,238,0.72
ptg002517l,5908834,5909120,286,RepeatMasker,DNA,5909054,5909116,63,0.22
ptg002580l,305829,306133,304,RepeatMasker,DNA,305605,305935,106,0.35
ptg002583l,6946806,6947086,280,RepeatMasker,DNA,6946927,6947144,160,0.57
ptg002598l,885120,885450,330,RepeatMasker,DNA,885379,885574,72,0.22
ptg002632l,519208,519508,300,RepeatMasker,DNA,518936,519473,265,0.88
ptg002632l,519208,519508,300,RepeatMasker,DNA,519011,519579,300,1.00
ptg002646l,599818,600134,316,RepeatMasker,DNA,599026,600940,316,1.00
ptg002646l,600848,601130,282,RepeatMasker,DNA,599026,600940,92,0.33
ptg002656l,1606023,1606335,312,RepeatMasker,DNA,1606314,1606359,22,0.07
ptg002666l,727421,727734,313,RepeatMasker,DNA,727712,727758,23,0.07
ptg002666l,2094961,2095267,306,RepeatMasker,DNA,2094082,2095082,121,0.40
ptg002687l,1415712,1415970,258,RepeatMasker,DNA,1415882,1416294,89,0.34
ptg002695l,1415888,1416205,317,RepeatMasker,DNA,1415800,1417952,317,1.00
ptg002756l,850609,850891,282,RepeatMasker,DNA,850369,851086,282,1.00
ptg002771l,4650854,4651142,288,RepeatMasker,DNA,4650884,4651058,175,0.61
ptg002811l,216574,216887,313,RepeatMasker,DNA,216865,216911,23,0.07
ptg002819l,2046343,2046627,284,RepeatMasker,DNA,2045448,2046434,91,0.32
ptg002819l,2264153,2264465,312,RepeatMasker,DNA,2264443,2264489,23,0.07
ptg002820l,627092,627382,290,RepeatMasker,DNA,627322,627378,57,0.20
ptg002837l,51339,51643,304,RepeatMasker,DNA,51573,51716,71,0.23
ptg002841l,1307009,1307322,313,RepeatMasker,DNA,1307300,1307346,23,0.07
ptg002860l,1164881,1165163,282,RepeatMasker,DNA,1165083,1165378,81,0.29
ptg002862l,5244662,5244956,294,RepeatMasker,DNA,5244441,5244919,257,0.87
ptg002873l,2403305,2403594,289,RepeatMasker,DNA,2403368,2403441,74,0.26
ptg002873l,2403305,2403594,289,RepeatMasker,DNA,2403539,2403634,56,0.19
ptg002879l,3135657,3135950,293,RepeatMasker,DNA,3135916,3135960,35,0.12
ptg002882l,3193097,3193382,285,RepeatMasker,DNA,3192846,3193188,91,0.32
ptg002887l,446814,447121,307,RepeatMasker,DNA,446956,447234,166,0.54
ptg002905l,1020910,1021197,287,RepeatMasker,DNA,1020895,1021088,178,0.62
ptg002932l,6348224,6348540,316,RepeatMasker,DNA,6348518,6348564,23,0.07
ptg002961l,535567,535879,312,RepeatMasker,DNA,534732,535766,199,0.64
ptg002962l,692786,693079,293,RepeatMasker,DNA,692408,692880,94,0.32
ptg002990l,496976,497258,282,RepeatMasker,DNA,494804,497069,93,0.33
ptg002998l,3062687,3062997,310,RepeatMasker,DNA,3062891,3063350,107,0.35
ptg003001l,547701,548019,318,RepeatMasker,DNA,547997,548043,23,0.07
ptg003019l,715328,715621,293,RepeatMasker,DNA,715537,716314,85,0.29
ptg003022l,1399821,1400127,306,RepeatMasker,DNA,1398782,1400045,224,0.73
ptg003028l,906907,907229,322,RepeatMasker,DNA,906925,907224,300,0.93
ptg003061l,2878819,2879099,280,RepeatMasker,DNA,2878573,2878847,28,0.10
ptg003061l,2878819,2879099,280,RepeatMasker,DNA,2878795,2879065,246,0.88
ptg003061l,2878819,2879099,280,RepeatMasker,DNA,2878949,2879055,107,0.38
ptg003067l,1198872,1199178,306,RepeatMasker,DNA,1198907,1199165,259,0.85
ptg003117l,866149,866452,303,RepeatMasker,DNA,866039,866678,303,1.00
ptg003124l,5753721,5754049,328,RepeatMasker,DNA,5753682,5754712,328,1.00
ptg003126l,106930,107251,321,RepeatMasker,DNA,107191,107247,57,0.18
ptg003154l,1471950,1472277,327,RepeatMasker,DNA,1471907,1472343,327,1.00
ptg003158l,26824,27117,293,RepeatMasker,DNA,27083,27127,35,0.12
ptg003162l,2681871,2682166,295,RepeatMasker,DNA,2681599,2682146,275,0.93
ptg003162l,2681871,2682166,295,RepeatMasker,DNA,2681674,2682236,295,1.00
ptg003164l,1207979,1208263,284,RepeatMasker,DNA,1207885,1208217,238,0.84
ptg003171l,815733,816038,305,RepeatMasker,DNA,816013,816211,26,0.09
ptg003186l,1439715,1440040,325,RepeatMasker,DNA,1439638,1440687,325,1.00
ptg003195l,715867,716183,316,RepeatMasker,DNA,715968,716146,179,0.57
ptg003195l,796080,796338,258,RepeatMasker,DNA,796001,796181,101,0.39
ptg003204l,1580151,1580458,307,RepeatMasker,DNA,1580346,1580730,113,0.37
ptg003209l,286068,286386,318,RepeatMasker,DNA,286221,286416,166,0.52
ptg003211l,869769,870084,315,RepeatMasker,DNA,869937,870103,148,0.47
ptg003235l,839198,839493,295,RepeatMasker,DNA,839333,839532,161,0.55
ptg003241l,1312960,1313242,282,RepeatMasker,DNA,1313112,1313338,131,0.46
ptg003250l,172533,172815,282,RepeatMasker,DNA,172037,172625,92,0.33
ptg003253l,79970,80292,322,RepeatMasker,DNA,79932,80325,322,1.00
ptg003292l,664664,664910,246,RepeatMasker,DNA,664626,664765,101,0.41
ptg003292l,664664,664910,246,RepeatMasker,DNA,664779,665548,132,0.54
ptg003294l,224939,225256,317,RepeatMasker,DNA,225223,225334,34,0.11
ptg003294l,274931,275223,292,RepeatMasker,DNA,275194,275289,30,0.10
ptg003331l,373220,373541,321,RepeatMasker,DNA,373182,374064,321,1.00
ptg003347l,1387021,1387301,280,RepeatMasker,DNA,1387141,1387345,161,0.58
ptg003355l,2230239,2230566,327,RepeatMasker,DNA,2230402,2230593,165,0.50
ptg003382l,644691,644985,294,RepeatMasker,DNA,644434,644974,283,0.96
ptg003392l,609404,609686,282,RepeatMasker,DNA,609526,609726,161,0.57
ptg003405l,90245,90526,281,RepeatMasker,DNA,90361,90575,166,0.59
ptg003405l,860061,860349,288,RepeatMasker,DNA,860176,860366,174,0.60
ptg003432l,111975,112293,318,RepeatMasker,DNA,112266,112312,28,0.09
ptg003432l,753138,753454,316,RepeatMasker,DNA,753330,753490,125,0.40
ptg003474l,2128918,2129247,329,RepeatMasker,DNA,2129029,2129419,219,0.67
ptg003478l,1075964,1076290,326,RepeatMasker,DNA,1075910,1076967,326,1.00
ptg003491l,223798,224088,290,RepeatMasker,DNA,223928,224128,161,0.56
ptg003507l,1224197,1224510,313,RepeatMasker,DNA,1223757,1224480,283,0.90
ptg003526l,4086856,4087114,258,RepeatMasker,DNA,4086671,4086884,28,0.11
ptg003526l,4086856,4087114,258,RepeatMasker,DNA,4086754,4086926,70,0.27
ptg003548l,1682260,1682555,295,RepeatMasker,DNA,1682028,1682266,6,0.02
ptg003556l,595514,595808,294,RepeatMasker,DNA,595583,595716,134,0.46
ptg003601l,3933884,3934173,289,RepeatMasker,DNA,3933100,3933975,91,0.31
ptg003621l,502194,502499,305,RepeatMasker,DNA,500186,502472,278,0.91
ptg003621l,502194,502499,305,RepeatMasker,DNA,500473,502916,305,1.00
ptg003693l,1706495,1706759,264,RepeatMasker,DNA,1706667,1706809,93,0.35
ptg003700l,4331231,4331515,284,RepeatMasker,DNA,4331482,4331689,34,0.12
ptg003707l,1599894,1600180,286,RepeatMasker,DNA,1599276,1599984,90,0.31
ptg003719l,283530,283816,286,RepeatMasker,DNA,282886,283622,92,0.32
ptg003737l,2514474,2514774,300,RepeatMasker,DNA,2514252,2514899,300,1.00
ptg003822l,849109,849386,277,RepeatMasker,DNA,848888,849349,240,0.87
ptg003839l,8784002,8784314,312,RepeatMasker,DNA,8784292,8784338,23,0.07
ptg003866l,259642,259950,308,RepeatMasker,DNA,258892,259665,23,0.07
ptg003866l,259642,259950,308,RepeatMasker,DNA,259795,260673,156,0.51
ptg003875l,28466,28737,271,RepeatMasker,DNA,28387,28591,125,0.46
ptg003880l,549864,550159,295,RepeatMasker,DNA,549592,550139,275,0.93
ptg003880l,549864,550159,295,RepeatMasker,DNA,549667,550230,295,1.00
ptg003892l,1200459,1200740,281,RepeatMasker,DNA,1200581,1200790,160,0.57
ptg003894l,1905860,1906141,281,RepeatMasker,DNA,1905647,1906038,178,0.63
ptg003898l,2180751,2181036,285,RepeatMasker,DNA,2180977,2181032,56,0.20
ptg003899l,1530733,1531000,267,RepeatMasker,DNA,1530798,1531427,203,0.76
ptg003901l,2336638,2336953,315,RepeatMasker,DNA,2336860,2337175,94,0.30
ptg003903l,218772,219067,295,RepeatMasker,DNA,218500,219064,292,0.99
ptg003903l,218772,219067,295,RepeatMasker,DNA,218575,219138,295,1.00
ptg003919l,335028,335356,328,RepeatMasker,DNA,335270,335709,87,0.27
ptg003934l,2930827,2931117,290,RepeatMasker,DNA,2929969,2930928,101,0.35
ptg003943l,295226,295523,297,RepeatMasker,DNA,294995,295452,226,0.76
ptg003959l,1404332,1404621,289,RepeatMasker,DNA,1404258,1405276,289,1.00
ptg003990l,760095,760411,316,RepeatMasker,DNA,760057,760230,135,0.43
ptg003990l,760095,760411,316,RepeatMasker,DNA,760309,761034,103,0.33
ptg004015l,394729,395009,280,RepeatMasker,DNA,394502,394799,70,0.25
ptg004041l,3002929,3003218,289,RepeatMasker,DNA,3003015,3004314,204,0.71
ptg004051l,599331,599621,290,RepeatMasker,DNA,597157,599440,109,0.38
ptg004053l,104083,104345,262,RepeatMasker,DNA,104324,104518,22,0.08
ptg004060l,2808360,2808640,280,RepeatMasker,DNA,2808423,2808776,218,0.78
ptg004107l,4554505,4554797,292,RepeatMasker,DNA,4554737,4554793,57,0.20
ptg004124l,349428,349722,294,RepeatMasker,DNA,349188,349596,168,0.57
ptg004136l,1278689,1278978,289,RepeatMasker,DNA,1277530,1278780,91,0.31
ptg004142l,1943779,1944102,323,RepeatMasker,DNA,1944042,1944098,57,0.18
ptg004143l,97694,97974,280,RepeatMasker,DNA,97815,98013,160,0.57
ptg004165l,1162067,1162394,327,RepeatMasker,DNA,1162159,1162796,236,0.72
ptg004165l,1162067,1162394,327,RepeatMasker,DNA,1162236,1162796,159,0.49
ptg004168l,3012087,3012408,321,RepeatMasker,DNA,3012278,3012493,131,0.41
ptg004173l,339795,340079,284,RepeatMasker,DNA,339960,340232,120,0.42
ptg004200l,4141040,4141343,303,RepeatMasker,DNA,4138857,4141146,106,0.35
ptg004233l,2641808,2642101,293,RepeatMasker,DNA,2641534,2642081,273,0.93
ptg004233l,2641808,2642101,293,RepeatMasker,DNA,2641582,2642172,293,1.00
ptg004263l,1512346,1512644,298,RepeatMasker,DNA,1512613,1512826,32,0.11
ptg004287l,144521,144801,280,RepeatMasker,DNA,144642,144853,160,0.57
ptg004294l,4932912,4933230,318,RepeatMasker,DNA,4933090,4933452,141,0.44
ptg004295l,130925,131205,280,RepeatMasker,DNA,131046,131251,160,0.57
ptg004309l,204422,204705,283,RepeatMasker,DNA,204581,204623,43,0.15
ptg004309l,204422,204705,283,RepeatMasker,DNA,204671,204728,35,0.12
ptg004315l,610333,610623,290,RepeatMasker,DNA,609462,610400,67,0.23
ptg004317l,1174760,1175051,291,RepeatMasker,DNA,1174439,1175904,291,1.00
ptg004323l,3259376,3259671,295,RepeatMasker,DNA,3259511,3259722,161,0.55
ptg004324l,2357523,2357810,287,RepeatMasker,DNA,2357485,2357614,91,0.32
ptg004324l,2357523,2357810,287,RepeatMasker,DNA,2357635,2358462,176,0.61
ptg004345l,1722145,1722458,313,RepeatMasker,DNA,1722436,1722482,23,0.07
ptg004408l,135288,135570,282,RepeatMasker,DNA,135411,135615,160,0.57
ptg004408l,142462,142741,279,RepeatMasker,DNA,142583,142786,159,0.57
ptg004421l,852715,853008,293,RepeatMasker,DNA,852833,853032,176,0.60
ptg004443l,1239899,1240209,310,RepeatMasker,DNA,1240187,1240233,23,0.07
ptg004482l,1555235,1555534,299,RepeatMasker,DNA,1555344,1555401,58,0.19
ptg004482l,1555235,1555534,299,RepeatMasker,DNA,1555447,1556415,88,0.29
ptg004482l,1555235,1555534,299,RepeatMasker,DNA,1555447,1556423,88,0.29
ptg004489l,2019716,2019997,281,RepeatMasker,DNA,2019838,2020060,160,0.57
ptg004523l,3546630,3546922,292,RepeatMasker,DNA,3546862,3546918,57,0.20
ptg004530l,1439397,1439679,282,RepeatMasker,DNA,1439462,1439815,218,0.77
ptg004537l,647514,647822,308,RepeatMasker,DNA,647727,647991,96,0.31
ptg004537l,647514,647822,308,RepeatMasker,DNA,647755,647991,68,0.22
ptg004544l,3582590,3582873,283,RepeatMasker,DNA,3582813,3582869,57,0.20
ptg004544l,3858814,3859135,321,RepeatMasker,DNA,3856680,3858940,126,0.39
ptg004555l,2057005,2057291,286,RepeatMasker,DNA,2056681,2057097,92,0.32
ptg004558l,1744128,1744423,295,RepeatMasker,DNA,1743851,1744403,275,0.93
ptg004558l,1744128,1744423,295,RepeatMasker,DNA,1743926,1744494,295,1.00
ptg004573l,58895,59213,318,RepeatMasker,DNA,59191,59237,23,0.07
ptg004620l,4152729,4153065,336,RepeatMasker,DNA,4153003,4153061,59,0.18
ptg004646l,85614,85904,290,RepeatMasker,DNA,85380,85705,91,0.31
ptg004663l,104966,105266,300,RepeatMasker,DNA,104434,105108,142,0.47
ptg004663l,104966,105266,300,RepeatMasker,DNA,105244,105606,23,0.08
ptg004689l,3039129,3039414,285,RepeatMasker,DNA,3036942,3039229,100,0.35
ptg004727l,226947,227276,329,RepeatMasker,DNA,227039,227677,238,0.72
ptg004727l,226947,227276,329,RepeatMasker,DNA,227118,227677,159,0.48
ptg004728l,1196430,1196710,280,RepeatMasker,DNA,1196550,1196757,161,0.58
ptg004743l,3845455,3845767,312,RepeatMasker,DNA,3845401,3845579,124,0.40
ptg004756l,407322,407638,316,RepeatMasker,DNA,407578,407634,57,0.18
ptg004756l,1183010,1183329,319,RepeatMasker,DNA,1183296,1183528,34,0.11
ptg004788l,2534442,2534764,322,RepeatMasker,DNA,2534280,2534483,41,0.13
ptg004805l,111445,111732,287,RepeatMasker,DNA,109848,111543,98,0.34
ptg004849l,270087,270404,317,RepeatMasker,DNA,270004,272325,317,1.00
ptg004864l,1053892,1054205,313,RepeatMasker,DNA,1053999,1054079,81,0.26
ptg004871l,4005550,4005821,271,RepeatMasker,DNA,4005195,4005950,271,1.00
ptg004884l,179530,179812,282,RepeatMasker,DNA,179302,179708,178,0.63
ptg004899l,1070758,1071071,313,RepeatMasker,DNA,1071049,1071095,23,0.07
ptg004902l,1393836,1394159,323,RepeatMasker,DNA,1393838,1395092,322,1.00
ptg004905l,2186762,2187032,270,RepeatMasker,DNA,2186900,2188231,133,0.49
ptg005011l,1975333,1975616,283,RepeatMasker,DNA,1975398,1975750,219,0.77
ptg005020l,535239,535562,323,RepeatMasker,DNA,534261,535404,165,0.51
ptg005037l,1651814,1652094,280,RepeatMasker,DNA,1651934,1652136,161,0.58
ptg005050l,404294,404573,279,RepeatMasker,DNA,404413,404619,161,0.58
ptg005053l,1115986,1116266,280,RepeatMasker,DNA,1114772,1116317,280,1.00
ptg005056l,1533987,1534299,312,RepeatMasker,DNA,1534277,1534323,23,0.07
ptg005070l,416639,416953,314,RepeatMasker,DNA,415519,421577,314,1.00
ptg005074l,957564,957856,292,RepeatMasker,DNA,957138,957656,92,0.32
ptg005074l,2527265,2527550,285,RepeatMasker,DNA,2527266,2527808,285,1.00
ptg005081l,286293,286592,299,RepeatMasker,DNA,286296,287243,297,0.99
ptg005099l,96430,96714,284,RepeatMasker,DNA,94832,96513,83,0.29
ptg005124l,496733,497027,294,RepeatMasker,DNA,495884,496824,91,0.31
ptg005153l,1756247,1756531,284,RepeatMasker,DNA,1756264,1756744,268,0.94
ptg005168l,1411859,1412193,334,RepeatMasker,DNA,1412112,1412262,82,0.25
ptg005172l,1243150,1243440,290,RepeatMasker,DNA,1242970,1243241,91,0.31
ptg005177l,2245959,2246278,319,RepeatMasker,DNA,2246173,2246224,52,0.16
ptg005179l,1454768,1455055,287,RepeatMasker,DNA,1454484,1455010,242,0.84
ptg005179l,1713346,1713610,264,RepeatMasker,DNA,1713539,1713687,72,0.27
ptg005214l,1216281,1216557,276,RepeatMasker,DNA,1216034,1216819,276,1.00
ptg005233l,3018503,3018785,282,RepeatMasker,DNA,3018263,3018976,282,1.00
ptg005304l,806019,806347,328,RepeatMasker,DNA,806111,806749,237,0.72
ptg005304l,806019,806347,328,RepeatMasker,DNA,806190,806694,158,0.48
ptg005315l,117937,118255,318,RepeatMasker,DNA,118233,118279,23,0.07
ptg005316l,864261,864540,279,RepeatMasker,DNA,864506,864550,35,0.13
ptg005397l,398723,399040,317,RepeatMasker,DNA,399018,399064,23,0.07
ptg005398l,87587,87878,291,RepeatMasker,DNA,87540,87690,103,0.35
ptg005398l,87587,87878,291,RepeatMasker,DNA,87758,88506,121,0.42
ptg005446l,3173101,3173412,311,RepeatMasker,DNA,3173390,3173436,23,0.07
ptg005462l,1280571,1280845,274,RepeatMasker,DNA,1280811,1280855,35,0.13
ptg005462l,6633637,6633917,280,RepeatMasker,DNA,6633757,6633952,161,0.58
ptg005478l,5042794,5043074,280,RepeatMasker,DNA,5042914,5043118,161,0.58
ptg005503l,767394,767685,291,RepeatMasker,DNA,767121,767523,129,0.44
ptg005506l,2113252,2113578,326,RepeatMasker,DNA,2113214,2114222,326,1.00
ptg005506l,2498667,2498996,329,RepeatMasker,DNA,2498759,2499398,238,0.72
ptg005506l,2498667,2498996,329,RepeatMasker,DNA,2498838,2499398,159,0.48
ptg005545l,2224235,2224511,276,RepeatMasker,DNA,2223995,2225558,276,1.00
ptg005576l,230702,230997,295,RepeatMasker,DNA,230430,230977,275,0.93
ptg005576l,230702,230997,295,RepeatMasker,DNA,230478,231068,295,1.00
ptg005588l,4256371,4256684,313,RepeatMasker,DNA,4256662,4256708,23,0.07
ptg005591l,1082833,1083115,282,RepeatMasker,DNA,1082594,1083442,282,1.00
ptg005615l,7275729,7276052,323,RepeatMasker,DNA,7275677,7276025,296,0.92
ptg005618l,2298221,2298482,261,RepeatMasker,DNA,2296772,2299100,261,1.00
ptg005623l,1052745,1053035,290,RepeatMasker,DNA,1052870,1053075,166,0.57
ptg005625l,946204,946524,320,RepeatMasker,DNA,946461,946614,64,0.20
ptg005639l,26743,27066,323,RepeatMasker,DNA,26906,27105,161,0.50
ptg005642l,820373,820686,313,RepeatMasker,DNA,820664,820710,23,0.07
ptg005642l,1049901,1050209,308,RepeatMasker,DNA,1050007,1050819,203,0.66
ptg005655l,42612,42930,318,RepeatMasker,DNA,42543,42701,89,0.28
ptg005655l,42612,42930,318,RepeatMasker,DNA,42843,43145,88,0.28
ptg005672l,1112238,1112519,281,RepeatMasker,DNA,1110034,1112330,92,0.33
ptg005702l,1416835,1417106,271,RepeatMasker,DNA,1416984,1417183,123,0.45
ptg005710l,175584,175864,280,RepeatMasker,DNA,175797,176086,68,0.24
ptg005718l,88201,88516,315,RepeatMasker,DNA,88392,88546,125,0.40
ptg005727l,1410144,1410436,292,RepeatMasker,DNA,1408128,1410238,94,0.32
ptg005809l,154479,154806,327,RepeatMasker,DNA,154421,155098,327,1.00
ptg005847l,756359,756641,282,RepeatMasker,DNA,756119,756858,282,1.00
ptg005876l,168092,168371,279,RepeatMasker,DNA,168066,168190,98,0.35
ptg005897l,116010,116323,313,RepeatMasker,DNA,116301,116347,23,0.07
ptg005909l,403856,404173,317,RepeatMasker,DNA,404083,404497,91,0.29
ptg005966l,8444905,8445199,294,RepeatMasker,DNA,8445039,8445242,161,0.55
ptg006045l,154074,154403,329,RepeatMasker,DNA,154166,154805,238,0.72
ptg006045l,154074,154403,329,RepeatMasker,DNA,154245,154805,159,0.48
ptg006058l,179692,180017,325,RepeatMasker,DNA,179755,180003,249,0.77
ptg006104l,1950465,1950760,295,RepeatMasker,DNA,1950193,1950740,275,0.93
ptg006104l,1950465,1950760,295,RepeatMasker,DNA,1950268,1950831,295,1.00
ptg006104l,3926361,3926672,311,RepeatMasker,DNA,3925149,3926453,92,0.30
ptg006122l,673493,673788,295,RepeatMasker,DNA,673221,673917,295,1.00
ptg006130l,1416723,1417035,312,RepeatMasker,DNA,1417013,1417059,23,0.07
ptg006153l,4240069,4240363,294,RepeatMasker,DNA,4240297,4240440,67,0.23
ptg006156l,3563866,3564212,346,RepeatMasker,DNA,3563829,3563897,31,0.09
ptg006197l,30296,30584,288,RepeatMasker,DNA,30246,31132,288,1.00
ptg006212l,211783,212091,308,RepeatMasker,DNA,211931,212132,161,0.52
ptg006218l,876906,877202,296,RepeatMasker,DNA,877042,877244,161,0.54
ptg006233l,1009451,1009754,303,RepeatMasker,DNA,1009413,1010423,303,1.00
ptg006233l,1980840,1981121,281,RepeatMasker,DNA,1980793,1981208,281,1.00
ptg006272l,2216029,2216358,329,RepeatMasker,DNA,2216045,2216760,314,0.95
ptg006289l,6260063,6260379,316,RepeatMasker,DNA,6260319,6260375,57,0.18
ptg006293l,1295722,1296050,328,RepeatMasker,DNA,1295682,1296388,328,1.00
ptg006297l,623829,624098,269,RepeatMasker,DNA,624056,624163,43,0.16
ptg006302l,368080,368386,306,RepeatMasker,DNA,368324,368382,59,0.19
ptg006320l,1186463,1186789,326,RepeatMasker,DNA,1186658,1186868,132,0.40
ptg006353l,1057273,1057593,320,RepeatMasker,DNA,1056796,1057423,150,0.47
ptg006353l,1057273,1057593,320,RepeatMasker,DNA,1056808,1057294,21,0.07
ptg006380l,1966575,1966859,284,RepeatMasker,DNA,1966516,1966778,203,0.71
ptg006389l,4282463,4282758,295,RepeatMasker,DNA,4282191,4282738,275,0.93
ptg006389l,4282463,4282758,295,RepeatMasker,DNA,4282266,4282828,295,1.00
ptg006393l,448840,449163,323,RepeatMasker,DNA,447413,448924,84,0.26
ptg006394l,259040,259345,305,RepeatMasker,DNA,259323,259369,23,0.08
ptg006439l,1012487,1012778,291,RepeatMasker,DNA,1011244,1013724,291,1.00
ptg006439l,1809121,1809416,295,RepeatMasker,DNA,1808849,1809396,275,0.93
ptg006439l,1809121,1809416,295,RepeatMasker,DNA,1808897,1809487,295,1.00
ptg006449l,772830,773115,285,RepeatMasker,DNA,772881,773005,125,0.44
ptg006465l,123631,123900,269,RepeatMasker,DNA,123707,123794,88,0.33
ptg006465l,2251431,2251742,311,RepeatMasker,DNA,2251674,2251819,69,0.22
ptg006473l,186932,187209,277,RepeatMasker,DNA,187103,187453,107,0.39
ptg006473l,1356071,1356359,288,RepeatMasker,DNA,1356292,1356355,64,0.22
ptg006521l,885205,885518,313,RepeatMasker,DNA,884860,885325,120,0.38
ptg006525l,2773058,2773357,299,RepeatMasker,DNA,2773326,2773528,32,0.11
ptg006529l,1030293,1030586,293,RepeatMasker,DNA,1030403,1030616,184,0.63
ptg006550l,634228,634508,280,RepeatMasker,DNA,632353,634320,92,0.33
ptg006566l,109391,109728,337,RepeatMasker,DNA,109501,109636,136,0.40
ptg006576l,1306735,1307032,297,RepeatMasker,DNA,1306738,1307019,282,0.95
ptg006589l,3319981,3320269,288,RepeatMasker,DNA,3320036,3320111,76,0.26
ptg006589l,3319981,3320269,288,RepeatMasker,DNA,3320216,3320309,54,0.19
ptg006598l,792245,792538,293,RepeatMasker,DNA,791820,792489,244,0.83
ptg006602l,205571,205857,286,RepeatMasker,DNA,205751,206211,107,0.37
ptg006640l,1161777,1162067,290,RepeatMasker,DNA,1161375,1161869,92,0.32
ptg006682l,459432,459726,294,RepeatMasker,DNA,459567,459771,160,0.54
ptg006687l,525292,525587,295,RepeatMasker,DNA,525563,525758,25,0.08
ptg006691l,351587,351876,289,RepeatMasker,DNA,351780,352229,97,0.34
ptg006703l,1902109,1902395,286,RepeatMasker,DNA,1902102,1902207,98,0.34
ptg006711l,3147074,3147350,276,RepeatMasker,DNA,3146429,3147166,92,0.33
ptg006711l,3174476,3174757,281,RepeatMasker,DNA,3174598,3174795,160,0.57
ptg006735l,1419005,1419270,265,RepeatMasker,DNA,1418082,1419136,131,0.49
ptg006788l,5554309,5554592,283,RepeatMasker,DNA,5554260,5554326,17,0.06
ptg006838l,1595195,1595492,297,RepeatMasker,DNA,1594805,1595291,96,0.32
ptg006899l,1542176,1542499,323,RepeatMasker,DNA,1542450,1542602,50,0.15
ptg006899l,2446731,2447046,315,RepeatMasker,DNA,2446922,2447076,125,0.40
ptg006900l,5770899,5771226,327,RepeatMasker,DNA,5770854,5771386,327,1.00
ptg006900l,10279313,10279598,285,RepeatMasker,DNA,10278534,10279406,93,0.33
ptg006917l,1915150,1915451,301,RepeatMasker,DNA,1915417,1915585,35,0.12
ptg006949l,92217,92499,282,RepeatMasker,DNA,91983,92695,282,1.00
ptg006980l,77206,77486,280,RepeatMasker,DNA,77326,77525,161,0.58
ptg006980l,84339,84633,294,RepeatMasker,DNA,84472,84672,162,0.55
ptg007004l,1642744,1643024,280,RepeatMasker,DNA,1642991,1643054,34,0.12
ptg007004l,4664364,4664637,273,RepeatMasker,DNA,4664637,4664695,1,0.00
ptg007028l,79438,79734,296,RepeatMasker,DNA,79575,79768,160,0.54
ptg007031l,485670,485949,279,RepeatMasker,DNA,485790,485990,160,0.57
ptg007040l,176858,177158,300,RepeatMasker,DNA,177074,177231,85,0.28
ptg007049l,1181815,1182128,313,RepeatMasker,DNA,1181777,1182774,313,1.00
ptg007057l,246941,247249,308,RepeatMasker,DNA,247090,247292,160,0.52
ptg007062l,1100874,1101169,295,RepeatMasker,DNA,1100602,1101149,275,0.93
ptg007062l,1100874,1101169,295,RepeatMasker,DNA,1100678,1101240,295,1.00
ptg007063l,223005,223306,301,RepeatMasker,DNA,221451,223109,104,0.35
ptg007063l,1336826,1337104,278,RepeatMasker,DNA,1336516,1336907,81,0.29
ptg007088l,1153118,1153429,311,RepeatMasker,DNA,1152990,1153231,113,0.36
ptg007131l,2098900,2099179,279,RepeatMasker,DNA,2099020,2099217,160,0.57
ptg007131l,2106078,2106358,280,RepeatMasker,DNA,2106199,2106396,160,0.57
ptg007149l,558753,559051,298,RepeatMasker,DNA,558970,559699,82,0.28
ptg007212l,646144,646479,335,RepeatMasker,DNA,646468,646583,12,0.04
ptg007218l,2710961,2711246,285,RepeatMasker,DNA,2710216,2711106,145,0.51
ptg007267l,1316215,1316494,279,RepeatMasker,DNA,1315894,1316308,93,0.33
ptg007274l,252327,252645,318,RepeatMasker,DNA,252557,252808,89,0.28
ptg007274l,252327,252645,318,RepeatMasker,DNA,252645,252836,1,0.00
ptg007295l,4442439,4442726,287,RepeatMasker,DNA,4442063,4442691,252,0.88
ptg007313l,673850,674158,308,RepeatMasker,DNA,674086,674314,73,0.24
ptg007318l,832362,832644,282,RepeatMasker,DNA,832554,832816,91,0.32
ptg007405l,739222,739551,329,RepeatMasker,DNA,739314,739953,238,0.72
ptg007406l,156386,156715,329,RepeatMasker,DNA,156402,157061,314,0.95
ptg007406l,524968,525247,279,RepeatMasker,DNA,524728,525443,279,1.00
ptg007412l,625623,625903,280,RepeatMasker,DNA,625743,625945,161,0.58
ptg007428l,562530,562859,329,RepeatMasker,DNA,562487,563513,329,1.00
ptg007458l,150576,150863,287,RepeatMasker,DNA,150837,150946,27,0.09
ptg007472l,538359,538679,320,RepeatMasker,DNA,538619,538675,57,0.18
ptg007473l,1777932,1778213,281,RepeatMasker,DNA,1777883,1778029,97,0.35
ptg007473l,1777932,1778213,281,RepeatMasker,DNA,1777904,1778123,191,0.68
ptg007526l,593604,593904,300,RepeatMasker,DNA,592829,593781,177,0.59
ptg007535l,136455,136736,281,RepeatMasker,DNA,136212,136746,281,1.00
ptg007535l,136455,136736,281,RepeatMasker,DNA,136279,136830,281,1.00
ptg007550l,848348,848670,322,RepeatMasker,DNA,848539,848700,132,0.41
ptg007556l,136668,136949,281,RepeatMasker,DNA,136790,136987,160,0.57
ptg007586l,1595807,1596129,322,RepeatMasker,DNA,1596068,1596125,58,0.18
ptg007610l,126198,126511,313,RepeatMasker,DNA,126424,126722,88,0.28
ptg007626l,62839,63147,308,RepeatMasker,DNA,62621,62897,58,0.19
ptg007633l,3803058,3803383,325,RepeatMasker,DNA,3802862,3803448,325,1.00
ptg007633l,3803058,3803383,325,RepeatMasker,DNA,3802863,3803639,325,1.00
ptg007636l,200821,201141,320,RepeatMasker,DNA,199253,201022,201,0.63
ptg007636l,328705,329032,327,RepeatMasker,DNA,329011,329328,22,0.07
ptg007661l,427821,428101,280,RepeatMasker,DNA,427884,428237,218,0.78
ptg007661l,1204471,1204751,280,RepeatMasker,DNA,1204592,1204795,160,0.57
ptg007691l,1464139,1464420,281,RepeatMasker,DNA,1464261,1464459,160,0.57
ptg007791l,295087,295414,327,RepeatMasker,DNA,295049,295645,327,1.00
ptg007807l,2664004,2664301,297,RepeatMasker,DNA,2663752,2664110,106,0.36
ptg007811l,429378,429663,285,RepeatMasker,DNA,429552,429719,112,0.39
ptg007842l,3224337,3224654,317,RepeatMasker,DNA,3224632,3224678,23,0.07
ptg007869l,351477,351801,324,RepeatMasker,DNA,351786,351879,16,0.05
ptg007882l,801383,801699,316,RepeatMasker,DNA,801539,801589,51,0.16
ptg007882l,801383,801699,316,RepeatMasker,DNA,801613,802551,87,0.28
ptg007907l,51747,52029,282,RepeatMasker,DNA,51870,52067,160,0.57
ptg007953l,3565226,3565525,299,RepeatMasker,DNA,3565492,3565695,34,0.11
ptg007954l,816576,816865,289,RepeatMasker,DNA,814856,816685,109,0.38
ptg007969l,73065,73347,282,RepeatMasker,DNA,73040,73120,55,0.20
ptg008060l,561130,561416,286,RepeatMasker,DNA,559847,561315,185,0.65
ptg008064l,107019,107314,295,RepeatMasker,DNA,106946,107385,295,1.00
ptg008094l,615856,616168,312,RepeatMasker,DNA,615414,616549,312,1.00
ptg008101l,625257,625562,305,RepeatMasker,DNA,623825,626989,305,1.00
ptg008106l,1988217,1988511,294,RepeatMasker,DNA,1988474,1988522,38,0.13
ptg008190l,942368,942681,313,RepeatMasker,DNA,942659,942705,23,0.07
ptg008216l,1337259,1337548,289,RepeatMasker,DNA,1337016,1337481,222,0.77
ptg008220l,1330061,1330350,289,RepeatMasker,DNA,1330350,1330398,1,0.00
ptg008231l,926322,926602,280,RepeatMasker,DNA,926569,926756,34,0.12
ptg008234l,789524,789820,296,RepeatMasker,DNA,788073,789610,86,0.29
ptg008275l,1033697,1034009,312,RepeatMasker,DNA,1033842,1035271,168,0.54
ptg008280l,805067,805349,282,RepeatMasker,DNA,805289,805345,57,0.20
ptg008299l,35252,35532,280,RepeatMasker,DNA,35372,35577,161,0.58
ptg008320l,15985,16280,295,RepeatMasker,DNA,15761,16260,275,0.93
ptg008320l,15985,16280,295,RepeatMasker,DNA,15788,16348,295,1.00
ptg008392l,293327,293655,328,RepeatMasker,DNA,293282,294284,328,1.00
ptg008392l,441720,442049,329,RepeatMasker,DNA,441737,442451,313,0.95
ptg008403l,2522039,2522321,282,RepeatMasker,DNA,2521862,2522442,282,1.00
ptg008413l,5271417,5271732,315,RepeatMasker,DNA,5271706,5271756,27,0.09
ptg008413l,6202400,6202716,316,RepeatMasker,DNA,6202591,6202747,126,0.40
ptg008415l,1200834,1201115,281,RepeatMasker,DNA,1200955,1201155,161,0.57
ptg008425l,2889775,2890059,284,RepeatMasker,DNA,2889301,2889868,93,0.33
ptg008436l,787930,788235,305,RepeatMasker,DNA,785958,788185,255,0.84
ptg008444l,524582,524875,293,RepeatMasker,DNA,524822,524905,54,0.18
ptg008451l,1110062,1110390,328,RepeatMasker,DNA,1110125,1111049,266,0.81
ptg008452l,1193715,1194026,311,RepeatMasker,DNA,1193002,1196753,311,1.00
ptg008454l,298276,298570,294,RepeatMasker,DNA,298207,298393,117,0.40
ptg008454l,298276,298570,294,RepeatMasker,DNA,298250,298332,56,0.19
ptg008516l,34195,34475,280,RepeatMasker,DNA,34315,34519,161,0.58
ptg008547l,1803114,1803371,257,RepeatMasker,DNA,1802138,1803159,45,0.18
ptg008604l,175281,175593,312,RepeatMasker,DNA,175571,175617,23,0.07
ptg008611l,847920,848200,280,RepeatMasker,DNA,848040,848237,161,0.58
ptg008623l,847719,847995,276,RepeatMasker,DNA,847835,848038,161,0.58
ptg008672l,276195,276472,277,RepeatMasker,DNA,275743,276287,92,0.33
ptg008700l,3501986,3502259,273,RepeatMasker,DNA,3502224,3502284,36,0.13
ptg008700l,5493178,5493489,311,RepeatMasker,DNA,5493452,5495786,38,0.12
ptg008703l,302619,302932,313,RepeatMasker,DNA,302847,303743,86,0.27
ptg008703l,408813,409108,295,RepeatMasker,DNA,408429,408908,95,0.32
ptg008724l,129233,129514,281,RepeatMasker,DNA,129354,129554,161,0.57
ptg008724l,2226240,2226525,285,RepeatMasker,DNA,2225519,2226349,109,0.38
ptg008764l,437626,437952,326,RepeatMasker,DNA,437580,438065,326,1.00
ptg008780l,1040323,1040636,313,RepeatMasker,DNA,1040614,1040660,23,0.07
ptg008795l,711215,711528,313,RepeatMasker,DNA,711506,711552,23,0.07
ptg008798l,615145,615467,322,RepeatMasker,DNA,615341,615546,127,0.39
ptg008806l,2128154,2128445,291,RepeatMasker,DNA,2128138,2128364,210,0.72
ptg008833l,233327,233623,296,RepeatMasker,DNA,232074,233418,91,0.31
ptg008838l,3080535,3080815,280,RepeatMasker,DNA,3080655,3080866,161,0.58
ptg008873l,404627,404935,308,RepeatMasker,DNA,404905,405110,31,0.10
ptg008960l,758198,758509,311,RepeatMasker,DNA,758504,759260,6,0.02
ptg008970l,823918,824201,283,RepeatMasker,DNA,823383,824009,91,0.32
ptg008973l,170270,170554,284,RepeatMasker,DNA,169526,170367,97,0.34
ptg009054l,634557,634864,307,RepeatMasker,DNA,634704,634906,161,0.52
ptg009076l,502344,502609,265,RepeatMasker,DNA,502172,502412,68,0.26
ptg009076l,502344,502609,265,RepeatMasker,DNA,502286,502528,184,0.69
ptg009076l,502344,502609,265,RepeatMasker,DNA,502398,502639,212,0.80
ptg009076l,502344,502609,265,RepeatMasker,DNA,502520,502742,90,0.34
ptg009141l,1199279,1199592,313,RepeatMasker,DNA,1198537,1199546,267,0.85
ptg009175l,758644,758957,313,RepeatMasker,DNA,758935,758981,23,0.07
ptg009186l,1452068,1452357,289,RepeatMasker,DNA,1451416,1452157,89,0.31
ptg009224l,3928313,3928625,312,RepeatMasker,DNA,3928509,3928648,117,0.38
ptg009240l,68890,69209,319,RepeatMasker,DNA,68847,69851,319,1.00
ptg009244l,284931,285225,294,RepeatMasker,DNA,284730,285188,257,0.87
ptg009244l,818287,818567,280,RepeatMasker,DNA,818408,818611,160,0.57
ptg009286l,737972,738276,304,RepeatMasker,DNA,738008,738183,176,0.58
ptg009291l,524464,524766,302,RepeatMasker,DNA,524544,524678,135,0.45
ptg009291l,524464,524766,302,RepeatMasker,DNA,524744,524790,23,0.08
ptg009303l,1093497,1093810,313,RepeatMasker,DNA,1093788,1093834,23,0.07
ptg009349l,623294,623588,294,RepeatMasker,DNA,623555,623633,34,0.12
ptg009354l,2753,3070,317,RepeatMasker,DNA,3048,3094,23,0.07
ptg009361l,1673028,1673325,297,RepeatMasker,DNA,1672920,1673159,131,0.44
ptg009376l,874173,874462,289,RepeatMasker,DNA,872049,874271,98,0.34
ptg009393l,3367906,3368213,307,RepeatMasker,DNA,3368076,3368292,138,0.45
ptg009426l,232313,232593,280,RepeatMasker,DNA,232433,232644,161,0.58
ptg009436l,568599,568878,279,RepeatMasker,DNA,568838,568936,41,0.15
ptg009440l,855957,856230,273,RepeatMasker,DNA,856168,856226,59,0.22
ptg009509l,1981279,1981572,293,RepeatMasker,DNA,1981041,1981535,256,0.87
ptg009523l,286253,286582,329,RepeatMasker,DNA,286345,286984,238,0.72
ptg009523l,676830,677103,273,RepeatMasker,DNA,676914,676975,62,0.23
ptg009591l,470381,470702,321,RepeatMasker,DNA,470606,470653,48,0.15
ptg009683l,5194,5508,314,RepeatMasker,DNA,5486,5532,23,0.07
ptg009691l,96574,96858,284,RepeatMasker,DNA,96356,97459,284,1.00
ptg009692l,456119,456404,285,RepeatMasker,DNA,454466,456210,91,0.32
ptg009703l,156455,156757,302,RepeatMasker,DNA,156562,156784,196,0.65
ptg009731l,2458845,2459134,289,RepeatMasker,DNA,2458521,2458933,88,0.30
ptg009741l,2970423,2970694,271,RepeatMasker,DNA,2970174,2970837,271,1.00
ptg009850l,376407,376727,320,RepeatMasker,DNA,376555,376789,173,0.54
ptg009862l,1208969,1209252,283,RepeatMasker,DNA,1209146,1209605,107,0.38
ptg009866l,446527,446844,317,RepeatMasker,DNA,446822,446868,23,0.07
ptg009879l,88263,88544,281,RepeatMasker,DNA,88384,88584,161,0.57
ptg009879l,3265197,3265514,317,RepeatMasker,DNA,3265443,3265733,72,0.23
ptg009879l,3265197,3265514,317,RepeatMasker,DNA,3265512,3265825,3,0.01
ptg009887l,859926,860257,331,RepeatMasker,DNA,860170,860472,88,0.27
ptg009887l,1648051,1648340,289,RepeatMasker,DNA,1647836,1648221,170,0.59
ptg009938l,865582,865864,282,RepeatMasker,DNA,865342,866189,282,1.00
ptg009940l,205030,205329,299,RepeatMasker,DNA,205169,205367,161,0.54
ptg009943l,2696989,2697323,334,RepeatMasker,DNA,2697166,2697239,74,0.22
ptg009950l,374170,374452,282,RepeatMasker,DNA,373930,374891,282,1.00
ptg009995l,2062486,2062774,288,RepeatMasker,DNA,2062260,2062737,251,0.87
ptg010027l,988325,988638,313,RepeatMasker,DNA,988616,988662,23,0.07
ptg010034l,135386,135700,314,RepeatMasker,DNA,134401,136253,314,1.00
ptg010052l,272699,272990,291,RepeatMasker,DNA,272105,272801,102,0.35
ptg010061l,1277588,1277909,321,RepeatMasker,DNA,1277550,1278526,321,1.00
ptg010088l,3526722,3527041,319,RepeatMasker,DNA,3526482,3527985,319,1.00
ptg010181l,705804,706095,291,RepeatMasker,DNA,706068,706114,28,0.10
ptg010195l,233765,234048,283,RepeatMasker,DNA,233965,234158,84,0.30
ptg010214l,156690,156989,299,RepeatMasker,DNA,154743,156979,289,0.97
ptg010251l,4933391,4933675,284,RepeatMasker,DNA,4933439,4937160,237,0.83
ptg010251l,5176948,5177238,290,RepeatMasker,DNA,5177053,5177267,186,0.64
ptg010259l,1095291,1095619,328,RepeatMasker,DNA,1095251,1096162,328,1.00
ptg010299l,480603,480887,284,RepeatMasker,DNA,480887,480936,1,0.00
ptg010299l,480603,480887,284,RepeatMasker,DNA,480887,480949,1,0.00
ptg010347l,307238,307551,313,RepeatMasker,DNA,307529,307575,23,0.07
ptg010350l,990354,990637,283,RepeatMasker,DNA,990204,991484,283,1.00
ptg010425l,405812,406149,337,RepeatMasker,DNA,406116,406334,34,0.10
ptg010427l,1902671,1902947,276,RepeatMasker,DNA,1902165,1903307,276,1.00
ptg010435l,363411,363692,281,RepeatMasker,DNA,363346,363794,281,1.00
ptg010500l,232019,232306,287,RepeatMasker,DNA,231798,232270,251,0.87
ptg010562l,1635830,1636104,274,RepeatMasker,DNA,1635847,1635942,96,0.35
ptg010594l,504118,504400,282,RepeatMasker,DNA,504242,504440,159,0.56
ptg010605l,1299820,1300110,290,RepeatMasker,DNA,1300085,1300280,26,0.09
ptg010617l,576891,577173,282,RepeatMasker,DNA,576051,576985,94,0.33
ptg010633l,511442,511748,306,RepeatMasker,DNA,511556,511720,165,0.54
ptg010651l,637847,638126,279,RepeatMasker,DNA,637909,638262,218,0.78
ptg010671l,168445,168770,325,RepeatMasker,DNA,168629,168983,142,0.44
ptg010673l,549358,549680,322,RepeatMasker,DNA,549075,549448,90,0.28
ptg010677l,897115,897381,266,RepeatMasker,DNA,897320,897373,54,0.20
ptg010727l,466802,467138,336,RepeatMasker,DNA,467113,467350,26,0.08
ptg010730l,856540,856853,313,RepeatMasker,DNA,856831,856877,23,0.07
ptg010743l,961458,961763,305,RepeatMasker,DNA,960936,961574,116,0.38
ptg010743l,961458,961763,305,RepeatMasker,DNA,961207,964040,305,1.00
ptg010764l,381926,382260,334,RepeatMasker,DNA,381876,382905,334,1.00
ptg010769l,320807,321103,296,RepeatMasker,DNA,319815,320834,27,0.09
ptg010778l,339981,340261,280,RepeatMasker,DNA,339416,339996,15,0.05
ptg010785l,481501,481822,321,RepeatMasker,DNA,481698,481895,125,0.39
ptg010792l,1931995,1932315,320,RepeatMasker,DNA,1932207,1932490,109,0.34
ptg010821l,391813,392105,292,RepeatMasker,DNA,391614,391983,170,0.58
ptg010824l,399464,399758,294,RepeatMasker,DNA,399727,399918,32,0.11
ptg010830l,63601,63896,295,RepeatMasker,DNA,63329,63876,275,0.93
ptg010830l,63601,63896,295,RepeatMasker,DNA,63404,63967,295,1.00
ptg010879l,4826335,4826619,284,RepeatMasker,DNA,4826586,4826737,34,0.12
ptg010887l,614906,615196,290,RepeatMasker,DNA,614635,615047,141,0.49
ptg010905l,1366603,1366908,305,RepeatMasker,DNA,1366785,1366938,124,0.41
ptg010917l,2044989,2045292,303,RepeatMasker,DNA,2044981,2045433,303,1.00
ptg010927l,1636153,1636472,319,RepeatMasker,DNA,1636210,1636261,52,0.16
ptg010965l,398638,398948,310,RepeatMasker,DNA,398926,398972,23,0.07
ptg010969l,880492,880803,311,RepeatMasker,DNA,880644,880841,160,0.51
ptg010978l,101926,102208,282,RepeatMasker,DNA,101686,102375,282,1.00
ptg010997l,726728,727017,289,RepeatMasker,DNA,726426,726881,153,0.53
ptg010997l,742455,742743,288,RepeatMasker,DNA,742176,742544,89,0.31
ptg011064l,290525,290816,291,RepeatMasker,DNA,290694,290895,123,0.42
ptg011068l,1105852,1106139,287,RepeatMasker,DNA,1106106,1106185,34,0.12
ptg011068l,2170615,2170933,318,RepeatMasker,DNA,2170911,2170957,23,0.07
ptg011068l,2170986,2171299,313,RepeatMasker,DNA,2171277,2171323,23,0.07
ptg011153l,514323,514605,282,RepeatMasker,DNA,514084,514933,282,1.00
ptg011168l,146671,146960,289,RepeatMasker,DNA,146042,149168,289,1.00
ptg011177l,648486,648793,307,RepeatMasker,DNA,648601,648645,45,0.15
ptg011177l,648486,648793,307,RepeatMasker,DNA,648711,648886,83,0.27
ptg011179l,1799928,1800265,337,RepeatMasker,DNA,1799206,1799973,45,0.13
ptg011211l,1394904,1395186,282,RepeatMasker,DNA,1394969,1395322,218,0.77
ptg011253l,943275,943555,280,RepeatMasker,DNA,942869,943367,92,0.33
ptg011254l,1142959,1143240,281,RepeatMasker,DNA,1143080,1143286,161,0.57
ptg011299l,1344979,1345273,294,RepeatMasker,DNA,1344967,1346535,294,1.00
ptg011307l,1665644,1665936,292,RepeatMasker,DNA,1665827,1666007,110,0.38
ptg011311l,2354430,2354710,280,RepeatMasker,DNA,2354205,2354963,280,1.00
ptg011315l,124756,125072,316,RepeatMasker,DNA,125050,125096,23,0.07
ptg011317l,757673,757962,289,RepeatMasker,DNA,755469,757764,91,0.31
ptg011330l,1327909,1328178,269,RepeatMasker,DNA,1327986,1328039,54,0.20
ptg011348l,30176,30460,284,RepeatMasker,DNA,29889,30232,56,0.20
ptg011394l,318955,319264,309,RepeatMasker,DNA,319150,319343,115,0.37
ptg011411l,869320,869600,280,RepeatMasker,DNA,869441,869641,160,0.57
ptg011420l,2105839,2106112,273,RepeatMasker,DNA,2105220,2105842,3,0.01
ptg011426l,179237,179560,323,RepeatMasker,DNA,178572,181986,323,1.00
ptg011434l,104498,104763,265,RepeatMasker,DNA,104640,104795,124,0.47
ptg011456l,1284586,1284868,282,RepeatMasker,DNA,1284255,1284667,81,0.29
ptg011481l,903534,903863,329,RepeatMasker,DNA,903626,904264,238,0.72
ptg011481l,903534,903863,329,RepeatMasker,DNA,903705,904210,159,0.48
ptg011489l,1188850,1189130,280,RepeatMasker,DNA,1188913,1189261,218,0.78
ptg011544l,32669,32950,281,RepeatMasker,DNA,32790,32991,161,0.57
ptg011619l,1032692,1032980,288,RepeatMasker,DNA,1032874,1033788,107,0.37
ptg011621l,548184,548497,313,RepeatMasker,DNA,548474,548521,24,0.08
ptg011635l,1367632,1367965,333,RepeatMasker,DNA,1367594,1368224,333,1.00
ptg011635l,1408648,1408973,325,RepeatMasker,DNA,1408610,1409232,325,1.00
ptg011663l,911972,912258,286,RepeatMasker,DNA,911915,912064,92,0.32
ptg011735l,1877053,1877366,313,RepeatMasker,DNA,1877344,1877390,23,0.07
ptg011756l,1528497,1528829,332,RepeatMasker,DNA,1528002,1528740,243,0.73
ptg011800l,477774,478103,329,RepeatMasker,DNA,477164,478014,240,0.73
ptg011841l,1284837,1285108,271,RepeatMasker,DNA,1285078,1285281,31,0.11
ptg011847l,297135,297442,307,RepeatMasker,DNA,297297,297387,91,0.30
ptg011875l,472900,473210,310,RepeatMasker,DNA,471753,473852,310,1.00
ptg012045l,128226,128509,283,RepeatMasker,DNA,128476,128669,34,0.12
ptg012058l,3373996,3374284,288,RepeatMasker,DNA,3373810,3374174,178,0.62
ptg012079l,2178339,2178638,299,RepeatMasker,DNA,2176755,2178530,191,0.64
ptg012079l,2178339,2178638,299,RepeatMasker,DNA,2178498,2178551,54,0.18
ptg012079l,2178339,2178638,299,RepeatMasker,DNA,2178507,2178557,51,0.17
ptg012079l,2178339,2178638,299,RepeatMasker,DNA,2178558,2179454,81,0.27
ptg012089l,316495,316808,313,RepeatMasker,DNA,316786,316832,23,0.07
ptg012106l,1676286,1676566,280,RepeatMasker,DNA,1676407,1676623,160,0.57
ptg012137l,558162,558451,289,RepeatMasker,DNA,558058,558340,178,0.62
ptg012176l,12191,12508,317,RepeatMasker,DNA,12375,12581,134,0.42
ptg012179l,248327,248608,281,RepeatMasker,DNA,248448,248647,161,0.57
ptg012194l,847917,848229,312,RepeatMasker,DNA,848207,848253,23,0.07
ptg012213l,1625033,1625351,318,RepeatMasker,DNA,1625227,1625431,125,0.39
ptg012228l,435547,435875,328,RepeatMasker,DNA,435794,435890,82,0.25
ptg012261l,550629,550959,330,RepeatMasker,DNA,550024,550872,243,0.74
ptg012315l,416456,416739,283,RepeatMasker,DNA,415796,416600,144,0.51
ptg012320l,499078,499359,281,RepeatMasker,DNA,499236,499638,124,0.44
ptg012336l,618114,618397,283,RepeatMasker,DNA,617576,618208,94,0.33
ptg012356l,1763459,1763739,280,RepeatMasker,DNA,1763579,1763788,161,0.58
ptg012357l,500652,500932,280,RepeatMasker,DNA,500875,500962,58,0.21
ptg012390l,1611277,1611566,289,RepeatMasker,DNA,1611406,1611606,161,0.56
ptg012430l,1159420,1159694,274,RepeatMasker,DNA,1159368,1159654,234,0.85
ptg012442l,68657,68964,307,RepeatMasker,DNA,67819,69602,307,1.00
ptg012455l,280291,280579,288,RepeatMasker,DNA,279102,280384,93,0.32
ptg012480l,1264369,1264643,274,RepeatMasker,DNA,1264445,1264708,199,0.73
ptg012480l,1264369,1264643,274,RepeatMasker,DNA,1264461,1264640,180,0.66
ptg012497l,1113070,1113365,295,RepeatMasker,DNA,1112799,1113362,292,0.99
ptg012510l,186238,186517,279,RepeatMasker,DNA,186358,186563,160,0.57
ptg012599l,228840,229130,290,RepeatMasker,DNA,226665,228927,87,0.30
ptg012617l,729417,729722,305,RepeatMasker,DNA,729562,729764,161,0.53
ptg012632l,7606,7919,313,RepeatMasker,DNA,7897,7943,23,0.07
ptg012697l,1062768,1063093,325,RepeatMasker,DNA,1062950,1063306,144,0.44
ptg012711l,92595,92885,290,RepeatMasker,DNA,92791,93057,95,0.33
ptg012717l,209810,210135,325,RepeatMasker,DNA,210043,210305,93,0.29
ptg012717l,209810,210135,325,RepeatMasker,DNA,210135,210383,1,0.00
ptg012721l,2231155,2231445,290,RepeatMasker,DNA,2228630,2233594,290,1.00
ptg012750l,825740,826053,313,RepeatMasker,DNA,826031,826077,23,0.07
ptg012754l,95565,95852,287,RepeatMasker,DNA,95164,95806,241,0.84
ptg012760l,365382,365661,279,RepeatMasker,DNA,365501,365705,161,0.58
ptg012773l,1208194,1208475,281,RepeatMasker,DNA,1207953,1208578,281,1.00
ptg012784l,975974,976255,281,RepeatMasker,DNA,975984,976426,272,0.97
ptg012804l,755342,755633,291,RepeatMasker,DNA,755185,757031,291,1.00
ptg012906l,74999,75296,297,RepeatMasker,DNA,75236,75292,57,0.19
ptg012980l,1815283,1815597,314,RepeatMasker,DNA,1815575,1815621,23,0.07
ptg012997l,653115,653427,312,RepeatMasker,DNA,653339,653605,89,0.29
ptg013006l,262728,263025,297,RepeatMasker,DNA,262866,263071,160,0.54
ptg013035l,1596904,1597184,280,RepeatMasker,DNA,1595211,1597072,168,0.60
ptg013050l,298726,299006,280,RepeatMasker,DNA,298846,299053,161,0.58
ptg013068l,2285113,2285412,299,RepeatMasker,DNA,2285075,2286056,299,1.00
ptg013082l,1097038,1097347,309,RepeatMasker,DNA,1097347,1097402,1,0.00
ptg013086l,196977,197270,293,RepeatMasker,DNA,196042,196990,13,0.04
ptg013087l,1905319,1905629,310,RepeatMasker,DNA,1905452,1906070,178,0.57
ptg013091l,489581,489873,292,RepeatMasker,DNA,489207,489822,241,0.83
ptg013154l,1436732,1437014,282,RepeatMasker,DNA,1436492,1437206,282,1.00
ptg013217l,750936,751238,302,RepeatMasker,DNA,751174,751889,65,0.22
ptg013240l,457754,458075,321,RepeatMasker,DNA,457797,458716,279,0.87
ptg013280l,1091080,1091375,295,RepeatMasker,DNA,1090808,1091372,292,0.99
ptg013280l,1091080,1091375,295,RepeatMasker,DNA,1090883,1091446,295,1.00
ptg013298l,354829,355105,276,RepeatMasker,DNA,354943,355207,163,0.59
ptg013403l,890093,890376,283,RepeatMasker,DNA,888673,890136,43,0.15
ptg013427l,2076416,2076682,266,RepeatMasker,DNA,2076576,2076903,107,0.40
ptg013463l,324322,324586,264,RepeatMasker,DNA,324388,324690,199,0.75
ptg013468l,280695,281011,316,RepeatMasker,DNA,280973,281040,39,0.12
ptg013469l,495709,496030,321,RepeatMasker,DNA,495944,496437,87,0.27
ptg013491l,2854370,2854681,311,RepeatMasker,DNA,2854659,2854705,23,0.07
ptg013591l,2901472,2901784,312,RepeatMasker,DNA,2901762,2901808,23,0.07
ptg013617l,532214,532512,298,RepeatMasker,DNA,532430,532619,83,0.28
ptg013621l,71250,71531,281,RepeatMasker,DNA,71371,72116,161,0.57
ptg013661l,1303437,1303719,282,RepeatMasker,DNA,1303641,1303866,79,0.28
ptg013661l,1303437,1303719,282,RepeatMasker,DNA,1303719,1303866,1,0.00
ptg013661l,1303437,1303719,282,RepeatMasker,DNA,1303719,1303946,1,0.00
ptg013670l,198356,198685,329,RepeatMasker,DNA,198448,199087,238,0.72
ptg013670l,198356,198685,329,RepeatMasker,DNA,198527,199108,159,0.48
ptg013724l,328811,329096,285,RepeatMasker,DNA,328726,328903,92,0.32
ptg013793l,715015,715327,312,RepeatMasker,DNA,715294,715349,34,0.11
ptg013794l,699593,699918,325,RepeatMasker,DNA,699545,699921,325,1.00
ptg013820l,620774,621054,280,RepeatMasker,DNA,620889,621104,166,0.59
ptg013838l,1280034,1280310,276,RepeatMasker,DNA,1279097,1280125,91,0.33
ptg013848l,108946,109226,280,RepeatMasker,DNA,109066,109268,161,0.58
ptg013890l,2572346,2572665,319,RepeatMasker,DNA,2572637,2572725,29,0.09
ptg013913l,1026213,1026528,315,RepeatMasker,DNA,1026430,1026700,99,0.31
ptg013919l,695657,695937,280,RepeatMasker,DNA,695777,695980,161,0.58
ptg013936l,118953,119262,309,RepeatMasker,DNA,119011,119114,104,0.34
ptg013997l,1676883,1677199,316,RepeatMasker,DNA,1676677,1676951,68,0.22
ptg014066l,1371302,1371627,325,RepeatMasker,DNA,1371433,1371843,195,0.60
ptg014066l,1371744,1372044,300,RepeatMasker,DNA,1371433,1371843,99,0.33
ptg014129l,190239,190549,310,RepeatMasker,DNA,190443,191474,107,0.35
ptg014190l,387299,387580,281,RepeatMasker,DNA,387049,387390,91,0.32
ptg014236l,901954,902249,295,RepeatMasker,DNA,901682,902246,292,0.99
ptg014243l,1531572,1531873,301,RepeatMasker,DNA,1531788,1532189,86,0.29
ptg014296l,27007,27301,294,RepeatMasker,DNA,26946,27123,116,0.39
ptg014296l,27007,27301,294,RepeatMasker,DNA,26988,27209,202,0.69
ptg014342l,450418,450717,299,RepeatMasker,DNA,450013,450503,85,0.28
ptg014351l,681458,681737,279,RepeatMasker,DNA,681084,681671,213,0.76
ptg014367l,720874,721200,326,RepeatMasker,DNA,720605,724111,326,1.00
ptg014392l,1157702,1157998,296,RepeatMasker,DNA,1157913,1158352,86,0.29
ptg014444l,94344,94623,279,RepeatMasker,DNA,94102,94743,279,1.00
ptg014453l,428,741,313,RepeatMasker,DNA,719,765,23,0.07
ptg014456l,1759573,1759905,332,RepeatMasker,DNA,1759503,1759635,62,0.19
ptg014557l,1481176,1481460,284,RepeatMasker,DNA,1481243,1481596,218,0.77
ptg014598l,1750742,1751030,288,RepeatMasker,DNA,1750892,1751067,139,0.48
ptg014599l,2125994,2126292,298,RepeatMasker,DNA,2125994,2126051,57,0.19
ptg014605l,1316765,1317062,297,RepeatMasker,DNA,1316928,1317137,135,0.45
ptg014609l,1193079,1193370,291,RepeatMasker,DNA,1193241,1193330,90,0.31
ptg014610l,622275,622556,281,RepeatMasker,DNA,622551,622698,6,0.02
ptg014650l,360578,360899,321,RepeatMasker,DNA,360792,360977,108,0.34
ptg014723l,1865506,1865829,323,RepeatMasker,DNA,1865430,1865624,118,0.37
ptg014745l,653750,654030,280,RepeatMasker,DNA,653871,654074,160,0.57
ptg014745l,664154,664434,280,RepeatMasker,DNA,664274,664478,161,0.58
ptg014750l,2647826,2648140,314,RepeatMasker,DNA,2648064,2648356,77,0.25
ptg014778l,366749,367044,295,RepeatMasker,DNA,366478,367024,275,0.93
ptg014778l,366749,367044,295,RepeatMasker,DNA,366572,367115,295,1.00
ptg014791l,665451,665753,302,RepeatMasker,DNA,664853,665519,68,0.23
ptg014791l,665451,665753,302,RepeatMasker,DNA,665518,666213,236,0.78
ptg014805l,201871,202162,291,RepeatMasker,DNA,202104,202153,50,0.17
ptg014898l,402115,402392,277,RepeatMasker,DNA,402085,402197,82,0.30
ptg014971l,688895,689206,311,RepeatMasker,DNA,688869,689097,202,0.65
ptg014989l,375580,375866,286,RepeatMasker,DNA,375016,375786,206,0.72
ptg015003l,2598078,2598366,288,RepeatMasker,DNA,2597494,2598169,91,0.32
ptg015030l,60538,60830,292,RepeatMasker,DNA,60750,60903,81,0.28
ptg015076l,347,658,311,RepeatMasker,DNA,636,682,23,0.07
ptg015105l,235773,236089,316,RepeatMasker,DNA,236067,236113,23,0.07
ptg015126l,54985,55265,280,RepeatMasker,DNA,54660,55077,92,0.33
ptg015134l,67898,68188,290,RepeatMasker,DNA,66951,67990,92,0.32
ptg015166l,471765,472100,335,RepeatMasker,DNA,472091,472259,10,0.03
ptg015257l,234956,235277,321,RepeatMasker,DNA,233804,234969,13,0.04
ptg015314l,291862,292143,281,RepeatMasker,DNA,291817,291953,91,0.32
ptg015318l,285366,285683,317,RepeatMasker,DNA,285458,285523,66,0.21
ptg015380l,1706360,1706658,298,RepeatMasker,DNA,1706503,1706737,156,0.52
ptg015384l,1076637,1076916,279,RepeatMasker,DNA,1076426,1077358,279,1.00
ptg015388l,658927,659217,290,RepeatMasker,DNA,657468,658974,47,0.16
ptg015445l,819088,819379,291,RepeatMasker,DNA,818596,822588,291,1.00
ptg015493l,372636,372916,280,RepeatMasker,DNA,372389,372986,280,1.00
ptg015646l,103275,103595,320,RepeatMasker,DNA,102887,103367,92,0.29
ptg015646l,103275,103595,320,RepeatMasker,DNA,103020,104643,320,1.00
ptg015666l,320974,321281,307,RepeatMasker,DNA,321253,321404,29,0.09
ptg015719l,1111499,1111781,282,RepeatMasker,DNA,1111499,1111565,66,0.23
ptg015729l,861577,861862,285,RepeatMasker,DNA,861840,861886,23,0.08
ptg015821l,800862,801148,286,RepeatMasker,DNA,800601,800954,92,0.32
ptg015855l,47660,47942,282,RepeatMasker,DNA,47460,48868,282,1.00
ptg015876l,807368,807652,284,RepeatMasker,DNA,807522,807663,131,0.46
ptg015890l,427149,427429,280,RepeatMasker,DNA,427269,427467,161,0.58
ptg015946l,2190049,2190339,290,RepeatMasker,DNA,2189268,2190142,93,0.32
ptg015960l,50412,50690,278,RepeatMasker,DNA,50181,50730,278,1.00
ptg015960l,50412,50690,278,RepeatMasker,DNA,50182,50949,278,1.00
ptg015960l,601921,602220,299,RepeatMasker,DNA,602187,602361,34,0.11
ptg015983l,545346,545675,329,RepeatMasker,DNA,545438,546077,238,0.72
ptg015983l,545346,545675,329,RepeatMasker,DNA,545517,546077,159,0.48
ptg015989l,24205,24496,291,RepeatMasker,DNA,23784,24306,101,0.35
ptg016016l,1072010,1072290,280,RepeatMasker,DNA,1072131,1072328,160,0.57
ptg016077l,90599,90891,292,RepeatMasker,DNA,90860,91016,32,0.11
ptg016168l,349778,350067,289,RepeatMasker,DNA,349901,350579,167,0.58
ptg016333l,163952,164231,279,RepeatMasker,DNA,164071,164282,161,0.58
ptg016341l,227209,227538,329,RepeatMasker,DNA,227301,227937,238,0.72
ptg016341l,227209,227538,329,RepeatMasker,DNA,227380,227935,159,0.48
ptg016344l,1451397,1451708,311,RepeatMasker,DNA,1451348,1451506,109,0.35
ptg016344l,1451397,1451708,311,RepeatMasker,DNA,1451372,1451605,208,0.67
ptg016344l,1451397,1451708,311,RepeatMasker,DNA,1451651,1451733,58,0.19
ptg016352l,175355,175653,298,RepeatMasker,DNA,173562,175554,199,0.67
ptg016369l,447102,447414,312,RepeatMasker,DNA,447392,447438,23,0.07
ptg016386l,449022,449297,275,RepeatMasker,DNA,448782,449626,275,1.00
ptg016435l,705439,705719,280,RepeatMasker,DNA,705559,705760,161,0.58
ptg016458l,115917,116197,280,RepeatMasker,DNA,116037,116245,161,0.58
ptg016466l,13727,14026,299,RepeatMasker,DNA,13545,14372,299,1.00
ptg016466l,4158199,4158511,312,RepeatMasker,DNA,4158395,4158591,117,0.38
ptg016545l,1149275,1149566,291,RepeatMasker,DNA,1149229,1149556,281,0.97
ptg016567l,1360100,1360392,292,RepeatMasker,DNA,1357946,1360192,92,0.32
ptg016574l,285192,285472,280,RepeatMasker,DNA,285313,285519,160,0.57
ptg016589l,712802,713100,298,RepeatMasker,DNA,712806,712861,56,0.19
ptg016622l,423830,424134,304,RepeatMasker,DNA,423786,424127,297,0.98
ptg016657l,809393,809686,293,RepeatMasker,DNA,809250,809484,91,0.31
ptg016659l,706291,706580,289,RepeatMasker,DNA,706555,706691,26,0.09
ptg016659l,818988,819298,310,RepeatMasker,DNA,819155,819277,123,0.40
ptg016663l,558524,558827,303,RepeatMasker,DNA,558628,558684,57,0.19
ptg016693l,51700,51989,289,RepeatMasker,DNA,51253,51792,92,0.32
ptg016720l,1033740,1034027,287,RepeatMasker,DNA,1033860,1034072,168,0.59
ptg016755l,965227,965506,279,RepeatMasker,DNA,965347,965557,160,0.57
ptg016758l,841706,842000,294,RepeatMasker,DNA,841992,842038,9,0.03
ptg016762l,16195,16468,273,RepeatMasker,DNA,16014,16557,273,1.00
ptg016762l,16195,16468,273,RepeatMasker,DNA,16031,16423,228,0.84
ptg016765l,1187270,1187555,285,RepeatMasker,DNA,1187220,1187346,76,0.27
ptg016767l,657220,657530,310,RepeatMasker,DNA,656983,657307,87,0.28
ptg016767l,657220,657530,310,RepeatMasker,DNA,657308,659038,223,0.72
ptg016824l,843662,843982,320,RepeatMasker,DNA,843875,844061,108,0.34
ptg016838l,349350,349628,278,RepeatMasker,DNA,349470,349669,159,0.57
ptg016875l,2085366,2085687,321,RepeatMasker,DNA,2085580,2085766,108,0.34
ptg016886l,32075,32387,312,RepeatMasker,DNA,32365,32411,23,0.07
ptg016890l,1728818,1729105,287,RepeatMasker,DNA,1727589,1729640,287,1.00
ptg016890l,1728818,1729105,287,RepeatMasker,DNA,1727641,1730859,287,1.00
ptg016890l,1806126,1806426,300,RepeatMasker,DNA,1804945,1806212,86,0.29
ptg016928l,225286,225607,321,RepeatMasker,DNA,225574,225800,34,0.11
ptg016934l,721998,722288,290,RepeatMasker,DNA,721085,722107,109,0.38
ptg016941l,233172,233416,244,RepeatMasker,DNA,233173,233443,244,1.00
ptg016945l,460242,460537,295,RepeatMasker,DNA,459970,460517,275,0.93
ptg016952l,125711,126022,311,RepeatMasker,DNA,126000,126046,23,0.07
ptg016952l,410855,411158,303,RepeatMasker,DNA,409004,411821,303,1.00
ptg016974l,511791,512108,317,RepeatMasker,DNA,512068,512138,41,0.13
ptg017007l,583280,583576,296,RepeatMasker,DNA,583081,583565,285,0.96
ptg017014l,432949,433239,290,RepeatMasker,DNA,431655,433035,86,0.30
ptg017014l,801281,801561,280,RepeatMasker,DNA,799879,801343,62,0.22
ptg017033l,541016,541307,291,RepeatMasker,DNA,540376,541108,92,0.32
ptg017079l,942044,942324,280,RepeatMasker,DNA,942165,942838,160,0.57
ptg017093l,945524,945819,295,RepeatMasker,DNA,945484,945622,98,0.33
ptg017093l,945524,945819,295,RepeatMasker,DNA,945674,946475,146,0.49
ptg017186l,333875,334177,302,RepeatMasker,DNA,333719,334385,302,1.00
ptg017268l,649919,650211,292,RepeatMasker,DNA,649849,650009,90,0.31
ptg017313l,1028322,1028602,280,RepeatMasker,DNA,1028442,1028648,161,0.58
ptg017322l,63318,63607,289,RepeatMasker,DNA,62937,63409,91,0.31
ptg017369l,218215,218495,280,RepeatMasker,DNA,218227,218631,269,0.96
ptg017429l,463903,464192,289,RepeatMasker,DNA,463822,465012,289,1.00
ptg017430l,196665,196946,281,RepeatMasker,DNA,196859,197162,88,0.31
ptg017440l,714832,715135,303,RepeatMasker,DNA,715024,715214,112,0.37
ptg017440l,746017,746325,308,RepeatMasker,DNA,746213,746404,113,0.37
ptg017444l,757356,757645,289,RepeatMasker,DNA,755881,757458,102,0.35
ptg017478l,247521,247806,285,RepeatMasker,DNA,247319,247696,175,0.61
ptg017489l,1106362,1106666,304,RepeatMasker,DNA,1106458,1107318,209,0.69
ptg017509l,155588,155870,282,RepeatMasker,DNA,155433,156000,282,1.00
ptg017523l,1028355,1028646,291,RepeatMasker,DNA,1027107,1028447,92,0.32
ptg017673l,327193,327508,315,RepeatMasker,DNA,327349,327548,160,0.51
ptg017759l,213421,213750,329,RepeatMasker,DNA,212708,215148,329,1.00
ptg017768l,33016,33306,290,RepeatMasker,DNA,31528,33106,90,0.31
ptg017771l,2673112,2673410,298,RepeatMasker,DNA,2673251,2673445,160,0.54
ptg017771l,2680322,2680603,281,RepeatMasker,DNA,2680444,2680638,160,0.57
ptg017782l,185947,186274,327,RepeatMasker,DNA,185908,186299,327,1.00
ptg017845l,344560,344846,286,RepeatMasker,DNA,344253,344578,18,0.06
ptg017876l,119053,119382,329,RepeatMasker,DNA,119301,120032,82,0.25
ptg017900l,946863,947158,295,RepeatMasker,DNA,946591,947138,275,0.93
ptg017900l,946863,947158,295,RepeatMasker,DNA,946591,947155,292,0.99
ptg017900l,946863,947158,295,RepeatMasker,DNA,946672,947229,295,1.00
ptg017901l,157209,157520,311,RepeatMasker,DNA,157360,157571,161,0.52
ptg018096l,2166565,2166865,300,RepeatMasker,DNA,2166860,2166943,6,0.02
ptg018314l,309091,309413,322,RepeatMasker,DNA,309052,310044,322,1.00
ptg018351l,834707,834985,278,RepeatMasker,DNA,834888,835008,98,0.35
ptg018436l,1180515,1180803,288,RepeatMasker,DNA,1180186,1180768,253,0.88
ptg018437l,152880,153157,277,RepeatMasker,DNA,152997,153201,161,0.58
ptg018458l,595303,595631,328,RepeatMasker,DNA,594699,595544,241,0.73
ptg018477l,352500,352796,296,RepeatMasker,DNA,352611,355151,186,0.63
ptg018504l,258274,258606,332,RepeatMasker,DNA,257803,258431,157,0.47
ptg018565l,1398972,1399257,285,RepeatMasker,DNA,1399088,1399288,170,0.60
ptg018580l,2528213,2528508,295,RepeatMasker,DNA,2527823,2528310,97,0.33
ptg018659l,424553,424871,318,RepeatMasker,DNA,424837,424977,35,0.11
ptg018753l,50066,50394,328,RepeatMasker,DNA,50028,51035,328,1.00
ptg018831l,387562,387851,289,RepeatMasker,DNA,387517,387652,90,0.31
ptg018857l,807500,807807,307,RepeatMasker,DNA,807521,807584,64,0.21
ptg018878l,1597195,1597504,309,RepeatMasker,DNA,1597350,1597407,58,0.19
ptg018882l,1073832,1074148,316,RepeatMasker,DNA,1073541,1074781,316,1.00
ptg018922l,891055,891350,295,RepeatMasker,DNA,890783,891347,292,0.99
ptg018922l,891055,891350,295,RepeatMasker,DNA,890858,891421,295,1.00
ptg018925l,375197,375481,284,RepeatMasker,DNA,375452,375639,30,0.11
ptg019027l,104160,104485,325,RepeatMasker,DNA,104397,104830,89,0.27
ptg019034l,46683,46996,313,RepeatMasker,DNA,46969,48645,28,0.09
ptg019077l,178185,178503,318,RepeatMasker,DNA,178381,178574,123,0.39
ptg019101l,461730,462024,294,RepeatMasker,DNA,461452,461849,119,0.40
ptg019120l,321505,321787,282,RepeatMasker,DNA,321265,322003,282,1.00
ptg019136l,767531,767829,298,RepeatMasker,DNA,767590,768742,240,0.81
ptg019255l,1045260,1045554,294,RepeatMasker,DNA,1045469,1046568,86,0.29
ptg019274l,490529,490819,290,RepeatMasker,DNA,488403,490634,105,0.36
ptg019349l,776186,776512,326,RepeatMasker,DNA,776430,776674,83,0.25
ptg019443l,293797,294075,278,RepeatMasker,DNA,292557,293889,92,0.33
ptg019469l,78683,79001,318,RepeatMasker,DNA,78979,79018,23,0.07
ptg019593l,298647,298952,305,RepeatMasker,DNA,298851,299762,102,0.33
ptg019686l,632852,633145,293,RepeatMasker,DNA,632477,632855,3,0.01
ptg019686l,632852,633145,293,RepeatMasker,DNA,633059,633205,87,0.30
ptg019793l,514204,514484,280,RepeatMasker,DNA,514324,514523,161,0.58
ptg019825l,132858,133148,290,RepeatMasker,DNA,132988,133200,161,0.56
ptg019881l,337230,337513,283,RepeatMasker,DNA,337148,337322,92,0.33
ptg019900l,293536,293855,319,RepeatMasker,DNA,293809,294016,47,0.15
ptg019904l,667609,667922,313,RepeatMasker,DNA,667900,667946,23,0.07
ptg019967l,90659,90969,310,RepeatMasker,DNA,90865,91073,105,0.34
ptg020010l,48167,48460,293,RepeatMasker,DNA,48377,48527,84,0.29
ptg020078l,958130,958411,281,RepeatMasker,DNA,958251,958450,161,0.57
ptg020104l,152514,152838,324,RepeatMasker,DNA,152307,152713,199,0.61
ptg020107l,595592,595904,312,RepeatMasker,DNA,595882,595928,23,0.07
ptg020197l,356486,356797,311,RepeatMasker,DNA,356775,356821,23,0.07
ptg020245l,125513,125798,285,RepeatMasker,DNA,125530,126371,269,0.94
ptg020345l,171758,172041,283,RepeatMasker,DNA,171726,171849,91,0.32
ptg020358l,282409,282715,306,RepeatMasker,DNA,282671,282960,45,0.15
ptg020358l,282731,283020,289,RepeatMasker,DNA,282671,282960,229,0.79
ptg020416l,38744,39042,298,RepeatMasker,DNA,38566,38853,109,0.37
ptg020428l,35177,35459,282,RepeatMasker,DNA,35299,35503,161,0.57
ptg020428l,258863,259156,293,RepeatMasker,DNA,259134,259180,23,0.08
ptg020443l,104656,104936,280,RepeatMasker,DNA,104777,104976,160,0.57
ptg020485l,903410,903730,320,RepeatMasker,DNA,903562,903770,169,0.53
ptg020513l,327647,327979,332,RepeatMasker,DNA,327893,328324,87,0.26
ptg020622l,964278,964533,255,RepeatMasker,DNA,964501,964733,33,0.13
ptg020748l,262149,262429,280,RepeatMasker,DNA,262269,262471,161,0.58
ptg020752l,619668,619972,304,RepeatMasker,DNA,619886,620203,87,0.29
ptg020771l,170210,170500,290,RepeatMasker,DNA,169502,170301,91,0.31
ptg020782l,26494,26783,289,RepeatMasker,DNA,24829,26583,89,0.31
ptg020854l,146803,147084,281,RepeatMasker,DNA,146814,147250,271,0.96
ptg020864l,694476,694801,325,RepeatMasker,DNA,694486,694653,168,0.52
ptg020864l,694476,694801,325,RepeatMasker,DNA,694523,694732,210,0.65
ptg020953l,382202,382510,308,RepeatMasker,DNA,382370,382589,141,0.46
ptg020960l,1777310,1777627,317,RepeatMasker,DNA,1777380,1779676,248,0.78
ptg021095l,476232,476542,310,RepeatMasker,DNA,475975,476597,310,1.00
ptg021111l,283556,283862,306,RepeatMasker,DNA,283776,283909,87,0.28
ptg021180l,457688,458025,337,RepeatMasker,DNA,457642,458103,337,1.00
ptg021299l,116729,117027,298,RepeatMasker,DNA,116867,117066,161,0.54
ptg021313l,1298457,1298739,282,RepeatMasker,DNA,1298642,1299056,98,0.35
ptg021490l,900765,901087,322,RepeatMasker,DNA,897085,900766,1,0.00
ptg021558l,32537,32852,315,RepeatMasker,DNA,32729,32882,124,0.39
ptg021574l,1138452,1138767,315,RepeatMasker,DNA,1138644,1138829,124,0.39
ptg021647l,463194,463513,319,RepeatMasker,DNA,463482,466304,32,0.10
ptg021769l,88675,88987,312,RepeatMasker,DNA,88918,88983,66,0.21
ptg021771l,361689,362004,315,RepeatMasker,DNA,361375,362636,315,1.00
ptg021836l,35665,35994,329,RepeatMasker,DNA,35063,35907,242,0.74
ptg021846l,1118049,1118327,278,RepeatMasker,DNA,1118206,1118373,122,0.44
ptg021871l,144658,144971,313,RepeatMasker,DNA,144778,144993,194,0.62
ptg021899l,149856,150155,299,RepeatMasker,DNA,150055,150323,101,0.34
ptg022003l,1695576,1695856,280,RepeatMasker,DNA,1695697,1695895,160,0.57
ptg022016l,186375,186669,294,RepeatMasker,DNA,186103,186649,274,0.93
ptg022016l,186375,186669,294,RepeatMasker,DNA,186179,186740,294,1.00
ptg022066l,277812,278127,315,RepeatMasker,DNA,277968,278203,160,0.51
ptg022078l,8348,8643,295,RepeatMasker,DNA,8616,8662,28,0.09
ptg022080l,202161,202484,323,RepeatMasker,DNA,202125,202848,323,1.00
ptg022151l,32654,32934,280,RepeatMasker,DNA,32774,32977,161,0.58
ptg022192l,779321,779601,280,RepeatMasker,DNA,779442,779646,160,0.57
ptg022243l,741020,741314,294,RepeatMasker,DNA,741303,744104,12,0.04
ptg022247l,85316,85633,317,RepeatMasker,DNA,85513,85712,121,0.38
ptg022256l,559022,559322,300,RepeatMasker,DNA,555798,560141,300,1.00
ptg022256l,639634,639899,265,RepeatMasker,DNA,639462,639705,71,0.27
ptg022256l,639634,639899,265,RepeatMasker,DNA,639576,639818,184,0.69
ptg022256l,639634,639899,265,RepeatMasker,DNA,639688,639929,212,0.80
ptg022328l,48245,48528,283,RepeatMasker,DNA,48180,48670,283,1.00
ptg022353l,213867,214167,300,RepeatMasker,DNA,214019,215799,149,0.50
ptg022479l,197574,197855,281,RepeatMasker,DNA,197695,197895,161,0.57
ptg022551l,1145181,1145480,299,RepeatMasker,DNA,1144547,1145317,136,0.45
ptg022582l,357875,358170,295,RepeatMasker,DNA,357603,358167,292,0.99
ptg022582l,357875,358170,295,RepeatMasker,DNA,357678,358241,295,1.00
ptg022693l,307211,307484,273,RepeatMasker,DNA,307459,307594,26,0.10
ptg022755l,161963,162240,277,RepeatMasker,DNA,162080,162280,161,0.58
ptg022858l,47256,47546,290,RepeatMasker,DNA,46756,47349,93,0.32
ptg022873l,534749,535053,304,RepeatMasker,DNA,534455,535008,259,0.85
ptg022886l,276025,276324,299,RepeatMasker,DNA,276206,276402,119,0.40
ptg022983l,40457,40738,281,RepeatMasker,DNA,40578,40788,161,0.57
ptg023022l,508135,508462,327,RepeatMasker,DNA,508435,508481,28,0.09
ptg023022l,508135,508462,327,RepeatMasker,DNA,507274,508408,273,0.83
ptg023132l,181487,181766,279,RepeatMasker,DNA,181681,181926,86,0.31
ptg023164l,888547,888837,290,RepeatMasker,DNA,888820,892010,18,0.06
ptg023172l,207870,208195,325,RepeatMasker,DNA,208110,208938,86,0.26
ptg023240l,230576,230882,306,RepeatMasker,DNA,230622,230673,52,0.17
ptg023243l,12038,12337,299,RepeatMasker,DNA,12304,12505,34,0.11
ptg023340l,462501,462815,314,RepeatMasker,DNA,462693,462895,123,0.39
ptg023342l,108810,109126,316,RepeatMasker,DNA,108519,109760,316,1.00
ptg023506l,4731,5044,313,RepeatMasker,DNA,5022,5068,23,0.07
ptg023531l,499067,499357,290,RepeatMasker,DNA,498073,499160,93,0.32
ptg023657l,467881,468167,286,RepeatMasker,DNA,467471,467962,81,0.28
ptg023671l,316655,316967,312,RepeatMasker,DNA,316906,316963,58,0.19
ptg023717l,236863,237137,274,RepeatMasker,DNA,237043,237356,95,0.35
ptg023717l,236863,237137,274,RepeatMasker,DNA,237137,237466,1,0.00
ptg023752l,1200526,1200822,296,RepeatMasker,DNA,1200805,1201304,18,0.06
ptg023990l,373410,373719,309,RepeatMasker,DNA,373041,373673,263,0.85
ptg024015l,460367,460677,310,RepeatMasker,DNA,460605,460985,73,0.24
ptg024044l,76200,76480,280,RepeatMasker,DNA,76320,76526,161,0.58
ptg024077l,221671,221996,325,RepeatMasker,DNA,221586,222500,325,1.00
ptg024137l,38083,38401,318,RepeatMasker,DNA,38369,39975,33,0.10
ptg024149l,393903,394182,279,RepeatMasker,DNA,394023,394220,160,0.57
ptg024270l,176874,177198,324,RepeatMasker,DNA,176786,176906,32,0.10
ptg024270l,176874,177198,324,RepeatMasker,DNA,176900,179031,299,0.92
ptg024274l,936411,936702,291,RepeatMasker,DNA,934274,936652,241,0.83
ptg024328l,321294,321621,327,RepeatMasker,DNA,321252,322237,327,1.00
ptg024383l,1363918,1364251,333,RepeatMasker,DNA,1363880,1364898,333,1.00
ptg024402l,241251,241577,326,RepeatMasker,DNA,241118,241302,51,0.16
ptg024414l,40978,41283,305,RepeatMasker,DNA,39166,41069,91,0.30
ptg024456l,949848,950109,261,RepeatMasker,DNA,950076,950288,34,0.13
ptg024601l,285006,285283,277,RepeatMasker,DNA,284734,285263,257,0.93
ptg024607l,547995,548316,321,RepeatMasker,DNA,548012,548954,305,0.95
ptg024619l,7157,7468,311,RepeatMasker,DNA,7309,7392,84,0.27
ptg024623l,95777,96103,326,RepeatMasker,DNA,96023,96803,81,0.25
ptg024776l,122767,123096,329,RepeatMasker,DNA,122859,123498,238,0.72
ptg024783l,393794,394087,293,RepeatMasker,DNA,393084,393885,91,0.31
ptg024839l,78628,78944,316,RepeatMasker,DNA,78858,79124,87,0.28
ptg024846l,152263,152593,330,RepeatMasker,DNA,152506,153134,88,0.27
ptg024881l,647286,647566,280,RepeatMasker,DNA,647406,647610,161,0.58
ptg024938l,55341,55636,295,RepeatMasker,DNA,55069,55616,275,0.93
ptg024938l,55341,55636,295,RepeatMasker,DNA,55144,55707,295,1.00
ptg024971l,346620,346936,316,RepeatMasker,DNA,346909,346942,28,0.09
ptg024977l,174694,174972,278,RepeatMasker,DNA,172949,174785,91,0.33
ptg025161l,469578,469858,280,RepeatMasker,DNA,469579,469773,195,0.70
ptg025287l,26729,27027,298,RepeatMasker,DNA,26429,27089,298,1.00
ptg025369l,105476,105790,314,RepeatMasker,DNA,105387,107639,314,1.00
ptg025376l,2078938,2079243,305,RepeatMasker,DNA,2079083,2079285,161,0.53
ptg025444l,275402,275718,316,RepeatMasker,DNA,275418,275501,84,0.27
ptg025673l,285319,285622,303,RepeatMasker,DNA,284007,285425,106,0.35
ptg025708l,163699,164021,322,RepeatMasker,DNA,163895,164100,127,0.39
ptg025722l,304177,304511,334,RepeatMasker,DNA,304479,304654,33,0.10
ptg025922l,60288,60574,286,RepeatMasker,DNA,60010,60380,92,0.32
ptg025935l,738587,738884,297,RepeatMasker,DNA,738776,738964,109,0.37
ptg026085l,146254,146572,318,RepeatMasker,DNA,146550,146596,23,0.07
ptg026382l,88404,88701,297,RepeatMasker,DNA,88658,88798,44,0.15
ptg026582l,46265,46555,290,RepeatMasker,DNA,45678,46367,102,0.35
ptg026620l,132181,132465,284,RepeatMasker,DNA,131928,133048,284,1.00
ptg026670l,491329,491633,304,RepeatMasker,DNA,489830,493256,304,1.00
ptg026711l,40581,40862,281,RepeatMasker,DNA,40702,40901,161,0.57
ptg026775l,813450,813742,292,RepeatMasker,DNA,813218,814282,292,1.00
ptg026775l,813450,813742,292,RepeatMasker,DNA,813218,814608,292,1.00
ptg027341l,128266,128553,287,RepeatMasker,DNA,128391,128580,163,0.57
ptg027363l,410448,410745,297,RepeatMasker,DNA,410615,410821,131,0.44
ptg027583l,1086831,1087119,288,RepeatMasker,DNA,1086330,1086984,153,0.53
ptg027669l,1537221,1537503,282,RepeatMasker,DNA,1537169,1537564,282,1.00
ptg027791l,21109,21406,297,RepeatMasker,DNA,21308,21714,99,0.33
ptg027801l,278215,278498,283,RepeatMasker,DNA,277926,278308,93,0.33
ptg027817l,354650,354936,286,RepeatMasker,DNA,353947,354738,88,0.31
ptg028215l,120731,121062,331,RepeatMasker,DNA,120400,120813,82,0.25
ptg028358l,56116,56423,307,RepeatMasker,DNA,56378,58388,46,0.15
ptg028378l,375324,375639,315,RepeatMasker,DNA,375101,375402,78,0.25
ptg028577l,189000,189302,302,RepeatMasker,DNA,188409,189128,128,0.42
ptg028864l,481671,481957,286,RepeatMasker,DNA,481562,481811,140,0.49
ptg028866l,102797,103092,295,RepeatMasker,DNA,102525,103089,292,0.99
ptg028866l,102797,103092,295,RepeatMasker,DNA,102600,103163,295,1.00
ptg028972l,216684,216982,298,RepeatMasker,DNA,216420,217248,298,1.00
ptg029055l,200242,200523,281,RepeatMasker,DNA,200363,200562,161,0.57
ptg029195l,60253,60549,296,RepeatMasker,DNA,60026,60538,285,0.96
ptg029270l,337055,337352,297,RepeatMasker,DNA,336786,337148,93,0.31
ptg029286l,66738,67047,309,RepeatMasker,DNA,66974,67179,74,0.24
ptg029672l,202298,202620,322,RepeatMasker,DNA,202593,202643,28,0.09
ptg029679l,89142,89422,280,RepeatMasker,DNA,89262,89474,161,0.58
ptg029697l,427145,427446,301,RepeatMasker,DNA,427420,427484,27,0.09
ptg029969l,62746,63026,280,RepeatMasker,DNA,62866,63070,161,0.58
ptg030036l,68861,69156,295,RepeatMasker,DNA,68996,69195,161,0.55
ptg030186l,201297,201611,314,RepeatMasker,DNA,201082,201379,82,0.26
ptg030513l,1538,1850,312,RepeatMasker,DNA,1828,1874,23,0.07
ptg030696l,132006,132291,285,RepeatMasker,DNA,132145,132224,80,0.28
ptg030696l,132006,132291,285,RepeatMasker,DNA,132235,132321,57,0.20
ptg030979l,73158,73451,293,RepeatMasker,DNA,73389,73447,59,0.20
ptg031127l,227154,227468,314,RepeatMasker,DNA,225519,227397,243,0.77
ptg031791l,615951,616239,288,RepeatMasker,DNA,614896,616193,242,0.84
ptg031797l,114195,114523,328,RepeatMasker,DNA,114165,114989,328,1.00
ptg031809l,165980,166286,306,RepeatMasker,DNA,166093,166934,194,0.63
ptg031842l,95972,96247,275,RepeatMasker,DNA,96220,96266,28,0.10
ptg031893l,70533,70851,318,RepeatMasker,DNA,70829,70875,23,0.07
ptg032202l,145340,145653,313,RepeatMasker,DNA,145631,145677,23,0.07
ptg032690l,265428,265708,280,RepeatMasker,DNA,265548,265747,161,0.58
ptg032875l,60834,61127,293,RepeatMasker,DNA,59063,60925,91,0.31
ptg032963l,14406,14685,279,RepeatMasker,DNA,13437,14449,43,0.15
ptg032997l,324581,324913,332,RepeatMasker,DNA,324109,324824,243,0.73
ptg033296l,64227,64508,281,RepeatMasker,DNA,64348,64549,161,0.57
ptg033723l,1041681,1041967,286,RepeatMasker,DNA,1040251,1041765,84,0.29
ptg034179l,840047,840328,281,RepeatMasker,DNA,839807,840465,281,1.00
ptg034228l,361781,362082,301,RepeatMasker,DNA,362049,362259,34,0.11
ptg034293l,607878,608167,289,RepeatMasker,DNA,608075,608799,93,0.32
ptg034571l,14306,14588,282,RepeatMasker,DNA,14254,14633,282,1.00
ptg034571l,33320,33644,324,RepeatMasker,DNA,33372,33559,188,0.58
ptg034571l,33320,33644,324,RepeatMasker,DNA,33622,33668,23,0.07
ptg034816l,33044,33320,276,RepeatMasker,DNA,32490,33157,113,0.41
ptg035224l,131181,131482,301,RepeatMasker,DNA,130134,131289,108,0.36
ptg035260l,449170,449450,280,RepeatMasker,DNA,449290,449494,161,0.58
ptg036340l,37659,37975,316,RepeatMasker,DNA,37027,37733,74,0.23
ptg036866l,2903461,2903745,284,RepeatMasker,DNA,2903735,2903838,11,0.04
ptg038776l,315695,315997,302,RepeatMasker,DNA,315936,316373,62,0.21
ptg039549l,3128318,3128630,312,RepeatMasker,DNA,3128245,3128463,145,0.46
ptg039662l,4102618,4102898,280,RepeatMasker,DNA,4102738,4102943,161,0.58
ptg041354l,69504,69784,280,RepeatMasker,DNA,69637,69885,148,0.53
ptg041904l,56299,56580,281,RepeatMasker,DNA,56421,56618,160,0.57
ptg042415l,1367981,1368318,337,RepeatMasker,DNA,1367334,1368154,173,0.51
ptg042615l,106617,106935,318,RepeatMasker,DNA,106776,106975,160,0.50
ptg043251l,291664,291951,287,RepeatMasker,DNA,291392,291931,267,0.93
ptg043251l,291664,291951,287,RepeatMasker,DNA,291467,292022,287,1.00
ptg044072l,150893,151194,301,RepeatMasker,DNA,150746,150898,5,0.02
ptg044072l,150893,151194,301,RepeatMasker,DNA,151044,151154,111,0.37
ptg044599l,232996,233304,308,RepeatMasker,DNA,232717,234113,308,1.00
ptg044938l,16363,16647,284,RepeatMasker,DNA,16646,16702,2,0.01
ptg046805l,214752,215081,329,RepeatMasker,DNA,215023,215072,50,0.15
ptg047559l,8299,8610,311,RepeatMasker,DNA,8362,8732,249,0.80
ptg050564l,61195,61490,295,RepeatMasker,DNA,61331,61532,160,0.54
ptg053617l,185560,185870,310,RepeatMasker,DNA,185522,185661,101,0.33
ptg053617l,185560,185870,310,RepeatMasker,DNA,185686,186503,185,0.60
ptg054119l,629,909,280,RepeatMasker,DNA,750,954,160,0.57
ptg056002l,356827,357140,313,RepeatMasker,DNA,356935,357213,206,0.66
ptg057520l,36567,36892,325,RepeatMasker,DNA,36586,36729,144,0.44
ptg057861l,11662,11943,281,RepeatMasker,DNA,11783,11986,161,0.57
ptg000004l,2589753,2590047,294,RepeatMasker,DNA,2589720,2589913,160,0.54
ptg000004l,2638325,2638605,280,RepeatMasker,DNA,2638273,2638485,160,0.57
ptg000043l,1229327,1229607,280,RepeatMasker,DNA,1229191,1229544,217,0.78
ptg000048l,11150888,11151177,289,RepeatMasker,DNA,11150774,11150930,42,0.15
ptg000057l,1866889,1867182,293,RepeatMasker,DNA,1866820,1867139,250,0.85
ptg000071l,5602261,5602536,275,RepeatMasker,DNA,5602242,5602409,148,0.54
ptg000078l,81130,81411,281,RepeatMasker,DNA,80449,81638,281,1.00
ptg000080l,1520752,1521047,295,RepeatMasker,DNA,1520681,1521255,295,1.00
ptg000080l,1520752,1521047,295,RepeatMasker,DNA,1520772,1521319,276,0.94
ptg000080l,3233117,3233398,281,RepeatMasker,DNA,3233046,3233276,159,0.57
ptg000080l,3406971,3407250,279,RepeatMasker,DNA,3406815,3407004,33,0.12
ptg000089l,1753396,1753676,280,RepeatMasker,DNA,1753263,1753555,159,0.57
ptg000089l,2118594,2118874,280,RepeatMasker,DNA,2114763,2118939,280,1.00
ptg000089l,2727207,2727496,289,RepeatMasker,DNA,2727406,2729000,91,0.31
ptg000094l,9004896,9005186,290,RepeatMasker,DNA,9005127,9006587,60,0.21
ptg000096l,1660227,1660528,301,RepeatMasker,DNA,1660148,1660388,161,0.53
ptg000104l,6629850,6630168,318,RepeatMasker,DNA,6629778,6629971,121,0.38
ptg000115l,784456,784784,328,RepeatMasker,DNA,784541,785391,244,0.74
ptg000156l,2153680,2153979,299,RepeatMasker,DNA,2153845,2153904,60,0.20
ptg000171l,515237,515537,300,RepeatMasker,DNA,515157,515361,124,0.41
ptg000175l,182367,182664,297,RepeatMasker,DNA,182243,182450,83,0.28
ptg000175l,516764,517046,282,RepeatMasker,DNA,516706,517286,282,1.00
ptg000179l,1553586,1553891,305,RepeatMasker,DNA,1553684,1554110,208,0.68
ptg000186l,6669099,6669385,286,RepeatMasker,DNA,6668948,6669127,28,0.10
ptg000193l,290479,290759,280,RepeatMasker,DNA,290439,290638,159,0.57
ptg000200l,3535075,3535401,326,RepeatMasker,DNA,3535035,3535109,34,0.10
ptg000232l,1107741,1108035,294,RepeatMasker,DNA,1107613,1107929,188,0.64
ptg000234l,3546260,3546565,305,RepeatMasker,DNA,3545625,3547171,305,1.00
ptg000261l,255101,255430,329,RepeatMasker,DNA,254700,255338,237,0.72
ptg000281l,318802,319099,297,RepeatMasker,DNA,318764,318961,159,0.54
ptg000283l,594180,594458,278,RepeatMasker,DNA,594367,595044,92,0.33
ptg000307l,2060849,2061162,313,RepeatMasker,DNA,2060825,2060871,22,0.07
ptg000325l,2091178,2091491,313,RepeatMasker,DNA,2091154,2091200,22,0.07
ptg000330l,445480,445775,295,RepeatMasker,DNA,445409,445972,295,1.00
ptg000330l,445480,445775,295,RepeatMasker,DNA,445483,446047,293,0.99
ptg000337l,7216460,7216766,306,RepeatMasker,DNA,7216464,7216520,57,0.19
ptg000367l,843153,843469,316,RepeatMasker,DNA,843117,843313,160,0.51
ptg000412l,184350,184679,329,RepeatMasker,DNA,184292,184717,329,1.00
ptg000421l,390690,390996,306,RepeatMasker,DNA,389002,391332,306,1.00
ptg000425l,134840,135128,288,RepeatMasker,DNA,135037,135697,92,0.32
ptg000438l,115715,116025,310,RepeatMasker,DNA,115702,115783,68,0.22
ptg000454l,2627287,2627586,299,RepeatMasker,DNA,2627113,2627320,33,0.11
ptg000493l,1513621,1513922,301,RepeatMasker,DNA,1513266,1513706,85,0.28
ptg000515l,5487950,5488231,281,RepeatMasker,DNA,5487642,5488018,68,0.24
ptg000520l,3754121,3754399,278,RepeatMasker,DNA,3751054,3754723,278,1.00
ptg000535l,148712,148993,281,RepeatMasker,DNA,148360,149196,281,1.00
ptg000561l,823659,823962,303,RepeatMasker,DNA,823420,823762,103,0.34
ptg000585l,2071872,2072178,306,RepeatMasker,DNA,2072115,2072425,64,0.21
ptg000605l,2069761,2070053,292,RepeatMasker,DNA,2069532,2069785,24,0.08
ptg000607l,1772708,1773005,297,RepeatMasker,DNA,1772826,1773341,180,0.61
ptg000615l,1395531,1395821,290,RepeatMasker,DNA,1395729,1395854,93,0.32
ptg000615l,2646081,2646393,312,RepeatMasker,DNA,2646057,2646103,22,0.07
ptg000617l,722292,722612,320,RepeatMasker,DNA,721663,722857,320,1.00
ptg000645l,1670783,1671064,281,RepeatMasker,DNA,1670750,1670941,158,0.56
ptg000676l,2646767,2647092,325,RepeatMasker,DNA,2646595,2647124,325,1.00
ptg000677l,158549,158833,284,RepeatMasker,DNA,158587,159150,247,0.87
ptg000733l,174241,174779,538,RepeatMasker,DNA,174064,174274,33,0.06
ptg000733l,174241,174779,538,RepeatMasker,DNA,174340,174386,47,0.09
ptg000767l,2139847,2140140,293,RepeatMasker,DNA,2139573,2140374,293,1.00
ptg000795l,2994971,2995278,307,RepeatMasker,DNA,2994647,2995077,106,0.35
ptg000798l,5182227,5182516,289,RepeatMasker,DNA,5182424,5183498,93,0.32
ptg000805l,1134845,1135079,234,RepeatMasker,DNA,1134849,1134906,58,0.25
ptg000813l,1597956,1598271,315,RepeatMasker,DNA,1597744,1598562,315,1.00
ptg000818l,928250,928577,327,RepeatMasker,DNA,928344,928535,192,0.59
ptg000820l,2097689,2098004,315,RepeatMasker,DNA,2097659,2097813,124,0.39
ptg000840l,2719849,2720144,295,RepeatMasker,DNA,2719809,2720009,160,0.54
ptg000847l,5009534,5009824,290,RepeatMasker,DNA,5009352,5009567,33,0.11
ptg000874l,1733581,1733900,319,RepeatMasker,DNA,1733770,1733875,106,0.33
ptg000925l,743809,744120,311,RepeatMasker,DNA,743768,743969,160,0.51
ptg000925l,758253,758534,281,RepeatMasker,DNA,758212,758413,160,0.57
ptg000927l,640992,641288,296,RepeatMasker,DNA,640953,641152,160,0.54
ptg000971l,2277654,2277956,302,RepeatMasker,DNA,2277473,2277815,161,0.53
ptg000990l,219825,220109,284,RepeatMasker,DNA,219793,220092,267,0.94
ptg000993l,625976,626274,298,RepeatMasker,DNA,626095,626900,180,0.60
ptg000996l,2239237,2239561,324,RepeatMasker,DNA,2239310,2239392,83,0.26
ptg001000l,1144173,1144490,317,RepeatMasker,DNA,1144149,1144195,22,0.07
ptg001052l,192028,192316,288,RepeatMasker,DNA,192189,192258,70,0.24
ptg001070l,170784,171067,283,RepeatMasker,DNA,170589,171048,264,0.93
ptg001077l,2279195,2279521,326,RepeatMasker,DNA,2279112,2279552,326,1.00
ptg001077l,5497588,5497900,312,RepeatMasker,DNA,5497564,5497610,22,0.07
ptg001083l,666784,667115,331,RepeatMasker,DNA,666707,667158,331,1.00
ptg001108l,216551,216858,307,RepeatMasker,DNA,216389,216632,81,0.26
ptg001108l,1104139,1104463,324,RepeatMasker,DNA,1103566,1104200,61,0.19
ptg001120l,394933,395232,299,RepeatMasker,DNA,394307,395126,193,0.65
ptg001131l,3523589,3523918,329,RepeatMasker,DNA,3522737,3523675,86,0.26
ptg001131l,3523589,3523918,329,RepeatMasker,DNA,3523691,3523741,51,0.16
ptg001161l,1158701,1158993,292,RepeatMasker,DNA,1158900,1159198,94,0.32
ptg001177l,1107686,1107979,293,RepeatMasker,DNA,1107690,1107746,57,0.19
ptg001210l,383880,384160,280,RepeatMasker,DNA,383838,384040,160,0.57
ptg001221l,1100100,1100375,275,RepeatMasker,DNA,1100069,1100130,30,0.11
ptg001244l,254294,254561,267,RepeatMasker,DNA,254527,254580,35,0.13
ptg001255l,330525,330786,261,RepeatMasker,DNA,330477,330616,91,0.35
ptg001288l,2334253,2334534,281,RepeatMasker,DNA,2334398,2334459,62,0.22
ptg001301l,692297,692600,303,RepeatMasker,DNA,692181,692327,30,0.10
ptg001305l,1655475,1655778,303,RepeatMasker,DNA,1655299,1655510,35,0.12
ptg001305l,4687849,4688175,326,RepeatMasker,DNA,4687447,4688004,155,0.48
ptg001305l,4687849,4688175,326,RepeatMasker,DNA,4687447,4688083,234,0.72
ptg001341l,639885,640192,307,RepeatMasker,DNA,639947,640018,72,0.23
ptg001353l,235203,235484,281,RepeatMasker,DNA,235023,235236,33,0.12
ptg001358l,1379038,1379324,286,RepeatMasker,DNA,1379276,1380319,49,0.17
ptg001369l,1156208,1156503,295,RepeatMasker,DNA,1156228,1156775,276,0.94
ptg001371l,9563862,9564140,278,RepeatMasker,DNA,9563949,9564161,192,0.69
ptg001371l,9563862,9564140,278,RepeatMasker,DNA,9564028,9564190,113,0.41
ptg001381l,5706833,5707144,311,RepeatMasker,DNA,5707019,5707131,113,0.36
ptg001410l,237174,237475,301,RepeatMasker,DNA,237347,237613,129,0.43
ptg001419l,26046,26375,329,RepeatMasker,DNA,25645,26283,237,0.72
ptg001419l,26046,26375,329,RepeatMasker,DNA,25647,26204,158,0.48
ptg001419l,1077510,1077805,295,RepeatMasker,DNA,1077439,1077999,295,1.00
ptg001419l,1077510,1077805,295,RepeatMasker,DNA,1077513,1078074,293,0.99
ptg001419l,1855804,1856118,314,RepeatMasker,DNA,1855576,1855839,35,0.11
ptg001420l,70843,71144,301,RepeatMasker,DNA,70989,72096,156,0.52
ptg001430l,164381,164667,286,RepeatMasker,DNA,164425,164963,243,0.85
ptg001441l,1620674,1620952,278,RepeatMasker,DNA,1620809,1621577,144,0.52
ptg001452l,494962,495294,332,RepeatMasker,DNA,494313,495332,332,1.00
ptg001519l,2892565,2892845,280,RepeatMasker,DNA,2892747,2893164,99,0.35
ptg001522l,14451,14744,293,RepeatMasker,DNA,14405,14611,160,0.55
ptg001527l,1845404,1845736,332,RepeatMasker,DNA,1845493,1846341,244,0.73
ptg001544l,1598602,1598895,293,RepeatMasker,DNA,1598804,1599890,92,0.31
ptg001551l,2047505,2047792,287,RepeatMasker,DNA,2045748,2047972,287,1.00
ptg001552l,3321740,3322029,289,RepeatMasker,DNA,3321937,3323184,93,0.32
ptg001567l,1384667,1384963,296,RepeatMasker,DNA,1384897,1385191,67,0.23
ptg001567l,2663106,2663367,261,RepeatMasker,DNA,2662779,2663212,106,0.41
ptg001637l,1629497,1629827,330,RepeatMasker,DNA,1628826,1629865,330,1.00
ptg001641l,3638968,3639255,287,RepeatMasker,DNA,3638809,3639001,33,0.11
ptg001656l,1761273,1761570,297,RepeatMasker,DNA,1761226,1761433,160,0.54
ptg001656l,4342561,4342872,311,RepeatMasker,DNA,4342551,4342595,34,0.11
ptg001663l,8953076,8953366,290,RepeatMasker,DNA,8952593,8953615,290,1.00
ptg001666l,4378786,4379044,258,RepeatMasker,DNA,4378829,4378887,59,0.23
ptg001666l,6933230,6933502,272,RepeatMasker,DNA,6933169,6933615,272,1.00
ptg001669l,218911,219191,280,RepeatMasker,DNA,218871,219071,160,0.57
ptg001669l,2062273,2062541,268,RepeatMasker,DNA,2062467,2063292,75,0.28
ptg001677l,354354,354670,316,RepeatMasker,DNA,354533,354631,99,0.31
ptg001682l,3754084,3754397,313,RepeatMasker,DNA,3754060,3754106,22,0.07
ptg001685l,3930346,3930646,300,RepeatMasker,DNA,3930316,3930455,109,0.36
ptg001723l,426478,426773,295,RepeatMasker,DNA,426407,426970,295,1.00
ptg001723l,426478,426773,295,RepeatMasker,DNA,426481,427045,293,0.99
ptg001739l,2755341,2755628,287,RepeatMasker,DNA,2755215,2755775,287,1.00
ptg001740l,3692874,3693203,329,RepeatMasker,DNA,3692472,3693111,237,0.72
ptg001745l,1276325,1276646,321,RepeatMasker,DNA,1276086,1276684,321,1.00
ptg001833l,468967,469248,281,RepeatMasker,DNA,468927,469013,46,0.16
ptg001851l,5843439,5843713,274,RepeatMasker,DNA,5843297,5843464,25,0.09
ptg001868l,223939,224242,303,RepeatMasker,DNA,223350,223961,22,0.07
ptg001868l,223939,224242,303,RepeatMasker,DNA,223837,223987,48,0.16
ptg001878l,233223,233525,302,RepeatMasker,DNA,233293,233779,233,0.77
ptg001921l,1416728,1417008,280,RepeatMasker,DNA,1416823,1416883,61,0.22
ptg001923l,2796277,2796557,280,RepeatMasker,DNA,2796233,2796437,160,0.57
ptg001935l,979190,979493,303,RepeatMasker,DNA,979018,979285,95,0.31
ptg001936l,5261219,5261505,286,RepeatMasker,DNA,5261223,5261281,59,0.21
ptg001943l,2533802,2534122,320,RepeatMasker,DNA,2533750,2533975,173,0.54
ptg001943l,2533802,2534122,320,RepeatMasker,DNA,2533802,2533975,173,0.54
ptg001964l,1259538,1259833,295,RepeatMasker,DNA,1259467,1260031,295,1.00
ptg001964l,1259538,1259833,295,RepeatMasker,DNA,1259558,1260106,276,0.94
ptg001968l,326086,326402,316,RepeatMasker,DNA,326006,326191,105,0.33
ptg001974l,2041385,2041691,306,RepeatMasker,DNA,2041214,2041452,67,0.22
ptg001988l,765394,765691,297,RepeatMasker,DNA,765596,765997,96,0.32
ptg001997l,265446,265758,312,RepeatMasker,DNA,265424,265468,22,0.07
ptg002002l,929733,930011,278,RepeatMasker,DNA,929456,930258,278,1.00
ptg002002l,929733,930011,278,RepeatMasker,DNA,929922,930530,90,0.32
ptg002011l,1630205,1630473,268,RepeatMasker,DNA,1629928,1630305,100,0.37
ptg002017l,154456,154736,280,RepeatMasker,DNA,154404,154616,160,0.57
ptg002044l,609783,610109,326,RepeatMasker,DNA,609555,609818,35,0.11
ptg002064l,2603813,2604125,312,RepeatMasker,DNA,2603789,2603835,22,0.07
ptg002064l,3242582,3242899,317,RepeatMasker,DNA,3242558,3242604,22,0.07
ptg002065l,2928115,2928397,282,RepeatMasker,DNA,2928202,2928402,196,0.70
ptg002065l,2928115,2928397,282,RepeatMasker,DNA,2928303,2928460,95,0.34
ptg002166l,1077887,1078167,280,RepeatMasker,DNA,1077848,1078047,160,0.57
ptg002187l,501208,501503,295,RepeatMasker,DNA,501137,501700,295,1.00
ptg002187l,501208,501503,295,RepeatMasker,DNA,501228,501775,276,0.94
ptg002211l,2043446,2043735,289,RepeatMasker,DNA,2043587,2043674,88,0.30
ptg002261l,298818,299112,294,RepeatMasker,DNA,298777,298983,165,0.56
ptg002277l,1435019,1435300,281,RepeatMasker,DNA,1434984,1435179,160,0.57
ptg002284l,2074689,2075012,323,RepeatMasker,DNA,2074650,2074848,159,0.49
ptg002284l,2082261,2082583,322,RepeatMasker,DNA,2082222,2082420,159,0.49
ptg002296l,915217,915517,300,RepeatMasker,DNA,915067,915250,33,0.11
ptg002302l,1503250,1503572,322,RepeatMasker,DNA,1503336,1503482,147,0.46
ptg002315l,403167,403489,322,RepeatMasker,DNA,403082,403243,76,0.24
ptg002317l,918266,918582,316,RepeatMasker,DNA,918242,918873,316,1.00
ptg002354l,1766417,1766705,288,RepeatMasker,DNA,1766537,1766938,169,0.59
ptg002367l,200581,200893,312,RepeatMasker,DNA,195963,201767,312,1.00
ptg002376l,2141810,2142102,292,RepeatMasker,DNA,2141672,2141893,83,0.28
ptg002377l,725613,725889,276,RepeatMasker,DNA,725803,727132,87,0.32
ptg002391l,1056494,1056822,328,RepeatMasker,DNA,1056093,1056730,236,0.72
ptg002391l,1056494,1056822,328,RepeatMasker,DNA,1056095,1056651,157,0.48
ptg002397l,1248235,1248540,305,RepeatMasker,DNA,1247907,1248322,87,0.29
ptg002397l,1248235,1248540,305,RepeatMasker,DNA,1248010,1248322,87,0.29
ptg002442l,624441,624731,290,RepeatMasker,DNA,624638,626100,94,0.32
ptg002445l,1684175,1684473,298,RepeatMasker,DNA,1684136,1684333,158,0.53
ptg002447l,27449,27754,305,RepeatMasker,DNA,27416,27609,160,0.52
ptg002447l,42441,42721,280,RepeatMasker,DNA,42401,42601,160,0.57
ptg002473l,2711773,2712079,306,RepeatMasker,DNA,2711694,2711821,48,0.16
ptg002497l,1757569,1757881,312,RepeatMasker,DNA,1755944,1757776,207,0.66
ptg002502l,2042797,2043096,299,RepeatMasker,DNA,2042741,2042957,160,0.54
ptg002516l,1299318,1299597,279,RepeatMasker,DNA,1298631,1299447,129,0.46
ptg002516l,1299318,1299597,279,RepeatMasker,DNA,1299495,1299635,103,0.37
ptg002517l,3450498,3450795,297,RepeatMasker,DNA,3450245,3450520,22,0.07
ptg002517l,3450498,3450795,297,RepeatMasker,DNA,3450647,3451403,149,0.50
ptg002573l,844283,844632,349,RepeatMasker,DNA,843895,844362,79,0.23
ptg002591l,581556,581854,298,RepeatMasker,DNA,581404,581638,82,0.28
ptg002605l,526202,526479,277,RepeatMasker,DNA,526378,526824,102,0.37
ptg002618l,364503,364836,333,RepeatMasker,DNA,364333,364569,66,0.20
ptg002618l,364503,364836,333,RepeatMasker,DNA,364431,364681,178,0.53
ptg002618l,364503,364836,333,RepeatMasker,DNA,364543,364793,251,0.75
ptg002618l,364503,364836,333,RepeatMasker,DNA,364655,364905,182,0.55
ptg002618l,364503,364836,333,RepeatMasker,DNA,364767,365018,70,0.21
ptg002619l,325471,325771,300,RepeatMasker,DNA,325679,325901,93,0.31
ptg002619l,754711,754993,282,RepeatMasker,DNA,754902,755562,92,0.33
ptg002629l,589794,590066,272,RepeatMasker,DNA,590002,590406,65,0.24
ptg002637l,3334853,3335134,281,RepeatMasker,DNA,3334814,3335013,160,0.57
ptg002646l,599524,599821,297,RepeatMasker,DNA,599026,600940,297,1.00
ptg002665l,2549198,2549478,280,RepeatMasker,DNA,2549160,2549357,159,0.57
ptg002677l,2303605,2303885,280,RepeatMasker,DNA,2303546,2303764,159,0.57
ptg002677l,4263011,4263294,283,RepeatMasker,DNA,4263056,4263645,239,0.84
ptg002699l,805543,805840,297,RepeatMasker,DNA,805328,805632,89,0.30
ptg002702l,698242,698571,329,RepeatMasker,DNA,698175,698253,11,0.03
ptg002736l,875596,875885,289,RepeatMasker,DNA,875531,875633,37,0.13
ptg002745l,1190434,1190746,312,RepeatMasker,DNA,1190410,1190456,22,0.07
ptg002751l,178989,179257,268,RepeatMasker,DNA,178970,179016,27,0.10
ptg002756l,850286,850612,326,RepeatMasker,DNA,850369,851086,244,0.75
ptg002776l,1626058,1626351,293,RepeatMasker,DNA,1626317,1627174,35,0.12
ptg002789l,6472156,6472444,288,RepeatMasker,DNA,6472357,6473485,88,0.31
ptg002795l,566572,566876,304,RepeatMasker,DNA,566783,569062,94,0.31
ptg002824l,615322,615612,290,RepeatMasker,DNA,615521,617815,92,0.32
ptg002852l,866689,866989,300,RepeatMasker,DNA,866665,866711,22,0.07
ptg002852l,1952037,1952362,325,RepeatMasker,DNA,1952008,1952346,309,0.95
ptg002855l,1239170,1239499,329,RepeatMasker,DNA,1238768,1239407,237,0.72
ptg002858l,3957187,3957482,295,RepeatMasker,DNA,3957116,3957679,295,1.00
ptg002858l,3957187,3957482,295,RepeatMasker,DNA,3957207,3957754,276,0.94
ptg002858l,4722523,4722796,273,RepeatMasker,DNA,4722485,4722531,8,0.03
ptg002862l,5244226,5244515,289,RepeatMasker,DNA,5244441,5244919,75,0.26
ptg002863l,585376,585690,314,RepeatMasker,DNA,582390,585673,297,0.95
ptg002891l,821056,821368,312,RepeatMasker,DNA,821037,821261,205,0.66
ptg002906l,3499056,3499340,284,RepeatMasker,DNA,3499030,3499409,284,1.00
ptg002914l,1149869,1150177,308,RepeatMasker,DNA,1149764,1149918,49,0.16
ptg002915l,511161,511459,298,RepeatMasker,DNA,511008,511194,33,0.11
ptg002916l,1889232,1889505,273,RepeatMasker,DNA,1889011,1889338,106,0.39
ptg002938l,2032047,2032353,306,RepeatMasker,DNA,2032211,2032348,138,0.45
ptg002938l,2032047,2032353,306,RepeatMasker,DNA,2032245,2032425,109,0.36
ptg002960l,477556,477844,288,RepeatMasker,DNA,477752,479020,93,0.32
ptg002963l,1536388,1536717,329,RepeatMasker,DNA,1535986,1536546,158,0.48
ptg002963l,1536388,1536717,329,RepeatMasker,DNA,1535986,1536625,237,0.72
ptg002965l,6814173,6814496,323,RepeatMasker,DNA,6813845,6814277,104,0.32
ptg002981l,1697221,1697510,289,RepeatMasker,DNA,1697419,1697820,92,0.32
ptg002990l,250983,251267,284,RepeatMasker,DNA,251175,251645,93,0.33
ptg002996l,2683961,2684256,295,RepeatMasker,DNA,2683890,2684451,295,1.00
ptg002996l,2683961,2684256,295,RepeatMasker,DNA,2683981,2684526,276,0.94
ptg002997l,4404961,4405243,282,RepeatMasker,DNA,4404825,4405178,217,0.77
ptg002999l,1168431,1168736,305,RepeatMasker,DNA,1168368,1168569,138,0.45
ptg003026l,245422,245739,317,RepeatMasker,DNA,245342,245546,124,0.39
ptg003026l,358338,358654,316,RepeatMasker,DNA,358295,360154,316,1.00
ptg003061l,866201,866481,280,RepeatMasker,DNA,866011,866234,33,0.12
ptg003096l,1266775,1267089,314,RepeatMasker,DNA,1266532,1266865,90,0.29
ptg003116l,327798,328078,280,RepeatMasker,DNA,327753,327958,160,0.57
ptg003140l,385306,385631,325,RepeatMasker,DNA,384688,385662,325,1.00
ptg003154l,1471638,1471953,315,RepeatMasker,DNA,1471907,1472343,47,0.15
ptg003180l,489611,489900,289,RepeatMasker,DNA,489571,489771,160,0.55
ptg003192l,214095,214377,282,RepeatMasker,DNA,214056,214255,160,0.57
ptg003204l,1209533,1209842,309,RepeatMasker,DNA,1209490,1209693,160,0.52
ptg003205l,644422,644707,285,RepeatMasker,DNA,644398,644444,22,0.08
ptg003227l,195582,195897,315,RepeatMasker,DNA,195376,195606,24,0.08
ptg003227l,195582,195897,315,RepeatMasker,DNA,195489,195718,136,0.43
ptg003227l,195582,195897,315,RepeatMasker,DNA,195601,195729,129,0.41
ptg003227l,195582,195897,315,RepeatMasker,DNA,195713,195955,185,0.59
ptg003227l,195582,195897,315,RepeatMasker,DNA,195826,196021,72,0.23
ptg003239l,1478638,1478962,324,RepeatMasker,DNA,1478558,1478766,128,0.40
ptg003268l,3769826,3770158,332,RepeatMasker,DNA,3770048,3770106,59,0.18
ptg003295l,405557,405865,308,RepeatMasker,DNA,405232,405663,106,0.34
ptg003312l,5180118,5180404,286,RepeatMasker,DNA,5180291,5180341,51,0.18
ptg003313l,276062,276352,290,RepeatMasker,DNA,276259,276660,94,0.32
ptg003339l,2780855,2781173,318,RepeatMasker,DNA,2780859,2780915,57,0.18
ptg003391l,1808946,1809235,289,RepeatMasker,DNA,1808782,1808979,33,0.11
ptg003405l,496764,497057,293,RepeatMasker,DNA,496724,496923,159,0.54
ptg003425l,595028,595342,314,RepeatMasker,DNA,594914,595188,160,0.51
ptg003434l,361717,361995,278,RepeatMasker,DNA,361956,362940,40,0.14
ptg003465l,1627569,1627859,290,RepeatMasker,DNA,1627759,1628417,101,0.35
ptg003471l,3425612,3425893,281,RepeatMasker,DNA,3425572,3425772,160,0.57
ptg003504l,902171,902452,281,RepeatMasker,DNA,902100,902253,82,0.29
ptg003507l,828084,828365,281,RepeatMasker,DNA,827611,828244,160,0.57
ptg003526l,4086583,4086859,276,RepeatMasker,DNA,4086671,4086884,189,0.68
ptg003526l,4086583,4086859,276,RepeatMasker,DNA,4086754,4086926,106,0.38
ptg003546l,1710665,1710945,280,RepeatMasker,DNA,1710627,1710825,160,0.57
ptg003554l,3210170,3210490,320,RepeatMasker,DNA,3210391,3210580,100,0.31
ptg003572l,251000,251282,282,RepeatMasker,DNA,250775,251067,67,0.24
ptg003601l,1656655,1656936,281,RepeatMasker,DNA,1656608,1656815,160,0.57
ptg003617l,3178786,3179076,290,RepeatMasker,DNA,3178985,3179346,92,0.32
ptg003618l,1477571,1477891,320,RepeatMasker,DNA,1476172,1478971,320,1.00
ptg003622l,414023,414331,308,RepeatMasker,DNA,413983,414183,160,0.52
ptg003678l,470555,470855,300,RepeatMasker,DNA,470269,470640,85,0.28
ptg003678l,470555,470855,300,RepeatMasker,DNA,470399,470800,245,0.82
ptg003687l,1202429,1202730,301,RepeatMasker,DNA,1202579,1202997,152,0.50
ptg003698l,910486,910742,256,RepeatMasker,DNA,910391,910546,60,0.23
ptg003698l,910486,910742,256,RepeatMasker,DNA,910457,910544,58,0.23
ptg003700l,1907502,1907784,282,RepeatMasker,DNA,1907437,1907661,159,0.56
ptg003700l,1914691,1914972,281,RepeatMasker,DNA,1914627,1914850,159,0.57
ptg003709l,3184478,3184802,324,RepeatMasker,DNA,3184407,3184970,324,1.00
ptg003709l,3184478,3184802,324,RepeatMasker,DNA,3184481,3185045,322,0.99
ptg003713l,36948,37256,308,RepeatMasker,DNA,36637,37527,308,1.00
ptg003720l,5718772,5719059,287,RepeatMasker,DNA,5718146,5718965,193,0.67
ptg003726l,1484203,1484476,273,RepeatMasker,DNA,1484173,1484356,153,0.56
ptg003740l,474728,475040,312,RepeatMasker,DNA,473920,476238,312,1.00
ptg003740l,1072271,1072601,330,RepeatMasker,DNA,1072137,1072533,262,0.79
ptg003753l,3057154,3057437,283,RepeatMasker,DNA,3057344,3058753,94,0.33
ptg003830l,1890711,1891039,328,RepeatMasker,DNA,1890072,1891036,325,0.99
ptg003849l,154699,155013,314,RepeatMasker,DNA,153138,156126,314,1.00
ptg003856l,139425,139716,291,RepeatMasker,DNA,139624,139946,93,0.32
ptg003894l,1183380,1183676,296,RepeatMasker,DNA,1183428,1183688,249,0.84
ptg003911l,550126,550441,315,RepeatMasker,DNA,550438,551054,4,0.01
ptg003916l,310548,310837,289,RepeatMasker,DNA,310746,313042,92,0.32
ptg003927l,875297,875580,283,RepeatMasker,DNA,875509,877124,72,0.25
ptg003980l,1443287,1443599,312,RepeatMasker,DNA,1443263,1443309,22,0.07
ptg004016l,4240206,4240522,316,RepeatMasker,DNA,4237779,4240429,223,0.71
ptg004033l,7575763,7576045,282,RepeatMasker,DNA,7575627,7575980,217,0.77
ptg004051l,931256,931569,313,RepeatMasker,DNA,931232,931278,22,0.07
ptg004096l,1487416,1487714,298,RepeatMasker,DNA,1487610,1489903,105,0.35
ptg004097l,644402,644709,307,RepeatMasker,DNA,644509,644734,201,0.65
ptg004097l,644402,644709,307,RepeatMasker,DNA,644593,644762,117,0.38
ptg004124l,293268,293596,328,RepeatMasker,DNA,293265,293533,265,0.81
ptg004125l,2786976,2787275,299,RepeatMasker,DNA,2787171,2787950,105,0.35
ptg004128l,834349,834673,324,RepeatMasker,DNA,834353,834411,59,0.18
ptg004128l,834349,834673,324,RepeatMasker,DNA,834408,834558,151,0.47
ptg004133l,141836,142131,295,RepeatMasker,DNA,141765,142328,295,1.00
ptg004133l,141836,142131,295,RepeatMasker,DNA,141871,142403,261,0.88
ptg004135l,947619,947947,328,RepeatMasker,DNA,947295,947725,106,0.32
ptg004162l,3152651,3152959,308,RepeatMasker,DNA,3152249,3152888,237,0.77
ptg004164l,272913,273210,297,RepeatMasker,DNA,272885,273889,297,1.00
ptg004165l,664577,664894,317,RepeatMasker,DNA,664253,664663,86,0.27
ptg004183l,258518,258820,302,RepeatMasker,DNA,258344,258540,22,0.07
ptg004193l,313826,314128,302,RepeatMasker,DNA,313802,313848,22,0.07
ptg004208l,2252497,2252780,283,RepeatMasker,DNA,2251878,2252520,23,0.08
ptg004208l,2252497,2252780,283,RepeatMasker,DNA,2252528,2252820,253,0.89
ptg004208l,3975609,3975935,326,RepeatMasker,DNA,3975256,3975715,106,0.33
ptg004217l,869252,869534,282,RepeatMasker,DNA,869213,869410,158,0.56
ptg004276l,1120995,1121306,311,RepeatMasker,DNA,1120328,1121179,184,0.59
ptg004291l,1864035,1864315,280,RepeatMasker,DNA,1863985,1864194,159,0.57
ptg004323l,732650,732938,288,RepeatMasker,DNA,732695,733281,244,0.85
ptg004356l,324779,325079,300,RepeatMasker,DNA,324667,324861,82,0.27
ptg004387l,1139464,1139745,281,RepeatMasker,DNA,1139423,1139624,160,0.57
ptg004412l,318936,319231,295,RepeatMasker,DNA,318865,319428,295,1.00
ptg004412l,318936,319231,295,RepeatMasker,DNA,318956,319503,276,0.94
ptg004445l,1974104,1974413,309,RepeatMasker,DNA,1974080,1974126,22,0.07
ptg004449l,2509633,2509946,313,RepeatMasker,DNA,2509609,2509655,22,0.07
ptg004454l,605790,606055,265,RepeatMasker,DNA,605063,605876,86,0.32
ptg004456l,1586462,1586742,280,RepeatMasker,DNA,1586326,1586679,217,0.78
ptg004463l,376798,377090,292,RepeatMasker,DNA,376765,376958,160,0.55
ptg004491l,1916403,1916683,280,RepeatMasker,DNA,1916187,1916923,280,1.00
ptg004555l,1870626,1870878,252,RepeatMasker,DNA,1870597,1870781,155,0.62
ptg004584l,67009,67299,290,RepeatMasker,DNA,66976,67189,180,0.62
ptg004615l,202420,202704,284,RepeatMasker,DNA,202484,202909,221,0.78
ptg004616l,374068,374386,318,RepeatMasker,DNA,374144,375184,243,0.76
ptg004628l,1539853,1540162,309,RepeatMasker,DNA,1539194,1540042,189,0.61
ptg004632l,1486911,1487198,287,RepeatMasker,DNA,1487021,1487417,178,0.62
ptg004646l,715956,716245,289,RepeatMasker,DNA,716108,716293,138,0.48
ptg004646l,1792590,1792915,325,RepeatMasker,DNA,1792142,1792954,325,1.00
ptg004664l,170827,171137,310,RepeatMasker,DNA,171023,171660,115,0.37
ptg004678l,1381018,1381310,292,RepeatMasker,DNA,1381254,1382762,57,0.20
ptg004707l,134812,135090,278,RepeatMasker,DNA,134766,134972,160,0.58
ptg004717l,125577,125896,319,RepeatMasker,DNA,124933,125934,319,1.00
ptg004736l,1023688,1023989,301,RepeatMasker,DNA,1023445,1023929,241,0.80
ptg004760l,245369,245684,315,RepeatMasker,DNA,245339,245493,124,0.39
ptg004771l,932705,932987,282,RepeatMasker,DNA,931258,933221,282,1.00
ptg004783l,304842,305127,285,RepeatMasker,DNA,305038,306735,90,0.32
ptg004790l,1842733,1843037,304,RepeatMasker,DNA,1842703,1842914,181,0.60
ptg004790l,1935288,1935553,265,RepeatMasker,DNA,1935211,1935402,114,0.43
ptg004793l,747573,747866,293,RepeatMasker,DNA,747497,747665,92,0.31
ptg004849l,269805,270090,285,RepeatMasker,DNA,270004,272325,87,0.31
ptg004871l,3256353,3256656,303,RepeatMasker,DNA,3256192,3256385,32,0.11
ptg004871l,4005247,4005553,306,RepeatMasker,DNA,4005195,4005950,306,1.00
ptg004871l,8563800,8564109,309,RepeatMasker,DNA,8563620,8563832,32,0.10
ptg004898l,738009,738297,288,RepeatMasker,DNA,738220,738310,78,0.27
ptg004903l,302857,303172,315,RepeatMasker,DNA,303020,303386,153,0.49
ptg004928l,566195,566476,281,RepeatMasker,DNA,566154,566355,160,0.57
ptg004957l,569510,569826,316,RepeatMasker,DNA,568776,569686,176,0.56
ptg004959l,582239,582513,274,RepeatMasker,DNA,582243,582299,57,0.21
ptg004986l,479279,479559,280,RepeatMasker,DNA,479239,479439,160,0.57
ptg004986l,486423,486703,280,RepeatMasker,DNA,486383,486583,160,0.57
ptg005010l,1830357,1830652,295,RepeatMasker,DNA,1830555,1831893,98,0.33
ptg005057l,987694,988021,327,RepeatMasker,DNA,988011,988214,11,0.03
ptg005059l,1414876,1415206,330,RepeatMasker,DNA,1414475,1415113,237,0.72
ptg005066l,733980,734263,283,RepeatMasker,DNA,733799,734179,199,0.70
ptg005078l,631668,631983,315,RepeatMasker,DNA,630849,632288,315,1.00
ptg005103l,427153,427433,280,RepeatMasker,DNA,427118,427313,160,0.57
ptg005114l,1274801,1275143,342,RepeatMasker,DNA,1274723,1274899,98,0.29
ptg005114l,1274801,1275143,342,RepeatMasker,DNA,1274792,1274873,72,0.21
ptg005147l,214325,214612,287,RepeatMasker,DNA,214521,214639,92,0.32
ptg005208l,650440,650725,285,RepeatMasker,DNA,650635,652902,91,0.32
ptg005233l,3026168,3026454,286,RepeatMasker,DNA,3026363,3027854,92,0.32
ptg005246l,1455255,1455578,323,RepeatMasker,DNA,1454607,1455633,323,1.00
ptg005276l,243084,243397,313,RepeatMasker,DNA,243060,243106,22,0.07
ptg005293l,152489,152783,294,RepeatMasker,DNA,152677,153123,107,0.36
ptg005301l,989767,990079,312,RepeatMasker,DNA,990004,990740,76,0.24
ptg005302l,3898867,3899193,326,RepeatMasker,DNA,3898216,3899232,326,1.00
ptg005304l,2260857,2261171,314,RepeatMasker,DNA,2260827,2260980,123,0.39
ptg005307l,57981,58302,321,RepeatMasker,DNA,57611,57994,13,0.04
ptg005335l,1870950,1871247,297,RepeatMasker,DNA,1870197,1871354,297,1.00
ptg005346l,2295911,2296193,282,RepeatMasker,DNA,2295712,2296433,282,1.00
ptg005384l,822031,822338,307,RepeatMasker,DNA,821436,822372,307,1.00
ptg005385l,2423478,2423796,318,RepeatMasker,DNA,2423454,2423500,22,0.07
ptg005403l,2378402,2378693,291,RepeatMasker,DNA,2378601,2379548,93,0.32
ptg005403l,2393319,2393617,298,RepeatMasker,DNA,2392710,2393644,298,1.00
ptg005420l,1941072,1941402,330,RepeatMasker,DNA,1940856,1941159,87,0.26
ptg005429l,322413,322703,290,RepeatMasker,DNA,322612,324900,92,0.32
ptg005439l,803204,803486,282,RepeatMasker,DNA,803068,803421,217,0.77
ptg005477l,608002,608281,279,RepeatMasker,DNA,607877,608524,279,1.00
ptg005478l,2267253,2267549,296,RepeatMasker,DNA,2267448,2267693,102,0.34
ptg005515l,1263140,1263480,340,RepeatMasker,DNA,1260302,1263185,45,0.13
ptg005515l,1844847,1845159,312,RepeatMasker,DNA,1844767,1844979,132,0.42
ptg005529l,5291977,5292292,315,RepeatMasker,DNA,5291744,5292136,159,0.50
ptg005533l,984186,984499,313,RepeatMasker,DNA,984162,984207,21,0.07
ptg005545l,2672872,2673182,310,RepeatMasker,DNA,2672061,2673365,310,1.00
ptg005579l,827322,827602,280,RepeatMasker,DNA,827287,827482,160,0.57
ptg005655l,42343,42633,290,RepeatMasker,DNA,42543,42701,91,0.31
ptg005681l,377097,377377,280,RepeatMasker,DNA,377055,377256,159,0.57
ptg005713l,492519,492799,280,RepeatMasker,DNA,492479,492679,160,0.57
ptg005722l,3358716,3359012,296,RepeatMasker,DNA,3358543,3358749,33,0.11
ptg005727l,658836,659117,281,RepeatMasker,DNA,658786,658996,160,0.57
ptg005777l,2080486,2080815,329,RepeatMasker,DNA,2080084,2080723,237,0.72
ptg005777l,2080486,2080815,329,RepeatMasker,DNA,2080139,2080644,158,0.48
ptg005790l,2317052,2317334,282,RepeatMasker,DNA,2316916,2317271,219,0.78
ptg005795l,355837,356137,300,RepeatMasker,DNA,355983,356493,155,0.52
ptg005816l,2599013,2599290,277,RepeatMasker,DNA,2598102,2599119,106,0.38
ptg005816l,2599013,2599290,277,RepeatMasker,DNA,2599269,2599429,22,0.08
ptg005856l,1135038,1135341,303,RepeatMasker,DNA,1135075,1135287,213,0.70
ptg005856l,1135038,1135341,303,RepeatMasker,DNA,1135157,1135399,185,0.61
ptg005856l,1135038,1135341,303,RepeatMasker,DNA,1135270,1135513,72,0.24
ptg005888l,137342,137628,286,RepeatMasker,DNA,133446,138496,286,1.00
ptg005909l,1095121,1095447,326,RepeatMasker,DNA,1094500,1095486,326,1.00
ptg005939l,1391273,1391571,298,RepeatMasker,DNA,1391429,1392155,143,0.48
ptg006027l,2647457,2647752,295,RepeatMasker,DNA,2647386,2647949,295,1.00
ptg006027l,2647457,2647752,295,RepeatMasker,DNA,2647477,2648024,276,0.94
ptg006069l,888748,889048,300,RepeatMasker,DNA,888560,889403,300,1.00
ptg006080l,607444,607752,308,RepeatMasker,DNA,607532,607783,221,0.72
ptg006081l,2139657,2139957,300,RepeatMasker,DNA,2139893,2140297,65,0.22
ptg006089l,2142675,2142992,317,RepeatMasker,DNA,2142447,2142940,265,0.84
ptg006108l,66013,66302,289,RepeatMasker,DNA,65534,66208,195,0.67
ptg006109l,1341722,1342027,305,RepeatMasker,DNA,1338788,1342200,305,1.00
ptg006109l,1899437,1899766,329,RepeatMasker,DNA,1899685,1899892,82,0.25
ptg006123l,1096122,1096417,295,RepeatMasker,DNA,1096125,1096689,293,0.99
ptg006135l,694488,694781,293,RepeatMasker,DNA,694443,694648,160,0.55
ptg006152l,335483,335801,318,RepeatMasker,DNA,335404,335609,126,0.40
ptg006189l,231966,232237,271,RepeatMasker,DNA,231659,232159,193,0.71
ptg006242l,9826,10136,310,RepeatMasker,DNA,10096,10207,41,0.13
ptg006255l,2179959,2180244,285,RepeatMasker,DNA,2179897,2180148,189,0.66
ptg006293l,811295,811610,315,RepeatMasker,DNA,810666,811924,315,1.00
ptg006316l,1898139,1898451,312,RepeatMasker,DNA,1898080,1898417,278,0.89
ptg006317l,375532,375830,298,RepeatMasker,DNA,375490,375692,160,0.54
ptg006331l,2277591,2277872,281,RepeatMasker,DNA,2277551,2277751,160,0.57
ptg006345l,1475274,1475565,291,RepeatMasker,DNA,1475465,1477316,101,0.35
ptg006347l,127514,127822,308,RepeatMasker,DNA,127469,127674,160,0.52
ptg006378l,320049,320336,287,RepeatMasker,DNA,320094,320748,243,0.85
ptg006380l,568526,568845,319,RepeatMasker,DNA,568381,568559,33,0.10
ptg006384l,730821,731135,314,RepeatMasker,DNA,731044,731311,92,0.29
ptg006397l,209964,210268,304,RepeatMasker,DNA,208280,210237,273,0.90
ptg006419l,651957,652234,277,RepeatMasker,DNA,651914,652117,160,0.58
ptg006443l,799781,800075,294,RepeatMasker,DNA,799842,800317,234,0.80
ptg006454l,3040321,3040634,313,RepeatMasker,DNA,3040243,3040456,135,0.43
ptg006457l,1041574,1041847,273,RepeatMasker,DNA,1041553,1041788,214,0.78
ptg006466l,1259601,1259929,328,RepeatMasker,DNA,1259389,1260170,328,1.00
ptg006468l,2795698,2795990,292,RepeatMasker,DNA,2795341,2795783,85,0.29
ptg006468l,2795698,2795990,292,RepeatMasker,DNA,2795918,2796315,73,0.25
ptg006473l,1014848,1015150,302,RepeatMasker,DNA,1015038,1017357,113,0.37
ptg006495l,1608021,1608341,320,RepeatMasker,DNA,1608316,1608571,26,0.08
ptg006566l,944880,945160,280,RepeatMasker,DNA,944744,945097,217,0.78
ptg006591l,172522,172830,308,RepeatMasker,DNA,172743,172816,74,0.24
ptg006628l,226984,227293,309,RepeatMasker,DNA,226700,227349,309,1.00
ptg006657l,1050899,1051181,282,RepeatMasker,DNA,1050763,1051116,217,0.77
ptg006658l,68097,68377,280,RepeatMasker,DNA,68053,68257,160,0.57
ptg006669l,358873,359186,313,RepeatMasker,DNA,358880,358952,73,0.23
ptg006669l,2308103,2308398,295,RepeatMasker,DNA,2308187,2308479,212,0.72
ptg006711l,3212389,3212691,302,RepeatMasker,DNA,3211818,3212468,79,0.26
ptg006732l,1825967,1826264,297,RepeatMasker,DNA,1825579,1826638,297,1.00
ptg006744l,334173,334491,318,RepeatMasker,DNA,334149,334195,22,0.07
ptg006744l,884461,884796,335,RepeatMasker,DNA,883847,884679,218,0.65
ptg006774l,1851206,1851493,287,RepeatMasker,DNA,1851402,1853674,92,0.32
ptg006808l,511654,511939,285,RepeatMasker,DNA,511855,512053,85,0.30
ptg006816l,430155,430468,313,RepeatMasker,DNA,429494,430351,196,0.63
ptg006860l,95221,95500,279,RepeatMasker,DNA,94987,95741,279,1.00
ptg006860l,95221,95500,279,RepeatMasker,DNA,95164,95742,279,1.00
ptg006876l,276003,276283,280,RepeatMasker,DNA,275963,276168,165,0.59
ptg006876l,279227,279528,301,RepeatMasker,DNA,278874,279325,98,0.33
ptg006884l,543994,544297,303,RepeatMasker,DNA,544114,544294,181,0.60
ptg006884l,543994,544297,303,RepeatMasker,DNA,544162,544392,136,0.45
ptg006900l,6564356,6564669,313,RepeatMasker,DNA,6564332,6564378,22,0.07
ptg006900l,9426358,9426679,321,RepeatMasker,DNA,9426279,9426495,137,0.43
ptg006900l,13798775,13799055,280,RepeatMasker,DNA,13798641,13798992,217,0.78
ptg006922l,440911,441223,312,RepeatMasker,DNA,440887,440933,22,0.07
ptg006933l,1015865,1016176,311,RepeatMasker,DNA,1015877,1016344,300,0.96
ptg006945l,1715830,1716104,274,RepeatMasker,DNA,1715800,1715994,164,0.60
ptg006949l,91896,92220,324,RepeatMasker,DNA,91983,92695,238,0.73
ptg006963l,227410,227721,311,RepeatMasker,DNA,227477,228193,245,0.79
ptg007004l,2942299,2942566,267,RepeatMasker,DNA,2941574,2942332,33,0.12
ptg007014l,1908580,1908891,311,RepeatMasker,DNA,1906154,1909311,311,1.00
ptg007022l,356821,357121,300,RepeatMasker,DNA,356880,358269,242,0.81
ptg007028l,776437,776735,298,RepeatMasker,DNA,776155,776440,3,0.01
ptg007028l,776437,776735,298,RepeatMasker,DNA,776434,776697,260,0.87
ptg007065l,265158,265471,313,RepeatMasker,DNA,264965,265184,26,0.08
ptg007099l,2815632,2815915,283,RepeatMasker,DNA,2815843,2816849,73,0.26
ptg007143l,5209982,5210258,276,RepeatMasker,DNA,5209940,5210138,156,0.57
ptg007144l,992037,992339,302,RepeatMasker,DNA,992284,992339,56,0.19
ptg007197l,858464,858747,283,RepeatMasker,DNA,858662,859124,86,0.30
ptg007198l,2123026,2123323,297,RepeatMasker,DNA,2123097,2123150,54,0.18
ptg007242l,812238,812533,295,RepeatMasker,DNA,812167,812704,295,1.00
ptg007242l,812238,812533,295,RepeatMasker,DNA,812241,812786,293,0.99
ptg007252l,1779659,1779972,313,RepeatMasker,DNA,1779635,1779681,22,0.07
ptg007274l,1064916,1065221,305,RepeatMasker,DNA,1064307,1065546,305,1.00
ptg007275l,99007,99287,280,RepeatMasker,DNA,98961,99167,160,0.57
ptg007276l,543183,543463,280,RepeatMasker,DNA,543137,543343,160,0.57
ptg007276l,1739345,1739631,286,RepeatMasker,DNA,1739540,1740497,92,0.32
ptg007298l,207373,207665,292,RepeatMasker,DNA,207189,207429,56,0.19
ptg007298l,207373,207665,292,RepeatMasker,DNA,207201,207458,85,0.29
ptg007326l,788358,788653,295,RepeatMasker,DNA,788435,788715,219,0.74
ptg007326l,890534,890829,295,RepeatMasker,DNA,890463,891026,295,1.00
ptg007326l,890534,890829,295,RepeatMasker,DNA,890537,891101,293,0.99
ptg007331l,106740,107020,280,RepeatMasker,DNA,106934,109184,87,0.31
ptg007342l,2447410,2447709,299,RepeatMasker,DNA,2447414,2447477,64,0.21
ptg007349l,839937,840248,311,RepeatMasker,DNA,838237,840540,311,1.00
ptg007355l,189995,190282,287,RepeatMasker,DNA,190039,190603,244,0.85
ptg007375l,5234162,5234438,276,RepeatMasker,DNA,5234166,5234196,31,0.11
ptg007375l,5929335,5929625,290,RepeatMasker,DNA,5929533,5929816,93,0.32
ptg007387l,106170,106459,289,RepeatMasker,DNA,106367,106974,93,0.32
ptg007405l,362927,363230,303,RepeatMasker,DNA,362662,363012,85,0.28
ptg007418l,355521,355798,277,RepeatMasker,DNA,354544,355553,32,0.12
ptg007428l,420690,420981,291,RepeatMasker,DNA,420729,421183,253,0.87
ptg007439l,10397156,10397448,292,RepeatMasker,DNA,10396673,10397229,73,0.25
ptg007455l,2220528,2220815,287,RepeatMasker,DNA,2220498,2220738,210,0.73
ptg007470l,271860,272188,328,RepeatMasker,DNA,271780,271916,56,0.17
ptg007470l,271860,272188,328,RepeatMasker,DNA,271863,271943,81,0.25
ptg007470l,271860,272188,328,RepeatMasker,DNA,271863,271958,96,0.29
ptg007470l,271860,272188,328,RepeatMasker,DNA,272090,272221,99,0.30
ptg007473l,5559919,5560227,308,RepeatMasker,DNA,5560022,5560252,206,0.67
ptg007473l,5559919,5560227,308,RepeatMasker,DNA,5560111,5560281,117,0.38
ptg007545l,5448695,5448976,281,RepeatMasker,DNA,5446455,5450343,281,1.00
ptg007554l,147325,147658,333,RepeatMasker,DNA,147459,147548,90,0.27
ptg007598l,527828,528144,316,RepeatMasker,DNA,527803,527850,22,0.07
ptg007607l,170048,170373,325,RepeatMasker,DNA,169199,170084,36,0.11
ptg007613l,4744212,4744474,262,RepeatMasker,DNA,4743660,4744661,262,1.00
ptg007630l,886681,886962,281,RepeatMasker,DNA,886631,886841,160,0.57
ptg007636l,1160109,1160427,318,RepeatMasker,DNA,1160038,1160233,124,0.39
ptg007644l,2243775,2244102,327,RepeatMasker,DNA,2243510,2245132,327,1.00
ptg007661l,72712,73036,324,RepeatMasker,DNA,72603,73077,324,1.00
ptg007665l,1018423,1018703,280,RepeatMasker,DNA,1018390,1018583,160,0.57
ptg007703l,142348,142663,315,RepeatMasker,DNA,142349,142394,46,0.15
ptg007703l,398548,398828,280,RepeatMasker,DNA,398506,398708,160,0.57
ptg007703l,442274,442562,288,RepeatMasker,DNA,442462,442655,101,0.35
ptg007710l,566187,566475,288,RepeatMasker,DNA,566083,566267,80,0.28
ptg007817l,210388,210687,299,RepeatMasker,DNA,210232,210410,22,0.07
ptg007824l,216832,217119,287,RepeatMasker,DNA,217028,217738,92,0.32
ptg007852l,3416807,3417134,327,RepeatMasker,DNA,3416968,3417206,167,0.51
ptg007868l,829341,829628,287,RepeatMasker,DNA,829314,829357,16,0.06
ptg007869l,1317531,1317827,296,RepeatMasker,DNA,1317535,1317591,57,0.19
ptg007869l,1643387,1643686,299,RepeatMasker,DNA,1643340,1643470,83,0.28
ptg007892l,528256,528549,293,RepeatMasker,DNA,528205,528421,165,0.56
ptg007904l,373617,373898,281,RepeatMasker,DNA,373571,373777,160,0.57
ptg007909l,403351,403649,298,RepeatMasker,DNA,403379,403686,271,0.91
ptg007940l,1732701,1733036,335,RepeatMasker,DNA,1732658,1732900,199,0.59
ptg007963l,1018563,1018837,274,RepeatMasker,DNA,1018601,1018814,214,0.78
ptg007989l,1634441,1634770,329,RepeatMasker,DNA,1634040,1634599,158,0.48
ptg007989l,1634441,1634770,329,RepeatMasker,DNA,1634040,1634678,237,0.72
ptg008019l,501668,501943,275,RepeatMasker,DNA,501603,501705,37,0.13
ptg008026l,701988,702301,313,RepeatMasker,DNA,701964,702010,22,0.07
ptg008026l,2784834,2785124,290,RepeatMasker,DNA,2784804,2784890,56,0.19
ptg008026l,2784834,2785124,290,RepeatMasker,DNA,2784899,2784950,52,0.18
ptg008031l,2444845,2445156,311,RepeatMasker,DNA,2444821,2444867,22,0.07
ptg008063l,4661291,4661570,279,RepeatMasker,DNA,4660825,4661398,107,0.38
ptg008063l,4661291,4661570,279,RepeatMasker,DNA,4661557,4661717,14,0.05
ptg008072l,275447,275752,305,RepeatMasker,DNA,274525,277595,305,1.00
ptg008075l,781650,781942,292,RepeatMasker,DNA,781465,781681,31,0.11
ptg008093l,761049,761377,328,RepeatMasker,DNA,760647,761361,312,0.95
ptg008110l,457799,458081,282,RepeatMasker,DNA,457478,458321,282,1.00
ptg008116l,2595455,2595748,293,RepeatMasker,DNA,2595376,2595571,116,0.40
ptg008121l,1220878,1221165,287,RepeatMasker,DNA,1221072,1223203,94,0.33
ptg008125l,49757,50087,330,RepeatMasker,DNA,49738,49784,27,0.08
ptg008143l,39282,39611,329,RepeatMasker,DNA,38888,39519,237,0.72
ptg008165l,486894,487202,308,RepeatMasker,DNA,486784,486996,102,0.33
ptg008165l,486894,487202,308,RepeatMasker,DNA,486943,487083,141,0.46
ptg008223l,277924,278203,279,RepeatMasker,DNA,277896,278016,92,0.33
ptg008239l,314446,314763,317,RepeatMasker,DNA,314422,314468,22,0.07
ptg008239l,314446,314763,317,RepeatMasker,DNA,314534,314698,165,0.52
ptg008259l,194662,194972,310,RepeatMasker,DNA,194643,194689,27,0.09
ptg008272l,638188,638467,279,RepeatMasker,DNA,638085,638713,279,1.00
ptg008288l,295772,296062,290,RepeatMasker,DNA,295971,298246,92,0.32
ptg008296l,1878688,1878977,289,RepeatMasker,DNA,1878776,1878839,64,0.22
ptg008305l,2927607,2927909,302,RepeatMasker,DNA,2927577,2927634,27,0.09
ptg008336l,682089,682392,303,RepeatMasker,DNA,681270,682697,303,1.00
ptg008337l,1184502,1184799,297,RepeatMasker,DNA,1184377,1184898,297,1.00
ptg008342l,303399,303687,288,RepeatMasker,DNA,303596,305131,92,0.32
ptg008362l,965301,965619,318,RepeatMasker,DNA,965404,968296,216,0.68
ptg008363l,2439840,2440105,265,RepeatMasker,DNA,2440050,2440132,56,0.21
ptg008378l,318272,318578,306,RepeatMasker,DNA,318248,318294,22,0.07
ptg008378l,757239,757548,309,RepeatMasker,DNA,757128,757272,33,0.11
ptg008384l,120592,120854,262,RepeatMasker,DNA,120700,120773,74,0.28
ptg008389l,2342959,2343254,295,RepeatMasker,DNA,2342908,2343120,161,0.55
ptg008396l,613747,614028,281,RepeatMasker,DNA,613972,614350,57,0.20
ptg008435l,2927112,2927427,315,RepeatMasker,DNA,2927389,2927577,39,0.12
ptg008494l,969430,969716,286,RepeatMasker,DNA,968470,969956,286,1.00
ptg008513l,498351,498646,295,RepeatMasker,DNA,498342,498869,295,1.00
ptg008523l,72228,72523,295,RepeatMasker,DNA,71986,72399,171,0.58
ptg008524l,197056,197369,313,RepeatMasker,DNA,197032,197078,22,0.07
ptg008551l,863157,863445,288,RepeatMasker,DNA,863345,864032,101,0.35
ptg008567l,1581848,1582161,313,RepeatMasker,DNA,1581852,1581908,57,0.18
ptg008579l,4358007,4358340,333,RepeatMasker,DNA,4358174,4358469,167,0.50
ptg008606l,793761,794079,318,RepeatMasker,DNA,793594,793788,27,0.08
ptg008666l,244748,245028,280,RepeatMasker,DNA,244708,244908,160,0.57
ptg008666l,252233,252513,280,RepeatMasker,DNA,252193,252393,160,0.57
ptg008668l,664702,664982,280,RepeatMasker,DNA,664660,664862,160,0.57
ptg008715l,818955,819275,320,RepeatMasker,DNA,819032,819749,244,0.76
ptg008731l,2287021,2287340,319,RepeatMasker,DNA,2286375,2287384,319,1.00
ptg008745l,743910,744204,294,RepeatMasker,DNA,744113,746374,92,0.31
ptg008758l,164159,164443,284,RepeatMasker,DNA,164300,164481,144,0.51
ptg008789l,3326037,3326339,302,RepeatMasker,DNA,3325958,3326175,138,0.46
ptg008789l,3661001,3661282,281,RepeatMasker,DNA,3660966,3661160,159,0.57
ptg008806l,3153359,3153649,290,RepeatMasker,DNA,3153557,3154177,93,0.32
ptg008818l,1101867,1102169,302,RepeatMasker,DNA,1101873,1102508,297,0.98
ptg008858l,552794,553089,295,RepeatMasker,DNA,551930,553286,295,1.00
ptg008883l,2387238,2387531,293,RepeatMasker,DNA,2387219,2387265,27,0.09
ptg008895l,584502,584814,312,RepeatMasker,DNA,584538,584593,56,0.18
ptg008902l,762314,762625,311,RepeatMasker,DNA,761995,762399,85,0.27
ptg008945l,67507,67821,314,RepeatMasker,DNA,67285,67611,104,0.33
ptg008973l,117804,118083,279,RepeatMasker,DNA,117626,117837,33,0.12
ptg008988l,444009,444337,328,RepeatMasker,DNA,443382,444385,328,1.00
ptg008999l,754127,754425,298,RepeatMasker,DNA,753958,754160,33,0.11
ptg009043l,559218,559528,310,RepeatMasker,DNA,559482,559637,47,0.15
ptg009077l,31764,32056,292,RepeatMasker,DNA,31549,31851,87,0.30
ptg009080l,1237880,1238159,279,RepeatMasker,DNA,1238073,1238465,87,0.31
ptg009091l,2250456,2250744,288,RepeatMasker,DNA,2250653,2252960,92,0.32
ptg009112l,75065,75354,289,RepeatMasker,DNA,75262,75645,93,0.32
ptg009139l,191594,191887,293,RepeatMasker,DNA,191796,193301,92,0.31
ptg009151l,339494,339817,323,RepeatMasker,DNA,339004,339641,147,0.46
ptg009186l,506958,507245,287,RepeatMasker,DNA,507075,509413,171,0.60
ptg009188l,1190591,1190875,284,RepeatMasker,DNA,1188773,1190782,191,0.67
ptg009190l,1297203,1297491,288,RepeatMasker,DNA,1297240,1297750,252,0.88
ptg009262l,2903459,2903769,310,RepeatMasker,DNA,2903463,2903519,57,0.18
ptg009326l,380697,380991,294,RepeatMasker,DNA,380800,381018,192,0.65
ptg009326l,380697,380991,294,RepeatMasker,DNA,380871,381050,121,0.41
ptg009331l,3336252,3336523,271,RepeatMasker,DNA,3334862,3339215,271,1.00
ptg009331l,3842563,3842877,314,RepeatMasker,DNA,3842836,3843015,42,0.13
ptg009347l,710480,710799,319,RepeatMasker,DNA,710428,710567,87,0.27
ptg009371l,2840169,2840451,282,RepeatMasker,DNA,2840214,2840638,238,0.84
ptg009410l,1535661,1535937,276,RepeatMasker,DNA,1535847,1536465,91,0.33
ptg009412l,1168407,1168683,276,RepeatMasker,DNA,1168619,1168870,65,0.24
ptg009414l,58049,58368,319,RepeatMasker,DNA,57969,58166,117,0.37
ptg009430l,68771,69081,310,RepeatMasker,DNA,68128,68925,154,0.50
ptg009430l,68771,69081,310,RepeatMasker,DNA,68980,69129,102,0.33
ptg009433l,928547,928845,298,RepeatMasker,DNA,928181,928633,86,0.29
ptg009452l,572233,572513,280,RepeatMasker,DNA,572195,572392,159,0.57
ptg009453l,117187,117461,274,RepeatMasker,DNA,117012,117229,42,0.15
ptg009464l,121531,121843,312,RepeatMasker,DNA,121778,123896,66,0.21
ptg009496l,189745,190057,312,RepeatMasker,DNA,189721,189767,22,0.07
ptg009534l,640455,640754,299,RepeatMasker,DNA,640284,640488,33,0.11
ptg009546l,2107391,2107673,282,RepeatMasker,DNA,2107255,2107608,217,0.77
ptg009573l,1024849,1025129,280,RepeatMasker,DNA,1024813,1025009,160,0.57
ptg009576l,1501353,1501666,313,RepeatMasker,DNA,1501329,1501375,22,0.07
ptg009579l,182094,182410,316,RepeatMasker,DNA,180817,183029,316,1.00
ptg009591l,2850808,2851098,290,RepeatMasker,DNA,2851005,2853276,94,0.32
ptg009621l,579883,580173,290,RepeatMasker,DNA,580072,581490,102,0.35
ptg009674l,668040,668351,311,RepeatMasker,DNA,667835,668196,156,0.50
ptg009711l,2280454,2280743,289,RepeatMasker,DNA,2280374,2280579,125,0.43
ptg009714l,937112,937394,282,RepeatMasker,DNA,936928,937143,31,0.11
ptg009720l,735363,735644,281,RepeatMasker,DNA,735324,735523,160,0.57
ptg009721l,2170257,2170529,272,RepeatMasker,DNA,2169984,2170407,150,0.55
ptg009724l,440595,440890,295,RepeatMasker,DNA,440524,441087,295,1.00
ptg009724l,440595,440890,295,RepeatMasker,DNA,440598,441162,293,0.99
ptg009731l,1867829,1868111,282,RepeatMasker,DNA,1867502,1868350,282,1.00
ptg009741l,1100091,1100404,313,RepeatMasker,DNA,1100067,1100113,22,0.07
ptg009744l,1037486,1037766,280,RepeatMasker,DNA,1037449,1037645,159,0.57
ptg009763l,958123,958450,327,RepeatMasker,DNA,958099,958145,22,0.07
ptg009771l,1852453,1852731,278,RepeatMasker,DNA,1851562,1852520,67,0.24
ptg009772l,1804132,1804415,283,RepeatMasker,DNA,1804095,1804292,160,0.57
ptg009785l,368554,368851,297,RepeatMasker,DNA,368514,368714,160,0.54
ptg009812l,791238,791569,331,RepeatMasker,DNA,790582,791607,331,1.00
ptg009818l,317401,317681,280,RepeatMasker,DNA,317359,317561,160,0.57
ptg009837l,1193688,1193965,277,RepeatMasker,DNA,1193496,1194106,277,1.00
ptg009879l,3489350,3489641,291,RepeatMasker,DNA,3489210,3489422,72,0.25
ptg009887l,830384,830703,319,RepeatMasker,DNA,830168,830457,73,0.23
ptg009934l,691152,691452,300,RepeatMasker,DNA,691048,691279,127,0.42
ptg010012l,142242,142523,281,RepeatMasker,DNA,142206,142402,160,0.57
ptg010024l,1264056,1264370,314,RepeatMasker,DNA,1263392,1264409,314,1.00
ptg010049l,546278,546575,297,RepeatMasker,DNA,546243,546438,160,0.54
ptg010075l,2438149,2438441,292,RepeatMasker,DNA,2438347,2439142,95,0.33
ptg010086l,2416707,2417012,305,RepeatMasker,DNA,2416598,2416713,6,0.02
ptg010091l,984989,985284,295,RepeatMasker,DNA,984946,985147,158,0.54
ptg010111l,3215512,3215836,324,RepeatMasker,DNA,3215441,3216033,324,1.00
ptg010111l,3215512,3215836,324,RepeatMasker,DNA,3215515,3216079,322,0.99
ptg010137l,1957366,1957673,307,RepeatMasker,DNA,1957660,1957910,14,0.05
ptg010141l,1732436,1732729,293,RepeatMasker,DNA,1732391,1732596,160,0.55
ptg010163l,324329,324636,307,RepeatMasker,DNA,323689,324514,185,0.60
ptg010181l,209169,209450,281,RepeatMasker,DNA,208889,209318,149,0.53
ptg010221l,65112,65391,279,RepeatMasker,DNA,64979,65637,279,1.00
ptg010231l,619357,619663,306,RepeatMasker,DNA,619585,619631,47,0.15
ptg010249l,1632004,1632318,314,RepeatMasker,DNA,1631934,1632124,120,0.38
ptg010267l,475410,475692,282,RepeatMasker,DNA,475086,475696,282,1.00
ptg010281l,1042826,1043154,328,RepeatMasker,DNA,1042186,1043192,328,1.00
ptg010299l,1147925,1148217,292,RepeatMasker,DNA,1147254,1148255,292,1.00
ptg010311l,2303863,2304154,291,RepeatMasker,DNA,2302337,2304039,176,0.60
ptg010340l,1724287,1724567,280,RepeatMasker,DNA,1724252,1724446,159,0.57
ptg010340l,1967943,1968256,313,RepeatMasker,DNA,1967919,1967965,22,0.07
ptg010340l,1975973,1976287,314,RepeatMasker,DNA,1975949,1975995,22,0.07
ptg010359l,1553913,1554211,298,RepeatMasker,DNA,1553723,1553946,33,0.11
ptg010387l,542483,542773,290,RepeatMasker,DNA,542681,543343,93,0.32
ptg010454l,120106,120419,313,RepeatMasker,DNA,120082,120128,22,0.07
ptg010466l,500682,500981,299,RepeatMasker,DNA,500922,502491,60,0.20
ptg010482l,147775,148063,288,RepeatMasker,DNA,147761,148273,288,1.00
ptg010504l,130742,131032,290,RepeatMasker,DNA,130940,133016,93,0.32
ptg010517l,2964932,2965202,270,RepeatMasker,DNA,2964885,2965020,88,0.33
ptg010592l,608651,608958,307,RepeatMasker,DNA,608848,609216,111,0.36
ptg010645l,58550,58833,283,RepeatMasker,DNA,58738,59458,96,0.34
ptg010647l,1659315,1659622,307,RepeatMasker,DNA,1659616,1659843,7,0.02
ptg010653l,467438,467726,288,RepeatMasker,DNA,467480,467804,247,0.86
ptg010674l,1605782,1606109,327,RepeatMasker,DNA,1605491,1606140,327,1.00
ptg010687l,1218860,1219151,291,RepeatMasker,DNA,1218816,1219019,159,0.55
ptg010711l,218239,218552,313,RepeatMasker,DNA,218159,218363,124,0.40
ptg010736l,49812,50093,281,RepeatMasker,DNA,49186,49855,43,0.15
ptg010742l,151626,151939,313,RepeatMasker,DNA,151602,151648,22,0.07
ptg010769l,786836,787158,322,RepeatMasker,DNA,783966,787831,322,1.00
ptg010807l,55240,55559,319,RepeatMasker,DNA,52342,55442,202,0.63
ptg010807l,55240,55559,319,RepeatMasker,DNA,55447,56306,113,0.35
ptg010842l,667251,667550,299,RepeatMasker,DNA,667070,667285,34,0.11
ptg010890l,396392,396709,317,RepeatMasker,DNA,396312,396511,119,0.38
ptg010908l,889617,889905,288,RepeatMasker,DNA,889812,892097,94,0.33
ptg010910l,1020109,1020389,280,RepeatMasker,DNA,1020072,1020269,160,0.57
ptg010910l,1027473,1027769,296,RepeatMasker,DNA,1027436,1027633,160,0.54
ptg010915l,310731,311040,309,RepeatMasker,DNA,310949,311204,92,0.30
ptg010917l,3516507,3516794,287,RepeatMasker,DNA,3516471,3517034,287,1.00
ptg010929l,1392018,1392299,281,RepeatMasker,DNA,1391695,1392537,281,1.00
ptg010951l,1876263,1876595,332,RepeatMasker,DNA,1876092,1876293,30,0.09
ptg010980l,379467,379747,280,RepeatMasker,DNA,379421,379626,159,0.57
ptg010983l,343254,343544,290,RepeatMasker,DNA,343453,345404,92,0.32
ptg010997l,741969,742299,330,RepeatMasker,DNA,742176,742544,124,0.38
ptg011015l,1755960,1756261,301,RepeatMasker,DNA,1755921,1756120,160,0.53
ptg011050l,1034628,1034945,317,RepeatMasker,DNA,1034549,1034754,126,0.40
ptg011064l,125903,126217,314,RepeatMasker,DNA,125879,125925,22,0.07
ptg011093l,330475,330788,313,RepeatMasker,DNA,330445,330502,27,0.09
ptg011099l,321097,321426,329,RepeatMasker,DNA,320754,321255,158,0.48
ptg011099l,321097,321426,329,RepeatMasker,DNA,320774,321334,237,0.72
ptg011122l,773263,773570,307,RepeatMasker,DNA,773035,774440,307,1.00
ptg011151l,166128,166427,299,RepeatMasker,DNA,166132,166370,239,0.80
ptg011153l,513997,514326,329,RepeatMasker,DNA,514084,514933,243,0.74
ptg011172l,816964,817261,297,RepeatMasker,DNA,817130,817369,132,0.44
ptg011179l,1799608,1799931,323,RepeatMasker,DNA,1799206,1799973,323,1.00
ptg011184l,1454017,1454330,313,RepeatMasker,DNA,1453993,1454039,22,0.07
ptg011239l,34965,35245,280,RepeatMasker,DNA,34904,35125,160,0.57
ptg011259l,115419,115699,280,RepeatMasker,DNA,115380,115579,160,0.57
ptg011270l,1133744,1134059,315,RepeatMasker,DNA,1133743,1133994,250,0.79
ptg011304l,119252,119564,312,RepeatMasker,DNA,118931,119910,312,1.00
ptg011348l,228357,228637,280,RepeatMasker,DNA,228317,228517,160,0.57
ptg011348l,2410675,2410983,308,RepeatMasker,DNA,2410841,2411646,143,0.46
ptg011359l,2048018,2048308,290,RepeatMasker,DNA,2048215,2048880,94,0.32
ptg011404l,1350027,1350298,271,RepeatMasker,DNA,1350120,1350238,119,0.44
ptg011408l,2536895,2537204,309,RepeatMasker,DNA,2537199,2538168,6,0.02
ptg011420l,321642,321934,292,RepeatMasker,DNA,321574,322010,292,1.00
ptg011423l,224010,224281,271,RepeatMasker,DNA,224109,224306,173,0.64
ptg011423l,224010,224281,271,RepeatMasker,DNA,224215,224334,67,0.25
ptg011444l,1202606,1202899,293,RepeatMasker,DNA,1202799,1205079,101,0.34
ptg011453l,1067761,1068084,323,RepeatMasker,DNA,1067838,1067915,78,0.24
ptg011473l,343922,344202,280,RepeatMasker,DNA,344110,345635,93,0.33
ptg011478l,1280461,1280723,262,RepeatMasker,DNA,1280373,1280506,45,0.17
ptg011493l,230440,230745,305,RepeatMasker,DNA,230029,232116,305,1.00
ptg011581l,523686,523966,280,RepeatMasker,DNA,523653,523844,158,0.56
ptg011596l,639405,639716,311,RepeatMasker,DNA,639625,639918,92,0.30
ptg011596l,639405,639716,311,RepeatMasker,DNA,639625,639996,92,0.30
ptg011596l,639405,639716,311,RepeatMasker,DNA,639630,640112,87,0.28
ptg011596l,639405,639716,311,RepeatMasker,DNA,639635,640056,82,0.26
ptg011596l,639405,639716,311,RepeatMasker,DNA,639690,640421,27,0.09
ptg011622l,2723050,2723352,302,RepeatMasker,DNA,2723223,2723405,130,0.43
ptg011622l,2723050,2723352,302,RepeatMasker,DNA,2723289,2723376,64,0.21
ptg011673l,1035672,1035961,289,RepeatMasker,DNA,1035869,1037289,93,0.32
ptg011702l,393820,394110,290,RepeatMasker,DNA,394009,395608,102,0.35
ptg011710l,252335,252655,320,RepeatMasker,DNA,252256,252459,124,0.39
ptg011727l,1589213,1589509,296,RepeatMasker,DNA,1589028,1589246,33,0.11
ptg011739l,1453639,1453917,278,RepeatMasker,DNA,1453490,1453720,81,0.29
ptg011756l,1528218,1528500,282,RepeatMasker,DNA,1528002,1528740,282,1.00
ptg011763l,56064,56331,267,RepeatMasker,DNA,56215,56301,87,0.33
ptg011783l,1118318,1118631,313,RepeatMasker,DNA,1118294,1118340,22,0.07
ptg011785l,222104,222369,265,RepeatMasker,DNA,221961,222193,89,0.34
ptg011785l,222104,222369,265,RepeatMasker,DNA,222074,222315,211,0.80
ptg011785l,222104,222369,265,RepeatMasker,DNA,222185,222427,185,0.70
ptg011785l,222104,222369,265,RepeatMasker,DNA,222298,222541,72,0.27
ptg011800l,477494,477777,283,RepeatMasker,DNA,477164,478014,283,1.00
ptg011818l,30135,30427,292,RepeatMasker,DNA,29840,30772,292,1.00
ptg011861l,731637,731963,326,RepeatMasker,DNA,730418,731994,326,1.00
ptg011886l,1178455,1178765,310,RepeatMasker,DNA,1178383,1178546,91,0.29
ptg011924l,606560,606839,279,RepeatMasker,DNA,606509,606718,158,0.57
ptg011969l,584457,584761,304,RepeatMasker,DNA,584046,588389,304,1.00
ptg011974l,266294,266632,338,RepeatMasker,DNA,266578,266738,55,0.16
ptg011974l,266294,266632,338,RepeatMasker,DNA,266609,266825,24,0.07
ptg011978l,4410562,4410859,297,RepeatMasker,DNA,4410491,4411054,297,1.00
ptg011978l,4410562,4410859,297,RepeatMasker,DNA,4410582,4411130,278,0.94
ptg011981l,295284,295584,300,RepeatMasker,DNA,295226,295488,204,0.68
ptg012006l,24221,24518,297,RepeatMasker,DNA,24200,24254,33,0.11
ptg012033l,51105,51419,314,RepeatMasker,DNA,51081,51127,22,0.07
ptg012076l,206191,206486,295,RepeatMasker,DNA,206144,206193,2,0.01
ptg012076l,206191,206486,295,RepeatMasker,DNA,206209,206456,248,0.84
ptg012076l,342801,343104,303,RepeatMasker,DNA,342446,346941,303,1.00
ptg012076l,998369,998687,318,RepeatMasker,DNA,998345,998391,22,0.07
ptg012105l,1604797,1605120,323,RepeatMasker,DNA,1604581,1604884,87,0.27
ptg012127l,161203,161516,313,RepeatMasker,DNA,161179,161225,22,0.07
ptg012138l,224165,224447,282,RepeatMasker,DNA,224362,225560,86,0.30
ptg012140l,457980,458250,270,RepeatMasker,DNA,457947,458131,151,0.56
ptg012211l,172943,173224,281,RepeatMasker,DNA,172898,173101,158,0.56
ptg012215l,242930,243214,284,RepeatMasker,DNA,242759,243001,71,0.25
ptg012215l,242930,243214,284,RepeatMasker,DNA,242781,242987,57,0.20
ptg012248l,55049,55371,322,RepeatMasker,DNA,54965,55105,56,0.17
ptg012248l,55049,55371,322,RepeatMasker,DNA,55059,55129,71,0.22
ptg012250l,1091372,1091675,303,RepeatMasker,DNA,1090784,1091375,3,0.01
ptg012252l,1124444,1124725,281,RepeatMasker,DNA,1124405,1124604,160,0.57
ptg012261l,771514,771831,317,RepeatMasker,DNA,771490,771536,22,0.07
ptg012303l,212691,212993,302,RepeatMasker,DNA,212889,213963,105,0.35
ptg012332l,730364,730652,288,RepeatMasker,DNA,730511,730925,142,0.49
ptg012392l,108616,108938,322,RepeatMasker,DNA,108106,108696,80,0.25
ptg012403l,507338,507656,318,RepeatMasker,DNA,507314,507360,22,0.07
ptg012406l,513219,513518,299,RepeatMasker,DNA,513173,513379,160,0.54
ptg012442l,54557,54885,328,RepeatMasker,DNA,54397,54940,328,1.00
ptg012449l,1164009,1164307,298,RepeatMasker,DNA,1163820,1164042,33,0.11
ptg012454l,151874,152180,306,RepeatMasker,DNA,151079,152122,248,0.81
ptg012497l,645106,645418,312,RepeatMasker,DNA,645082,645128,22,0.07
ptg012520l,964365,964688,323,RepeatMasker,DNA,963593,964581,216,0.67
ptg012526l,743100,743432,332,RepeatMasker,DNA,743189,743693,244,0.73
ptg012534l,695388,695683,295,RepeatMasker,DNA,695317,695860,295,1.00
ptg012534l,695388,695683,295,RepeatMasker,DNA,695408,695955,276,0.94
ptg012545l,844066,844363,297,RepeatMasker,DNA,844204,845314,160,0.54
ptg012545l,992368,992665,297,RepeatMasker,DNA,992476,993128,190,0.64
ptg012554l,696618,696906,288,RepeatMasker,DNA,696323,696939,288,1.00
ptg012587l,1161674,1161941,267,RepeatMasker,DNA,1161363,1161733,59,0.22
ptg012592l,3629572,3629865,293,RepeatMasker,DNA,3629530,3629732,160,0.55
ptg012634l,1235319,1235607,288,RepeatMasker,DNA,1235598,1236151,10,0.03
ptg012645l,1300977,1301297,320,RepeatMasker,DNA,1299256,1301532,320,1.00
ptg012647l,471132,471427,295,RepeatMasker,DNA,471152,471699,276,0.94
ptg012658l,79207,79505,298,RepeatMasker,DNA,79380,79615,126,0.42
ptg012701l,130711,131018,307,RepeatMasker,DNA,130631,130722,11,0.04
ptg012701l,3325862,3326148,286,RepeatMasker,DNA,3326049,3326336,100,0.35
ptg012761l,871322,871600,278,RepeatMasker,DNA,871481,873776,120,0.43
ptg012764l,991053,991348,295,RepeatMasker,DNA,989395,991465,295,1.00
ptg012775l,2031107,2031402,295,RepeatMasker,DNA,2031036,2031599,295,1.00
ptg012775l,2031107,2031402,295,RepeatMasker,DNA,2031110,2031674,293,0.99
ptg012843l,475002,475283,281,RepeatMasker,DNA,474961,475162,160,0.57
ptg012867l,1301236,1301543,307,RepeatMasker,DNA,1300581,1301507,271,0.88
ptg012872l,1430134,1430417,283,RepeatMasker,DNA,1430249,1430659,169,0.60
ptg012877l,331495,331793,298,RepeatMasker,DNA,331736,331862,58,0.19
ptg012902l,122528,122909,381,RepeatMasker,DNA,122341,122561,33,0.09
ptg012926l,883495,883794,299,RepeatMasker,DNA,883712,883809,83,0.28
ptg012956l,227336,227591,255,RepeatMasker,DNA,227401,227579,179,0.70
ptg012956l,227336,227591,255,RepeatMasker,DNA,227591,228463,1,0.00
ptg012997l,975835,976123,288,RepeatMasker,DNA,976031,977651,93,0.32
ptg013043l,208159,208438,279,RepeatMasker,DNA,208090,208681,279,1.00
ptg013050l,561208,561501,293,RepeatMasker,DNA,561305,561676,197,0.67
ptg013087l,772149,772429,280,RepeatMasker,DNA,772337,773545,93,0.33
ptg013117l,1370777,1371065,288,RepeatMasker,DNA,1370823,1371457,243,0.84
ptg013206l,473421,473750,329,RepeatMasker,DNA,473170,473788,329,1.00
ptg013240l,3144899,3145180,281,RepeatMasker,DNA,3144945,3145606,236,0.84
ptg013251l,678836,679137,301,RepeatMasker,DNA,678806,679019,183,0.61
ptg013251l,678836,679137,301,RepeatMasker,DNA,679080,679438,58,0.19
ptg013382l,449505,449816,311,RepeatMasker,DNA,449481,449527,22,0.07
ptg013387l,3055666,3055946,280,RepeatMasker,DNA,3055623,3055826,160,0.57
ptg013389l,167503,167789,286,RepeatMasker,DNA,167424,168208,286,1.00
ptg013404l,1370167,1370449,282,RepeatMasker,DNA,1369887,1370183,16,0.06
ptg013463l,266095,266376,281,RepeatMasker,DNA,266061,266255,160,0.57
ptg013468l,183236,183556,320,RepeatMasker,DNA,182419,183322,86,0.27
ptg013487l,754808,755114,306,RepeatMasker,DNA,754776,754937,129,0.42
ptg013502l,4147433,4147734,301,RepeatMasker,DNA,4147631,4147687,57,0.19
ptg013505l,893303,893615,312,RepeatMasker,DNA,893232,893419,116,0.37
ptg013533l,1097169,1097445,276,RepeatMasker,DNA,1097093,1097296,127,0.46
ptg013537l,517290,517572,282,RepeatMasker,DNA,517256,517451,161,0.57
ptg013551l,484523,484829,306,RepeatMasker,DNA,484199,484608,85,0.28
ptg013571l,305293,305575,282,RepeatMasker,DNA,303557,305498,205,0.73
ptg013573l,1107544,1107862,318,RepeatMasker,DNA,1107520,1107566,22,0.07
ptg013591l,296024,296320,296,RepeatMasker,DNA,295862,296294,270,0.91
ptg013611l,315635,315936,301,RepeatMasker,DNA,315849,316845,88,0.29
ptg013647l,2139721,2140033,312,RepeatMasker,DNA,2138910,2140272,312,1.00
ptg013677l,546772,547075,303,RepeatMasker,DNA,546701,547272,303,1.00
ptg013677l,546772,547075,303,RepeatMasker,DNA,546800,547347,276,0.91
ptg013717l,1305408,1305726,318,RepeatMasker,DNA,1305384,1305430,22,0.07
ptg013730l,1242798,1243094,296,RepeatMasker,DNA,1242721,1242890,92,0.31
ptg013794l,161558,161838,280,RepeatMasker,DNA,161514,161718,160,0.57
ptg013886l,287424,287713,289,RepeatMasker,DNA,287622,288498,92,0.32
ptg013932l,34093,34390,297,RepeatMasker,DNA,34133,34319,187,0.63
ptg013943l,129329,129621,292,RepeatMasker,DNA,129288,129489,160,0.55
ptg014008l,96984,97295,311,RepeatMasker,DNA,96879,98436,311,1.00
ptg014104l,616775,617103,328,RepeatMasker,DNA,616119,617157,328,1.00
ptg014141l,658357,658656,299,RepeatMasker,DNA,656671,660610,299,1.00
ptg014178l,321728,322016,288,RepeatMasker,DNA,321907,322497,110,0.38
ptg014190l,1779009,1779297,288,RepeatMasker,DNA,1779156,1780073,142,0.49
ptg014216l,1793957,1794235,278,RepeatMasker,DNA,1793192,1794003,46,0.17
ptg014218l,49772,50038,266,RepeatMasker,DNA,49609,50121,266,1.00
ptg014243l,2669616,2669929,313,RepeatMasker,DNA,2669638,2670082,292,0.93
ptg014252l,629649,629956,307,RepeatMasker,DNA,629608,629809,160,0.52
ptg014268l,1432089,1432416,327,RepeatMasker,DNA,1431427,1432459,327,1.00
ptg014346l,238192,238471,279,RepeatMasker,DNA,238146,238352,160,0.57
ptg014405l,1226566,1226872,306,RepeatMasker,DNA,1226382,1226913,306,1.00
ptg014415l,694098,694416,318,RepeatMasker,DNA,694056,694258,160,0.50
ptg014436l,208308,208579,271,RepeatMasker,DNA,208521,209506,59,0.22
ptg014458l,2513648,2513977,329,RepeatMasker,DNA,2513246,2513885,237,0.72
ptg014506l,316171,316456,285,RepeatMasker,DNA,316364,317644,93,0.33
ptg014577l,79443,79724,281,RepeatMasker,DNA,79424,79470,27,0.10
ptg014610l,310170,310483,313,RepeatMasker,DNA,310146,310192,22,0.07
ptg014652l,192715,193005,290,RepeatMasker,DNA,192913,194343,93,0.32
ptg014653l,1509154,1509470,316,RepeatMasker,DNA,1508938,1509241,87,0.28
ptg014663l,1140476,1140788,312,RepeatMasker,DNA,1140292,1140536,60,0.19
ptg014669l,534246,534545,299,RepeatMasker,DNA,534259,534996,287,0.96
ptg014677l,615420,615701,281,RepeatMasker,DNA,615374,615585,165,0.59
ptg014716l,264172,264462,290,RepeatMasker,DNA,264371,265017,92,0.32
ptg014762l,976117,976416,299,RepeatMasker,DNA,975916,976150,33,0.11
ptg014762l,982477,982763,286,RepeatMasker,DNA,982290,982510,33,0.12
ptg014762l,989600,989886,286,RepeatMasker,DNA,989407,989633,33,0.12
ptg014764l,2842107,2842402,295,RepeatMasker,DNA,2842036,2842599,295,1.00
ptg014764l,2842107,2842402,295,RepeatMasker,DNA,2842127,2842674,276,0.94
ptg014824l,2725612,2725943,331,RepeatMasker,DNA,2725908,2726403,36,0.11
ptg014846l,946668,946985,317,RepeatMasker,DNA,946172,947821,317,1.00
ptg014851l,1816140,1816451,311,RepeatMasker,DNA,1816199,1816289,91,0.29
ptg014859l,609790,610084,294,RepeatMasker,DNA,609738,609949,159,0.54
ptg014861l,390984,391266,282,RepeatMasker,DNA,390294,391242,258,0.91
ptg014861l,390984,391266,282,RepeatMasker,DNA,391244,391464,23,0.08
ptg014861l,390984,391266,282,RepeatMasker,DNA,391250,391507,17,0.06
ptg014885l,349579,349875,296,RepeatMasker,DNA,348712,350143,296,1.00
ptg014908l,391739,392051,312,RepeatMasker,DNA,391715,391761,22,0.07
ptg014935l,1005981,1006298,317,RepeatMasker,DNA,1005765,1006593,317,1.00
ptg014951l,507797,508088,291,RepeatMasker,DNA,507751,507957,160,0.55
ptg014992l,1084618,1084926,308,RepeatMasker,DNA,1084538,1084694,76,0.25
ptg015020l,1225044,1225335,291,RepeatMasker,DNA,1225078,1225278,201,0.69
ptg015031l,413039,413317,278,RepeatMasker,DNA,412084,413145,106,0.38
ptg015031l,749572,749861,289,RepeatMasker,DNA,749768,749845,78,0.27
ptg015130l,162124,162394,270,RepeatMasker,DNA,161595,162159,35,0.13
ptg015130l,162124,162394,270,RepeatMasker,DNA,162338,162611,57,0.21
ptg015133l,357987,358267,280,RepeatMasker,DNA,357940,358147,160,0.57
ptg015136l,228402,228718,316,RepeatMasker,DNA,227741,228766,316,1.00
ptg015158l,401770,402053,283,RepeatMasker,DNA,401747,401797,27,0.10
ptg015235l,523682,523983,301,RepeatMasker,DNA,523640,523842,160,0.53
ptg015254l,296611,296943,332,RepeatMasker,DNA,296595,296803,192,0.58
ptg015278l,48028,48331,303,RepeatMasker,DNA,47184,48113,85,0.28
ptg015317l,242284,242572,288,RepeatMasker,DNA,242472,243211,101,0.35
ptg015332l,713224,713543,319,RepeatMasker,DNA,712749,713290,66,0.21
ptg015342l,192879,193204,325,RepeatMasker,DNA,193107,193276,98,0.30
ptg015347l,1233871,1234184,313,RepeatMasker,DNA,1233577,1233958,87,0.28
ptg015357l,2758388,2758670,282,RepeatMasker,DNA,2758252,2758605,217,0.77
ptg015378l,410595,410915,320,RepeatMasker,DNA,410411,410627,32,0.10
ptg015384l,469939,470268,329,RepeatMasker,DNA,469537,470252,313,0.95
ptg015389l,716711,717022,311,RepeatMasker,DNA,715027,717312,311,1.00
ptg015418l,407103,407392,289,RepeatMasker,DNA,405568,409974,289,1.00
ptg015426l,568873,569154,281,RepeatMasker,DNA,568826,569033,160,0.57
ptg015488l,289669,289973,304,RepeatMasker,DNA,289526,289679,10,0.03
ptg015580l,512727,513007,280,RepeatMasker,DNA,512465,513020,280,1.00
ptg015586l,149919,150234,315,RepeatMasker,DNA,149706,150045,126,0.40
ptg015712l,306173,306494,321,RepeatMasker,DNA,306093,306278,105,0.33
ptg015763l,785303,785588,285,RepeatMasker,DNA,785133,785336,33,0.12
ptg015766l,156630,156943,313,RepeatMasker,DNA,154983,156743,113,0.36
ptg015778l,300661,300943,282,RepeatMasker,DNA,300664,301217,280,0.99
ptg015801l,951548,951873,325,RepeatMasker,DNA,951636,952179,238,0.73
ptg015852l,17960,18242,282,RepeatMasker,DNA,17913,18120,160,0.57
ptg015959l,419809,420139,330,RepeatMasker,DNA,419730,419943,134,0.41
ptg015982l,387299,387604,305,RepeatMasker,DNA,387459,387778,146,0.48
ptg015982l,927365,927654,289,RepeatMasker,DNA,927533,928577,122,0.42
ptg016013l,1079108,1079431,323,RepeatMasker,DNA,1079033,1079222,114,0.35
ptg016051l,207560,207894,334,RepeatMasker,DNA,207803,208818,92,0.28
ptg016053l,1947838,1948118,280,RepeatMasker,DNA,1947842,1947898,57,0.20
ptg016139l,92201,92486,285,RepeatMasker,DNA,92422,92477,56,0.20
ptg016165l,327176,327488,312,RepeatMasker,DNA,327152,327198,22,0.07
ptg016248l,190758,191030,272,RepeatMasker,DNA,190883,191084,148,0.54
ptg016265l,163481,163771,290,RepeatMasker,DNA,163628,164564,144,0.50
ptg016302l,643449,643713,264,RepeatMasker,DNA,643597,644198,117,0.44
ptg016335l,363335,363616,281,RepeatMasker,DNA,363289,363495,160,0.57
ptg016343l,986325,986619,294,RepeatMasker,DNA,986254,986816,294,1.00
ptg016343l,986325,986619,294,RepeatMasker,DNA,986328,986888,292,0.99
ptg016352l,175328,175640,312,RepeatMasker,DNA,173562,175554,226,0.72
ptg016386l,448695,449025,330,RepeatMasker,DNA,448782,449626,244,0.74
ptg016515l,39456,39723,267,RepeatMasker,DNA,39281,39564,108,0.40
ptg016537l,1213652,1213934,282,RepeatMasker,DNA,1213887,1214250,48,0.17
ptg016543l,326543,326856,313,RepeatMasker,DNA,326717,327804,140,0.45
ptg016596l,1057408,1057701,293,RepeatMasker,DNA,1057364,1057568,160,0.55
ptg016681l,198929,199242,313,RepeatMasker,DNA,198617,199278,313,1.00
ptg016684l,410638,410937,299,RepeatMasker,DNA,410614,410660,22,0.07
ptg016714l,260698,261014,316,RepeatMasker,DNA,260073,261328,316,1.00
ptg016753l,771761,772041,280,RepeatMasker,DNA,771657,771926,165,0.59
ptg016763l,646985,647265,280,RepeatMasker,DNA,647052,647091,40,0.14
ptg016934l,1540617,1540928,311,RepeatMasker,DNA,1540702,1540960,227,0.73
ptg016938l,719817,720123,306,RepeatMasker,DNA,719893,720170,231,0.75
ptg016945l,547607,547902,295,RepeatMasker,DNA,547687,548408,216,0.73
ptg016947l,1345351,1345666,315,RepeatMasker,DNA,1345332,1345480,129,0.41
ptg016949l,447238,447533,295,RepeatMasker,DNA,447441,449219,93,0.32
ptg016982l,721354,721647,293,RepeatMasker,DNA,721506,722234,142,0.48
ptg017000l,298361,298641,280,RepeatMasker,DNA,298322,298520,159,0.57
ptg017078l,560885,561189,304,RepeatMasker,DNA,561087,562326,103,0.34
ptg017136l,65956,66273,317,RepeatMasker,DNA,65932,65978,22,0.07
ptg017143l,165734,166014,280,RepeatMasker,DNA,165598,165951,217,0.78
ptg017233l,429931,430211,280,RepeatMasker,DNA,429887,430090,159,0.57
ptg017256l,870177,870472,295,RepeatMasker,DNA,869813,870263,86,0.29
ptg017272l,447753,448033,280,RepeatMasker,DNA,447711,447913,160,0.57
ptg017278l,224055,224367,312,RepeatMasker,DNA,224031,224077,22,0.07
ptg017285l,1096177,1096457,280,RepeatMasker,DNA,1096137,1096337,160,0.57
ptg017295l,157867,158181,314,RepeatMasker,DNA,157235,158492,314,1.00
ptg017313l,1232921,1233222,301,RepeatMasker,DNA,1232698,1233216,295,0.98
ptg017313l,1232921,1233222,301,RepeatMasker,DNA,1233198,1233336,25,0.08
ptg017313l,1236378,1236679,301,RepeatMasker,DNA,1235181,1236673,295,0.98
ptg017313l,1236378,1236679,301,RepeatMasker,DNA,1236655,1236798,25,0.08
ptg017509l,1243339,1243630,291,RepeatMasker,DNA,1243182,1243372,33,0.11
ptg017596l,137435,137722,287,RepeatMasker,DNA,137391,137595,160,0.56
ptg017647l,112172,112471,299,RepeatMasker,DNA,111996,112205,33,0.11
ptg017685l,735318,735618,300,RepeatMasker,DNA,735468,735656,151,0.50
ptg017787l,296598,296907,309,RepeatMasker,DNA,296802,297668,106,0.34
ptg017815l,1226755,1227036,281,RepeatMasker,DNA,1226710,1226915,160,0.57
ptg017872l,785814,786140,326,RepeatMasker,DNA,785770,785973,159,0.49
ptg017898l,4303174,4303507,333,RepeatMasker,DNA,4303040,4303344,170,0.51
ptg017931l,1135578,1135877,299,RepeatMasker,DNA,1135684,1136798,194,0.65
ptg017939l,1926711,1927001,290,RepeatMasker,DNA,1926892,1927474,110,0.38
ptg017939l,2448743,2449040,297,RepeatMasker,DNA,2448698,2448902,159,0.54
ptg018003l,1036966,1037284,318,RepeatMasker,DNA,1036942,1036988,22,0.07
ptg018007l,270125,270429,304,RepeatMasker,DNA,270221,270463,209,0.69
ptg018058l,1115419,1115736,317,RepeatMasker,DNA,1115395,1115441,22,0.07
ptg018078l,200315,200602,287,RepeatMasker,DNA,200511,201113,92,0.32
ptg018090l,21657,21939,282,RepeatMasker,DNA,21465,22179,282,1.00
ptg018115l,507525,507853,328,RepeatMasker,DNA,504045,508099,328,1.00
ptg018115l,507525,507853,328,RepeatMasker,DNA,507713,508372,141,0.43
ptg018144l,206777,207080,303,RepeatMasker,DNA,206912,207019,108,0.36
ptg018151l,205939,206230,291,RepeatMasker,DNA,206139,206299,92,0.32
ptg018188l,799414,799692,278,RepeatMasker,DNA,799278,799631,217,0.78
ptg018243l,1471787,1472068,281,RepeatMasker,DNA,1471746,1471945,158,0.56
ptg018300l,124049,124342,293,RepeatMasker,DNA,124250,125272,93,0.32
ptg018345l,651965,652246,281,RepeatMasker,DNA,652158,653008,89,0.32
ptg018351l,9180,9485,305,RepeatMasker,DNA,9100,9318,138,0.45
ptg018366l,85575,85863,288,RepeatMasker,DNA,85772,86855,92,0.32
ptg018378l,750135,750466,331,RepeatMasker,DNA,749892,750165,30,0.09
ptg018383l,154812,155133,321,RepeatMasker,DNA,154904,155058,155,0.48
ptg018403l,218346,218682,336,RepeatMasker,DNA,218397,218809,286,0.85
ptg018408l,156167,156456,289,RepeatMasker,DNA,156270,156481,187,0.65
ptg018408l,156167,156456,289,RepeatMasker,DNA,156364,156509,93,0.32
ptg018416l,242545,242831,286,RepeatMasker,DNA,242741,242876,91,0.32
ptg018435l,724944,725240,296,RepeatMasker,DNA,724873,725437,296,1.00
ptg018435l,724944,725240,296,RepeatMasker,DNA,724964,725512,277,0.94
ptg018458l,595025,595306,281,RepeatMasker,DNA,594699,595544,281,1.00
ptg018459l,143282,143594,312,RepeatMasker,DNA,143258,143304,22,0.07
ptg018518l,832272,832574,302,RepeatMasker,DNA,832131,832352,80,0.26
ptg018598l,63562,63853,291,RepeatMasker,DNA,63542,63728,166,0.57
ptg018645l,58320,58645,325,RepeatMasker,DNA,57848,58618,298,0.92
ptg018667l,139689,139977,288,RepeatMasker,DNA,138535,142648,288,1.00
ptg018672l,502970,503257,287,RepeatMasker,DNA,502866,503135,165,0.57
ptg018689l,207925,208209,284,RepeatMasker,DNA,207744,207958,33,0.12
ptg018691l,729967,730247,280,RepeatMasker,DNA,729922,730127,160,0.57
ptg018698l,301108,301430,322,RepeatMasker,DNA,300318,301194,86,0.27
ptg018723l,283440,283747,307,RepeatMasker,DNA,283190,283443,3,0.01
ptg018878l,442888,443195,307,RepeatMasker,DNA,442838,442993,105,0.34
ptg018879l,137804,138084,280,RepeatMasker,DNA,137753,137964,160,0.57
ptg018894l,134724,135018,294,RepeatMasker,DNA,134895,135387,124,0.42
ptg018903l,577250,577565,315,RepeatMasker,DNA,577220,577374,124,0.39
ptg018989l,148896,149214,318,RepeatMasker,DNA,149090,149131,42,0.13
ptg018995l,1421276,1421588,312,RepeatMasker,DNA,1421252,1421298,22,0.07
ptg019006l,1088379,1088697,318,RepeatMasker,DNA,1088306,1088471,92,0.29
ptg019013l,279259,279539,280,RepeatMasker,DNA,279209,279424,165,0.59
ptg019063l,476636,476930,294,RepeatMasker,DNA,476725,477025,206,0.70
ptg019069l,385952,386254,302,RepeatMasker,DNA,385855,386102,150,0.50
ptg019088l,931971,932252,281,RepeatMasker,DNA,932048,932127,80,0.28
ptg019111l,184109,184447,338,RepeatMasker,DNA,183894,184205,96,0.28
ptg019120l,321176,321508,332,RepeatMasker,DNA,321265,322003,244,0.73
ptg019123l,42174,42469,295,RepeatMasker,DNA,42103,42666,295,1.00
ptg019123l,42174,42469,295,RepeatMasker,DNA,42177,42741,293,0.99
ptg019173l,336204,336520,316,RepeatMasker,DNA,335389,336816,316,1.00
ptg019180l,200738,201032,294,RepeatMasker,DNA,200942,203219,91,0.31
ptg019180l,1460591,1460904,313,RepeatMasker,DNA,1460757,1461821,148,0.47
ptg019190l,1468436,1468716,280,RepeatMasker,DNA,1468473,1468953,244,0.87
ptg019303l,1042669,1042939,270,RepeatMasker,DNA,1042598,1042797,128,0.47
ptg019372l,951650,951967,317,RepeatMasker,DNA,951610,951810,160,0.50
ptg019374l,178332,178636,304,RepeatMasker,DNA,178090,178336,4,0.01
ptg019374l,178332,178636,304,RepeatMasker,DNA,178105,178366,34,0.11
ptg019374l,301639,301927,288,RepeatMasker,DNA,301835,302336,93,0.32
ptg019392l,101265,101543,278,RepeatMasker,DNA,101462,102275,82,0.29
ptg019457l,180186,180497,311,RepeatMasker,DNA,179617,180365,179,0.58
ptg019457l,691926,692256,330,RepeatMasker,DNA,691771,692056,130,0.39
ptg019457l,691926,692256,330,RepeatMasker,DNA,692215,692774,42,0.13
ptg019495l,4620,4895,275,RepeatMasker,DNA,4818,5180,78,0.28
ptg019580l,301187,301482,295,RepeatMasker,DNA,300655,301394,207,0.70
ptg019581l,247409,247704,295,RepeatMasker,DNA,247335,247670,261,0.88
ptg019584l,284146,284421,275,RepeatMasker,DNA,283830,284347,201,0.73
ptg019594l,171928,172223,295,RepeatMasker,DNA,171931,172497,293,0.99
ptg019643l,80440,80705,265,RepeatMasker,DNA,80269,80473,33,0.12
ptg019702l,1359391,1359687,296,RepeatMasker,DNA,1358772,1359977,296,1.00
ptg019737l,291269,291549,280,RepeatMasker,DNA,290630,291434,165,0.59
ptg019738l,703407,703695,288,RepeatMasker,DNA,703353,703566,159,0.55
ptg019891l,241387,241698,311,RepeatMasker,DNA,241536,241638,103,0.33
ptg020015l,504482,504797,315,RepeatMasker,DNA,504443,504642,160,0.51
ptg020075l,148512,148807,295,RepeatMasker,DNA,148334,148545,33,0.11
ptg020077l,84670,84971,301,RepeatMasker,DNA,84895,85218,77,0.26
ptg020192l,1532183,1532500,317,RepeatMasker,DNA,1531884,1533189,317,1.00
ptg020202l,612658,612944,286,RepeatMasker,DNA,612853,613160,92,0.32
ptg020225l,1125194,1125474,280,RepeatMasker,DNA,1125143,1125354,160,0.57
ptg020226l,469069,469365,296,RepeatMasker,DNA,469011,469151,82,0.28
ptg020247l,500338,500603,265,RepeatMasker,DNA,500389,500488,100,0.38
ptg020256l,431621,431949,328,RepeatMasker,DNA,431560,431980,328,1.00
ptg020263l,67292,67587,295,RepeatMasker,DNA,67222,67784,295,1.00
ptg020263l,67292,67587,295,RepeatMasker,DNA,67312,67859,276,0.94
ptg020302l,420756,421035,279,RepeatMasker,DNA,420714,420916,160,0.57
ptg020365l,312974,313282,308,RepeatMasker,DNA,313086,313211,126,0.41
ptg020378l,1286543,1286837,294,RepeatMasker,DNA,1286400,1286612,69,0.23
ptg020419l,279212,279509,297,RepeatMasker,DNA,279178,279371,159,0.54
ptg020428l,114666,114947,281,RepeatMasker,DNA,114600,114825,159,0.57
ptg020463l,133414,133754,340,RepeatMasker,DNA,133306,133447,33,0.10
ptg020636l,497629,497943,314,RepeatMasker,DNA,496990,497981,314,1.00
ptg020675l,460148,460411,263,RepeatMasker,DNA,460260,460422,152,0.58
ptg020694l,1295450,1295764,314,RepeatMasker,DNA,1295420,1295573,123,0.39
ptg020696l,411093,411413,320,RepeatMasker,DNA,410521,412165,320,1.00
ptg020752l,458793,459085,292,RepeatMasker,DNA,458994,461276,92,0.32
ptg020755l,23336,23647,311,RepeatMasker,DNA,23312,23358,22,0.07
ptg020934l,97240,97511,271,RepeatMasker,DNA,97210,97290,50,0.18
ptg020974l,972899,973212,313,RepeatMasker,DNA,972875,972921,22,0.07
ptg021118l,182112,182414,302,RepeatMasker,DNA,182062,182272,160,0.53
ptg021118l,189640,189920,280,RepeatMasker,DNA,189590,189800,160,0.57
ptg021220l,440795,441067,272,RepeatMasker,DNA,440950,441230,118,0.43
ptg021338l,83374,83686,312,RepeatMasker,DNA,82478,83812,312,1.00
ptg021372l,534757,535047,290,RepeatMasker,DNA,534955,535313,93,0.32
ptg021377l,117901,118197,296,RepeatMasker,DNA,117370,118302,296,1.00
ptg021425l,808993,809305,312,RepeatMasker,DNA,808969,809015,22,0.07
ptg021534l,496102,496392,290,RepeatMasker,DNA,496298,498590,95,0.33
ptg021579l,154629,154914,285,RepeatMasker,DNA,154803,156434,112,0.39
ptg021601l,781249,781568,319,RepeatMasker,DNA,781171,781376,127,0.40
ptg021637l,626371,626683,312,RepeatMasker,DNA,626347,626393,22,0.07
ptg021724l,1008793,1009074,281,RepeatMasker,DNA,1008754,1008958,165,0.59
ptg021762l,188762,189023,261,RepeatMasker,DNA,188798,189111,226,0.87
ptg021771l,294714,295040,326,RepeatMasker,DNA,294685,295569,326,1.00
ptg021815l,165063,165343,280,RepeatMasker,DNA,165019,165223,160,0.57
ptg021836l,35388,35668,280,RepeatMasker,DNA,35063,35907,280,1.00
ptg021867l,616319,616604,285,RepeatMasker,DNA,614532,617734,285,1.00
ptg021871l,381401,381695,294,RepeatMasker,DNA,381592,381902,104,0.35
ptg021911l,44259,44559,300,RepeatMasker,DNA,43651,45447,300,1.00
ptg021951l,321233,321526,293,RepeatMasker,DNA,321435,322795,92,0.31
ptg021960l,515995,516320,325,RepeatMasker,DNA,515782,516138,143,0.44
ptg022023l,1478940,1479264,324,RepeatMasker,DNA,1478783,1478988,48,0.15
ptg022062l,271209,271503,294,RepeatMasker,DNA,271138,271700,294,1.00
ptg022078l,8640,8953,313,RepeatMasker,DNA,8616,8662,22,0.07
ptg022143l,1004744,1005036,292,RepeatMasker,DNA,1004943,1005379,94,0.32
ptg022193l,85168,85459,291,RepeatMasker,DNA,85368,87089,92,0.32
ptg022201l,442583,442861,278,RepeatMasker,DNA,442538,442740,157,0.56
ptg022201l,449743,450026,283,RepeatMasker,DNA,449698,449905,162,0.57
ptg022359l,132624,132938,314,RepeatMasker,DNA,132544,132746,122,0.39
ptg022381l,87072,87368,296,RepeatMasker,DNA,87047,87299,227,0.77
ptg022520l,373091,373386,295,RepeatMasker,DNA,373020,373583,295,1.00
ptg022520l,373091,373386,295,RepeatMasker,DNA,373111,373658,276,0.94
ptg022562l,138751,139073,322,RepeatMasker,DNA,138087,139016,265,0.82
ptg022731l,374508,374798,290,RepeatMasker,DNA,374130,374835,290,1.00
ptg023053l,34008,34328,320,RepeatMasker,DNA,33488,36202,320,1.00
ptg023090l,1237760,1238076,316,RepeatMasker,DNA,1237737,1237888,128,0.41
ptg023118l,94627,94920,293,RepeatMasker,DNA,94590,94786,159,0.54
ptg023225l,129173,129465,292,RepeatMasker,DNA,129375,130426,91,0.31
ptg023234l,170916,171199,283,RepeatMasker,DNA,171029,171544,171,0.60
ptg023472l,1441431,1441760,329,RepeatMasker,DNA,1441030,1441668,237,0.72
ptg023472l,1441431,1441760,329,RepeatMasker,DNA,1441032,1441589,158,0.48
ptg023557l,737537,737789,252,RepeatMasker,DNA,737498,737597,60,0.24
ptg023720l,21392,21693,301,RepeatMasker,DNA,21297,21639,247,0.82
ptg023809l,343640,343929,289,RepeatMasker,DNA,343837,346068,93,0.32
ptg023815l,2014175,2014468,293,RepeatMasker,DNA,2013894,2014422,247,0.84
ptg023930l,126347,126647,300,RepeatMasker,DNA,126351,126408,58,0.19
ptg024054l,30484,30763,279,RepeatMasker,DNA,30313,30516,32,0.11
ptg024072l,932783,933108,325,RepeatMasker,DNA,932787,932843,57,0.18
ptg024232l,226962,227260,298,RepeatMasker,DNA,226859,227214,252,0.85
ptg024365l,737255,737566,311,RepeatMasker,DNA,737138,737285,30,0.10
ptg024411l,193778,194068,290,RepeatMasker,DNA,193728,193938,160,0.55
ptg024468l,177262,177542,280,RepeatMasker,DNA,177221,177421,159,0.57
ptg024507l,845456,845756,300,RepeatMasker,DNA,845739,846370,18,0.06
ptg024555l,696740,697048,308,RepeatMasker,DNA,696690,696900,160,0.52
ptg024557l,428947,429258,311,RepeatMasker,DNA,428923,428969,22,0.07
ptg024601l,1926539,1926864,325,RepeatMasker,DNA,1926341,1926561,22,0.07
ptg024749l,148193,148487,294,RepeatMasker,DNA,148122,148684,294,1.00
ptg024749l,148193,148487,294,RepeatMasker,DNA,148213,148759,275,0.94
ptg024803l,248234,248523,289,RepeatMasker,DNA,248344,248727,180,0.62
ptg024951l,1180275,1180565,290,RepeatMasker,DNA,1180474,1181596,92,0.32
ptg024978l,261484,261815,331,RepeatMasker,DNA,261244,261488,4,0.01
ptg025056l,357179,357506,327,RepeatMasker,DNA,356855,357286,107,0.33
ptg025128l,365241,365559,318,RepeatMasker,DNA,365089,365595,318,1.00
ptg025162l,185492,185806,314,RepeatMasker,DNA,185468,185514,22,0.07
ptg025287l,26438,26732,294,RepeatMasker,DNA,26429,27089,294,1.00
ptg025355l,187674,187955,281,RepeatMasker,DNA,187636,187833,159,0.57
ptg025355l,198381,198661,280,RepeatMasker,DNA,198343,198540,159,0.57
ptg025402l,112081,112362,281,RepeatMasker,DNA,112038,112241,160,0.57
ptg025541l,140478,140762,284,RepeatMasker,DNA,140671,140900,92,0.32
ptg025641l,308736,309062,326,RepeatMasker,DNA,308685,308896,160,0.49
ptg025699l,34154,34434,280,RepeatMasker,DNA,34109,34314,160,0.57
ptg025857l,248591,248903,312,RepeatMasker,DNA,248567,248613,22,0.07
ptg025857l,250188,250503,315,RepeatMasker,DNA,250168,250314,126,0.40
ptg025908l,350737,351007,270,RepeatMasker,DNA,350694,350903,166,0.61
ptg026041l,52687,53016,329,RepeatMasker,DNA,52284,52845,158,0.48
ptg026041l,52687,53016,329,RepeatMasker,DNA,52284,52924,237,0.72
ptg026067l,99373,99669,296,RepeatMasker,DNA,99561,101427,109,0.37
ptg026074l,234653,234968,315,RepeatMasker,DNA,234327,235120,315,1.00
ptg026126l,61241,61545,304,RepeatMasker,DNA,60484,61326,85,0.28
ptg026173l,769821,770094,273,RepeatMasker,DNA,770014,772241,81,0.30
ptg026201l,229471,229751,280,RepeatMasker,DNA,229425,229631,160,0.57
ptg026303l,283406,283693,287,RepeatMasker,DNA,283246,283469,63,0.22
ptg026437l,140490,140774,284,RepeatMasker,DNA,140007,140575,85,0.30
ptg026536l,209661,209977,316,RepeatMasker,DNA,209028,210254,316,1.00
ptg026635l,18760,19072,312,RepeatMasker,DNA,18853,20543,220,0.71
ptg026643l,648170,648451,281,RepeatMasker,DNA,648130,648330,160,0.57
ptg026681l,182421,182722,301,RepeatMasker,DNA,182397,182443,22,0.07
ptg026684l,63626,63922,296,RepeatMasker,DNA,63586,63786,160,0.54
ptg026855l,4134302,4134624,322,RepeatMasker,DNA,4133070,4135050,322,1.00
ptg026870l,1146551,1146842,291,RepeatMasker,DNA,1146750,1147898,93,0.32
ptg027154l,187206,187492,286,RepeatMasker,DNA,187370,187465,96,0.34
ptg027239l,210270,210560,290,RepeatMasker,DNA,210504,212152,57,0.20
ptg027274l,22256,22568,312,RepeatMasker,DNA,22232,22278,22,0.07
ptg027472l,387183,387472,289,RepeatMasker,DNA,387379,389638,94,0.33
ptg027476l,312762,313098,336,RepeatMasker,DNA,312701,313041,279,0.83
ptg027477l,2426,2706,280,RepeatMasker,DNA,2383,2586,160,0.57
ptg027678l,167918,168232,314,RepeatMasker,DNA,167899,167945,27,0.09
ptg027749l,3160437,3160750,313,RepeatMasker,DNA,3160413,3160459,22,0.07
ptg027788l,39584,39897,313,RepeatMasker,DNA,39692,39905,206,0.66
ptg027838l,556115,556431,316,RepeatMasker,DNA,556035,556233,118,0.37
ptg027932l,9699,9995,296,RepeatMasker,DNA,9528,9732,33,0.11
ptg027932l,9699,9995,296,RepeatMasker,DNA,9827,9861,35,0.12
ptg028063l,46944,47257,313,RepeatMasker,DNA,46920,46966,22,0.07
ptg028084l,2008,2289,281,RepeatMasker,DNA,1969,2169,161,0.57
ptg028096l,67191,67503,312,RepeatMasker,DNA,67167,67213,22,0.07
ptg028373l,733821,734109,288,RepeatMasker,DNA,733760,733980,159,0.55
ptg028537l,211654,211966,312,RepeatMasker,DNA,211630,211676,22,0.07
ptg028550l,591949,592240,291,RepeatMasker,DNA,591901,592109,160,0.55
ptg028722l,345113,345402,289,RepeatMasker,DNA,345311,346939,92,0.32
ptg028768l,1621594,1621906,312,RepeatMasker,DNA,1621570,1621616,22,0.07
ptg028812l,133461,133756,295,RepeatMasker,DNA,133390,133953,295,1.00
ptg028812l,133461,133756,295,RepeatMasker,DNA,133464,134028,293,0.99
ptg029025l,336088,336390,302,RepeatMasker,DNA,335927,336387,299,0.99
ptg029351l,220657,220941,284,RepeatMasker,DNA,220510,220685,28,0.10
ptg029382l,179125,179423,298,RepeatMasker,DNA,179316,181637,108,0.36
ptg029418l,613810,614126,316,RepeatMasker,DNA,613786,613832,22,0.07
ptg029475l,92889,93175,286,RepeatMasker,DNA,93152,94100,24,0.08
ptg029932l,223842,224155,313,RepeatMasker,DNA,223818,223864,22,0.07
ptg030000l,201016,201301,285,RepeatMasker,DNA,200314,201050,34,0.12
ptg030131l,314652,314970,318,RepeatMasker,DNA,314708,314789,82,0.26
ptg030382l,3631167,3631446,279,RepeatMasker,DNA,3631268,3631640,179,0.64
ptg030402l,139361,139692,331,RepeatMasker,DNA,139051,139446,85,0.26
ptg030586l,337012,337311,299,RepeatMasker,DNA,337209,337349,103,0.34
ptg030749l,101027,101308,281,RepeatMasker,DNA,100975,101187,160,0.57
ptg030776l,110832,111113,281,RepeatMasker,DNA,110786,110992,160,0.57
ptg031005l,342197,342496,299,RepeatMasker,DNA,342022,342222,25,0.08
ptg031571l,350677,350969,292,RepeatMasker,DNA,350645,350837,160,0.55
ptg031995l,1002,1328,326,RepeatMasker,DNA,1037,1343,292,0.90
ptg032148l,173423,173713,290,RepeatMasker,DNA,173604,175763,110,0.38
ptg032193l,28797,29093,296,RepeatMasker,DNA,28450,28961,164,0.55
ptg032193l,28797,29093,296,RepeatMasker,DNA,28971,29309,123,0.42
ptg032484l,67915,68204,289,RepeatMasker,DNA,67926,68192,267,0.92
ptg032852l,210781,211062,281,RepeatMasker,DNA,210743,210940,159,0.57
ptg032932l,18480,18761,281,RepeatMasker,DNA,18442,18639,159,0.57
ptg032963l,14078,14411,333,RepeatMasker,DNA,13437,14449,333,1.00
ptg033092l,647351,647648,297,RepeatMasker,DNA,644140,647473,122,0.41
ptg033264l,118436,118713,277,RepeatMasker,DNA,118384,118595,159,0.57
ptg033451l,41682,42000,318,RepeatMasker,DNA,41546,41715,33,0.10
ptg033723l,1434326,1434626,300,RepeatMasker,DNA,1434284,1434486,160,0.53
ptg034020l,209962,210242,280,RepeatMasker,DNA,209911,210121,159,0.57
ptg034100l,53108,53435,327,RepeatMasker,DNA,51250,53500,327,1.00
ptg034179l,839734,840050,316,RepeatMasker,DNA,839807,840465,244,0.77
ptg034294l,117158,117449,291,RepeatMasker,DNA,116278,117608,291,1.00
ptg034436l,53384,53700,316,RepeatMasker,DNA,52578,53996,316,1.00
ptg034593l,13868,14181,313,RepeatMasker,DNA,13107,14370,313,1.00
ptg034593l,13868,14181,313,RepeatMasker,DNA,14057,14870,125,0.40
ptg034748l,10956,11269,313,RepeatMasker,DNA,10885,11029,73,0.23
ptg034861l,124557,124838,281,RepeatMasker,DNA,124519,124717,160,0.57
ptg034927l,58221,58539,318,RepeatMasker,DNA,58299,59976,241,0.76
ptg034940l,161129,161419,290,RepeatMasker,DNA,160907,161430,290,1.00
ptg035556l,167957,168266,309,RepeatMasker,DNA,168029,168441,238,0.77
ptg035675l,144615,144895,280,RepeatMasker,DNA,144575,144774,159,0.57
ptg035751l,25902,26190,288,RepeatMasker,DNA,25950,26392,241,0.84
ptg036034l,188492,188784,292,RepeatMasker,DNA,188473,188519,27,0.09
ptg036222l,252526,252822,296,RepeatMasker,DNA,252481,252684,158,0.53
ptg036333l,255340,255612,272,RepeatMasker,DNA,255310,255787,272,1.00
ptg036714l,106340,106630,290,RepeatMasker,DNA,106262,106351,11,0.04
ptg036923l,291507,291803,296,RepeatMasker,DNA,291424,291522,15,0.05
ptg037615l,4175141,4175450,309,RepeatMasker,DNA,4174719,4175337,196,0.63
ptg037615l,4175141,4175450,309,RepeatMasker,DNA,4174753,4175245,104,0.34
ptg037615l,5478258,5478533,275,RepeatMasker,DNA,5478014,5478344,86,0.31
ptg038338l,74487,74800,313,RepeatMasker,DNA,74463,74509,22,0.07
ptg039154l,231074,231355,281,RepeatMasker,DNA,231034,231235,161,0.57
ptg039228l,268895,269182,287,RepeatMasker,DNA,268932,269380,251,0.87
ptg039228l,1197889,1198200,311,RepeatMasker,DNA,1197865,1197911,22,0.07
ptg039252l,93518,93828,310,RepeatMasker,DNA,93482,93605,87,0.28
ptg039549l,1090564,1090844,280,RepeatMasker,DNA,1090519,1090724,160,0.57
ptg039590l,31176,31502,326,RepeatMasker,DNA,31180,31237,58,0.18
ptg039662l,1370032,1370317,285,RepeatMasker,DNA,1369824,1370118,86,0.30
ptg039789l,1554705,1554980,275,RepeatMasker,DNA,1554363,1556451,275,1.00
ptg039927l,93128,93441,313,RepeatMasker,DNA,93104,93150,22,0.07
ptg040204l,2304749,2305037,288,RepeatMasker,DNA,2304583,2305200,288,1.00
ptg040380l,1224333,1224614,281,RepeatMasker,DNA,1224337,1224393,57,0.20
ptg040936l,412711,413029,318,RepeatMasker,DNA,412787,413330,243,0.76
ptg041167l,71064,71359,295,RepeatMasker,DNA,70321,71149,85,0.29
ptg041253l,203980,204260,280,RepeatMasker,DNA,203943,204139,159,0.57
ptg043040l,22128,22456,328,RepeatMasker,DNA,21726,22365,237,0.72
ptg043531l,90183,90451,268,RepeatMasker,DNA,90141,90343,160,0.60
ptg043804l,110318,110599,281,RepeatMasker,DNA,110279,110478,160,0.57
ptg044072l,13402,13731,329,RepeatMasker,DNA,12998,13639,237,0.72
ptg044110l,196243,196547,304,RepeatMasker,DNA,195756,196638,304,1.00
ptg047465l,25024,25308,284,RepeatMasker,DNA,25132,25521,177,0.62
ptg048990l,39046,39326,280,RepeatMasker,DNA,39011,39206,160,0.57
ptg049024l,1338511,1338829,318,RepeatMasker,DNA,1338487,1338533,22,0.07
ptg054819l,11724,12035,311,RepeatMasker,DNA,11644,11844,120,0.39
ptg058450l,24971,25287,316,RepeatMasker,DNA,25131,25273,143,0.45
ptg000010l,194282,194593,311,RepeatMasker,LINE,194593,194880,1,0.00
ptg000020l,3055137,3055439,302,RepeatMasker,LINE,3054380,3055375,238,0.79
ptg000024l,4269910,4270221,311,RepeatMasker,LINE,4269713,4269998,88,0.28
ptg000035l,409429,409749,320,RepeatMasker,LINE,409595,413637,155,0.48
ptg000047l,656433,656707,274,RepeatMasker,LINE,656317,658958,274,1.00
ptg000047l,656433,656707,274,RepeatMasker,LINE,656330,658277,274,1.00
ptg000048l,3608734,3609051,317,RepeatMasker,LINE,3608633,3610655,317,1.00
ptg000057l,518824,519130,306,RepeatMasker,LINE,518603,518910,86,0.28
ptg000057l,518824,519130,306,RepeatMasker,LINE,518781,518917,93,0.30
ptg000059l,910194,910507,313,RepeatMasker,LINE,909963,911835,313,1.00
ptg000062l,34461,34757,296,RepeatMasker,LINE,34611,37449,147,0.50
ptg000062l,1424737,1425024,287,RepeatMasker,LINE,1424786,1424839,54,0.19
ptg000068l,3674743,3675023,280,RepeatMasker,LINE,3673274,3674772,29,0.10
ptg000077l,658283,658607,324,RepeatMasker,LINE,658120,658954,324,1.00
ptg000080l,705597,705897,300,RepeatMasker,LINE,705645,705697,53,0.18
ptg000085l,3845860,3846155,295,RepeatMasker,LINE,3845858,3846095,235,0.80
ptg000085l,5545859,5546159,300,RepeatMasker,LINE,5545835,5546127,268,0.89
ptg000095l,2183670,2183973,303,RepeatMasker,LINE,2183527,2183826,156,0.51
ptg000097l,639638,639939,301,RepeatMasker,LINE,638934,639826,188,0.62
ptg000104l,3541617,3541940,323,RepeatMasker,LINE,3541842,3543285,99,0.31
ptg000104l,6617888,6618189,301,RepeatMasker,LINE,6618124,6618276,66,0.22
ptg000104l,10667949,10668269,320,RepeatMasker,LINE,10668184,10668727,86,0.27
ptg000124l,1049922,1050220,298,RepeatMasker,LINE,1047435,1051217,298,1.00
ptg000124l,2167779,2168074,295,RepeatMasker,LINE,2167876,2167977,102,0.35
ptg000127l,3347511,3347785,274,RepeatMasker,LINE,3347777,3348221,9,0.03
ptg000147l,4615753,4616087,334,RepeatMasker,LINE,4615922,4618646,166,0.50
ptg000157l,1823107,1823440,333,RepeatMasker,LINE,1823357,1823422,66,0.20
ptg000163l,670157,670479,322,RepeatMasker,LINE,669353,670208,51,0.16
ptg000168l,786095,786400,305,RepeatMasker,LINE,784912,786143,48,0.16
ptg000185l,179527,179806,279,RepeatMasker,LINE,179311,180161,279,1.00
ptg000186l,2990416,2990716,300,RepeatMasker,LINE,2990657,2990737,60,0.20
ptg000200l,3492622,3492914,292,RepeatMasker,LINE,3492705,3493070,210,0.72
ptg000210l,2068639,2068942,303,RepeatMasker,LINE,2068052,2068871,232,0.77
ptg000210l,3193310,3193600,290,RepeatMasker,LINE,3193334,3193438,105,0.36
ptg000211l,7210,7537,327,RepeatMasker,LINE,7282,7853,256,0.78
ptg000216l,115877,116162,285,RepeatMasker,LINE,115996,116485,167,0.59
ptg000220l,2159891,2160184,293,RepeatMasker,LINE,2159820,2159996,105,0.36
ptg000221l,1334960,1335199,239,RepeatMasker,LINE,1335126,1335635,74,0.31
ptg000222l,4061018,4061315,297,RepeatMasker,LINE,4061097,4061404,219,0.74
ptg000235l,1411236,1411534,298,RepeatMasker,LINE,1411495,1411588,40,0.13
ptg000244l,3132675,3132973,298,RepeatMasker,LINE,3132969,3133362,5,0.02
ptg000258l,805480,805818,338,RepeatMasker,LINE,804794,807690,338,1.00
ptg000265l,1194798,1195090,292,RepeatMasker,LINE,1193980,1195226,292,1.00
ptg000267l,3489344,3489648,304,RepeatMasker,LINE,3489623,3489794,26,0.09
ptg000269l,800129,800456,327,RepeatMasker,LINE,797537,800805,327,1.00
ptg000273l,1977695,1977998,303,RepeatMasker,LINE,1977914,1978493,85,0.28
ptg000278l,380945,381236,291,RepeatMasker,LINE,381010,381167,158,0.54
ptg000278l,821118,821399,281,RepeatMasker,LINE,821281,823253,119,0.42
ptg000304l,4168931,4169233,302,RepeatMasker,LINE,4168741,4168936,5,0.02
ptg000304l,5441803,5442082,279,RepeatMasker,LINE,5441994,5442039,46,0.16
ptg000307l,829993,830308,315,RepeatMasker,LINE,829976,830898,315,1.00
ptg000307l,4817321,4817589,268,RepeatMasker,LINE,4817351,4817902,239,0.89
ptg000307l,7238542,7238842,300,RepeatMasker,LINE,7238610,7239260,233,0.78
ptg000311l,954270,954599,329,RepeatMasker,LINE,954344,955271,256,0.78
ptg000313l,1675446,1675752,306,RepeatMasker,LINE,1675695,1675920,58,0.19
ptg000313l,3737575,3737899,324,RepeatMasker,LINE,3736808,3738228,324,1.00
ptg000319l,467068,467369,301,RepeatMasker,LINE,466703,467652,301,1.00
ptg000320l,398239,398547,308,RepeatMasker,LINE,398174,402000,308,1.00
ptg000321l,955457,955743,286,RepeatMasker,LINE,955686,955779,58,0.20
ptg000337l,3618018,3618302,284,RepeatMasker,LINE,3617939,3618055,37,0.13
ptg000337l,3618018,3618302,284,RepeatMasker,LINE,3618162,3618229,68,0.24
ptg000337l,5954279,5954585,306,RepeatMasker,LINE,5954306,5954379,74,0.24
ptg000337l,5954279,5954585,306,RepeatMasker,LINE,5954320,5954380,61,0.20
ptg000337l,5954279,5954585,306,RepeatMasker,LINE,5954320,5954388,69,0.23
ptg000349l,1076662,1076960,298,RepeatMasker,LINE,1076942,1077109,19,0.06
ptg000350l,747793,748102,309,RepeatMasker,LINE,747800,747870,71,0.23
ptg000359l,1351209,1351507,298,RepeatMasker,LINE,1351299,1352056,209,0.70
ptg000360l,657526,657851,325,RepeatMasker,LINE,657010,658314,325,1.00
ptg000362l,2701426,2701719,293,RepeatMasker,LINE,2700989,2702287,293,1.00
ptg000363l,521695,522012,317,RepeatMasker,LINE,520416,524186,317,1.00
ptg000369l,1518471,1518758,287,RepeatMasker,LINE,1518558,1519291,201,0.70
ptg000375l,360255,360565,310,RepeatMasker,LINE,360296,360836,270,0.87
ptg000375l,841770,842090,320,RepeatMasker,LINE,840856,841961,191,0.60
ptg000377l,1357549,1357863,314,RepeatMasker,LINE,1357768,1357829,62,0.20
ptg000383l,1171593,1171921,328,RepeatMasker,LINE,1171793,1171843,51,0.16
ptg000387l,38684,38991,307,RepeatMasker,LINE,38847,42126,145,0.47
ptg000387l,2640260,2640593,333,RepeatMasker,LINE,2640556,2640928,38,0.11
ptg000393l,5382777,5383081,304,RepeatMasker,LINE,5381965,5382908,131,0.43
ptg000393l,5382777,5383081,304,RepeatMasker,LINE,5382914,5382974,61,0.20
ptg000397l,3414549,3414866,317,RepeatMasker,LINE,3414662,3415265,205,0.65
ptg000398l,407056,407345,289,RepeatMasker,LINE,406961,407662,289,1.00
ptg000406l,563740,564041,301,RepeatMasker,LINE,563291,563951,211,0.70
ptg000406l,802285,802605,320,RepeatMasker,LINE,800668,804447,320,1.00
ptg000411l,4578326,4578653,327,RepeatMasker,LINE,4578551,4579554,103,0.31
ptg000412l,1302933,1303207,274,RepeatMasker,LINE,1303142,1303294,66,0.24
ptg000445l,123881,124193,312,RepeatMasker,LINE,124103,124711,91,0.29
ptg000451l,3897447,3897774,327,RepeatMasker,LINE,3897233,3900468,327,1.00
ptg000455l,454593,454877,284,RepeatMasker,LINE,454293,454623,30,0.11
ptg000460l,523227,523510,283,RepeatMasker,LINE,523387,523451,65,0.23
ptg000464l,394935,395243,308,RepeatMasker,LINE,394529,394982,47,0.15
ptg000493l,2297739,2298053,314,RepeatMasker,LINE,2297710,2298063,314,1.00
ptg000496l,675348,675645,297,RepeatMasker,LINE,673657,677269,297,1.00
ptg000502l,2413420,2413754,334,RepeatMasker,LINE,2413412,2414536,334,1.00
ptg000502l,2413420,2413754,334,RepeatMasker,LINE,2413569,2414536,186,0.56
ptg000506l,8310865,8311148,283,RepeatMasker,LINE,8311021,8314269,128,0.45
ptg000508l,2127866,2128136,270,RepeatMasker,LINE,2127894,2128001,108,0.40
ptg000508l,2127866,2128136,270,RepeatMasker,LINE,2127970,2128042,73,0.27
ptg000510l,860007,860305,298,RepeatMasker,LINE,859738,862053,298,1.00
ptg000510l,860007,860305,298,RepeatMasker,LINE,859925,861796,298,1.00
ptg000511l,5258251,5258543,292,RepeatMasker,LINE,5258275,5258324,50,0.17
ptg000516l,156686,156994,308,RepeatMasker,LINE,155185,157835,308,1.00
ptg000516l,916812,917081,269,RepeatMasker,LINE,914690,917224,269,1.00
ptg000519l,219157,219432,275,RepeatMasker,LINE,219407,220438,26,0.09
ptg000519l,6665857,6666124,267,RepeatMasker,LINE,6665833,6666266,267,1.00
ptg000519l,6991873,6992181,308,RepeatMasker,LINE,6988619,6992649,308,1.00
ptg000530l,847704,847985,281,RepeatMasker,LINE,847962,848343,24,0.09
ptg000534l,373548,373842,294,RepeatMasker,LINE,373399,373585,37,0.13
ptg000534l,373548,373842,294,RepeatMasker,LINE,373721,373768,48,0.16
ptg000539l,7605670,7605980,310,RepeatMasker,LINE,7605649,7605718,48,0.15
ptg000553l,851126,851402,276,RepeatMasker,LINE,850870,851227,101,0.37
ptg000558l,153877,154204,327,RepeatMasker,LINE,153132,154562,327,1.00
ptg000559l,486334,486653,319,RepeatMasker,LINE,486586,486810,68,0.21
ptg000563l,422827,423101,274,RepeatMasker,LINE,422212,422981,154,0.56
ptg000567l,2726018,2726342,324,RepeatMasker,LINE,2726145,2726378,198,0.61
ptg000567l,2726018,2726342,324,RepeatMasker,LINE,2726152,2726298,147,0.45
ptg000572l,527941,528219,278,RepeatMasker,LINE,528054,528677,166,0.60
ptg000572l,693504,693823,319,RepeatMasker,LINE,692136,693570,66,0.21
ptg000576l,2239417,2239701,284,RepeatMasker,LINE,2239267,2241018,284,1.00
ptg000580l,1099029,1099324,295,RepeatMasker,LINE,1099041,1099129,89,0.30
ptg000580l,1099029,1099324,295,RepeatMasker,LINE,1099063,1099139,77,0.26
ptg000580l,1862237,1862528,291,RepeatMasker,LINE,1861974,1862491,254,0.87
ptg000586l,3752187,3752504,317,RepeatMasker,LINE,3752328,3752463,136,0.43
ptg000586l,3752187,3752504,317,RepeatMasker,LINE,3751807,3752287,100,0.32
ptg000595l,1549751,1550040,289,RepeatMasker,LINE,1549765,1550011,247,0.85
ptg000610l,2306843,2307172,329,RepeatMasker,LINE,2307095,2308131,78,0.24
ptg000610l,2306843,2307172,329,RepeatMasker,LINE,2307096,2307933,77,0.23
ptg000618l,1398372,1398683,311,RepeatMasker,LINE,1398047,1399966,311,1.00
ptg000622l,192658,192997,339,RepeatMasker,LINE,192844,193268,154,0.45
ptg000622l,320055,320371,316,RepeatMasker,LINE,320319,320710,53,0.17
ptg000627l,3659298,3659601,303,RepeatMasker,LINE,3658755,3659429,131,0.43
ptg000631l,797213,797501,288,RepeatMasker,LINE,797302,797347,46,0.16
ptg000637l,1175767,1176056,289,RepeatMasker,LINE,1175745,1175816,49,0.17
ptg000645l,490741,491048,307,RepeatMasker,LINE,490284,494215,307,1.00
ptg000657l,595720,595992,272,RepeatMasker,LINE,595823,595912,90,0.33
ptg000665l,3231848,3232157,309,RepeatMasker,LINE,3232125,3232417,33,0.11
ptg000665l,9652729,9653031,302,RepeatMasker,LINE,9652712,9655702,302,1.00
ptg000668l,539375,539700,325,RepeatMasker,LINE,538075,540056,325,1.00
ptg000676l,3214810,3215086,276,RepeatMasker,LINE,3214721,3215729,276,1.00
ptg000678l,182162,182451,289,RepeatMasker,LINE,181839,182405,243,0.84
ptg000682l,2663390,2663731,341,RepeatMasker,LINE,2663320,2663528,138,0.40
ptg000682l,2663390,2663731,341,RepeatMasker,LINE,2663384,2663526,136,0.40
ptg000688l,590358,590664,306,RepeatMasker,LINE,590524,591419,141,0.46
ptg000688l,3184742,3185060,318,RepeatMasker,LINE,3183485,3187212,318,1.00
ptg000692l,2937587,2937909,322,RepeatMasker,LINE,2937904,2938054,6,0.02
ptg000708l,385988,386322,334,RepeatMasker,LINE,385598,386046,58,0.17
ptg000716l,922988,923275,287,RepeatMasker,LINE,920875,923552,287,1.00
ptg000719l,1280091,1280405,314,RepeatMasker,LINE,1280283,1280838,123,0.39
ptg000722l,4281836,4282130,294,RepeatMasker,LINE,4281999,4285228,132,0.45
ptg000731l,2984435,2984737,302,RepeatMasker,LINE,2984305,2984655,220,0.73
ptg000738l,1248325,1248633,308,RepeatMasker,LINE,1248568,1248721,66,0.21
ptg000741l,44828,45157,329,RepeatMasker,LINE,41218,45628,329,1.00
ptg000748l,2729626,2729943,317,RepeatMasker,LINE,2729942,2730662,2,0.01
ptg000748l,3400002,3400291,289,RepeatMasker,LINE,3399184,3400635,289,1.00
ptg000753l,896701,897007,306,RepeatMasker,LINE,896890,896932,43,0.14
ptg000755l,48285,48574,289,RepeatMasker,LINE,48468,51355,107,0.37
ptg000757l,225522,225796,274,RepeatMasker,LINE,225485,226250,274,1.00
ptg000762l,710872,711162,290,RepeatMasker,LINE,711050,711349,113,0.39
ptg000762l,710872,711162,290,RepeatMasker,LINE,711146,711755,17,0.06
ptg000764l,2682266,2682563,297,RepeatMasker,LINE,2682301,2682366,66,0.22
ptg000765l,2060751,2061066,315,RepeatMasker,LINE,2060754,2062027,313,0.99
ptg000769l,2498037,2498329,292,RepeatMasker,LINE,2498058,2498132,75,0.26
ptg000776l,1605021,1605304,283,RepeatMasker,LINE,1604986,1606454,283,1.00
ptg000788l,5647552,5647862,310,RepeatMasker,LINE,5647531,5647601,49,0.16
ptg000788l,6117988,6118316,328,RepeatMasker,LINE,6117960,6119001,328,1.00
ptg000796l,172578,172904,326,RepeatMasker,LINE,172627,172943,278,0.85
ptg000798l,3493971,3494306,335,RepeatMasker,LINE,3493287,3496556,335,1.00
ptg000799l,3382272,3382564,292,RepeatMasker,LINE,3382355,3382880,210,0.72
ptg000804l,712085,712415,330,RepeatMasker,LINE,712352,712734,64,0.19
ptg000816l,294348,294634,286,RepeatMasker,LINE,293730,299409,286,1.00
ptg000819l,4827501,4827825,324,RepeatMasker,LINE,4827193,4828475,324,1.00
ptg000821l,462523,462843,320,RepeatMasker,LINE,462711,465061,133,0.42
ptg000836l,348160,348462,302,RepeatMasker,LINE,348198,348639,265,0.88
ptg000839l,898375,898681,306,RepeatMasker,LINE,898564,898622,59,0.19
ptg000844l,5543839,5544141,302,RepeatMasker,LINE,5543676,5544971,302,1.00
ptg000863l,2056701,2057015,314,RepeatMasker,LINE,2056145,2057372,314,1.00
ptg000868l,686401,686710,309,RepeatMasker,LINE,685668,687399,309,1.00
ptg000873l,1690715,1691012,297,RepeatMasker,LINE,1690981,1691057,32,0.11
ptg000878l,2178994,2179284,290,RepeatMasker,LINE,2179042,2179100,59,0.20
ptg000885l,3322242,3322572,330,RepeatMasker,LINE,3320316,3323571,330,1.00
ptg000885l,4040644,4040943,299,RepeatMasker,LINE,4040416,4040823,179,0.60
ptg000885l,4040644,4040943,299,RepeatMasker,LINE,4040870,4042068,74,0.25
ptg000885l,6984957,6985277,320,RepeatMasker,LINE,6985004,6985059,56,0.18
ptg000886l,5274385,5274698,313,RepeatMasker,LINE,5274429,5277586,270,0.86
ptg000893l,1584255,1584591,336,RepeatMasker,LINE,1583574,1586856,336,1.00
ptg000900l,361667,361999,332,RepeatMasker,LINE,361866,364856,134,0.40
ptg000906l,1856300,1856598,298,RepeatMasker,LINE,1856479,1856700,120,0.40
ptg000906l,1856300,1856598,298,RepeatMasker,LINE,1856486,1856664,113,0.38
ptg000913l,6379921,6380228,307,RepeatMasker,LINE,6379086,6380239,307,1.00
ptg000914l,3684004,3684305,301,RepeatMasker,LINE,3683799,3684915,301,1.00
ptg000914l,7749476,7749755,279,RepeatMasker,LINE,7749452,7749525,49,0.18
ptg000929l,2545698,2545993,295,RepeatMasker,LINE,2545849,2547042,145,0.49
ptg000931l,196166,196441,275,RepeatMasker,LINE,196346,196416,71,0.26
ptg000931l,808898,809220,322,RepeatMasker,LINE,808786,809493,322,1.00
ptg000937l,3769386,3769715,329,RepeatMasker,LINE,3769133,3772392,329,1.00
ptg000939l,1897395,1897687,292,RepeatMasker,LINE,1897587,1898739,101,0.35
ptg000940l,719065,719359,294,RepeatMasker,LINE,719068,719138,71,0.24
ptg000943l,76283,76612,329,RepeatMasker,LINE,76420,76493,74,0.22
ptg000943l,76283,76612,329,RepeatMasker,LINE,76424,76474,51,0.16
ptg000943l,76283,76612,329,RepeatMasker,LINE,76559,77353,54,0.16
ptg000948l,2266551,2266878,327,RepeatMasker,LINE,2266572,2266641,70,0.21
ptg000952l,1910924,1911250,326,RepeatMasker,LINE,1911048,1911345,203,0.62
ptg000953l,884237,884498,261,RepeatMasker,LINE,884388,884449,62,0.24
ptg000962l,679261,679539,278,RepeatMasker,LINE,677604,679724,278,1.00
ptg000966l,3009972,3010251,279,RepeatMasker,LINE,3009921,3012289,279,1.00
ptg000967l,1580863,1581141,278,RepeatMasker,LINE,1579422,1580978,115,0.41
ptg000974l,136833,137112,279,RepeatMasker,LINE,137029,137173,84,0.30
ptg000975l,4728051,4728348,297,RepeatMasker,LINE,4728130,4728195,66,0.22
ptg000982l,1548655,1548940,285,RepeatMasker,LINE,1548717,1548905,189,0.66
ptg000994l,250259,250555,296,RepeatMasker,LINE,249845,250432,173,0.58
ptg000995l,231187,231505,318,RepeatMasker,LINE,230445,233061,318,1.00
ptg001001l,3512580,3512866,286,RepeatMasker,LINE,3512605,3512663,59,0.21
ptg001012l,1771261,1771588,327,RepeatMasker,LINE,1771360,1772051,229,0.70
ptg001018l,6106403,6106695,292,RepeatMasker,LINE,6106504,6106745,192,0.66
ptg001027l,3094108,3094430,322,RepeatMasker,LINE,3094309,3094380,72,0.22
ptg001033l,272430,272756,326,RepeatMasker,LINE,272651,272933,106,0.33
ptg001033l,2112024,2112346,322,RepeatMasker,LINE,2111505,2112782,322,1.00
ptg001033l,2112024,2112346,322,RepeatMasker,LINE,2112211,2112902,136,0.42
ptg001039l,3438201,3438491,290,RepeatMasker,LINE,3437818,3438216,15,0.05
ptg001039l,4197655,4197800,145,RepeatMasker,LINE,4197301,4197719,64,0.44
ptg001040l,3271763,3272084,321,RepeatMasker,LINE,3271896,3272158,189,0.59
ptg001041l,3436034,3436342,308,RepeatMasker,LINE,3434943,3436191,157,0.51
ptg001059l,3661734,3662059,325,RepeatMasker,LINE,3660123,3662558,325,1.00
ptg001064l,475024,475347,323,RepeatMasker,LINE,475007,475097,73,0.23
ptg001077l,2039584,2039918,334,RepeatMasker,LINE,2039784,2040254,135,0.40
ptg001077l,5799262,5799549,287,RepeatMasker,LINE,5796803,5800612,287,1.00
ptg001086l,4458492,4458793,301,RepeatMasker,LINE,4458776,4461465,18,0.06
ptg001093l,4999979,5000274,295,RepeatMasker,LINE,4999347,5000007,28,0.09
ptg001096l,481051,481374,323,RepeatMasker,LINE,481244,481749,131,0.41
ptg001106l,5470893,5471204,311,RepeatMasker,LINE,5469172,5472899,311,1.00
ptg001110l,1705999,1706282,283,RepeatMasker,LINE,1706083,1706261,179,0.63
ptg001118l,536056,536346,290,RepeatMasker,LINE,536091,536175,85,0.29
ptg001125l,498300,498622,322,RepeatMasker,LINE,498286,500773,322,1.00
ptg001131l,5913588,5913924,336,RepeatMasker,LINE,5912909,5914094,336,1.00
ptg001132l,4929315,4929657,342,RepeatMasker,LINE,4929561,4929938,97,0.28
ptg001138l,59182,59478,296,RepeatMasker,LINE,59417,59539,62,0.21
ptg001138l,59182,59478,296,RepeatMasker,LINE,59434,60313,45,0.15
ptg001145l,755938,756254,316,RepeatMasker,LINE,755489,756527,316,1.00
ptg001151l,97472,97786,314,RepeatMasker,LINE,97483,99115,304,0.97
ptg001161l,10881429,10881739,310,RepeatMasker,LINE,10881704,10884416,36,0.12
ptg001162l,1372941,1373220,279,RepeatMasker,LINE,1369584,1373279,279,1.00
ptg001162l,1372941,1373220,279,RepeatMasker,LINE,1370495,1373312,279,1.00
ptg001166l,228401,228696,295,RepeatMasker,LINE,228579,229010,118,0.40
ptg001169l,1192603,1192932,329,RepeatMasker,LINE,1190817,1192621,18,0.05
ptg001169l,1192603,1192932,329,RepeatMasker,LINE,1191049,1192663,60,0.18
ptg001172l,500680,501005,325,RepeatMasker,LINE,499817,501025,325,1.00
ptg001177l,1567811,1568103,292,RepeatMasker,LINE,1567286,1567984,173,0.59
ptg001192l,2938852,2939179,327,RepeatMasker,LINE,2938989,2940232,191,0.58
ptg001203l,465741,466074,333,RepeatMasker,LINE,465675,465765,24,0.07
ptg001205l,899664,899990,326,RepeatMasker,LINE,899457,902678,326,1.00
ptg001218l,1434662,1434984,322,RepeatMasker,LINE,1432065,1435309,322,1.00
ptg001233l,815716,816041,325,RepeatMasker,LINE,815886,818286,156,0.48
ptg001235l,686501,686822,321,RepeatMasker,LINE,686167,686679,178,0.55
ptg001237l,1679391,1679703,312,RepeatMasker,LINE,1679522,1679625,104,0.33
ptg001243l,1279866,1280168,302,RepeatMasker,LINE,1279308,1280281,302,1.00
ptg001245l,299223,299509,286,RepeatMasker,LINE,297626,299270,47,0.16
ptg001245l,1005505,1005821,316,RepeatMasker,LINE,1005685,1008941,137,0.43
ptg001246l,604974,605262,288,RepeatMasker,LINE,604672,605056,82,0.28
ptg001251l,1011884,1012176,292,RepeatMasker,LINE,1012163,1012866,14,0.05
ptg001262l,3521729,3522047,318,RepeatMasker,LINE,3521636,3523088,318,1.00
ptg001262l,4834192,4834487,295,RepeatMasker,LINE,4834067,4834321,129,0.44
ptg001269l,387110,387402,292,RepeatMasker,LINE,387256,387416,147,0.50
ptg001270l,2592877,2593164,287,RepeatMasker,LINE,2592918,2592977,60,0.21
ptg001279l,2919906,2920228,322,RepeatMasker,LINE,2919435,2921366,322,1.00
ptg001282l,343015,343297,282,RepeatMasker,LINE,339957,343200,185,0.66
ptg001285l,43806,44079,273,RepeatMasker,LINE,44034,44657,46,0.17
ptg001293l,130504,130779,275,RepeatMasker,LINE,130467,130862,275,1.00
ptg001293l,130504,130779,275,RepeatMasker,LINE,130598,131203,182,0.66
ptg001293l,5217198,5217479,281,RepeatMasker,LINE,5217360,5217428,69,0.25
ptg001299l,768125,768431,306,RepeatMasker,LINE,768085,768135,10,0.03
ptg001301l,925032,925357,325,RepeatMasker,LINE,925134,928672,224,0.69
ptg001302l,1088002,1088280,278,RepeatMasker,LINE,1088008,1088242,235,0.85
ptg001307l,2369590,2369856,266,RepeatMasker,LINE,2369616,2369682,67,0.25
ptg001307l,2369590,2369856,266,RepeatMasker,LINE,2369791,2369939,66,0.25
ptg001316l,3438912,3439213,301,RepeatMasker,LINE,3438284,3441083,301,1.00
ptg001320l,485360,485693,333,RepeatMasker,LINE,485346,488006,333,1.00
ptg001321l,1828361,1828663,302,RepeatMasker,LINE,1827829,1829627,302,1.00
ptg001325l,1564011,1564294,283,RepeatMasker,LINE,1563914,1564417,283,1.00
ptg001338l,384226,384539,313,RepeatMasker,LINE,384508,387507,32,0.10
ptg001339l,666722,667037,315,RepeatMasker,LINE,666765,666810,46,0.15
ptg001342l,1313842,1314152,310,RepeatMasker,LINE,1313930,1314229,223,0.72
ptg001344l,1896255,1896537,282,RepeatMasker,LINE,1896153,1897637,282,1.00
ptg001344l,1896255,1896537,282,RepeatMasker,LINE,1896338,1897637,200,0.71
ptg001344l,4186723,4187000,277,RepeatMasker,LINE,4186611,4186762,39,0.14
ptg001344l,4186723,4187000,277,RepeatMasker,LINE,4186866,4186936,71,0.26
ptg001348l,4924595,4924916,321,RepeatMasker,LINE,4924582,4924642,47,0.15
ptg001364l,1486186,1486471,285,RepeatMasker,LINE,1486163,1486235,49,0.17
ptg001372l,1392499,1392813,314,RepeatMasker,LINE,1392808,1393321,6,0.02
ptg001388l,1717345,1717677,332,RepeatMasker,LINE,1717342,1717519,174,0.52
ptg001388l,1717345,1717677,332,RepeatMasker,LINE,1717352,1718491,326,0.98
ptg001412l,153407,153721,314,RepeatMasker,LINE,150832,154652,314,1.00
ptg001415l,2961352,2961659,307,RepeatMasker,LINE,2961387,2963045,273,0.89
ptg001416l,1623682,1624008,326,RepeatMasker,LINE,1623582,1626696,326,1.00
ptg001416l,5038415,5038742,327,RepeatMasker,LINE,5038531,5041420,212,0.65
ptg001420l,373496,373819,323,RepeatMasker,LINE,373667,373740,74,0.23
ptg001420l,373496,373819,323,RepeatMasker,LINE,373752,373875,68,0.21
ptg001420l,1151866,1152166,300,RepeatMasker,LINE,1152065,1152690,102,0.34
ptg001422l,570460,570759,299,RepeatMasker,LINE,570701,571174,59,0.20
ptg001422l,3805681,3805972,291,RepeatMasker,LINE,3805833,3805905,73,0.25
ptg001428l,147787,148076,289,RepeatMasker,LINE,147886,148145,191,0.66
ptg001429l,1739973,1740296,323,RepeatMasker,LINE,1740091,1740219,129,0.40
ptg001437l,2120199,2120513,314,RepeatMasker,LINE,2119943,2123209,314,1.00
ptg001441l,1804040,1804303,263,RepeatMasker,LINE,1804012,1804107,67,0.25
ptg001441l,2380124,2380403,279,RepeatMasker,LINE,2379027,2381844,279,1.00
ptg001448l,112499,112803,304,RepeatMasker,LINE,112639,112777,139,0.46
ptg001456l,1971239,1971529,290,RepeatMasker,LINE,1970220,1972457,290,1.00
ptg001457l,601737,602075,338,RepeatMasker,LINE,601666,601856,119,0.35
ptg001478l,55646,55983,337,RepeatMasker,LINE,55473,58360,337,1.00
ptg001483l,2248522,2248837,315,RepeatMasker,LINE,2247935,2249866,315,1.00
ptg001493l,1534160,1534430,270,RepeatMasker,LINE,1534092,1534183,23,0.09
ptg001502l,3078988,3079285,297,RepeatMasker,LINE,3076985,3079213,225,0.76
ptg001505l,3301221,3301526,305,RepeatMasker,LINE,3297929,3301740,305,1.00
ptg001513l,4894414,4894727,313,RepeatMasker,LINE,4894318,4894498,84,0.27
ptg001517l,2769487,2769767,280,RepeatMasker,LINE,2766141,2769826,280,1.00
ptg001517l,2769487,2769767,280,RepeatMasker,LINE,2767040,2769859,280,1.00
ptg001523l,789058,789381,323,RepeatMasker,LINE,788983,789074,16,0.05
ptg001524l,239973,240252,279,RepeatMasker,LINE,239959,241642,279,1.00
ptg001528l,113880,114201,321,RepeatMasker,LINE,114002,114261,200,0.62
ptg001551l,882688,883001,313,RepeatMasker,LINE,882711,882850,140,0.45
ptg001551l,3446102,3446399,297,RepeatMasker,LINE,3446273,3446373,101,0.34
ptg001560l,1643593,1643925,332,RepeatMasker,LINE,1643784,1643906,123,0.37
ptg001562l,728765,729088,323,RepeatMasker,LINE,728752,730714,323,1.00
ptg001563l,376647,376956,309,RepeatMasker,LINE,376868,376922,55,0.18
ptg001574l,3974687,3974998,311,RepeatMasker,LINE,3973283,3975732,311,1.00
ptg001577l,6467458,6467790,332,RepeatMasker,LINE,6465625,6468449,332,1.00
ptg001578l,1499487,1499799,312,RepeatMasker,LINE,1499576,1499689,114,0.37
ptg001581l,216261,216562,301,RepeatMasker,LINE,216514,216557,44,0.15
ptg001582l,1287652,1287943,291,RepeatMasker,LINE,1287824,1290347,120,0.41
ptg001583l,2729547,2729864,317,RepeatMasker,LINE,2729630,2729776,147,0.46
ptg001589l,3443708,3444021,313,RepeatMasker,LINE,3443144,3443831,123,0.39
ptg001613l,700777,701056,279,RepeatMasker,LINE,700919,701383,138,0.49
ptg001617l,1567812,1568142,330,RepeatMasker,LINE,1567997,1568042,46,0.14
ptg001620l,418106,418400,294,RepeatMasker,LINE,417065,418245,139,0.47
ptg001620l,418106,418400,294,RepeatMasker,LINE,417261,418281,175,0.60
ptg001653l,334075,334388,313,RepeatMasker,LINE,334275,334363,89,0.28
ptg001656l,4272039,4272344,305,RepeatMasker,LINE,4269001,4272315,276,0.90
ptg001657l,4016798,4017086,288,RepeatMasker,LINE,4015402,4017432,288,1.00
ptg001660l,6478384,6478691,307,RepeatMasker,LINE,6478590,6479058,102,0.33
ptg001662l,342275,342549,274,RepeatMasker,LINE,342413,342940,137,0.50
ptg001663l,9016394,9016720,326,RepeatMasker,LINE,9016334,9016512,118,0.36
ptg001668l,3241542,3241850,308,RepeatMasker,LINE,3241728,3242167,123,0.40
ptg001671l,10078403,10078690,287,RepeatMasker,LINE,10077879,10079314,287,1.00
ptg001671l,10078403,10078690,287,RepeatMasker,LINE,10078682,10080148,9,0.03
ptg001674l,592991,593278,287,RepeatMasker,LINE,591973,594239,287,1.00
ptg001681l,3425393,3425728,335,RepeatMasker,LINE,3425661,3425706,46,0.14
ptg001682l,3212684,3213011,327,RepeatMasker,LINE,3212545,3214481,327,1.00
ptg001685l,3864255,3864573,318,RepeatMasker,LINE,3864036,3865148,318,1.00
ptg001687l,5452739,5453024,285,RepeatMasker,LINE,5452141,5452769,30,0.11
ptg001692l,5991452,5991774,322,RepeatMasker,LINE,5991675,5991778,100,0.31
ptg001695l,748305,748637,332,RepeatMasker,LINE,748101,748741,332,1.00
ptg001695l,2072079,2072396,317,RepeatMasker,LINE,2072062,2075302,317,1.00
ptg001701l,4197077,4197360,283,RepeatMasker,LINE,4197220,4197681,141,0.50
ptg001704l,2918985,2919293,308,RepeatMasker,LINE,2917577,2919001,16,0.05
ptg001704l,5612033,5612373,340,RepeatMasker,LINE,5612368,5612600,6,0.02
ptg001711l,2643228,2643517,289,RepeatMasker,LINE,2643269,2643372,104,0.36
ptg001711l,2643228,2643517,289,RepeatMasker,LINE,2643407,2643687,111,0.38
ptg001713l,2503813,2504105,292,RepeatMasker,LINE,2503966,2506922,140,0.48
ptg001732l,1833884,1834170,286,RepeatMasker,LINE,1833258,1834358,286,1.00
ptg001734l,937662,937967,305,RepeatMasker,LINE,937705,937774,70,0.23
ptg001746l,4557970,4558281,311,RepeatMasker,LINE,4558147,4559440,135,0.43
ptg001746l,4557970,4558281,311,RepeatMasker,LINE,4558156,4559268,126,0.41
ptg001747l,1250053,1250377,324,RepeatMasker,LINE,1249046,1252268,324,1.00
ptg001748l,4473425,4473747,322,RepeatMasker,LINE,4473442,4473722,281,0.87
ptg001748l,5166476,5166795,319,RepeatMasker,LINE,5166120,5166506,30,0.09
ptg001759l,1402079,1402400,321,RepeatMasker,LINE,1402330,1402364,35,0.11
ptg001767l,1675381,1675676,295,RepeatMasker,LINE,1675384,1675453,70,0.24
ptg001773l,749985,750273,288,RepeatMasker,LINE,749556,750126,141,0.49
ptg001773l,766545,766870,325,RepeatMasker,LINE,766686,766731,46,0.14
ptg001773l,766545,766870,325,RepeatMasker,LINE,766687,766747,61,0.19
ptg001791l,2339331,2339627,296,RepeatMasker,LINE,2339235,2339454,123,0.42
ptg001791l,2844054,2844353,299,RepeatMasker,LINE,2840659,2844471,299,1.00
ptg001793l,1004284,1004562,278,RepeatMasker,LINE,1004518,1005413,45,0.16
ptg001799l,5785265,5785549,284,RepeatMasker,LINE,5785143,5785785,284,1.00
ptg001799l,6007565,6007844,279,RepeatMasker,LINE,6007466,6007592,27,0.10
ptg001812l,3774645,3774958,313,RepeatMasker,LINE,3774889,3775135,70,0.22
ptg001814l,3478609,3478919,310,RepeatMasker,LINE,3477269,3479531,310,1.00
ptg001827l,1977767,1978082,315,RepeatMasker,LINE,1975483,1977902,135,0.43
ptg001837l,2251059,2251383,324,RepeatMasker,LINE,2250927,2251238,179,0.55
ptg001851l,4263395,4263684,289,RepeatMasker,LINE,4263179,4263713,289,1.00
ptg001863l,8666841,8667140,299,RepeatMasker,LINE,8666731,8667050,209,0.70
ptg001875l,2374903,2375208,305,RepeatMasker,LINE,2374836,2375041,138,0.45
ptg001881l,246339,246628,289,RepeatMasker,LINE,246227,246918,289,1.00
ptg001905l,1058048,1058363,315,RepeatMasker,LINE,1057795,1058631,315,1.00
ptg001906l,5919208,5919519,311,RepeatMasker,LINE,5919453,5920107,67,0.22
ptg001909l,5609315,5609612,297,RepeatMasker,LINE,5609205,5609441,126,0.42
ptg001911l,1850337,1850651,314,RepeatMasker,LINE,1849718,1850346,9,0.03
ptg001916l,330442,330734,292,RepeatMasker,LINE,329591,330547,105,0.36
ptg001921l,20342,20659,317,RepeatMasker,LINE,20562,20747,98,0.31
ptg001933l,3749522,3749833,311,RepeatMasker,LINE,3749621,3749794,174,0.56
ptg001936l,5255222,5255519,297,RepeatMasker,LINE,5255454,5255606,66,0.22
ptg001941l,98588,98913,325,RepeatMasker,LINE,97910,101097,325,1.00
ptg001960l,141543,141854,311,RepeatMasker,LINE,140986,142933,311,1.00
ptg001964l,1078380,1078683,303,RepeatMasker,LINE,1075016,1078752,303,1.00
ptg001968l,411554,411836,282,RepeatMasker,LINE,411434,412090,282,1.00
ptg001971l,28852,29170,318,RepeatMasker,LINE,28560,29181,318,1.00
ptg002011l,2992634,2992922,288,RepeatMasker,LINE,2991033,2993367,288,1.00
ptg002016l,11873,12165,292,RepeatMasker,LINE,11206,12803,292,1.00
ptg002016l,383780,384096,316,RepeatMasker,LINE,383282,385287,316,1.00
ptg002024l,507919,508245,326,RepeatMasker,LINE,508086,508572,160,0.49
ptg002024l,507919,508245,326,RepeatMasker,LINE,507715,507968,49,0.15
ptg002027l,766758,767075,317,RepeatMasker,LINE,766709,766762,4,0.01
ptg002030l,573853,574153,300,RepeatMasker,LINE,573884,573944,61,0.20
ptg002043l,4740889,4741174,285,RepeatMasker,LINE,4740721,4740890,1,0.00
ptg002052l,82051,82365,314,RepeatMasker,LINE,81691,82285,234,0.75
ptg002072l,4110594,4110884,290,RepeatMasker,LINE,4110622,4111070,263,0.91
ptg002072l,4694227,4694496,269,RepeatMasker,LINE,4694265,4694332,68,0.25
ptg002072l,4694227,4694496,269,RepeatMasker,LINE,4694441,4694550,56,0.21
ptg002073l,2600751,2601046,295,RepeatMasker,LINE,2600698,2600770,19,0.06
ptg002073l,2600751,2601046,295,RepeatMasker,LINE,2600756,2600909,154,0.52
ptg002086l,976015,976291,276,RepeatMasker,LINE,976213,977393,79,0.29
ptg002088l,919183,919501,318,RepeatMasker,LINE,916316,919189,6,0.02
ptg002088l,3544455,3544773,318,RepeatMasker,LINE,3544463,3544533,71,0.22
ptg002091l,4026232,4026560,328,RepeatMasker,LINE,4026086,4029234,328,1.00
ptg002102l,3473018,3473324,306,RepeatMasker,LINE,3473040,3473422,285,0.93
ptg002116l,1391553,1391875,322,RepeatMasker,LINE,1391369,1392094,322,1.00
ptg002121l,1171331,1171600,269,RepeatMasker,LINE,1171350,1172021,251,0.93
ptg002127l,1381648,1381941,293,RepeatMasker,LINE,1381682,1381741,60,0.20
ptg002136l,716414,716721,307,RepeatMasker,LINE,714986,717622,307,1.00
ptg002141l,574995,575270,275,RepeatMasker,LINE,575245,575990,26,0.09
ptg002141l,4369243,4369568,325,RepeatMasker,LINE,4369394,4369486,93,0.29
ptg002158l,2955906,2956232,326,RepeatMasker,LINE,2956107,2958945,126,0.39
ptg002159l,1899116,1899408,292,RepeatMasker,LINE,1899109,1899188,72,0.25
ptg002161l,561019,561295,276,RepeatMasker,LINE,560614,561103,84,0.30
ptg002166l,1353793,1354093,300,RepeatMasker,LINE,1353961,1354261,133,0.44
ptg002188l,1081217,1081514,297,RepeatMasker,LINE,1079799,1081242,25,0.08
ptg002190l,171342,171672,330,RepeatMasker,LINE,169436,171866,330,1.00
ptg002190l,171342,171672,330,RepeatMasker,LINE,169867,172023,330,1.00
ptg002195l,329635,329914,279,RepeatMasker,LINE,329444,330224,279,1.00
ptg002211l,1781160,1781457,297,RepeatMasker,LINE,1780056,1781267,107,0.36
ptg002219l,3096988,3097286,298,RepeatMasker,LINE,3096266,3098124,298,1.00
ptg002219l,3614610,3614955,345,RepeatMasker,LINE,3614916,3617931,40,0.12
ptg002221l,3413562,3413882,320,RepeatMasker,LINE,3411736,3413572,10,0.03
ptg002221l,3413562,3413882,320,RepeatMasker,LINE,3413736,3413804,69,0.22
ptg002226l,6833313,6833597,284,RepeatMasker,LINE,6832328,6835260,284,1.00
ptg002226l,6833313,6833597,284,RepeatMasker,LINE,6833264,6836065,284,1.00
ptg002226l,9035911,9036174,263,RepeatMasker,LINE,9035450,9035964,53,0.20
ptg002227l,1820654,1820981,327,RepeatMasker,LINE,1820252,1822081,327,1.00
ptg002228l,1145651,1145958,307,RepeatMasker,LINE,1144860,1145859,208,0.68
ptg002240l,1525054,1525364,310,RepeatMasker,LINE,1525165,1525678,200,0.65
ptg002241l,507393,507723,330,RepeatMasker,LINE,507297,507428,35,0.11
ptg002241l,507393,507723,330,RepeatMasker,LINE,507518,507603,86,0.26
ptg002249l,2068019,2068344,325,RepeatMasker,LINE,2068148,2068228,81,0.25
ptg002249l,2068019,2068344,325,RepeatMasker,LINE,2068160,2068278,119,0.37
ptg002268l,1913369,1913675,306,RepeatMasker,LINE,1913529,1914143,147,0.48
ptg002290l,311048,311346,298,RepeatMasker,LINE,311024,311097,49,0.16
ptg002290l,1307472,1307779,307,RepeatMasker,LINE,1304051,1307790,307,1.00
ptg002290l,1838552,1838841,289,RepeatMasker,LINE,1838768,1839153,74,0.26
ptg002304l,2725373,2725649,276,RepeatMasker,LINE,2724815,2727627,276,1.00
ptg002307l,1550904,1551226,322,RepeatMasker,LINE,1551027,1551699,200,0.62
ptg002310l,1730448,1730759,311,RepeatMasker,LINE,1730535,1733667,225,0.72
ptg002315l,1000997,1001277,280,RepeatMasker,LINE,997540,1001364,280,1.00
ptg002319l,1668228,1668556,328,RepeatMasker,LINE,1668090,1669999,328,1.00
ptg002319l,1668228,1668556,328,RepeatMasker,LINE,1668164,1669839,328,1.00
ptg002338l,1305258,1305563,305,RepeatMasker,LINE,1303931,1305401,143,0.47
ptg002338l,1446921,1447199,278,RepeatMasker,LINE,1446577,1448016,278,1.00
ptg002338l,5098757,5099068,311,RepeatMasker,LINE,5098733,5098806,49,0.16
ptg002341l,776869,777198,329,RepeatMasker,LINE,777082,777924,117,0.36
ptg002341l,776869,777198,329,RepeatMasker,LINE,777184,777727,15,0.05
ptg002356l,325222,325539,317,RepeatMasker,LINE,325442,325669,98,0.31
ptg002358l,5954786,5955115,329,RepeatMasker,LINE,5954717,5957801,329,1.00
ptg002361l,4117040,4117312,272,RepeatMasker,LINE,4114569,4117214,174,0.64
ptg002362l,552703,553013,310,RepeatMasker,LINE,552707,552777,71,0.23
ptg002370l,2949132,2949448,316,RepeatMasker,LINE,2949285,2949971,164,0.52
ptg002370l,2949132,2949448,316,RepeatMasker,LINE,2949324,2949778,125,0.40
ptg002370l,2949132,2949448,316,RepeatMasker,LINE,2949398,2949963,51,0.16
ptg002387l,1617290,1617603,313,RepeatMasker,LINE,1617405,1619502,199,0.64
ptg002391l,572147,572433,286,RepeatMasker,LINE,571220,572167,20,0.07
ptg002404l,193889,194197,308,RepeatMasker,LINE,191136,193940,51,0.17
ptg002417l,3246240,3246528,288,RepeatMasker,LINE,3242589,3246998,288,1.00
ptg002419l,887967,888254,287,RepeatMasker,LINE,888014,888071,58,0.20
ptg002433l,427656,427939,283,RepeatMasker,LINE,427545,428743,283,1.00
ptg002442l,1151985,1152294,309,RepeatMasker,LINE,1152091,1152384,204,0.66
ptg002452l,3118269,3118585,316,RepeatMasker,LINE,3118442,3121716,144,0.46
ptg002452l,3118717,3119046,329,RepeatMasker,LINE,3118442,3121716,329,1.00
ptg002453l,1093429,1093729,300,RepeatMasker,LINE,1092517,1094222,300,1.00
ptg002454l,3950171,3950469,298,RepeatMasker,LINE,3949449,3951082,298,1.00
ptg002459l,1488931,1489264,333,RepeatMasker,LINE,1486645,1489328,333,1.00
ptg002460l,2295622,2295940,318,RepeatMasker,LINE,2294518,2295750,128,0.40
ptg002468l,1358898,1359205,307,RepeatMasker,LINE,1358877,1358947,49,0.16
ptg002470l,975387,975687,300,RepeatMasker,LINE,975683,977369,5,0.02
ptg002472l,81994,82323,329,RepeatMasker,LINE,82103,82150,48,0.15
ptg002473l,3426240,3426561,321,RepeatMasker,LINE,3426540,3427017,22,0.07
ptg002473l,4118648,4118971,323,RepeatMasker,LINE,4115768,4119077,323,1.00
ptg002473l,4467756,4468047,291,RepeatMasker,LINE,4467813,4469090,235,0.81
ptg002499l,1912738,1913061,323,RepeatMasker,LINE,1912786,1912846,61,0.19
ptg002526l,1033026,1033333,307,RepeatMasker,LINE,1033067,1033303,237,0.77
ptg002527l,2030417,2030710,293,RepeatMasker,LINE,2030568,2030680,113,0.39
ptg002527l,3803151,3803428,277,RepeatMasker,LINE,3803223,3803547,206,0.74
ptg002527l,4645897,4646206,309,RepeatMasker,LINE,4646194,4646281,13,0.04
ptg002541l,1360956,1361233,277,RepeatMasker,LINE,1361135,1361230,96,0.35
ptg002551l,3532194,3532508,314,RepeatMasker,LINE,3530944,3532264,70,0.22
ptg002559l,3171157,3171464,307,RepeatMasker,LINE,3171328,3174594,137,0.45
ptg002569l,3637456,3637785,329,RepeatMasker,LINE,3637191,3640460,329,1.00
ptg002570l,3012256,3012553,297,RepeatMasker,LINE,3012552,3012632,2,0.01
ptg002578l,294822,295098,276,RepeatMasker,LINE,294686,295148,276,1.00
ptg002595l,38914,39202,288,RepeatMasker,LINE,38444,39137,223,0.77
ptg002598l,584491,584818,327,RepeatMasker,LINE,584673,584856,146,0.45
ptg002616l,1715855,1716155,300,RepeatMasker,LINE,1715834,1715904,49,0.16
ptg002617l,3526326,3526613,287,RepeatMasker,LINE,3526459,3526657,155,0.54
ptg002617l,4927547,4927855,308,RepeatMasker,LINE,4927447,4927708,161,0.52
ptg002617l,4927547,4927855,308,RepeatMasker,LINE,4927692,4928056,164,0.53
ptg002628l,2945085,2945382,297,RepeatMasker,LINE,2945358,2945964,25,0.08
ptg002628l,3734114,3734412,298,RepeatMasker,LINE,3733960,3734193,79,0.27
ptg002628l,3734114,3734412,298,RepeatMasker,LINE,3734026,3734405,291,0.98
ptg002629l,1976119,1976445,326,RepeatMasker,LINE,1976122,1976192,71,0.22
ptg002631l,2480329,2480632,303,RepeatMasker,LINE,2480419,2481073,214,0.71
ptg002631l,5256153,5256431,278,RepeatMasker,LINE,5255649,5257025,278,1.00
ptg002643l,430749,431045,296,RepeatMasker,LINE,429665,430902,153,0.52
ptg002651l,1256144,1256428,284,RepeatMasker,LINE,1256285,1256370,86,0.30
ptg002654l,3313287,3313616,329,RepeatMasker,LINE,3313061,3316341,329,1.00
ptg002660l,2620009,2620298,289,RepeatMasker,LINE,2620091,2620197,107,0.37
ptg002678l,1920314,1920628,314,RepeatMasker,LINE,1920085,1921105,314,1.00
ptg002679l,451291,451582,291,RepeatMasker,LINE,450777,451391,100,0.34
ptg002679l,451291,451582,291,RepeatMasker,LINE,450881,451501,210,0.72
ptg002687l,3333946,3334254,308,RepeatMasker,LINE,3333799,3334199,253,0.82
ptg002690l,1371420,1371708,288,RepeatMasker,LINE,1370435,1371611,191,0.66
ptg002690l,4885114,4885451,337,RepeatMasker,LINE,4885344,4888607,108,0.32
ptg002690l,6166624,6166937,313,RepeatMasker,LINE,6166725,6167651,213,0.68
ptg002700l,27028,27349,321,RepeatMasker,LINE,27244,27760,106,0.33
ptg002708l,165097,165413,316,RepeatMasker,LINE,165365,166939,49,0.16
ptg002716l,119499,119828,329,RepeatMasker,LINE,119231,122511,329,1.00
ptg002732l,3768407,3768725,318,RepeatMasker,LINE,3768393,3770674,318,1.00
ptg002739l,587342,587632,290,RepeatMasker,LINE,586569,587520,178,0.61
ptg002746l,776957,777242,285,RepeatMasker,LINE,776920,777006,49,0.17
ptg002746l,5554393,5554708,315,RepeatMasker,LINE,5554633,5554699,67,0.21
ptg002747l,264281,264565,284,RepeatMasker,LINE,264332,264854,234,0.82
ptg002751l,610763,611083,320,RepeatMasker,LINE,610978,611261,106,0.33
ptg002787l,1159402,1159696,294,RepeatMasker,LINE,1159581,1159945,116,0.39
ptg002787l,1159402,1159696,294,RepeatMasker,LINE,1159651,1159954,46,0.16
ptg002789l,3457112,3457408,296,RepeatMasker,LINE,3457087,3457161,49,0.17
ptg002795l,2229126,2229445,319,RepeatMasker,LINE,2229286,2229532,160,0.50
ptg002804l,827866,828185,319,RepeatMasker,LINE,827912,828007,96,0.30
ptg002808l,1098822,1099106,284,RepeatMasker,LINE,1098927,1098976,50,0.18
ptg002813l,4074638,4074919,281,RepeatMasker,LINE,4074410,4074987,281,1.00
ptg002815l,2380997,2381299,302,RepeatMasker,LINE,2380629,2381393,302,1.00
ptg002824l,646829,647110,281,RepeatMasker,LINE,645831,646842,13,0.05
ptg002824l,646829,647110,281,RepeatMasker,LINE,646953,647012,60,0.21
ptg002825l,654633,654911,278,RepeatMasker,LINE,654619,656897,278,1.00
ptg002825l,1443995,1444287,292,RepeatMasker,LINE,1444278,1444932,10,0.03
ptg002831l,2248790,2249073,283,RepeatMasker,LINE,2248134,2248949,159,0.56
ptg002833l,1878705,1878989,284,RepeatMasker,LINE,1878514,1878788,83,0.29
ptg002841l,1497303,1497585,282,RepeatMasker,LINE,1497110,1497781,282,1.00
ptg002845l,913169,913472,303,RepeatMasker,LINE,911037,913234,65,0.21
ptg002858l,350208,350508,300,RepeatMasker,LINE,349529,353260,300,1.00
ptg002858l,3024346,3024618,272,RepeatMasker,LINE,3024271,3026075,272,1.00
ptg002869l,660635,660934,299,RepeatMasker,LINE,659765,660920,285,0.95
ptg002874l,1218154,1218470,316,RepeatMasker,LINE,1218094,1218186,32,0.10
ptg002877l,633027,633331,304,RepeatMasker,LINE,632695,633700,304,1.00
ptg002881l,729814,730117,303,RepeatMasker,LINE,729854,729952,99,0.33
ptg002882l,1749329,1749621,292,RepeatMasker,LINE,1749050,1749718,292,1.00
ptg002882l,2386283,2386612,329,RepeatMasker,LINE,2386017,2389266,329,1.00
ptg002894l,601089,601373,284,RepeatMasker,LINE,601223,601288,66,0.23
ptg002896l,545810,546091,281,RepeatMasker,LINE,545614,546472,281,1.00
ptg002903l,798899,799202,303,RepeatMasker,LINE,798127,799239,303,1.00
ptg002908l,1270702,1270988,286,RepeatMasker,LINE,1270729,1272029,260,0.91
ptg002910l,1388161,1388475,314,RepeatMasker,LINE,1385881,1388686,314,1.00
ptg002911l,463019,463328,309,RepeatMasker,LINE,462969,463054,35,0.11
ptg002911l,463019,463328,309,RepeatMasker,LINE,463178,463244,67,0.22
ptg002918l,644114,644256,142,RepeatMasker,LINE,644137,644558,120,0.85
ptg002920l,7149501,7149811,310,RepeatMasker,LINE,7149659,7149738,80,0.26
ptg002938l,978077,978360,283,RepeatMasker,LINE,978150,979643,211,0.75
ptg002965l,5537645,5537957,312,RepeatMasker,LINE,5537179,5537733,88,0.28
ptg002968l,468748,469058,310,RepeatMasker,LINE,468577,469276,310,1.00
ptg002971l,4708804,4709120,316,RepeatMasker,LINE,4707950,4709030,226,0.72
ptg002971l,4708804,4709120,316,RepeatMasker,LINE,4708108,4709030,226,0.72
ptg002971l,4708804,4709120,316,RepeatMasker,LINE,4708525,4709211,316,1.00
ptg002972l,1914368,1914671,303,RepeatMasker,LINE,1913119,1914437,69,0.23
ptg002982l,1262219,1262513,294,RepeatMasker,LINE,1260916,1262612,294,1.00
ptg002984l,1440716,1440999,283,RepeatMasker,LINE,1440154,1441040,283,1.00
ptg002986l,1943563,1943886,323,RepeatMasker,LINE,1943486,1944092,323,1.00
ptg002993l,641702,642002,300,RepeatMasker,LINE,641878,645129,125,0.42
ptg002993l,1091341,1091646,305,RepeatMasker,LINE,1091386,1091936,261,0.86
ptg002993l,1654506,1654793,287,RepeatMasker,LINE,1654785,1658373,9,0.03
ptg003000l,3522434,3522764,330,RepeatMasker,LINE,3522169,3525445,330,1.00
ptg003012l,230869,231202,333,RepeatMasker,LINE,230819,231122,253,0.76
ptg003012l,301305,301618,313,RepeatMasker,LINE,301258,301541,236,0.75
ptg003012l,913226,913545,319,RepeatMasker,LINE,913180,913462,236,0.74
ptg003016l,1006555,1006865,310,RepeatMasker,LINE,1003674,1007409,310,1.00
ptg003020l,2226542,2226859,317,RepeatMasker,LINE,2226771,2226964,89,0.28
ptg003022l,1399821,1400127,306,RepeatMasker,LINE,1400110,1400372,18,0.06
ptg003029l,2767068,2767381,313,RepeatMasker,LINE,2766900,2767235,167,0.53
ptg003042l,831676,831984,308,RepeatMasker,LINE,831863,832456,122,0.40
ptg003050l,1872549,1872878,329,RepeatMasker,LINE,1872301,1875520,329,1.00
ptg003051l,378716,378985,269,RepeatMasker,LINE,378976,381845,10,0.04
ptg003051l,3595741,3596010,269,RepeatMasker,LINE,3595100,3595834,93,0.35
ptg003067l,374602,374910,308,RepeatMasker,LINE,373783,374728,126,0.41
ptg003084l,2707057,2707363,306,RepeatMasker,LINE,2706990,2707195,138,0.45
ptg003085l,1858135,1858425,290,RepeatMasker,LINE,1858040,1858141,6,0.02
ptg003085l,1993405,1993715,310,RepeatMasker,LINE,1992652,1993505,100,0.32
ptg003085l,1993405,1993715,310,RepeatMasker,LINE,1993463,1994571,253,0.82
ptg003092l,1125721,1126002,281,RepeatMasker,LINE,1125610,1125890,169,0.60
ptg003125l,1760303,1760634,331,RepeatMasker,LINE,1760029,1763231,331,1.00
ptg003135l,211092,211418,326,RepeatMasker,LINE,208516,211781,326,1.00
ptg003137l,655744,656024,280,RepeatMasker,LINE,655838,655881,44,0.16
ptg003138l,186332,186624,292,RepeatMasker,LINE,186383,186461,79,0.27
ptg003138l,186332,186624,292,RepeatMasker,LINE,186449,189592,176,0.60
ptg003139l,1499204,1499518,314,RepeatMasker,LINE,1499183,1499690,314,1.00
ptg003141l,1205959,1206229,270,RepeatMasker,LINE,1206020,1206062,43,0.16
ptg003147l,1708187,1708485,298,RepeatMasker,LINE,1708288,1708341,54,0.18
ptg003147l,5843110,5843410,300,RepeatMasker,LINE,5843403,5846528,8,0.03
ptg003155l,837708,837980,272,RepeatMasker,LINE,837742,837858,117,0.43
ptg003158l,1924347,1924661,314,RepeatMasker,LINE,1923663,1924651,304,0.97
ptg003161l,398299,398611,312,RepeatMasker,LINE,397192,399173,312,1.00
ptg003177l,1477041,1477350,309,RepeatMasker,LINE,1477220,1478682,131,0.42
ptg003181l,1734808,1735115,307,RepeatMasker,LINE,1734755,1735004,196,0.64
ptg003181l,1734808,1735115,307,RepeatMasker,LINE,1734829,1735067,239,0.78
ptg003200l,1512911,1513239,328,RepeatMasker,LINE,1512890,1513905,328,1.00
ptg003209l,275826,276120,294,RepeatMasker,LINE,275804,275864,38,0.13
ptg003216l,84151,84436,285,RepeatMasker,LINE,84256,84525,181,0.64
ptg003216l,84151,84436,285,RepeatMasker,LINE,84379,84561,58,0.20
ptg003217l,3478897,3479210,313,RepeatMasker,LINE,3478628,3479189,292,0.93
ptg003217l,3478897,3479210,313,RepeatMasker,LINE,3478869,3479182,285,0.91
ptg003218l,1187342,1187628,286,RepeatMasker,LINE,1186785,1187609,267,0.93
ptg003222l,1695372,1695666,294,RepeatMasker,LINE,1695509,1695594,86,0.29
ptg003230l,4320303,4320616,313,RepeatMasker,LINE,4320516,4321166,101,0.32
ptg003235l,1018474,1018754,280,RepeatMasker,LINE,1018558,1018625,68,0.24
ptg003241l,321311,321604,293,RepeatMasker,LINE,318523,321417,106,0.36
ptg003241l,321311,321604,293,RepeatMasker,LINE,321519,321573,55,0.19
ptg003247l,1203265,1203581,316,RepeatMasker,LINE,1203527,1203715,55,0.17
ptg003251l,175568,175843,275,RepeatMasker,LINE,175398,175588,20,0.07
ptg003251l,175568,175843,275,RepeatMasker,LINE,175573,175712,140,0.51
ptg003268l,1288920,1289217,297,RepeatMasker,LINE,1288294,1289020,100,0.34
ptg003268l,3065150,3065442,292,RepeatMasker,LINE,3065420,3065642,23,0.08
ptg003271l,838690,839005,315,RepeatMasker,LINE,838956,839354,50,0.16
ptg003285l,319395,319696,301,RepeatMasker,LINE,318109,319498,103,0.34
ptg003286l,1271614,1271918,304,RepeatMasker,LINE,1271665,1271731,67,0.22
ptg003286l,1271614,1271918,304,RepeatMasker,LINE,1271679,1271724,46,0.15
ptg003303l,2129646,2129963,317,RepeatMasker,LINE,2129061,2129757,111,0.35
ptg003320l,1890024,1890326,302,RepeatMasker,LINE,1886663,1890393,302,1.00
ptg003339l,134274,134567,293,RepeatMasker,LINE,134394,134668,174,0.59
ptg003350l,1222440,1222762,322,RepeatMasker,LINE,1222218,1222582,142,0.44
ptg003351l,3751785,3752080,295,RepeatMasker,LINE,3751784,3753982,295,1.00
ptg003367l,368791,369058,267,RepeatMasker,LINE,368706,368857,66,0.25
ptg003376l,544627,544951,324,RepeatMasker,LINE,544679,544749,71,0.22
ptg003389l,2036952,2037255,303,RepeatMasker,LINE,2037244,2040372,12,0.04
ptg003395l,112337,112593,256,RepeatMasker,LINE,112422,112671,172,0.67
ptg003395l,139380,139636,256,RepeatMasker,LINE,139438,139714,199,0.78
ptg003402l,2131482,2131790,308,RepeatMasker,LINE,2131546,2131756,211,0.69
ptg003412l,2896168,2896499,331,RepeatMasker,LINE,2896227,2896302,76,0.23
ptg003417l,1160384,1160676,292,RepeatMasker,LINE,1160062,1161760,292,1.00
ptg003419l,260625,260907,282,RepeatMasker,LINE,260436,261391,282,1.00
ptg003429l,157263,157567,304,RepeatMasker,LINE,157349,160011,219,0.72
ptg003433l,711160,711448,288,RepeatMasker,LINE,707511,711516,288,1.00
ptg003440l,1134937,1135242,305,RepeatMasker,LINE,1134773,1134974,37,0.12
ptg003445l,1796695,1797009,314,RepeatMasker,LINE,1796422,1796890,195,0.62
ptg003457l,2159959,2160282,323,RepeatMasker,LINE,2159993,2160072,80,0.25
ptg003465l,613776,614042,266,RepeatMasker,LINE,613978,614383,65,0.24
ptg003478l,1158530,1158840,310,RepeatMasker,LINE,1158575,1158665,91,0.29
ptg003486l,1505275,1505568,293,RepeatMasker,LINE,1505301,1506053,268,0.91
ptg003492l,4433938,4434253,315,RepeatMasker,LINE,4433907,4434047,109,0.35
ptg003517l,2081105,2081391,286,RepeatMasker,LINE,2081131,2081199,69,0.24
ptg003526l,3277633,3277890,257,RepeatMasker,LINE,3277528,3277646,13,0.05
ptg003534l,9932683,9932985,302,RepeatMasker,LINE,9930755,9933305,302,1.00
ptg003582l,693555,693835,280,RepeatMasker,LINE,693643,696515,193,0.69
ptg003590l,175452,175762,310,RepeatMasker,LINE,173956,175547,95,0.31
ptg003590l,4878041,4878347,306,RepeatMasker,LINE,4878065,4878128,64,0.21
ptg003591l,929306,929630,324,RepeatMasker,LINE,929120,931146,324,1.00
ptg003596l,364859,365159,300,RepeatMasker,LINE,364638,365133,274,0.91
ptg003596l,364859,365159,300,RepeatMasker,LINE,364768,364901,42,0.14
ptg003596l,364859,365159,300,RepeatMasker,LINE,364786,365265,300,1.00
ptg003598l,429553,429861,308,RepeatMasker,LINE,427090,430980,308,1.00
ptg003610l,110142,110430,288,RepeatMasker,LINE,110274,110389,116,0.40
ptg003615l,3062678,3063001,323,RepeatMasker,LINE,3061849,3063606,323,1.00
ptg003617l,1201230,1201515,285,RepeatMasker,LINE,1200970,1203960,285,1.00
ptg003634l,1034366,1034636,270,RepeatMasker,LINE,1034498,1037780,139,0.51
ptg003634l,9724469,9724810,341,RepeatMasker,LINE,9724727,9724772,46,0.13
ptg003640l,390288,390581,293,RepeatMasker,LINE,389332,390649,293,1.00
ptg003661l,409149,409460,311,RepeatMasker,LINE,408511,409255,106,0.34
ptg003666l,2149000,2149296,296,RepeatMasker,LINE,2148427,2149076,76,0.26
ptg003678l,415964,416289,325,RepeatMasker,LINE,415830,418554,325,1.00
ptg003699l,2892865,2893143,278,RepeatMasker,LINE,2892799,2894626,278,1.00
ptg003700l,1896296,1896593,297,RepeatMasker,LINE,1896439,1896922,155,0.52
ptg003700l,3156662,3156981,319,RepeatMasker,LINE,3156587,3156666,4,0.01
ptg003700l,4231963,4232280,317,RepeatMasker,LINE,4231794,4233067,317,1.00
ptg003700l,4231963,4232280,317,RepeatMasker,LINE,4231956,4233043,317,1.00
ptg003700l,4231963,4232280,317,RepeatMasker,LINE,4232112,4233080,169,0.53
ptg003709l,382507,382798,291,RepeatMasker,LINE,382522,382662,141,0.48
ptg003719l,411025,411303,278,RepeatMasker,LINE,411103,411162,60,0.22
ptg003719l,746181,746471,290,RepeatMasker,LINE,746345,747457,127,0.44
ptg003721l,1040998,1041337,339,RepeatMasker,LINE,1041172,1041228,57,0.17
ptg003722l,4303727,4304016,289,RepeatMasker,LINE,4303244,4303773,46,0.16
ptg003722l,4303727,4304016,289,RepeatMasker,LINE,4303455,4304228,289,1.00
ptg003725l,2856326,2856628,302,RepeatMasker,LINE,2856470,2857356,159,0.53
ptg003725l,3523332,3523654,322,RepeatMasker,LINE,3523588,3523899,67,0.21
ptg003729l,1989729,1990018,289,RepeatMasker,LINE,1988621,1990261,289,1.00
ptg003734l,1679681,1679958,277,RepeatMasker,LINE,1677217,1680820,277,1.00
ptg003740l,1015008,1015364,356,RepeatMasker,LINE,1015045,1015100,56,0.16
ptg003743l,11366,11645,279,RepeatMasker,LINE,9760,11774,279,1.00
ptg003747l,89072,89398,326,RepeatMasker,LINE,86501,89722,326,1.00
ptg003749l,3440199,3440494,295,RepeatMasker,LINE,3440331,3440475,145,0.49
ptg003749l,6584017,6584312,295,RepeatMasker,LINE,6584269,6585133,44,0.15
ptg003749l,6697382,6697660,278,RepeatMasker,LINE,6697481,6697546,66,0.24
ptg003749l,7904876,7905165,289,RepeatMasker,LINE,7904917,7905148,232,0.80
ptg003751l,1542857,1543156,299,RepeatMasker,LINE,1542561,1544325,299,1.00
ptg003751l,1542857,1543156,299,RepeatMasker,LINE,1542569,1544560,299,1.00
ptg003769l,325343,325667,324,RepeatMasker,LINE,323291,325968,324,1.00
ptg003773l,128872,129194,322,RepeatMasker,LINE,129064,129129,66,0.20
ptg003779l,3626360,3626646,286,RepeatMasker,LINE,3625361,3626427,67,0.23
ptg003782l,492145,492439,294,RepeatMasker,LINE,492017,492500,294,1.00
ptg003784l,2520637,2520932,295,RepeatMasker,LINE,2519446,2520912,275,0.93
ptg003784l,2520637,2520932,295,RepeatMasker,LINE,2520335,2521653,295,1.00
ptg003785l,1480238,1480556,318,RepeatMasker,LINE,1480262,1480304,43,0.14
ptg003787l,91555,91881,326,RepeatMasker,LINE,91323,94545,326,1.00
ptg003790l,415231,415541,310,RepeatMasker,LINE,414487,416809,310,1.00
ptg003793l,1171345,1171631,286,RepeatMasker,LINE,1171451,1171487,37,0.13
ptg003798l,2278514,2278828,314,RepeatMasker,LINE,2278620,2279702,209,0.67
ptg003805l,101862,102169,307,RepeatMasker,LINE,97423,101978,116,0.38
ptg003812l,2174621,2174907,286,RepeatMasker,LINE,2174508,2174748,127,0.44
ptg003838l,574357,574655,298,RepeatMasker,LINE,574472,574531,60,0.20
ptg003838l,574357,574655,298,RepeatMasker,LINE,573372,574366,9,0.03
ptg003839l,2477205,2477502,297,RepeatMasker,LINE,2474940,2479200,297,1.00
ptg003839l,4395230,4395547,317,RepeatMasker,LINE,4393239,4395240,10,0.03
ptg003839l,4395230,4395547,317,RepeatMasker,LINE,4395399,4395472,74,0.23
ptg003841l,956852,957131,279,RepeatMasker,LINE,956787,959481,279,1.00
ptg003844l,61083,61358,275,RepeatMasker,LINE,60943,61503,275,1.00
ptg003850l,755553,755834,281,RepeatMasker,LINE,755262,756508,281,1.00
ptg003873l,827959,828282,323,RepeatMasker,LINE,827944,828797,323,1.00
ptg003877l,777973,778241,268,RepeatMasker,LINE,778057,779255,185,0.69
ptg003883l,468539,468812,273,RepeatMasker,LINE,467855,468916,273,1.00
ptg003884l,229210,229484,274,RepeatMasker,LINE,229343,229955,142,0.52
ptg003894l,911146,911426,280,RepeatMasker,LINE,910804,911613,280,1.00
ptg003895l,1179364,1179631,267,RepeatMasker,LINE,1179625,1179691,7,0.03
ptg003897l,2688769,2689084,315,RepeatMasker,LINE,2688771,2688910,140,0.44
ptg003898l,1196564,1196863,299,RepeatMasker,LINE,1196394,1197016,299,1.00
ptg003923l,2906586,2906889,303,RepeatMasker,LINE,2906599,2906669,71,0.23
ptg003923l,3052387,3052709,322,RepeatMasker,LINE,3052695,3053063,15,0.05
ptg003930l,370765,371046,281,RepeatMasker,LINE,370346,370884,119,0.42
ptg003933l,1106613,1106931,318,RepeatMasker,LINE,1105047,1107058,318,1.00
ptg003936l,2881827,2882158,331,RepeatMasker,LINE,2881960,2883760,199,0.60
ptg003938l,2015656,2015970,314,RepeatMasker,LINE,2015660,2015733,74,0.24
ptg003967l,853419,853711,292,RepeatMasker,LINE,853578,853761,134,0.46
ptg003968l,3823458,3823756,298,RepeatMasker,LINE,3822736,3824597,298,1.00
ptg003970l,214810,215115,305,RepeatMasker,LINE,214880,214913,34,0.11
ptg003982l,2340476,2340787,311,RepeatMasker,LINE,2340454,2340532,56,0.18
ptg003994l,5615141,5615476,335,RepeatMasker,LINE,5615119,5615595,335,1.00
ptg003994l,6934485,6934781,296,RepeatMasker,LINE,6934438,6934499,14,0.05
ptg003994l,6934485,6934781,296,RepeatMasker,LINE,6934442,6934494,9,0.03
ptg003997l,3031520,3031780,260,RepeatMasker,LINE,3031371,3031557,37,0.14
ptg003998l,63892,64217,325,RepeatMasker,LINE,61354,64569,325,1.00
ptg004004l,419031,419356,325,RepeatMasker,LINE,419174,422278,183,0.56
ptg004006l,390885,391170,285,RepeatMasker,LINE,390514,391017,132,0.46
ptg004009l,9563054,9563382,328,RepeatMasker,LINE,9562380,9565110,328,1.00
ptg004012l,2555190,2555472,282,RepeatMasker,LINE,2554985,2555239,49,0.17
ptg004012l,2555190,2555472,282,RepeatMasker,LINE,2555118,2555844,282,1.00
ptg004012l,3963262,3963566,304,RepeatMasker,LINE,3963304,3967053,263,0.87
ptg004015l,394729,395009,280,RepeatMasker,LINE,394824,395287,186,0.66
ptg004015l,394729,395009,280,RepeatMasker,LINE,394847,395095,163,0.58
ptg004021l,2968260,2968541,281,RepeatMasker,LINE,2967678,2968507,247,0.88
ptg004021l,4520613,4520925,312,RepeatMasker,LINE,4519362,4520853,240,0.77
ptg004029l,541744,542061,317,RepeatMasker,LINE,539592,542266,317,1.00
ptg004033l,5596174,5596513,339,RepeatMasker,LINE,5596421,5596843,93,0.27
ptg004051l,1461805,1462090,285,RepeatMasker,LINE,1462015,1462600,76,0.27
ptg004060l,119062,119379,317,RepeatMasker,LINE,118584,119344,282,0.89
ptg004068l,3214091,3214412,321,RepeatMasker,LINE,3214280,3217514,133,0.41
ptg004071l,281169,281469,300,RepeatMasker,LINE,280608,281171,2,0.01
ptg004072l,992622,992918,296,RepeatMasker,LINE,992188,992763,141,0.48
ptg004072l,992622,992918,296,RepeatMasker,LINE,992688,992783,96,0.32
ptg004082l,1855309,1855597,288,RepeatMasker,LINE,1855288,1855358,49,0.17
ptg004082l,5342322,5342616,294,RepeatMasker,LINE,5339966,5342429,107,0.36
ptg004096l,883058,883382,324,RepeatMasker,LINE,882854,883116,58,0.18
ptg004096l,883058,883382,324,RepeatMasker,LINE,883231,883285,55,0.17
ptg004096l,883058,883382,324,RepeatMasker,LINE,883335,883434,48,0.15
ptg004107l,539460,539764,304,RepeatMasker,LINE,539473,539530,58,0.19
ptg004111l,429207,429499,292,RepeatMasker,LINE,429294,429855,206,0.71
ptg004113l,2793453,2793757,304,RepeatMasker,LINE,2790051,2793766,304,1.00
ptg004118l,392000,392340,340,RepeatMasker,LINE,392007,393499,334,0.98
ptg004118l,1294781,1295107,326,RepeatMasker,LINE,1294516,1295451,326,1.00
ptg004123l,1452694,1452983,289,RepeatMasker,LINE,1452836,1452893,58,0.20
ptg004123l,1564137,1564446,309,RepeatMasker,LINE,1564314,1564444,131,0.42
ptg004130l,868962,869274,312,RepeatMasker,LINE,868947,869010,48,0.15
ptg004135l,1837505,1837787,282,RepeatMasker,LINE,1837547,1837610,64,0.23
ptg004141l,2106418,2106699,281,RepeatMasker,LINE,2106295,2106888,281,1.00
ptg004149l,386690,387022,332,RepeatMasker,LINE,386649,386800,110,0.33
ptg004152l,3536742,3537046,304,RepeatMasker,LINE,3533497,3537126,304,1.00
ptg004162l,1844555,1844858,303,RepeatMasker,LINE,1844760,1844828,69,0.23
ptg004165l,560733,561025,292,RepeatMasker,LINE,560784,561357,242,0.83
ptg004183l,322426,322741,315,RepeatMasker,LINE,322638,322794,104,0.33
ptg004208l,2872167,2872473,306,RepeatMasker,LINE,2871999,2872185,18,0.06
ptg004208l,2872167,2872473,306,RepeatMasker,LINE,2872173,2872346,174,0.57
ptg004208l,4158463,4158763,300,RepeatMasker,LINE,4157520,4159477,300,1.00
ptg004214l,1600931,1601224,293,RepeatMasker,LINE,1601151,1601461,74,0.25
ptg004214l,1600931,1601224,293,RepeatMasker,LINE,1601221,1601480,4,0.01
ptg004228l,1560795,1561113,318,RepeatMasker,LINE,1559498,1561020,225,0.71
ptg004253l,500832,501131,299,RepeatMasker,LINE,499898,501837,299,1.00
ptg004258l,18527,18794,267,RepeatMasker,LINE,18737,18796,58,0.22
ptg004260l,244831,245147,316,RepeatMasker,LINE,245004,245433,144,0.46
ptg004261l,830398,830712,314,RepeatMasker,LINE,830593,833840,120,0.38
ptg004265l,1754237,1754563,326,RepeatMasker,LINE,1754421,1755126,143,0.44
ptg004269l,784910,785220,310,RepeatMasker,LINE,784615,785204,294,0.95
ptg004270l,1107905,1108185,280,RepeatMasker,LINE,1107356,1108465,280,1.00
ptg004288l,1179791,1180072,281,RepeatMasker,LINE,1179771,1179943,152,0.54
ptg004300l,4171253,4171564,311,RepeatMasker,LINE,4170174,4172924,311,1.00
ptg004303l,2030259,2030547,288,RepeatMasker,LINE,2030432,2030483,52,0.18
ptg004303l,6800963,6801234,271,RepeatMasker,LINE,6801052,6801547,183,0.68
ptg004304l,1350169,1350498,329,RepeatMasker,LINE,1350420,1350476,57,0.17
ptg004311l,813184,813477,293,RepeatMasker,LINE,813239,813284,46,0.16
ptg004312l,508152,508442,290,RepeatMasker,LINE,508426,508552,17,0.06
ptg004316l,195368,195621,253,RepeatMasker,LINE,195435,196124,187,0.74
ptg004319l,2193298,2193588,290,RepeatMasker,LINE,2193318,2193389,72,0.25
ptg004319l,2193298,2193588,290,RepeatMasker,LINE,2193487,2193645,102,0.35
ptg004319l,3790033,3790307,274,RepeatMasker,LINE,3790240,3790509,68,0.25
ptg004324l,329841,330116,275,RepeatMasker,LINE,329975,331238,142,0.52
ptg004327l,6003212,6003494,282,RepeatMasker,LINE,6003485,6006076,10,0.04
ptg004327l,6878328,6878636,308,RepeatMasker,LINE,6878417,6880561,220,0.71
ptg004341l,122249,122571,322,RepeatMasker,LINE,122264,125341,308,0.96
ptg004342l,456137,456436,299,RepeatMasker,LINE,456260,456975,177,0.59
ptg004343l,4115053,4115361,308,RepeatMasker,LINE,4112613,4116482,308,1.00
ptg004344l,1066182,1066474,292,RepeatMasker,LINE,1066345,1067752,130,0.45
ptg004345l,110296,110623,327,RepeatMasker,LINE,109732,110966,327,1.00
ptg004373l,540911,541193,282,RepeatMasker,LINE,540583,541286,282,1.00
ptg004376l,789607,789857,250,RepeatMasker,LINE,789651,789696,46,0.18
ptg004376l,1532705,1533018,313,RepeatMasker,LINE,1532729,1532771,43,0.14
ptg004376l,1532705,1533018,313,RepeatMasker,LINE,1532788,1534542,231,0.74
ptg004382l,4348976,4349265,289,RepeatMasker,LINE,4348271,4349142,166,0.57
ptg004396l,31607,31910,303,RepeatMasker,LINE,31441,33197,303,1.00
ptg004401l,4360405,4360692,287,RepeatMasker,LINE,4359604,4361468,287,1.00
ptg004406l,18590,18885,295,RepeatMasker,LINE,16809,18751,161,0.55
ptg004406l,618856,619182,326,RepeatMasker,LINE,618435,619196,326,1.00
ptg004406l,618856,619182,326,RepeatMasker,LINE,618594,619201,326,1.00
ptg004417l,295785,296105,320,RepeatMasker,LINE,293276,296327,320,1.00
ptg004417l,296448,296773,325,RepeatMasker,LINE,296331,297178,325,1.00
ptg004420l,286111,286449,338,RepeatMasker,LINE,285053,286802,338,1.00
ptg004429l,815046,815319,273,RepeatMasker,LINE,815243,815532,77,0.28
ptg004445l,2442213,2442545,332,RepeatMasker,LINE,2442203,2443138,332,1.00
ptg004449l,1913465,1913797,332,RepeatMasker,LINE,1912834,1916053,332,1.00
ptg004454l,181898,182210,312,RepeatMasker,LINE,182192,183212,19,0.06
ptg004456l,1564425,1564693,268,RepeatMasker,LINE,1561959,1564647,222,0.83
ptg004475l,152588,152880,292,RepeatMasker,LINE,152798,153328,83,0.28
ptg004477l,1589736,1590010,274,RepeatMasker,LINE,1589633,1590068,274,1.00
ptg004477l,1589736,1590010,274,RepeatMasker,LINE,1589699,1590007,271,0.99
ptg004479l,2996795,2997120,325,RepeatMasker,LINE,2996728,2997501,325,1.00
ptg004479l,2996795,2997120,325,RepeatMasker,LINE,2996759,2997380,325,1.00
ptg004492l,2516819,2517117,298,RepeatMasker,LINE,2516187,2518378,298,1.00
ptg004499l,1718482,1718764,282,RepeatMasker,LINE,1718102,1719566,282,1.00
ptg004499l,1718482,1718764,282,RepeatMasker,LINE,1718266,1719896,282,1.00
ptg004510l,1040976,1041257,281,RepeatMasker,LINE,1040313,1041638,281,1.00
ptg004513l,1209496,1209781,285,RepeatMasker,LINE,1209526,1209599,74,0.26
ptg004517l,528911,529175,264,RepeatMasker,LINE,529020,529395,156,0.59
ptg004530l,3368374,3368697,323,RepeatMasker,LINE,3368359,3371575,323,1.00
ptg004530l,6380757,6381030,273,RepeatMasker,LINE,6379741,6381151,273,1.00
ptg004530l,7274251,7274525,274,RepeatMasker,LINE,7274211,7274356,105,0.38
ptg004543l,1778351,1778645,294,RepeatMasker,LINE,1778410,1778532,123,0.42
ptg004543l,1778351,1778645,294,RepeatMasker,LINE,1778522,1779127,124,0.42
ptg004549l,324010,324296,286,RepeatMasker,LINE,324245,324666,52,0.18
ptg004555l,1742825,1743136,311,RepeatMasker,LINE,1742323,1742845,20,0.06
ptg004557l,549880,550160,280,RepeatMasker,LINE,550104,551327,57,0.20
ptg004563l,275318,275597,279,RepeatMasker,LINE,275267,277913,279,1.00
ptg004563l,275318,275597,279,RepeatMasker,LINE,275267,278391,279,1.00
ptg004571l,2574646,2574934,288,RepeatMasker,LINE,2574909,2575285,26,0.09
ptg004573l,70269,70583,314,RepeatMasker,LINE,70325,70395,71,0.23
ptg004581l,92224,92523,299,RepeatMasker,LINE,91404,92671,299,1.00
ptg004594l,704029,704338,309,RepeatMasker,LINE,703859,704401,309,1.00
ptg004600l,697833,698160,327,RepeatMasker,LINE,697811,701033,327,1.00
ptg004610l,1372762,1373039,277,RepeatMasker,LINE,1372930,1373080,110,0.40
ptg004616l,93380,93695,315,RepeatMasker,LINE,93417,93472,56,0.18
ptg004628l,285591,285866,275,RepeatMasker,LINE,285742,286868,125,0.45
ptg004639l,3581833,3582118,285,RepeatMasker,LINE,3581922,3585182,197,0.69
ptg004641l,1810098,1810375,277,RepeatMasker,LINE,1810019,1811849,277,1.00
ptg004669l,252639,252929,290,RepeatMasker,LINE,252682,252729,48,0.17
ptg004674l,3205348,3205657,309,RepeatMasker,LINE,3205355,3205425,71,0.23
ptg004682l,4192134,4192443,309,RepeatMasker,LINE,4192111,4192284,150,0.49
ptg004685l,1216730,1217039,309,RepeatMasker,LINE,1216706,1216776,46,0.15
ptg004692l,402705,403033,328,RepeatMasker,LINE,402736,402805,70,0.21
ptg004692l,402705,403033,328,RepeatMasker,LINE,402739,402827,89,0.27
ptg004699l,1849802,1850103,301,RepeatMasker,LINE,1849386,1849804,2,0.01
ptg004705l,2755350,2755674,324,RepeatMasker,LINE,2753497,2756017,324,1.00
ptg004717l,3129491,3129816,325,RepeatMasker,LINE,3126641,3132380,325,1.00
ptg004737l,237254,237534,280,RepeatMasker,LINE,233802,237614,280,1.00
ptg004749l,691320,691623,303,RepeatMasker,LINE,691253,691579,259,0.85
ptg004785l,193071,193381,310,RepeatMasker,LINE,192119,194139,310,1.00
ptg004803l,64254,64550,296,RepeatMasker,LINE,64426,64667,125,0.42
ptg004803l,64254,64550,296,RepeatMasker,LINE,64528,64686,23,0.08
ptg004803l,830187,830491,304,RepeatMasker,LINE,830295,830370,76,0.25
ptg004812l,881350,881679,329,RepeatMasker,LINE,881083,884383,329,1.00
ptg004830l,1508601,1508929,328,RepeatMasker,LINE,1508482,1508675,74,0.23
ptg004834l,2291087,2291362,275,RepeatMasker,LINE,2291099,2291288,190,0.69
ptg004834l,2291087,2291362,275,RepeatMasker,LINE,2291127,2291509,236,0.86
ptg004841l,266442,266767,325,RepeatMasker,LINE,266608,267477,160,0.49
ptg004841l,1871080,1871403,323,RepeatMasker,LINE,1868492,1871762,323,1.00
ptg004845l,681928,682239,311,RepeatMasker,LINE,682021,682457,219,0.70
ptg004845l,791548,791834,286,RepeatMasker,LINE,791686,791946,149,0.52
ptg004849l,1420249,1420581,332,RepeatMasker,LINE,1420441,1420474,34,0.10
ptg004855l,628713,629016,303,RepeatMasker,LINE,625354,629083,303,1.00
ptg004864l,1053892,1054205,313,RepeatMasker,LINE,1053992,1054061,70,0.22
ptg004873l,766474,766741,267,RepeatMasker,LINE,766715,766760,27,0.10
ptg004875l,107465,107767,302,RepeatMasker,LINE,107045,109062,302,1.00
ptg004883l,320557,320879,322,RepeatMasker,LINE,320755,323029,125,0.39
ptg004894l,438920,439231,311,RepeatMasker,LINE,438797,439753,311,1.00
ptg004898l,2399398,2399721,323,RepeatMasker,LINE,2399368,2400360,323,1.00
ptg004901l,2376027,2376337,310,RepeatMasker,LINE,2376325,2376473,13,0.04
ptg004902l,587676,587985,309,RepeatMasker,LINE,587774,588146,212,0.69
ptg004937l,1356957,1357271,314,RepeatMasker,LINE,1357043,1357113,71,0.23
ptg004946l,38761,39087,326,RepeatMasker,LINE,38824,39465,264,0.81
ptg004955l,4235349,4235642,293,RepeatMasker,LINE,4235512,4235576,65,0.22
ptg004957l,985652,985952,300,RepeatMasker,LINE,985519,986390,300,1.00
ptg004968l,3219387,3219701,314,RepeatMasker,LINE,3219684,3219730,18,0.06
ptg004968l,4700468,4700768,300,RepeatMasker,LINE,4700529,4700587,59,0.20
ptg004968l,5171800,5172097,297,RepeatMasker,LINE,5171733,5171837,37,0.12
ptg004968l,8613825,8614135,310,RepeatMasker,LINE,8611886,8614948,310,1.00
ptg004968l,8613825,8614135,310,RepeatMasker,LINE,8612302,8615855,310,1.00
ptg004968l,9638381,9638664,283,RepeatMasker,LINE,9635597,9639787,283,1.00
ptg004991l,3212628,3212957,329,RepeatMasker,LINE,3212364,3215646,329,1.00
ptg004995l,611418,611715,297,RepeatMasker,LINE,611680,614320,36,0.12
ptg005000l,2455697,2456011,314,RepeatMasker,LINE,2455113,2456168,314,1.00
ptg005006l,546335,546646,311,RepeatMasker,LINE,546452,547625,195,0.63
ptg005006l,1149086,1149354,268,RepeatMasker,LINE,1149304,1149417,51,0.19
ptg005019l,1073883,1074170,287,RepeatMasker,LINE,1072766,1073970,87,0.30
ptg005021l,2440910,2441223,313,RepeatMasker,LINE,2440934,2440977,44,0.14
ptg005034l,1641214,1641530,316,RepeatMasker,LINE,1641164,1641953,316,1.00
ptg005042l,1116502,1116800,298,RepeatMasker,LINE,1116380,1116897,298,1.00
ptg005047l,224680,224955,275,RepeatMasker,LINE,224875,225022,81,0.29
ptg005048l,2525764,2526070,306,RepeatMasker,LINE,2525821,2525885,65,0.21
ptg005048l,2525764,2526070,306,RepeatMasker,LINE,2525826,2525877,52,0.17
ptg005055l,1030509,1030813,304,RepeatMasker,LINE,1030512,1030581,70,0.23
ptg005057l,251950,252225,275,RepeatMasker,LINE,252067,252714,159,0.58
ptg005070l,3308717,3308995,278,RepeatMasker,LINE,3308557,3308725,8,0.03
ptg005070l,3308717,3308995,278,RepeatMasker,LINE,3308697,3308800,83,0.30
ptg005078l,793107,793408,301,RepeatMasker,LINE,793119,793187,69,0.23
ptg005078l,793107,793408,301,RepeatMasker,LINE,793284,794314,125,0.42
ptg005086l,2952600,2952922,322,RepeatMasker,LINE,2950507,2952670,70,0.22
ptg005086l,2952600,2952922,322,RepeatMasker,LINE,2950813,2952670,70,0.22
ptg005095l,109464,109739,275,RepeatMasker,LINE,109615,110769,125,0.45
ptg005095l,2785380,2785687,307,RepeatMasker,LINE,2785614,2785659,46,0.15
ptg005105l,549432,549744,312,RepeatMasker,LINE,549744,550658,1,0.00
ptg005121l,4103594,4103921,327,RepeatMasker,LINE,4103790,4107059,132,0.40
ptg005123l,853771,854083,312,RepeatMasker,LINE,853846,854263,238,0.76
ptg005123l,853771,854083,312,RepeatMasker,LINE,853969,854448,115,0.37
ptg005145l,2643948,2644250,302,RepeatMasker,LINE,2644110,2644337,141,0.47
ptg005145l,2643948,2644250,302,RepeatMasker,LINE,2644111,2644517,140,0.46
ptg005146l,3567377,3567707,330,RepeatMasker,LINE,3567381,3570668,327,0.99
ptg005151l,276971,277251,280,RepeatMasker,LINE,277052,279214,200,0.71
ptg005152l,1786802,1787119,317,RepeatMasker,LINE,1783411,1787165,317,1.00
ptg005161l,2139124,2139422,298,RepeatMasker,LINE,2139306,2139409,104,0.35
ptg005161l,3025843,3026153,310,RepeatMasker,LINE,3025846,3025916,71,0.23
ptg005178l,2532773,2533068,295,RepeatMasker,LINE,2532682,2533016,243,0.82
ptg005185l,600905,601235,330,RepeatMasker,LINE,600980,604158,256,0.78
ptg005205l,962811,963090,279,RepeatMasker,LINE,962454,965051,279,1.00
ptg005226l,633243,633508,265,RepeatMasker,LINE,633259,633585,250,0.94
ptg005231l,662045,662302,257,RepeatMasker,LINE,662181,662254,74,0.29
ptg005234l,1648702,1648981,279,RepeatMasker,LINE,1648785,1651300,197,0.71
ptg005245l,2758079,2758405,326,RepeatMasker,LINE,2758238,2758514,168,0.52
ptg005251l,1335838,1336118,280,RepeatMasker,LINE,1332993,1336219,280,1.00
ptg005269l,1744959,1745250,291,RepeatMasker,LINE,1744927,1745005,46,0.16
ptg005288l,2295061,2295351,290,RepeatMasker,LINE,2293208,2295323,262,0.90
ptg005301l,441453,441742,289,RepeatMasker,LINE,440059,441576,123,0.43
ptg005306l,1806591,1806916,325,RepeatMasker,LINE,1806404,1807265,325,1.00
ptg005314l,2619518,2619839,321,RepeatMasker,LINE,2619767,2620103,73,0.23
ptg005314l,6094640,6094957,317,RepeatMasker,LINE,6094008,6094871,231,0.73
ptg005316l,2368272,2368600,328,RepeatMasker,LINE,2368227,2368705,328,1.00
ptg005319l,245322,245634,312,RepeatMasker,LINE,245547,247230,88,0.28
ptg005332l,1104876,1105207,331,RepeatMasker,LINE,1104394,1105271,331,1.00
ptg005355l,1826463,1826790,327,RepeatMasker,LINE,1826654,1827138,137,0.42
ptg005368l,788962,789230,268,RepeatMasker,LINE,788849,788997,35,0.13
ptg005368l,788962,789230,268,RepeatMasker,LINE,789112,789174,63,0.24
ptg005372l,114560,114865,305,RepeatMasker,LINE,114659,114729,71,0.23
ptg005373l,858055,858363,308,RepeatMasker,LINE,855241,858837,308,1.00
ptg005389l,907430,907747,317,RepeatMasker,LINE,907625,909271,123,0.39
ptg005393l,1962737,1963041,304,RepeatMasker,LINE,1962817,1962871,55,0.18
ptg005393l,1962737,1963041,304,RepeatMasker,LINE,1962977,1963022,46,0.15
ptg005398l,504177,504498,321,RepeatMasker,LINE,504123,505470,321,1.00
ptg005398l,504177,504498,321,RepeatMasker,LINE,504375,504741,124,0.39
ptg005398l,830085,830378,293,RepeatMasker,LINE,830377,830777,2,0.01
ptg005421l,2776797,2777102,305,RepeatMasker,LINE,2776800,2776870,71,0.23
ptg005422l,4591408,4591723,315,RepeatMasker,LINE,4591040,4591788,315,1.00
ptg005422l,4641009,4641306,297,RepeatMasker,LINE,4638615,4641117,108,0.36
ptg005427l,3043390,3043690,300,RepeatMasker,LINE,3042935,3043502,112,0.37
ptg005446l,2489224,2489520,296,RepeatMasker,LINE,2487949,2489472,248,0.84
ptg005459l,3064733,3065039,306,RepeatMasker,LINE,3064623,3064808,75,0.25
ptg005460l,150183,150506,323,RepeatMasker,LINE,150335,150426,92,0.28
ptg005460l,150183,150506,323,RepeatMasker,LINE,150433,150568,74,0.23
ptg005468l,1375625,1375932,307,RepeatMasker,LINE,1375614,1375815,190,0.62
ptg005469l,861556,861856,300,RepeatMasker,LINE,861396,861603,47,0.16
ptg005477l,1704538,1704808,270,RepeatMasker,LINE,1704702,1707957,107,0.40
ptg005478l,1494256,1494530,274,RepeatMasker,LINE,1494505,1497480,26,0.09
ptg005483l,58473,58760,287,RepeatMasker,LINE,58478,58895,283,0.99
ptg005486l,413729,414054,325,RepeatMasker,LINE,413743,414761,312,0.96
ptg005487l,1122946,1123255,309,RepeatMasker,LINE,1122949,1123019,71,0.23
ptg005493l,1786289,1786596,307,RepeatMasker,LINE,1786370,1786920,227,0.74
ptg005498l,323269,323564,295,RepeatMasker,LINE,323054,323310,41,0.14
ptg005502l,59533,59835,302,RepeatMasker,LINE,59512,59582,49,0.16
ptg005506l,1519038,1519350,312,RepeatMasker,LINE,1519046,1520184,305,0.98
ptg005508l,5560547,5560860,313,RepeatMasker,LINE,5560554,5560628,75,0.24
ptg005515l,2606886,2607192,306,RepeatMasker,LINE,2606926,2608763,267,0.87
ptg005529l,7486117,7486423,306,RepeatMasker,LINE,7486292,7486538,132,0.43
ptg005529l,7486117,7486423,306,RepeatMasker,LINE,7486316,7486574,108,0.35
ptg005537l,446324,446664,340,RepeatMasker,LINE,443111,447353,340,1.00
ptg005558l,508488,508748,260,RepeatMasker,LINE,508683,508835,66,0.25
ptg005562l,230415,230742,327,RepeatMasker,LINE,230426,230567,142,0.43
ptg005562l,619059,619358,299,RepeatMasker,LINE,619006,619094,35,0.12
ptg005567l,510707,511015,308,RepeatMasker,LINE,510918,510998,81,0.26
ptg005574l,416832,417141,309,RepeatMasker,LINE,416461,416848,16,0.05
ptg005574l,416832,417141,309,RepeatMasker,LINE,416957,417021,65,0.21
ptg005578l,1503182,1503504,322,RepeatMasker,LINE,1503289,1503427,139,0.43
ptg005583l,4414420,4414743,323,RepeatMasker,LINE,4414509,4414595,87,0.27
ptg005583l,4414420,4414743,323,RepeatMasker,LINE,4414543,4414607,65,0.20
ptg005589l,741979,742236,257,RepeatMasker,LINE,741988,742085,98,0.38
ptg005589l,741979,742236,257,RepeatMasker,LINE,742018,742080,63,0.25
ptg005594l,1003586,1003887,301,RepeatMasker,LINE,1003589,1003637,49,0.16
ptg005605l,889073,889369,296,RepeatMasker,LINE,889011,890912,296,1.00
ptg005607l,477253,477579,326,RepeatMasker,LINE,477160,477967,326,1.00
ptg005650l,397637,397939,302,RepeatMasker,LINE,397838,400833,102,0.34
ptg005661l,236228,236516,288,RepeatMasker,LINE,236074,236877,288,1.00
ptg005661l,999083,999391,308,RepeatMasker,LINE,998887,999719,308,1.00
ptg005674l,204671,204946,275,RepeatMasker,LINE,204828,205930,119,0.43
ptg005676l,293791,294068,277,RepeatMasker,LINE,293306,295149,277,1.00
ptg005681l,2094039,2094358,319,RepeatMasker,LINE,2093205,2095571,319,1.00
ptg005681l,2094039,2094358,319,RepeatMasker,LINE,2094273,2096305,86,0.27
ptg005681l,2094039,2094358,319,RepeatMasker,LINE,2094273,2096606,86,0.27
ptg005687l,1379601,1379921,320,RepeatMasker,LINE,1379770,1379845,76,0.24
ptg005695l,807681,807979,298,RepeatMasker,LINE,807727,808897,253,0.85
ptg005699l,963135,963443,308,RepeatMasker,LINE,963089,963252,117,0.38
ptg005699l,963135,963443,308,RepeatMasker,LINE,963113,963232,97,0.31
ptg005718l,1922128,1922423,295,RepeatMasker,LINE,1922108,1922297,169,0.57
ptg005720l,1884315,1884622,307,RepeatMasker,LINE,1884294,1884364,49,0.16
ptg005737l,708145,708461,316,RepeatMasker,LINE,708360,710524,102,0.32
ptg005737l,1085648,1085953,305,RepeatMasker,LINE,1085858,1085979,96,0.31
ptg005737l,5453611,5453914,303,RepeatMasker,LINE,5453359,5455317,303,1.00
ptg005738l,1304753,1305035,282,RepeatMasker,LINE,1304966,1305090,70,0.25
ptg005741l,422106,422440,334,RepeatMasker,LINE,422110,425382,331,0.99
ptg005746l,583698,583997,299,RepeatMasker,LINE,583677,583747,49,0.16
ptg005757l,1946531,1946871,340,RepeatMasker,LINE,1946855,1947250,17,0.05
ptg005761l,1149237,1149540,303,RepeatMasker,LINE,1149132,1149435,198,0.65
ptg005766l,683006,683322,316,RepeatMasker,LINE,682476,683659,316,1.00
ptg005770l,284324,284641,317,RepeatMasker,LINE,283310,284352,28,0.09
ptg005770l,284324,284641,317,RepeatMasker,LINE,284343,284412,70,0.22
ptg005772l,1488718,1489019,301,RepeatMasker,LINE,1488725,1488770,46,0.15
ptg005778l,2032614,2032927,313,RepeatMasker,LINE,2032382,2034228,313,1.00
ptg005778l,2557357,2557666,309,RepeatMasker,LINE,2557662,2557920,5,0.02
ptg005783l,741319,741637,318,RepeatMasker,LINE,741222,741940,318,1.00
ptg005791l,1860837,1861145,308,RepeatMasker,LINE,1861113,1862665,33,0.11
ptg005800l,1039049,1039362,313,RepeatMasker,LINE,1039275,1040167,88,0.28
ptg005804l,2245969,2246280,311,RepeatMasker,LINE,2245968,2246109,140,0.45
ptg005808l,1293054,1293355,301,RepeatMasker,LINE,1292845,1293440,301,1.00
ptg005808l,1293054,1293355,301,RepeatMasker,LINE,1292992,1293424,301,1.00
ptg005816l,2696054,2696372,318,RepeatMasker,LINE,2696142,2696705,231,0.73
ptg005818l,1028610,1028880,270,RepeatMasker,LINE,1028683,1030093,198,0.73
ptg005819l,156802,157075,273,RepeatMasker,LINE,156752,156964,162,0.59
ptg005834l,1102974,1103257,283,RepeatMasker,LINE,1102780,1103594,283,1.00
ptg005872l,1710819,1711107,288,RepeatMasker,LINE,1707179,1711570,288,1.00
ptg005878l,639938,640241,303,RepeatMasker,LINE,640104,643365,138,0.46
ptg005878l,725741,726047,306,RepeatMasker,LINE,725376,725878,137,0.45
ptg005908l,1078685,1079005,320,RepeatMasker,LINE,1078996,1079069,10,0.03
ptg005916l,2144559,2144891,332,RepeatMasker,LINE,2143889,2146447,332,1.00
ptg005930l,1205428,1205742,314,RepeatMasker,LINE,1205508,1205570,63,0.20
ptg005930l,1205428,1205742,314,RepeatMasker,LINE,1205515,1205582,68,0.22
ptg005930l,1205428,1205742,314,RepeatMasker,LINE,1205673,1205858,70,0.22
ptg005930l,1205428,1205742,314,RepeatMasker,LINE,1205716,1205873,27,0.09
ptg005943l,2228314,2228603,289,RepeatMasker,LINE,2228497,2228567,71,0.25
ptg005966l,2976206,2976497,291,RepeatMasker,LINE,2976282,2976403,122,0.42
ptg005966l,3738078,3738358,280,RepeatMasker,LINE,3738281,3738585,78,0.28
ptg005966l,5560968,5561275,307,RepeatMasker,LINE,5560835,5560979,11,0.04
ptg005973l,2873578,2873851,273,RepeatMasker,LINE,2873668,2876715,184,0.67
ptg005987l,290655,290966,311,RepeatMasker,LINE,290514,292868,311,1.00
ptg005989l,2054848,2055146,298,RepeatMasker,LINE,2054681,2054863,15,0.05
ptg005999l,187573,187879,306,RepeatMasker,LINE,186818,187663,90,0.29
ptg006003l,1146112,1146448,336,RepeatMasker,LINE,1145470,1148705,336,1.00
ptg006027l,3895352,3895642,290,RepeatMasker,LINE,3895400,3895453,54,0.19
ptg006028l,817938,818266,328,RepeatMasker,LINE,816811,818610,328,1.00
ptg006028l,817938,818266,328,RepeatMasker,LINE,816820,818152,214,0.65
ptg006037l,1967209,1967524,315,RepeatMasker,LINE,1967357,1967434,78,0.25
ptg006045l,883925,884211,286,RepeatMasker,LINE,883904,883974,49,0.17
ptg006058l,681313,681647,334,RepeatMasker,LINE,681332,681502,171,0.51
ptg006059l,222064,222356,292,RepeatMasker,LINE,222190,222387,167,0.57
ptg006059l,222064,222356,292,RepeatMasker,LINE,222353,222420,4,0.01
ptg006074l,386473,386764,291,RepeatMasker,LINE,385664,386707,234,0.80
ptg006078l,1323358,1323640,282,RepeatMasker,LINE,1323272,1323401,43,0.15
ptg006078l,1421614,1421892,278,RepeatMasker,LINE,1421312,1423526,278,1.00
ptg006081l,947476,947780,304,RepeatMasker,LINE,947537,948111,244,0.80
ptg006083l,2782260,2782547,287,RepeatMasker,LINE,2782192,2782277,17,0.06
ptg006086l,191532,191811,279,RepeatMasker,LINE,190973,191563,31,0.11
ptg006094l,259236,259527,291,RepeatMasker,LINE,259496,259575,32,0.11
ptg006104l,3225184,3225506,322,RepeatMasker,LINE,3225133,3225273,89,0.28
ptg006104l,3225184,3225506,322,RepeatMasker,LINE,3225254,3225388,135,0.42
ptg006115l,1655194,1655473,279,RepeatMasker,LINE,1655080,1655600,279,1.00
ptg006121l,924107,924431,324,RepeatMasker,LINE,924157,925949,275,0.85
ptg006136l,1115799,1116088,289,RepeatMasker,LINE,1115360,1116042,243,0.84
ptg006158l,372584,372913,329,RepeatMasker,LINE,372133,373078,329,1.00
ptg006159l,2828443,2828729,286,RepeatMasker,LINE,2828679,2829276,51,0.18
ptg006163l,623393,623725,332,RepeatMasker,LINE,623092,624086,332,1.00
ptg006183l,3152148,3152426,278,RepeatMasker,LINE,3152387,3153262,40,0.14
ptg006191l,2240291,2240577,286,RepeatMasker,LINE,2240097,2240801,286,1.00
ptg006197l,3375981,3376256,275,RepeatMasker,LINE,3375509,3376175,194,0.71
ptg006200l,1206723,1207037,314,RepeatMasker,LINE,1206283,1206923,200,0.64
ptg006200l,1206723,1207037,314,RepeatMasker,LINE,1206859,1207014,156,0.50
ptg006216l,87255,87580,325,RepeatMasker,LINE,87360,88626,221,0.68
ptg006222l,139407,139721,314,RepeatMasker,LINE,139588,140921,134,0.43
ptg006222l,3239642,3239938,296,RepeatMasker,LINE,3239776,3241240,163,0.55
ptg006223l,31297,31583,286,RepeatMasker,LINE,31127,31489,192,0.67
ptg006224l,2494446,2494743,297,RepeatMasker,LINE,2494456,2497689,288,0.97
ptg006229l,389340,389638,298,RepeatMasker,LINE,389146,392871,298,1.00
ptg006229l,390410,390727,317,RepeatMasker,LINE,389146,392871,317,1.00
ptg006242l,304064,304375,311,RepeatMasker,LINE,304322,304426,54,0.17
ptg006249l,762160,762471,311,RepeatMasker,LINE,762174,762246,73,0.23
ptg006249l,762160,762471,311,RepeatMasker,LINE,762185,762497,287,0.92
ptg006256l,1405371,1405672,301,RepeatMasker,LINE,1405048,1405466,95,0.32
ptg006260l,864998,865321,323,RepeatMasker,LINE,864425,865112,114,0.35
ptg006272l,763463,763766,303,RepeatMasker,LINE,763472,763596,125,0.41
ptg006272l,763463,763766,303,RepeatMasker,LINE,763565,763641,77,0.25
ptg006284l,1511562,1511856,294,RepeatMasker,LINE,1511495,1512176,294,1.00
ptg006284l,1511562,1511856,294,RepeatMasker,LINE,1511795,1512364,62,0.21
ptg006298l,4733073,4733355,282,RepeatMasker,LINE,4733281,4733668,75,0.27
ptg006298l,7185311,7185576,265,RepeatMasker,LINE,7185502,7186141,75,0.28
ptg006302l,1725388,1725680,292,RepeatMasker,LINE,1725227,1725464,76,0.26
ptg006329l,2219900,2220188,288,RepeatMasker,LINE,2216228,2219944,44,0.15
ptg006334l,1621686,1621974,288,RepeatMasker,LINE,1621741,1623318,234,0.81
ptg006344l,836735,837031,296,RepeatMasker,LINE,836854,836937,84,0.28
ptg006344l,836735,837031,296,RepeatMasker,LINE,836885,836982,98,0.33
ptg006361l,1918678,1918953,275,RepeatMasker,LINE,1918648,1920068,275,1.00
ptg006372l,6736948,6737236,288,RepeatMasker,LINE,6736985,6737550,252,0.88
ptg006404l,376933,377241,308,RepeatMasker,LINE,376623,377167,234,0.76
ptg006420l,910267,910544,277,RepeatMasker,LINE,910295,910372,78,0.28
ptg006420l,2189782,2190118,336,RepeatMasker,LINE,2189720,2190275,336,1.00
ptg006420l,2189782,2190118,336,RepeatMasker,LINE,2189853,2190075,223,0.66
ptg006422l,1634119,1634407,288,RepeatMasker,LINE,1630469,1634475,288,1.00
ptg006428l,1260667,1260990,323,RepeatMasker,LINE,1259956,1261432,323,1.00
ptg006432l,356414,356735,321,RepeatMasker,LINE,356558,356637,80,0.25
ptg006455l,3039792,3040097,305,RepeatMasker,LINE,3039799,3039844,46,0.15
ptg006466l,678278,678580,302,RepeatMasker,LINE,678085,678807,302,1.00
ptg006468l,3193415,3193704,289,RepeatMasker,LINE,3193209,3194179,289,1.00
ptg006478l,374321,374609,288,RepeatMasker,LINE,371663,374355,34,0.12
ptg006481l,1172406,1172725,319,RepeatMasker,LINE,1172625,1175875,101,0.32
ptg006481l,1734856,1735162,306,RepeatMasker,LINE,1734678,1735602,306,1.00
ptg006486l,1927702,1928034,332,RepeatMasker,LINE,1927781,1928351,254,0.77
ptg006492l,3363032,3363323,291,RepeatMasker,LINE,3363111,3363215,105,0.36
ptg006495l,884757,885045,288,RepeatMasker,LINE,884849,885085,197,0.68
ptg006501l,4166237,4166552,315,RepeatMasker,LINE,4166491,4166835,62,0.20
ptg006507l,101215,101533,318,RepeatMasker,LINE,101123,101374,159,0.50
ptg006507l,167657,167964,307,RepeatMasker,LINE,164227,167973,307,1.00
ptg006511l,524180,524485,305,RepeatMasker,LINE,523289,524836,305,1.00
ptg006511l,524180,524485,305,RepeatMasker,LINE,523300,525671,305,1.00
ptg006513l,1132090,1132621,531,RepeatMasker,LINE,1132263,1132308,46,0.09
ptg006513l,1132090,1132621,531,RepeatMasker,LINE,1132494,1132634,128,0.24
ptg006514l,650465,650795,330,RepeatMasker,LINE,650316,650584,119,0.36
ptg006516l,2151530,2151806,276,RepeatMasker,LINE,2151270,2151906,276,1.00
ptg006524l,2441800,2442092,292,RepeatMasker,LINE,2441822,2441874,53,0.18
ptg006528l,199579,199898,319,RepeatMasker,LINE,199854,200537,45,0.14
ptg006536l,2678146,2678436,290,RepeatMasker,LINE,2678068,2680263,290,1.00
ptg006537l,574613,574879,266,RepeatMasker,LINE,574561,574638,25,0.09
ptg006537l,3195778,3196104,326,RepeatMasker,LINE,3193843,3196947,326,1.00
ptg006555l,2257904,2258199,295,RepeatMasker,LINE,2256524,2258626,295,1.00
ptg006562l,71464,71760,296,RepeatMasker,LINE,70650,71594,130,0.44
ptg006583l,3285818,3286131,313,RepeatMasker,LINE,3285852,3285928,77,0.25
ptg006583l,3285818,3286131,313,RepeatMasker,LINE,3285855,3285914,60,0.19
ptg006591l,1148476,1148767,291,RepeatMasker,LINE,1146427,1148523,47,0.16
ptg006600l,326021,326352,331,RepeatMasker,LINE,326047,326117,71,0.21
ptg006606l,614926,615211,285,RepeatMasker,LINE,614576,617675,285,1.00
ptg006613l,2778953,2779221,268,RepeatMasker,LINE,2779147,2779558,75,0.28
ptg006627l,859508,859811,303,RepeatMasker,LINE,859737,860396,75,0.25
ptg006632l,72933,73236,303,RepeatMasker,LINE,73119,75637,118,0.39
ptg006638l,3121606,3121919,313,RepeatMasker,LINE,3120568,3121869,263,0.84
ptg006638l,4171746,4172032,286,RepeatMasker,LINE,4171443,4172227,286,1.00
ptg006639l,1917081,1917381,300,RepeatMasker,LINE,1916986,1917286,205,0.68
ptg006640l,1345791,1346081,290,RepeatMasker,LINE,1346023,1346479,59,0.20
ptg006646l,1221454,1221751,297,RepeatMasker,LINE,1221579,1222840,173,0.58
ptg006657l,787472,787771,299,RepeatMasker,LINE,787121,789046,299,1.00
ptg006671l,298483,298804,321,RepeatMasker,LINE,298766,298857,39,0.12
ptg006682l,1656741,1657065,324,RepeatMasker,LINE,1656443,1656962,221,0.68
ptg006704l,721423,721712,289,RepeatMasker,LINE,721445,721697,253,0.88
ptg006704l,721423,721712,289,RepeatMasker,LINE,721633,721950,80,0.28
ptg006711l,1354505,1354845,340,RepeatMasker,LINE,1354502,1354878,340,1.00
ptg006716l,4402437,4402721,284,RepeatMasker,LINE,4402514,4406432,208,0.73
ptg006723l,1953793,1954101,308,RepeatMasker,LINE,1954021,1954265,81,0.26
ptg006724l,516282,516564,282,RepeatMasker,LINE,515885,516486,204,0.72
ptg006725l,1332340,1332618,278,RepeatMasker,LINE,1329473,1332748,278,1.00
ptg006735l,1419005,1419270,265,RepeatMasker,LINE,1419140,1422394,131,0.49
ptg006744l,471049,471377,328,RepeatMasker,LINE,468595,471263,214,0.65
ptg006744l,471049,471377,328,RepeatMasker,LINE,470848,471729,328,1.00
ptg006744l,874402,874728,326,RepeatMasker,LINE,873539,874747,326,1.00
ptg006767l,2618864,2619156,292,RepeatMasker,LINE,2618931,2620994,226,0.77
ptg006771l,1682545,1682881,336,RepeatMasker,LINE,1682717,1682851,135,0.40
ptg006771l,1682545,1682881,336,RepeatMasker,LINE,1682746,1682852,107,0.32
ptg006774l,2084525,2084821,296,RepeatMasker,LINE,2084173,2086723,296,1.00
ptg006774l,2084525,2084821,296,RepeatMasker,LINE,2084725,2088527,97,0.33
ptg006794l,86020,86345,325,RepeatMasker,LINE,86294,86455,52,0.16
ptg006804l,799380,799679,299,RepeatMasker,LINE,799504,800171,176,0.59
ptg006804l,1449931,1450254,323,RepeatMasker,LINE,1450068,1450160,93,0.29
ptg006822l,3484036,3484357,321,RepeatMasker,LINE,3484065,3484253,189,0.59
ptg006822l,3484036,3484357,321,RepeatMasker,LINE,3484169,3484269,101,0.31
ptg006822l,3484036,3484357,321,RepeatMasker,LINE,3484180,3484531,178,0.55
ptg006825l,2624543,2624868,325,RepeatMasker,LINE,2624852,2625198,17,0.05
ptg006830l,262187,262483,296,RepeatMasker,LINE,262296,262366,71,0.24
ptg006830l,954788,955108,320,RepeatMasker,LINE,954398,957363,320,1.00
ptg006831l,1257611,1257897,286,RepeatMasker,LINE,1257630,1259761,268,0.94
ptg006831l,2905201,2905497,296,RepeatMasker,LINE,2905335,2905980,163,0.55
ptg006842l,625658,625978,320,RepeatMasker,LINE,625676,625746,71,0.22
ptg006845l,2372542,2372826,284,RepeatMasker,LINE,2372792,2372869,35,0.12
ptg006860l,500257,500570,313,RepeatMasker,LINE,499941,501492,313,1.00
ptg006873l,3508983,3509266,283,RepeatMasker,LINE,3509029,3509095,67,0.24
ptg006873l,3508983,3509266,283,RepeatMasker,LINE,3509201,3509349,66,0.23
ptg006880l,637657,637967,310,RepeatMasker,LINE,637936,638024,32,0.10
ptg006880l,637657,637967,310,RepeatMasker,LINE,637947,641283,21,0.07
ptg006880l,1860078,1860361,283,RepeatMasker,LINE,1856014,1860138,60,0.21
ptg006890l,194801,195115,314,RepeatMasker,LINE,195054,195481,62,0.20
ptg006898l,99825,100131,306,RepeatMasker,LINE,100128,100993,4,0.01
ptg006900l,3574386,3574693,307,RepeatMasker,LINE,3571152,3574736,307,1.00
ptg006900l,16888406,16888726,320,RepeatMasker,LINE,16888613,16888678,66,0.21
ptg006902l,76647,76967,320,RepeatMasker,LINE,76671,79325,297,0.93
ptg006912l,533965,534247,282,RepeatMasker,LINE,533715,535389,282,1.00
ptg006915l,540197,540517,320,RepeatMasker,LINE,540224,540862,294,0.92
ptg006944l,273076,273403,327,RepeatMasker,LINE,273153,274775,251,0.77
ptg006945l,2063069,2063405,336,RepeatMasker,LINE,2062421,2065663,336,1.00
ptg006949l,544090,544356,266,RepeatMasker,LINE,544149,546262,208,0.78
ptg006962l,305318,305617,299,RepeatMasker,LINE,305568,306083,50,0.17
ptg006964l,334064,334375,311,RepeatMasker,LINE,334069,334142,74,0.24
ptg006981l,822025,822342,317,RepeatMasker,LINE,822202,822255,54,0.17
ptg006992l,577482,577792,310,RepeatMasker,LINE,577468,580687,310,1.00
ptg006993l,1114350,1114615,265,RepeatMasker,LINE,1114415,1115765,201,0.76
ptg007004l,2343445,2343732,287,RepeatMasker,LINE,2343453,2343549,97,0.34
ptg007004l,3530846,3531154,308,RepeatMasker,LINE,3527866,3531073,227,0.74
ptg007004l,4930851,4931133,282,RepeatMasker,LINE,4930995,4931888,139,0.49
ptg007005l,2085538,2085855,317,RepeatMasker,LINE,2085531,2085599,61,0.19
ptg007036l,446172,446475,303,RepeatMasker,LINE,446108,446202,30,0.10
ptg007040l,1127738,1128028,290,RepeatMasker,LINE,1126934,1128128,290,1.00
ptg007063l,1315512,1315803,291,RepeatMasker,LINE,1315008,1315591,79,0.27
ptg007063l,1315512,1315803,291,RepeatMasker,LINE,1315193,1315607,95,0.33
ptg007065l,1231297,1231612,315,RepeatMasker,LINE,1230270,1231494,197,0.63
ptg007065l,1231297,1231612,315,RepeatMasker,LINE,1231441,1231501,61,0.19
ptg007065l,1714080,1714376,296,RepeatMasker,LINE,1714327,1714416,50,0.17
ptg007078l,1449684,1449975,291,RepeatMasker,LINE,1447482,1451289,291,1.00
ptg007097l,221003,221321,318,RepeatMasker,LINE,218463,222295,318,1.00
ptg007099l,2534843,2535158,315,RepeatMasker,LINE,2534878,2535055,178,0.57
ptg007099l,3404820,3405115,295,RepeatMasker,LINE,3404872,3404926,55,0.19
ptg007101l,1433093,1433404,311,RepeatMasker,LINE,1433099,1433170,72,0.23
ptg007107l,1175103,1175388,285,RepeatMasker,LINE,1175095,1175152,49,0.17
ptg007121l,68554,68832,278,RepeatMasker,LINE,68252,70147,278,1.00
ptg007125l,218219,218528,309,RepeatMasker,LINE,218186,218268,49,0.16
ptg007158l,1073356,1073680,324,RepeatMasker,LINE,1073153,1073408,52,0.16
ptg007158l,1073356,1073680,324,RepeatMasker,LINE,1073539,1073583,45,0.14
ptg007174l,46518,46836,318,RepeatMasker,LINE,43853,46821,303,0.95
ptg007177l,794056,794372,316,RepeatMasker,LINE,794247,795813,126,0.40
ptg007180l,195881,196211,330,RepeatMasker,LINE,195883,199147,329,1.00
ptg007180l,335931,336247,316,RepeatMasker,LINE,335870,336318,316,1.00
ptg007186l,1031572,1031905,333,RepeatMasker,LINE,1031689,1032356,217,0.65
ptg007205l,198902,199215,313,RepeatMasker,LINE,198886,201686,313,1.00
ptg007205l,966549,966853,304,RepeatMasker,LINE,966656,966801,146,0.48
ptg007216l,2360334,2360645,311,RepeatMasker,LINE,2359109,2361336,311,1.00
ptg007229l,2423391,2423678,287,RepeatMasker,LINE,2423421,2423551,131,0.46
ptg007238l,1752732,1753038,306,RepeatMasker,LINE,1752735,1752805,71,0.23
ptg007247l,15434,15728,294,RepeatMasker,LINE,15564,15974,165,0.56
ptg007252l,770594,770900,306,RepeatMasker,LINE,769201,771022,306,1.00
ptg007287l,2021328,2021637,309,RepeatMasker,LINE,2021083,2022151,309,1.00
ptg007287l,2500452,2500744,292,RepeatMasker,LINE,2500718,2501117,27,0.09
ptg007289l,3911460,3911760,300,RepeatMasker,LINE,3911742,3911870,19,0.06
ptg007343l,82888,83206,318,RepeatMasker,LINE,83198,83627,9,0.03
ptg007376l,3632280,3632572,292,RepeatMasker,LINE,3630042,3632487,207,0.71
ptg007376l,3632280,3632572,292,RepeatMasker,LINE,3632486,3633966,87,0.30
ptg007396l,980645,980933,288,RepeatMasker,LINE,976997,981403,288,1.00
ptg007397l,506048,506354,306,RepeatMasker,LINE,506219,508077,136,0.44
ptg007424l,582363,582673,310,RepeatMasker,LINE,581618,582706,310,1.00
ptg007434l,845749,846065,316,RepeatMasker,LINE,845880,845935,56,0.18
ptg007439l,4117712,4117991,279,RepeatMasker,LINE,4117633,4118624,279,1.00
ptg007439l,7881665,7881964,299,RepeatMasker,LINE,7881241,7882212,299,1.00
ptg007439l,7881665,7881964,299,RepeatMasker,LINE,7881388,7882472,299,1.00
ptg007442l,1026728,1027035,307,RepeatMasker,LINE,1026623,1028665,307,1.00
ptg007442l,1026728,1027035,307,RepeatMasker,LINE,1026841,1029804,195,0.64
ptg007459l,770634,770974,340,RepeatMasker,LINE,770122,771735,340,1.00
ptg007464l,280826,281132,306,RepeatMasker,LINE,280837,281502,296,0.97
ptg007470l,545608,545905,297,RepeatMasker,LINE,545493,545950,297,1.00
ptg007512l,724227,724551,324,RepeatMasker,LINE,724435,724736,117,0.36
ptg007513l,112504,112801,297,RepeatMasker,LINE,112313,112609,105,0.35
ptg007516l,3051706,3052023,317,RepeatMasker,LINE,3050429,3052214,317,1.00
ptg007516l,3051706,3052023,317,RepeatMasker,LINE,3051565,3052793,317,1.00
ptg007516l,3051706,3052023,317,RepeatMasker,LINE,3051706,3052697,317,1.00
ptg007538l,269855,270174,319,RepeatMasker,LINE,269819,269971,116,0.36
ptg007538l,269855,270174,319,RepeatMasker,LINE,270084,270150,67,0.21
ptg007541l,1126747,1127024,277,RepeatMasker,LINE,1126582,1128074,277,1.00
ptg007545l,5893337,5893649,312,RepeatMasker,LINE,5893368,5893435,68,0.22
ptg007551l,1510121,1510403,282,RepeatMasker,LINE,1509183,1510693,282,1.00
ptg007552l,545234,545517,283,RepeatMasker,LINE,544981,545950,283,1.00
ptg007570l,448058,448370,312,RepeatMasker,LINE,447843,448317,259,0.83
ptg007603l,622137,622481,344,RepeatMasker,LINE,622359,622470,112,0.33
ptg007615l,719229,719540,311,RepeatMasker,LINE,719387,719862,154,0.50
ptg007633l,1671952,1672276,324,RepeatMasker,LINE,1672027,1672084,58,0.18
ptg007640l,44068,44395,327,RepeatMasker,LINE,44377,44665,19,0.06
ptg007645l,1166474,1166758,284,RepeatMasker,LINE,1166498,1166637,140,0.49
ptg007656l,133799,134126,327,RepeatMasker,LINE,133807,133893,87,0.27
ptg007656l,133799,134126,327,RepeatMasker,LINE,134070,134269,57,0.17
ptg007661l,1783866,1784161,295,RepeatMasker,LINE,1782731,1784592,295,1.00
ptg007661l,2739114,2739442,328,RepeatMasker,LINE,2738381,2740479,328,1.00
ptg007668l,2863776,2864099,323,RepeatMasker,LINE,2863857,2864634,243,0.75
ptg007668l,3199507,3199810,303,RepeatMasker,LINE,3199548,3199694,147,0.49
ptg007668l,4206124,4206438,314,RepeatMasker,LINE,4206197,4206242,46,0.15
ptg007678l,730247,730549,302,RepeatMasker,LINE,728577,730662,302,1.00
ptg007715l,713771,714074,303,RepeatMasker,LINE,713904,714382,171,0.56
ptg007717l,1426133,1426425,292,RepeatMasker,LINE,1426319,1426989,107,0.37
ptg007729l,1197827,1198105,278,RepeatMasker,LINE,1197877,1197954,78,0.28
ptg007763l,4722099,4722414,315,RepeatMasker,LINE,4722386,4722817,29,0.09
ptg007781l,1685237,1685533,296,RepeatMasker,LINE,1685035,1685363,126,0.43
ptg007781l,1685237,1685533,296,RepeatMasker,LINE,1685374,1686988,160,0.54
ptg007781l,1685237,1685533,296,RepeatMasker,LINE,1685374,1687356,160,0.54
ptg007795l,865505,865783,278,RepeatMasker,LINE,865431,865535,30,0.11
ptg007802l,762783,763095,312,RepeatMasker,LINE,762096,762984,201,0.64
ptg007819l,816490,816785,295,RepeatMasker,LINE,816561,817244,225,0.76
ptg007824l,1202658,1202986,328,RepeatMasker,LINE,1202346,1204413,328,1.00
ptg007827l,351844,352139,295,RepeatMasker,LINE,351723,351960,116,0.39
ptg007827l,1362722,1363033,311,RepeatMasker,LINE,1362441,1362857,135,0.43
ptg007831l,2799721,2800011,290,RepeatMasker,LINE,2798835,2799935,214,0.74
ptg007847l,1497374,1497656,282,RepeatMasker,LINE,1497417,1499897,240,0.85
ptg007856l,855251,855576,325,RepeatMasker,LINE,855495,855901,82,0.25
ptg007858l,2552062,2552341,279,RepeatMasker,LINE,2552175,2552248,74,0.27
ptg007858l,2884230,2884491,261,RepeatMasker,LINE,2883674,2885244,261,1.00
ptg007858l,2884230,2884491,261,RepeatMasker,LINE,2883484,2884511,261,1.00
ptg007910l,929779,930062,283,RepeatMasker,LINE,929852,932555,211,0.75
ptg007910l,929779,930062,283,RepeatMasker,LINE,929862,933031,201,0.71
ptg007934l,1709732,1710024,292,RepeatMasker,LINE,1709588,1710018,286,0.98
ptg007934l,1709732,1710024,292,RepeatMasker,LINE,1709959,1710120,66,0.23
ptg007944l,431200,431502,302,RepeatMasker,LINE,431399,431444,46,0.15
ptg007966l,1825557,1825858,301,RepeatMasker,LINE,1825388,1825624,67,0.22
ptg007966l,1825557,1825858,301,RepeatMasker,LINE,1825392,1825683,126,0.42
ptg007979l,1099236,1099519,283,RepeatMasker,LINE,1099155,1099258,22,0.08
ptg007979l,1377698,1377987,289,RepeatMasker,LINE,1377760,1380898,228,0.79
ptg007982l,1733553,1733887,334,RepeatMasker,LINE,1733581,1733651,71,0.21
ptg007986l,672303,672630,327,RepeatMasker,LINE,672463,673297,168,0.51
ptg008006l,787099,787428,329,RepeatMasker,LINE,786931,790107,329,1.00
ptg008036l,449367,449642,275,RepeatMasker,LINE,449315,450208,275,1.00
ptg008036l,449367,449642,275,RepeatMasker,LINE,449519,450221,124,0.45
ptg008043l,1449718,1450007,289,RepeatMasker,LINE,1449865,1449909,45,0.16
ptg008062l,466269,466590,321,RepeatMasker,LINE,466360,467449,231,0.72
ptg008063l,3742765,3743072,307,RepeatMasker,LINE,3742408,3742854,89,0.29
ptg008063l,3844213,3844506,293,RepeatMasker,LINE,3844363,3844449,87,0.30
ptg008067l,1357364,1357666,302,RepeatMasker,LINE,1357606,1358127,61,0.20
ptg008075l,1992822,1993144,322,RepeatMasker,LINE,1992481,1993309,322,1.00
ptg008088l,403085,403372,287,RepeatMasker,LINE,403348,403510,25,0.09
ptg008088l,1333432,1333746,314,RepeatMasker,LINE,1333724,1334105,23,0.07
ptg008090l,6204643,6204966,323,RepeatMasker,LINE,6202067,6205293,323,1.00
ptg008091l,2391410,2391713,303,RepeatMasker,LINE,2391639,2391834,75,0.25
ptg008099l,2084215,2084521,306,RepeatMasker,LINE,2082411,2084490,275,0.90
ptg008106l,1241645,1241929,284,RepeatMasker,LINE,1241237,1241778,133,0.47
ptg008107l,2368677,2368999,322,RepeatMasker,LINE,2367856,2368770,93,0.29
ptg008107l,2368677,2368999,322,RepeatMasker,LINE,2368102,2369324,322,1.00
ptg008115l,789716,790005,289,RepeatMasker,LINE,788294,789749,33,0.11
ptg008122l,1222775,1223091,316,RepeatMasker,LINE,1222521,1222789,14,0.04
ptg008132l,2825922,2826246,324,RepeatMasker,LINE,2825626,2827676,324,1.00
ptg008142l,1352627,1352919,292,RepeatMasker,LINE,1352691,1353242,229,0.78
ptg008172l,436057,436340,283,RepeatMasker,LINE,436278,436715,63,0.22
ptg008183l,505348,505662,314,RepeatMasker,LINE,505320,506471,314,1.00
ptg008191l,372396,372684,288,RepeatMasker,LINE,371625,372781,288,1.00
ptg008193l,348970,349275,305,RepeatMasker,LINE,349153,349436,123,0.40
ptg008203l,929936,930229,293,RepeatMasker,LINE,930119,930464,111,0.38
ptg008213l,496004,496327,323,RepeatMasker,LINE,495992,496088,84,0.26
ptg008216l,1306372,1306655,283,RepeatMasker,LINE,1306404,1306479,76,0.27
ptg008220l,991542,991866,324,RepeatMasker,LINE,991556,991618,63,0.19
ptg008242l,1465615,1465930,315,RepeatMasker,LINE,1465358,1465810,195,0.62
ptg008252l,1096131,1096418,287,RepeatMasker,LINE,1096161,1096227,67,0.23
ptg008253l,630857,631136,279,RepeatMasker,LINE,629735,631974,279,1.00
ptg008253l,630857,631136,279,RepeatMasker,LINE,630795,633561,279,1.00
ptg008273l,3127427,3127740,313,RepeatMasker,LINE,3127683,3127823,58,0.19
ptg008305l,3317902,3318215,313,RepeatMasker,LINE,3318107,3318200,94,0.30
ptg008309l,1460244,1460523,279,RepeatMasker,LINE,1460234,1460672,279,1.00
ptg008319l,682238,682537,299,RepeatMasker,LINE,682421,682464,44,0.15
ptg008338l,539335,539638,303,RepeatMasker,LINE,535959,539704,303,1.00
ptg008347l,311175,311452,277,RepeatMasker,LINE,311332,311845,121,0.44
ptg008353l,2905,3197,292,RepeatMasker,LINE,2912,3336,286,0.98
ptg008354l,149406,149693,287,RepeatMasker,LINE,149240,149453,47,0.16
ptg008357l,90527,90832,305,RepeatMasker,LINE,90143,92619,305,1.00
ptg008389l,2028009,2028290,281,RepeatMasker,LINE,2027591,2028597,281,1.00
ptg008398l,214126,214408,282,RepeatMasker,LINE,214165,214636,244,0.87
ptg008413l,2546215,2546528,313,RepeatMasker,LINE,2546344,2546952,185,0.59
ptg008422l,218211,218524,313,RepeatMasker,LINE,218190,218260,49,0.16
ptg008428l,1487329,1487643,314,RepeatMasker,LINE,1487425,1489881,219,0.70
ptg008435l,2984941,2985252,311,RepeatMasker,LINE,2985038,2985800,215,0.69
ptg008459l,629795,630108,313,RepeatMasker,LINE,630094,630189,15,0.05
ptg008467l,1287461,1287761,300,RepeatMasker,LINE,1287388,1287557,96,0.32
ptg008487l,161974,162244,270,RepeatMasker,LINE,162016,162146,131,0.49
ptg008492l,2322490,2322791,301,RepeatMasker,LINE,2322231,2325461,301,1.00
ptg008502l,2200829,2201134,305,RepeatMasker,LINE,2200476,2201290,305,1.00
ptg008503l,406025,406322,297,RepeatMasker,LINE,406025,406100,75,0.25
ptg008517l,58951,59246,295,RepeatMasker,LINE,58674,59059,108,0.37
ptg008517l,58951,59246,295,RepeatMasker,LINE,58985,59069,85,0.29
ptg008525l,1077744,1078080,336,RepeatMasker,LINE,1077061,1080325,336,1.00
ptg008526l,750048,750372,324,RepeatMasker,LINE,750074,753134,299,0.92
ptg008539l,1667397,1667654,257,RepeatMasker,LINE,1667432,1667774,223,0.87
ptg008554l,3784138,3784416,278,RepeatMasker,LINE,3784102,3787207,278,1.00
ptg008554l,3784138,3784416,278,RepeatMasker,LINE,3784130,3786727,278,1.00
ptg008562l,1018318,1018637,319,RepeatMasker,LINE,1018213,1019398,319,1.00
ptg008563l,330213,330505,292,RepeatMasker,LINE,330489,330701,17,0.06
ptg008567l,1398042,1398371,329,RepeatMasker,LINE,1395272,1398113,71,0.22
ptg008570l,337122,337433,311,RepeatMasker,LINE,336668,337246,124,0.40
ptg008570l,527430,527721,291,RepeatMasker,LINE,527560,527630,71,0.24
ptg008572l,481097,481387,290,RepeatMasker,LINE,480776,481287,190,0.66
ptg008590l,972528,972868,340,RepeatMasker,LINE,972737,976021,132,0.39
ptg008593l,1436447,1436746,299,RepeatMasker,LINE,1435574,1437535,299,1.00
ptg008594l,149620,149931,311,RepeatMasker,LINE,149788,152160,144,0.46
ptg008607l,1378793,1379080,287,RepeatMasker,LINE,1378860,1382793,221,0.77
ptg008642l,81912,82218,306,RepeatMasker,LINE,78994,82378,306,1.00
ptg008649l,208466,208778,312,RepeatMasker,LINE,208204,208603,137,0.44
ptg008649l,2562082,2562387,305,RepeatMasker,LINE,2562098,2562193,96,0.31
ptg008666l,521393,521708,315,RepeatMasker,LINE,521443,521520,78,0.25
ptg008681l,1298137,1298412,275,RepeatMasker,LINE,1297784,1298148,11,0.04
ptg008683l,1042381,1042674,293,RepeatMasker,LINE,1042505,1042554,50,0.17
ptg008688l,2266748,2267083,335,RepeatMasker,LINE,2266751,2266800,50,0.15
ptg008696l,1464387,1464704,317,RepeatMasker,LINE,1464443,1464509,67,0.21
ptg008700l,2987015,2987312,297,RepeatMasker,LINE,2985109,2987109,94,0.32
ptg008700l,2987015,2987312,297,RepeatMasker,LINE,2987065,2987127,63,0.21
ptg008721l,2811387,2811693,306,RepeatMasker,LINE,2811483,2812971,211,0.69
ptg008726l,617318,617616,298,RepeatMasker,LINE,617280,617766,298,1.00
ptg008727l,3445585,3445903,318,RepeatMasker,LINE,3445727,3445806,80,0.25
ptg008741l,2583797,2584108,311,RepeatMasker,LINE,2583874,2584176,235,0.76
ptg008751l,518191,518502,311,RepeatMasker,LINE,517958,518576,311,1.00
ptg008760l,2037443,2037757,314,RepeatMasker,LINE,2037450,2037550,101,0.32
ptg008760l,2037443,2037757,314,RepeatMasker,LINE,2037539,2037785,219,0.70
ptg008777l,1649663,1649953,290,RepeatMasker,LINE,1648779,1650294,290,1.00
ptg008789l,1889802,1890119,317,RepeatMasker,LINE,1889976,1890171,144,0.45
ptg008789l,1889802,1890119,317,RepeatMasker,LINE,1890050,1890189,70,0.22
ptg008795l,1243170,1243479,309,RepeatMasker,LINE,1243263,1243303,41,0.13
ptg008806l,2289768,2290092,324,RepeatMasker,LINE,2289286,2289988,220,0.68
ptg008806l,2289768,2290092,324,RepeatMasker,LINE,2289399,2290552,324,1.00
ptg008818l,243258,243570,312,RepeatMasker,LINE,243331,245813,240,0.77
ptg008827l,1072354,1072647,293,RepeatMasker,LINE,1072330,1072660,293,1.00
ptg008830l,609401,609729,328,RepeatMasker,LINE,609250,611220,328,1.00
ptg008830l,609401,609729,328,RepeatMasker,LINE,609372,611000,328,1.00
ptg008835l,1651955,1652284,329,RepeatMasker,LINE,1651734,1654954,329,1.00
ptg008836l,1039423,1039713,290,RepeatMasker,LINE,1039438,1039498,61,0.21
ptg008836l,1039423,1039713,290,RepeatMasker,LINE,1039622,1039792,92,0.32
ptg008843l,717071,717396,325,RepeatMasker,LINE,715259,717306,235,0.72
ptg008843l,717071,717396,325,RepeatMasker,LINE,717310,717354,45,0.14
ptg008854l,1742202,1742503,301,RepeatMasker,LINE,1742464,1745625,40,0.13
ptg008854l,2115088,2115376,288,RepeatMasker,LINE,2113883,2115963,288,1.00
ptg008883l,1419869,1420170,301,RepeatMasker,LINE,1420155,1420198,16,0.05
ptg008902l,1946324,1946619,295,RepeatMasker,LINE,1946349,1946412,64,0.22
ptg008905l,39277,39584,307,RepeatMasker,LINE,39446,39525,80,0.26
ptg008912l,289418,289720,302,RepeatMasker,LINE,289397,289467,49,0.16
ptg008913l,656717,657003,286,RepeatMasker,LINE,656619,658884,286,1.00
ptg008917l,1573444,1573772,328,RepeatMasker,LINE,1573678,1573737,60,0.18
ptg008919l,402711,403035,324,RepeatMasker,LINE,402718,402773,56,0.17
ptg008936l,227391,227695,304,RepeatMasker,LINE,225138,227440,49,0.16
ptg008936l,227391,227695,304,RepeatMasker,LINE,227541,227584,44,0.14
ptg008963l,300152,300477,325,RepeatMasker,LINE,300113,300767,325,1.00
ptg008968l,698391,698692,301,RepeatMasker,LINE,698265,698903,301,1.00
ptg008969l,2025063,2025360,297,RepeatMasker,LINE,2025072,2025110,39,0.13
ptg008969l,2025063,2025360,297,RepeatMasker,LINE,2025272,2025998,89,0.30
ptg008970l,1104783,1105085,302,RepeatMasker,LINE,1104517,1104961,178,0.59
ptg008972l,271026,271345,319,RepeatMasker,LINE,270922,271152,126,0.39
ptg008992l,3564053,3564358,305,RepeatMasker,LINE,3564210,3566134,149,0.49
ptg008992l,4173117,4173440,323,RepeatMasker,LINE,4171181,4173782,323,1.00
ptg008999l,1371202,1371493,291,RepeatMasker,LINE,1370203,1372038,291,1.00
ptg009001l,674406,674681,275,RepeatMasker,LINE,674553,674836,129,0.47
ptg009002l,860975,861273,298,RepeatMasker,LINE,861103,861236,134,0.45
ptg009012l,2554278,2554575,297,RepeatMasker,LINE,2554471,2554573,103,0.35
ptg009012l,2554278,2554575,297,RepeatMasker,LINE,2554513,2554586,63,0.21
ptg009012l,3023061,3023389,328,RepeatMasker,LINE,3023113,3023150,38,0.12
ptg009012l,3023061,3023389,328,RepeatMasker,LINE,3023263,3023668,127,0.39
ptg009019l,987944,988263,319,RepeatMasker,LINE,988134,988364,130,0.41
ptg009019l,1367200,1367537,337,RepeatMasker,LINE,1366026,1367406,206,0.61
ptg009029l,864956,865255,299,RepeatMasker,LINE,865107,865732,149,0.50
ptg009029l,1161070,1161375,305,RepeatMasker,LINE,1161220,1161335,116,0.38
ptg009047l,1180053,1180328,275,RepeatMasker,LINE,1180016,1180659,275,1.00
ptg009047l,1180053,1180328,275,RepeatMasker,LINE,1180016,1180760,275,1.00
ptg009054l,87412,87731,319,RepeatMasker,LINE,85590,88419,319,1.00
ptg009080l,465386,465686,300,RepeatMasker,LINE,465399,465455,57,0.19
ptg009104l,1740795,1741088,293,RepeatMasker,LINE,1740846,1740894,49,0.17
ptg009104l,1740795,1741088,293,RepeatMasker,LINE,1740846,1740905,60,0.20
ptg009104l,2221602,2221876,274,RepeatMasker,LINE,2221083,2221731,129,0.47
ptg009111l,5211,5503,292,RepeatMasker,LINE,5291,5825,213,0.73
ptg009143l,1519321,1519622,301,RepeatMasker,LINE,1519596,1519641,27,0.09
ptg009152l,148289,148599,310,RepeatMasker,LINE,148429,148531,103,0.33
ptg009152l,148289,148599,310,RepeatMasker,LINE,148574,150227,26,0.08
ptg009155l,586724,587036,312,RepeatMasker,LINE,586744,586824,81,0.26
ptg009155l,586724,587036,312,RepeatMasker,LINE,586842,586888,47,0.15
ptg009184l,636407,636737,330,RepeatMasker,LINE,636422,636597,176,0.53
ptg009186l,656004,656283,279,RepeatMasker,LINE,656200,656294,84,0.30
ptg009193l,1526762,1527087,325,RepeatMasker,LINE,1525642,1527381,325,1.00
ptg009208l,677264,677565,301,RepeatMasker,LINE,677166,677373,109,0.36
ptg009220l,338102,338383,281,RepeatMasker,LINE,338189,338643,195,0.69
ptg009224l,3928313,3928625,312,RepeatMasker,LINE,3928318,3928388,71,0.23
ptg009231l,512200,512512,312,RepeatMasker,LINE,512078,512243,43,0.14
ptg009231l,512200,512512,312,RepeatMasker,LINE,512330,512410,81,0.26
ptg009243l,434302,434599,297,RepeatMasker,LINE,434481,434931,119,0.40
ptg009271l,926432,926747,315,RepeatMasker,LINE,926441,926511,71,0.23
ptg009276l,61064,61388,324,RepeatMasker,LINE,61349,64529,40,0.12
ptg009285l,884815,885098,283,RepeatMasker,LINE,883464,885043,228,0.81
ptg009298l,601059,601382,323,RepeatMasker,LINE,601015,601286,227,0.70
ptg009298l,1010776,1011090,314,RepeatMasker,LINE,1010108,1010981,205,0.65
ptg009300l,1976040,1976369,329,RepeatMasker,LINE,1975778,1979059,329,1.00
ptg009323l,2717882,2718194,312,RepeatMasker,LINE,2717055,2718081,199,0.64
ptg009328l,1378805,1379095,290,RepeatMasker,LINE,1379062,1379195,34,0.12
ptg009328l,1378805,1379095,290,RepeatMasker,LINE,1379063,1379162,33,0.11
ptg009342l,100861,101167,306,RepeatMasker,LINE,100849,100962,101,0.33
ptg009349l,623294,623588,294,RepeatMasker,LINE,623276,623477,183,0.62
ptg009352l,1190795,1191125,330,RepeatMasker,LINE,1190367,1190983,188,0.57
ptg009352l,1190795,1191125,330,RepeatMasker,LINE,1190427,1190900,105,0.32
ptg009357l,590371,590704,333,RepeatMasker,LINE,589716,592960,333,1.00
ptg009361l,517645,517966,321,RepeatMasker,LINE,517853,517931,79,0.25
ptg009361l,851896,852199,303,RepeatMasker,LINE,851829,851933,37,0.12
ptg009393l,1982178,1982480,302,RepeatMasker,LINE,1982214,1982279,66,0.22
ptg009393l,1982178,1982480,302,RepeatMasker,LINE,1982292,1983483,189,0.63
ptg009402l,126814,127095,281,RepeatMasker,LINE,126458,128817,281,1.00
ptg009405l,845034,845327,293,RepeatMasker,LINE,845225,845303,79,0.27
ptg009423l,496880,497166,286,RepeatMasker,LINE,495961,497910,286,1.00
ptg009433l,554013,554289,276,RepeatMasker,LINE,554164,555417,126,0.46
ptg009434l,271774,272025,251,RepeatMasker,LINE,271720,271831,57,0.23
ptg009445l,1468645,1468909,264,RepeatMasker,LINE,1468835,1469577,75,0.28
ptg009445l,1468645,1468909,264,RepeatMasker,LINE,1468838,1469724,72,0.27
ptg009451l,203368,203680,312,RepeatMasker,LINE,203651,204095,30,0.10
ptg009451l,1460106,1460408,302,RepeatMasker,LINE,1460140,1460282,143,0.47
ptg009478l,871451,871778,327,RepeatMasker,LINE,871186,874463,327,1.00
ptg009482l,341497,341824,327,RepeatMasker,LINE,341394,341531,34,0.10
ptg009508l,134110,134440,330,RepeatMasker,LINE,133309,134123,13,0.04
ptg009544l,870103,870413,310,RepeatMasker,LINE,870082,870152,49,0.16
ptg009546l,3390868,3391179,311,RepeatMasker,LINE,3390968,3391090,123,0.40
ptg009546l,3390868,3391179,311,RepeatMasker,LINE,3391090,3391217,90,0.29
ptg009552l,499721,500016,295,RepeatMasker,LINE,499887,500049,130,0.44
ptg009587l,604449,604751,302,RepeatMasker,LINE,604403,604473,24,0.08
ptg009587l,604449,604751,302,RepeatMasker,LINE,604668,604838,84,0.28
ptg009592l,1999025,1999315,290,RepeatMasker,LINE,1998722,2000186,290,1.00
ptg009619l,83026,83343,317,RepeatMasker,LINE,83206,83306,101,0.32
ptg009619l,2645117,2645396,279,RepeatMasker,LINE,2644920,2646635,279,1.00
ptg009627l,938832,939114,282,RepeatMasker,LINE,938541,939909,282,1.00
ptg009627l,940962,941274,312,RepeatMasker,LINE,940994,941132,139,0.45
ptg009627l,1057047,1057374,327,RepeatMasker,LINE,1057233,1058375,142,0.43
ptg009633l,2003745,2004048,303,RepeatMasker,LINE,2001195,2004103,303,1.00
ptg009686l,484737,485059,322,RepeatMasker,LINE,484260,484879,142,0.44
ptg009692l,913834,914109,275,RepeatMasker,LINE,913416,913994,160,0.58
ptg009692l,913834,914109,275,RepeatMasker,LINE,913993,914171,117,0.43
ptg009693l,863119,863398,279,RepeatMasker,LINE,862911,863290,171,0.61
ptg009698l,1946611,1946883,272,RepeatMasker,LINE,1946362,1946806,195,0.72
ptg009698l,3028728,3029053,325,RepeatMasker,LINE,3029026,3029591,28,0.09
ptg009701l,1336092,1336383,291,RepeatMasker,LINE,1336306,1336396,78,0.27
ptg009714l,333179,333502,323,RepeatMasker,LINE,333349,333375,27,0.08
ptg009719l,968100,968391,291,RepeatMasker,LINE,968192,968257,66,0.23
ptg009728l,1297810,1298111,301,RepeatMasker,LINE,1297769,1297948,138,0.46
ptg009747l,1987187,1987519,332,RepeatMasker,LINE,1987417,1990411,103,0.31
ptg009775l,2585910,2586185,275,RepeatMasker,LINE,2585917,2588491,269,0.98
ptg009778l,218976,219302,326,RepeatMasker,LINE,216177,219009,33,0.10
ptg009791l,1222193,1222487,294,RepeatMasker,LINE,1221732,1223181,294,1.00
ptg009793l,2696470,2696784,314,RepeatMasker,LINE,2696487,2699186,298,0.95
ptg009797l,1317242,1317567,325,RepeatMasker,LINE,1316864,1317298,56,0.17
ptg009797l,1317242,1317567,325,RepeatMasker,LINE,1316928,1317298,56,0.17
ptg009815l,659809,660105,296,RepeatMasker,LINE,659474,659828,19,0.06
ptg009842l,722361,722682,321,RepeatMasker,LINE,722289,722445,84,0.26
ptg009847l,285059,285390,331,RepeatMasker,LINE,285215,285299,85,0.26
ptg009862l,1178254,1178582,328,RepeatMasker,LINE,1177739,1179208,328,1.00
ptg009877l,139162,139437,275,RepeatMasker,LINE,138900,139883,275,1.00
ptg009877l,139162,139437,275,RepeatMasker,LINE,139060,139883,275,1.00
ptg009887l,1929772,1930089,317,RepeatMasker,LINE,1928499,1932241,317,1.00
ptg009898l,3522830,3523146,316,RepeatMasker,LINE,3523012,3523260,135,0.43
ptg009913l,731067,731382,315,RepeatMasker,LINE,731165,731298,134,0.43
ptg009918l,948633,948937,304,RepeatMasker,LINE,948512,950014,304,1.00
ptg009919l,2156271,2156540,269,RepeatMasker,LINE,2156137,2156407,136,0.51
ptg009919l,2156271,2156540,269,RepeatMasker,LINE,2156351,2156663,190,0.71
ptg009919l,2325242,2325577,335,RepeatMasker,LINE,2325491,2325651,87,0.26
ptg009928l,1389516,1389840,324,RepeatMasker,LINE,1388863,1390008,324,1.00
ptg009934l,122081,122388,307,RepeatMasker,LINE,122186,122307,122,0.40
ptg009934l,122081,122388,307,RepeatMasker,LINE,122313,122448,76,0.25
ptg009945l,1603883,1604204,321,RepeatMasker,LINE,1604122,1604339,83,0.26
ptg009958l,2084547,2084825,278,RepeatMasker,LINE,2084589,2084900,237,0.85
ptg009979l,1214237,1214507,270,RepeatMasker,LINE,1214284,1214337,54,0.20
ptg009979l,2106742,2107047,305,RepeatMasker,LINE,2104109,2106884,142,0.47
ptg009984l,3716198,3716523,325,RepeatMasker,LINE,3716034,3717489,325,1.00
ptg009988l,1516070,1516368,298,RepeatMasker,LINE,1515017,1516212,142,0.48
ptg009988l,1516070,1516368,298,RepeatMasker,LINE,1516290,1516960,79,0.27
ptg009989l,1188649,1188917,268,RepeatMasker,LINE,1188595,1188668,19,0.07
ptg009998l,3119737,3120055,318,RepeatMasker,LINE,3119993,3120073,63,0.20
ptg010010l,357592,357879,287,RepeatMasker,LINE,357835,361011,45,0.16
ptg010016l,229119,229413,294,RepeatMasker,LINE,229217,229275,59,0.20
ptg010020l,584104,584384,280,RepeatMasker,LINE,584275,584335,61,0.22
ptg010028l,828306,828637,331,RepeatMasker,LINE,828535,828695,103,0.31
ptg010040l,410566,410823,257,RepeatMasker,LINE,410573,410618,46,0.18
ptg010040l,567663,567997,334,RepeatMasker,LINE,567489,568629,334,1.00
ptg010085l,2794430,2794719,289,RepeatMasker,LINE,2793822,2794647,217,0.75
ptg010086l,1055782,1056073,291,RepeatMasker,LINE,1055805,1056236,269,0.92
ptg010086l,1055782,1056073,291,RepeatMasker,LINE,1055915,1056235,159,0.55
ptg010086l,1055782,1056073,291,RepeatMasker,LINE,1056073,1056251,1,0.00
ptg010092l,210874,211147,273,RepeatMasker,LINE,210594,211180,273,1.00
ptg010096l,168829,169116,287,RepeatMasker,LINE,168786,171911,287,1.00
ptg010096l,168829,169116,287,RepeatMasker,LINE,168823,171431,287,1.00
ptg010097l,544790,545101,311,RepeatMasker,LINE,545073,545423,29,0.09
ptg010123l,527218,527530,312,RepeatMasker,LINE,527121,527430,212,0.68
ptg010147l,526359,526666,307,RepeatMasker,LINE,526572,526928,95,0.31
ptg010147l,526359,526666,307,RepeatMasker,LINE,526629,527175,38,0.12
ptg010172l,1585655,1585949,294,RepeatMasker,LINE,1585927,1586171,23,0.08
ptg010213l,1344004,1344310,306,RepeatMasker,LINE,1343628,1344352,306,1.00
ptg010231l,2398609,2398938,329,RepeatMasker,LINE,2398541,2400242,329,1.00
ptg010231l,2564525,2564843,318,RepeatMasker,LINE,2564535,2564593,59,0.19
ptg010240l,519026,519329,303,RepeatMasker,LINE,518681,519817,303,1.00
ptg010242l,93452,93729,277,RepeatMasker,LINE,93645,94084,85,0.31
ptg010246l,106293,106617,324,RepeatMasker,LINE,106458,106545,88,0.27
ptg010250l,428502,428795,293,RepeatMasker,LINE,427132,428591,89,0.30
ptg010250l,542983,543311,328,RepeatMasker,LINE,542712,545973,328,1.00
ptg010251l,1805541,1805825,284,RepeatMasker,LINE,1805437,1806361,284,1.00
ptg010251l,4367455,4367767,312,RepeatMasker,LINE,4367589,4370154,179,0.57
ptg010267l,491504,491830,326,RepeatMasker,LINE,491727,493744,104,0.32
ptg010272l,609770,610042,272,RepeatMasker,LINE,609871,610534,172,0.63
ptg010272l,3557534,3557870,336,RepeatMasker,LINE,3557870,3558916,1,0.00
ptg010277l,501667,501966,299,RepeatMasker,LINE,501121,501704,37,0.12
ptg010300l,129169,129474,305,RepeatMasker,LINE,129236,129351,116,0.38
ptg010321l,66536,66808,272,RepeatMasker,LINE,66679,66940,130,0.48
ptg010322l,1857319,1857619,300,RepeatMasker,LINE,1857286,1857678,300,1.00
ptg010329l,209063,209343,280,RepeatMasker,LINE,209109,209168,60,0.21
ptg010336l,1242712,1243003,291,RepeatMasker,LINE,1242666,1245926,291,1.00
ptg010361l,1239387,1239665,278,RepeatMasker,LINE,1239085,1242827,278,1.00
ptg010365l,164468,164749,281,RepeatMasker,LINE,164216,164544,76,0.27
ptg010368l,243809,244131,322,RepeatMasker,LINE,243908,244461,224,0.70
ptg010377l,560517,560825,308,RepeatMasker,LINE,560152,560759,242,0.79
ptg010377l,560517,560825,308,RepeatMasker,LINE,560280,560755,238,0.77
ptg010388l,152976,153293,317,RepeatMasker,LINE,153202,153576,92,0.29
ptg010398l,1566045,1566367,322,RepeatMasker,LINE,1566067,1566128,62,0.19
ptg010411l,539134,539455,321,RepeatMasker,LINE,539271,539336,66,0.21
ptg010415l,4466630,4466941,311,RepeatMasker,LINE,4466575,4466661,31,0.10
ptg010416l,951224,951526,302,RepeatMasker,LINE,951015,951464,240,0.79
ptg010431l,186046,186328,282,RepeatMasker,LINE,186282,186362,47,0.17
ptg010435l,1887151,1887437,286,RepeatMasker,LINE,1887199,1887266,68,0.24
ptg010435l,1887151,1887437,286,RepeatMasker,LINE,1887372,1887519,66,0.23
ptg010451l,39135,39444,309,RepeatMasker,LINE,39308,39364,57,0.18
ptg010451l,39135,39444,309,RepeatMasker,LINE,39369,39433,65,0.21
ptg010468l,165726,166028,302,RepeatMasker,LINE,164571,166072,302,1.00
ptg010476l,126036,126339,303,RepeatMasker,LINE,126095,126318,224,0.74
ptg010484l,639005,639322,317,RepeatMasker,LINE,638866,639368,317,1.00
ptg010500l,1178127,1178402,275,RepeatMasker,LINE,1178028,1178164,37,0.13
ptg010512l,364540,364835,295,RepeatMasker,LINE,364761,365344,75,0.25
ptg010520l,548131,548434,303,RepeatMasker,LINE,548093,548337,206,0.68
ptg010532l,1340314,1340615,301,RepeatMasker,LINE,1340527,1342882,89,0.30
ptg010548l,2275308,2275624,316,RepeatMasker,LINE,2275283,2277213,316,1.00
ptg010550l,637741,638049,308,RepeatMasker,LINE,637984,638119,66,0.21
ptg010563l,76264,76604,340,RepeatMasker,LINE,73077,76654,340,1.00
ptg010568l,1210215,1210521,306,RepeatMasker,LINE,1207237,1211035,306,1.00
ptg010585l,3232976,3233284,308,RepeatMasker,LINE,3233192,3233846,93,0.30
ptg010625l,2043871,2044200,329,RepeatMasker,LINE,2044036,2044200,165,0.50
ptg010637l,927503,927804,301,RepeatMasker,LINE,927568,927695,128,0.43
ptg010651l,25915,26205,290,RepeatMasker,LINE,26124,27215,82,0.28
ptg010662l,1057719,1058028,309,RepeatMasker,LINE,1057811,1058526,218,0.71
ptg010673l,549358,549680,322,RepeatMasker,LINE,549442,549505,64,0.20
ptg010676l,885430,885719,289,RepeatMasker,LINE,885514,885677,164,0.57
ptg010749l,947117,947440,323,RepeatMasker,LINE,946299,949396,323,1.00
ptg010749l,947117,947440,323,RepeatMasker,LINE,946299,950068,323,1.00
ptg010757l,572342,572627,285,RepeatMasker,LINE,572320,572391,49,0.17
ptg010766l,193791,194106,315,RepeatMasker,LINE,193626,194071,280,0.89
ptg010773l,3789309,3789638,329,RepeatMasker,LINE,3789044,3792333,329,1.00
ptg010792l,214635,214911,276,RepeatMasker,LINE,214538,214882,247,0.89
ptg010796l,1029595,1029907,312,RepeatMasker,LINE,1029521,1030006,312,1.00
ptg010798l,1154245,1154526,281,RepeatMasker,LINE,1154196,1154354,109,0.39
ptg010809l,806851,807141,290,RepeatMasker,LINE,806975,807030,56,0.19
ptg010814l,336962,337227,265,RepeatMasker,LINE,337214,337368,14,0.05
ptg010814l,1324462,1324768,306,RepeatMasker,LINE,1324716,1325062,53,0.17
ptg010821l,188155,188477,322,RepeatMasker,LINE,188204,188265,62,0.19
ptg010837l,69646,69925,279,RepeatMasker,LINE,69331,71096,279,1.00
ptg010847l,260148,260473,325,RepeatMasker,LINE,257579,260824,325,1.00
ptg010871l,613664,613988,324,RepeatMasker,LINE,613891,614265,98,0.30
ptg010879l,6368179,6368487,308,RepeatMasker,LINE,6367220,6369298,308,1.00
ptg010880l,276101,276437,336,RepeatMasker,LINE,275427,278695,336,1.00
ptg010899l,2445640,2445958,318,RepeatMasker,LINE,2445804,2445873,70,0.22
ptg010905l,1366603,1366908,305,RepeatMasker,LINE,1366652,1366773,122,0.40
ptg010905l,1545010,1545323,313,RepeatMasker,LINE,1544988,1546087,313,1.00
ptg010917l,787869,788187,318,RepeatMasker,LINE,788079,788703,109,0.34
ptg010918l,660716,660991,275,RepeatMasker,LINE,660613,661052,275,1.00
ptg010918l,660716,660991,275,RepeatMasker,LINE,660679,661050,275,1.00
ptg010952l,1290843,1291138,295,RepeatMasker,LINE,1290198,1290919,76,0.26
ptg010953l,326169,326477,308,RepeatMasker,LINE,324220,326406,237,0.77
ptg010964l,401100,401422,322,RepeatMasker,LINE,400005,401207,107,0.33
ptg010976l,2714342,2714658,316,RepeatMasker,LINE,2714284,2714345,3,0.01
ptg010976l,2714342,2714658,316,RepeatMasker,LINE,2714446,2714597,152,0.48
ptg010976l,2714342,2714658,316,RepeatMasker,LINE,2714601,2714747,58,0.18
ptg010985l,684459,684740,281,RepeatMasker,LINE,684471,684520,50,0.18
ptg010996l,719872,720172,300,RepeatMasker,LINE,717779,720289,300,1.00
ptg011004l,429486,429793,307,RepeatMasker,LINE,428819,430478,307,1.00
ptg011039l,603781,604111,330,RepeatMasker,LINE,603833,603900,68,0.21
ptg011040l,1589717,1590030,313,RepeatMasker,LINE,1589908,1590378,123,0.39
ptg011068l,2620442,2620721,279,RepeatMasker,LINE,2620682,2621101,40,0.14
ptg011106l,2486671,2486969,298,RepeatMasker,LINE,2485949,2488092,298,1.00
ptg011132l,1027862,1028176,314,RepeatMasker,LINE,1027880,1027950,71,0.23
ptg011145l,1030461,1030752,291,RepeatMasker,LINE,1030502,1030918,251,0.86
ptg011151l,1499845,1500145,300,RepeatMasker,LINE,1497092,1499893,48,0.16
ptg011151l,1499845,1500145,300,RepeatMasker,LINE,1499895,1500303,251,0.84
ptg011163l,358337,358627,290,RepeatMasker,LINE,358319,358500,163,0.56
ptg011163l,358337,358627,290,RepeatMasker,LINE,358485,358547,63,0.22
ptg011163l,470916,471237,321,RepeatMasker,LINE,470947,471016,70,0.22
ptg011225l,336275,336577,302,RepeatMasker,LINE,336278,336337,60,0.20
ptg011232l,261953,262276,323,RepeatMasker,LINE,261959,262042,84,0.26
ptg011238l,2658631,2658939,308,RepeatMasker,LINE,2658638,2658708,71,0.23
ptg011263l,1108529,1108850,321,RepeatMasker,LINE,1108417,1110908,321,1.00
ptg011279l,4106830,4107129,299,RepeatMasker,LINE,4106809,4106879,49,0.16
ptg011282l,2120767,2121038,271,RepeatMasker,LINE,2118807,2121030,263,0.97
ptg011298l,323379,323702,323,RepeatMasker,LINE,323384,326614,319,0.99
ptg011305l,615891,616216,325,RepeatMasker,LINE,613300,616520,325,1.00
ptg011317l,846199,846495,296,RepeatMasker,LINE,846434,848466,62,0.21
ptg011330l,193010,193332,322,RepeatMasker,LINE,193034,193139,106,0.33
ptg011330l,193010,193332,322,RepeatMasker,LINE,193282,193415,51,0.16
ptg011332l,1207155,1207471,316,RepeatMasker,LINE,1207186,1207232,47,0.15
ptg011350l,2974215,2974498,283,RepeatMasker,LINE,2974298,2976084,201,0.71
ptg011359l,72036,72337,301,RepeatMasker,LINE,71990,72372,301,1.00
ptg011364l,111841,112179,338,RepeatMasker,LINE,111892,113788,288,0.85
ptg011373l,232541,232865,324,RepeatMasker,LINE,229974,233228,324,1.00
ptg011384l,237253,237568,315,RepeatMasker,LINE,237449,237817,120,0.38
ptg011384l,237253,237568,315,RepeatMasker,LINE,237496,237928,73,0.23
ptg011384l,237253,237568,315,RepeatMasker,LINE,237561,238622,8,0.03
ptg011384l,587824,588139,315,RepeatMasker,LINE,588019,588579,121,0.38
ptg011396l,359660,359944,284,RepeatMasker,LINE,359571,359934,274,0.96
ptg011400l,371882,372188,306,RepeatMasker,LINE,370935,372198,306,1.00
ptg011445l,1095618,1095930,312,RepeatMasker,LINE,1095665,1099084,266,0.85
ptg011461l,146332,146634,302,RepeatMasker,LINE,146583,147094,52,0.17
ptg011469l,367284,367590,306,RepeatMasker,LINE,366926,367374,90,0.29
ptg011473l,207665,207976,311,RepeatMasker,LINE,207661,207782,117,0.38
ptg011485l,433839,434128,289,RepeatMasker,LINE,433068,434094,255,0.88
ptg011498l,282991,283303,312,RepeatMasker,LINE,283015,283086,72,0.23
ptg011515l,884095,884416,321,RepeatMasker,LINE,883352,884397,302,0.94
ptg011551l,292042,292344,302,RepeatMasker,LINE,291318,293910,302,1.00
ptg011557l,711143,711451,308,RepeatMasker,LINE,711204,711261,58,0.19
ptg011605l,426445,426724,279,RepeatMasker,LINE,426701,426910,24,0.09
ptg011636l,70780,71113,333,RepeatMasker,LINE,70790,71168,324,0.97
ptg011644l,1096588,1096893,305,RepeatMasker,LINE,1096567,1096637,49,0.16
ptg011659l,122623,122897,274,RepeatMasker,LINE,122632,122669,38,0.14
ptg011671l,234666,234989,323,RepeatMasker,LINE,234715,234783,69,0.21
ptg011686l,1888208,1888528,320,RepeatMasker,LINE,1887438,1888970,320,1.00
ptg011696l,3422207,3422509,302,RepeatMasker,LINE,3422231,3422274,44,0.15
ptg011702l,284933,285228,295,RepeatMasker,LINE,284138,285041,108,0.37
ptg011702l,284933,285228,295,RepeatMasker,LINE,284984,285052,69,0.23
ptg011706l,806584,806887,303,RepeatMasker,LINE,806793,808072,95,0.31
ptg011706l,884972,885252,280,RepeatMasker,LINE,884320,885552,280,1.00
ptg011713l,291963,292242,279,RepeatMasker,LINE,291798,293307,279,1.00
ptg011713l,884522,884807,285,RepeatMasker,LINE,884672,884819,136,0.48
ptg011715l,279398,279699,301,RepeatMasker,LINE,278674,280331,301,1.00
ptg011729l,1053934,1054242,308,RepeatMasker,LINE,1052563,1054087,153,0.50
ptg011729l,1053934,1054242,308,RepeatMasker,LINE,1054150,1054233,84,0.27
ptg011735l,887234,887564,330,RepeatMasker,LINE,885320,888572,330,1.00
ptg011765l,1349430,1349750,320,RepeatMasker,LINE,1349649,1352851,102,0.32
ptg011790l,2097084,2097410,326,RepeatMasker,LINE,2096803,2097430,326,1.00
ptg011829l,402025,402307,282,RepeatMasker,LINE,401923,402366,282,1.00
ptg011840l,747253,747550,297,RepeatMasker,LINE,747240,747793,297,1.00
ptg011841l,1284837,1285108,271,RepeatMasker,LINE,1284901,1284989,89,0.33
ptg011850l,1134642,1134939,297,RepeatMasker,LINE,1134703,1135947,237,0.80
ptg011872l,606090,606373,283,RepeatMasker,LINE,605900,606153,63,0.22
ptg011888l,1140235,1140522,287,RepeatMasker,LINE,1140139,1141572,287,1.00
ptg011897l,876255,876560,305,RepeatMasker,LINE,876205,877626,305,1.00
ptg011903l,2818895,2819224,329,RepeatMasker,LINE,2818695,2821909,329,1.00
ptg011924l,95050,95345,295,RepeatMasker,LINE,95124,98263,222,0.75
ptg011927l,471492,471823,331,RepeatMasker,LINE,471660,471724,65,0.20
ptg011978l,2117598,2117922,324,RepeatMasker,LINE,2117754,2118093,169,0.52
ptg011978l,3879115,3879424,309,RepeatMasker,LINE,3879183,3879272,90,0.29
ptg011978l,3879115,3879424,309,RepeatMasker,LINE,3879359,3879507,66,0.21
ptg011978l,6282614,6282937,323,RepeatMasker,LINE,6282397,6282730,116,0.36
ptg011978l,7020807,7021081,274,RepeatMasker,LINE,7020376,7020990,183,0.67
ptg012066l,152046,152383,337,RepeatMasker,LINE,151907,152095,49,0.15
ptg012072l,980211,980529,318,RepeatMasker,LINE,980487,981610,43,0.14
ptg012079l,1946104,1946429,325,RepeatMasker,LINE,1946028,1946582,325,1.00
ptg012081l,1498754,1499061,307,RepeatMasker,LINE,1497692,1499074,307,1.00
ptg012100l,355606,355938,332,RepeatMasker,LINE,355884,357808,55,0.17
ptg012103l,375938,376211,273,RepeatMasker,LINE,376107,378462,105,0.38
ptg012105l,1803534,1803867,333,RepeatMasker,LINE,1803574,1803665,92,0.28
ptg012105l,1803534,1803867,333,RepeatMasker,LINE,1803655,1805028,213,0.64
ptg012111l,416653,416959,306,RepeatMasker,LINE,416469,416672,19,0.06
ptg012129l,71,216,145,RepeatMasker,LINE,173,2093,44,0.30
ptg012134l,213925,214223,298,RepeatMasker,LINE,213928,213998,71,0.24
ptg012144l,374687,375015,328,RepeatMasker,LINE,372817,374700,13,0.04
ptg012171l,1213838,1214133,295,RepeatMasker,LINE,1213269,1214225,295,1.00
ptg012199l,1309218,1309532,314,RepeatMasker,LINE,1308963,1309375,157,0.50
ptg012199l,1309218,1309532,314,RepeatMasker,LINE,1309492,1309604,41,0.13
ptg012228l,614220,614545,325,RepeatMasker,LINE,613946,614272,52,0.16
ptg012265l,652663,652950,287,RepeatMasker,LINE,652697,653283,254,0.89
ptg012290l,1431203,1431511,308,RepeatMasker,LINE,1431503,1431680,9,0.03
ptg012296l,740284,740590,306,RepeatMasker,LINE,740402,740450,49,0.16
ptg012332l,885984,886309,325,RepeatMasker,LINE,885113,887792,325,1.00
ptg012332l,885984,886309,325,RepeatMasker,LINE,884658,886190,206,0.63
ptg012337l,174927,175224,297,RepeatMasker,LINE,174951,175372,274,0.92
ptg012367l,591197,591513,316,RepeatMasker,LINE,591438,593034,76,0.24
ptg012403l,690315,690601,286,RepeatMasker,LINE,690323,690603,279,0.98
ptg012428l,424456,424752,296,RepeatMasker,LINE,422848,424653,197,0.67
ptg012438l,337622,337920,298,RepeatMasker,LINE,337720,338609,201,0.67
ptg012455l,211293,211614,321,RepeatMasker,LINE,210794,212114,321,1.00
ptg012466l,1609337,1609655,318,RepeatMasker,LINE,1609521,1611024,135,0.42
ptg012477l,512988,513304,316,RepeatMasker,LINE,512764,513298,310,0.98
ptg012478l,623694,624021,327,RepeatMasker,LINE,623848,624289,174,0.53
ptg012498l,199098,199414,316,RepeatMasker,LINE,198997,199266,168,0.53
ptg012498l,199098,199414,316,RepeatMasker,LINE,199401,199615,14,0.04
ptg012531l,712306,712598,292,RepeatMasker,LINE,712288,712772,292,1.00
ptg012533l,288558,288850,292,RepeatMasker,LINE,288469,288684,126,0.43
ptg012545l,1338164,1338448,284,RepeatMasker,LINE,1338201,1338255,55,0.19
ptg012547l,1215630,1215941,311,RepeatMasker,LINE,1215722,1216226,220,0.71
ptg012559l,1381451,1381730,279,RepeatMasker,LINE,1381608,1384088,123,0.44
ptg012570l,156839,157119,280,RepeatMasker,LINE,156484,157928,280,1.00
ptg012573l,1250717,1251042,325,RepeatMasker,LINE,1250574,1251033,316,0.97
ptg012577l,557948,558240,292,RepeatMasker,LINE,558167,559070,74,0.25
ptg012579l,2571961,2572252,291,RepeatMasker,LINE,2572117,2572201,85,0.29
ptg012579l,3114361,3114654,293,RepeatMasker,LINE,3114141,3115008,293,1.00
ptg012607l,24766,25040,274,RepeatMasker,LINE,24803,24857,55,0.20
ptg012630l,741972,742288,316,RepeatMasker,LINE,741999,742082,84,0.27
ptg012630l,741972,742288,316,RepeatMasker,LINE,742097,742606,192,0.61
ptg012655l,24092,24423,331,RepeatMasker,LINE,24196,24312,117,0.35
ptg012679l,2063725,2064011,286,RepeatMasker,LINE,2063331,2063974,249,0.87
ptg012692l,821062,821369,307,RepeatMasker,LINE,821318,821575,52,0.17
ptg012715l,1364992,1365279,287,RepeatMasker,LINE,1364969,1365313,287,1.00
ptg012728l,510816,511086,270,RepeatMasker,LINE,509206,513065,270,1.00
ptg012733l,180492,180815,323,RepeatMasker,LINE,177584,181320,323,1.00
ptg012735l,700510,700812,302,RepeatMasker,LINE,700489,700559,49,0.16
ptg012735l,1059748,1060047,299,RepeatMasker,LINE,1056332,1060767,299,1.00
ptg012758l,1426140,1426460,320,RepeatMasker,LINE,1425858,1426363,223,0.70
ptg012773l,1641812,1642121,309,RepeatMasker,LINE,1641896,1641965,70,0.23
ptg012773l,1641812,1642121,309,RepeatMasker,LINE,1642065,1642198,57,0.18
ptg012790l,437015,437319,304,RepeatMasker,LINE,437113,437264,152,0.50
ptg012790l,437015,437319,304,RepeatMasker,LINE,437209,437360,111,0.37
ptg012791l,1222902,1223226,324,RepeatMasker,LINE,1223149,1223218,70,0.22
ptg012795l,30489,30804,315,RepeatMasker,LINE,29991,30650,161,0.51
ptg012835l,571392,571731,339,RepeatMasker,LINE,570275,571449,57,0.17
ptg012841l,211284,211595,311,RepeatMasker,LINE,210256,211428,144,0.46
ptg012848l,583196,583493,297,RepeatMasker,LINE,580932,585190,297,1.00
ptg012858l,1266054,1266380,326,RepeatMasker,LINE,1266075,1269247,306,0.94
ptg012863l,586248,586523,275,RepeatMasker,LINE,586143,586749,275,1.00
ptg012866l,1317769,1318061,292,RepeatMasker,LINE,1318045,1318385,17,0.06
ptg012878l,546377,546700,323,RepeatMasker,LINE,546420,548359,281,0.87
ptg012902l,114186,114516,330,RepeatMasker,LINE,114277,114841,240,0.73
ptg012906l,3745,4075,330,RepeatMasker,LINE,3089,5097,330,1.00
ptg012913l,609363,609702,339,RepeatMasker,LINE,609411,610975,292,0.86
ptg012919l,257324,257629,305,RepeatMasker,LINE,256791,257561,237,0.78
ptg012932l,464719,465010,291,RepeatMasker,LINE,464160,465260,291,1.00
ptg012932l,464719,465010,291,RepeatMasker,LINE,464637,465362,291,1.00
ptg012950l,112443,112745,302,RepeatMasker,LINE,112450,112520,71,0.24
ptg012957l,2663332,2663630,298,RepeatMasker,LINE,2662610,2664247,298,1.00
ptg012961l,524943,525230,287,RepeatMasker,LINE,525183,525343,48,0.17
ptg012969l,3361110,3361402,292,RepeatMasker,LINE,3361209,3361452,194,0.66
ptg012988l,129805,130097,292,RepeatMasker,LINE,129867,129943,77,0.26
ptg012988l,129805,130097,292,RepeatMasker,LINE,129894,131008,204,0.70
ptg012993l,196037,196346,309,RepeatMasker,LINE,196040,196110,71,0.23
ptg013011l,206079,206405,326,RepeatMasker,LINE,205988,206114,35,0.11
ptg013014l,531020,531308,288,RepeatMasker,LINE,530707,531278,258,0.90
ptg013014l,531020,531308,288,RepeatMasker,LINE,531178,531343,131,0.45
ptg013015l,461709,462003,294,RepeatMasker,LINE,461757,461810,54,0.18
ptg013015l,461709,462003,294,RepeatMasker,LINE,461865,462090,139,0.47
ptg013020l,1917213,1917532,319,RepeatMasker,LINE,1917196,1920376,319,1.00
ptg013047l,654433,654719,286,RepeatMasker,LINE,654408,654483,50,0.17
ptg013050l,398315,398626,311,RepeatMasker,LINE,398123,400093,311,1.00
ptg013050l,398315,398626,311,RepeatMasker,LINE,398558,400117,69,0.22
ptg013060l,182284,182586,302,RepeatMasker,LINE,182562,183164,25,0.08
ptg013081l,106670,106974,304,RepeatMasker,LINE,105765,106859,189,0.62
ptg013085l,202349,202633,284,RepeatMasker,LINE,202386,202880,248,0.87
ptg013087l,379670,379956,286,RepeatMasker,LINE,379562,379730,60,0.21
ptg013087l,379670,379956,286,RepeatMasker,LINE,379580,379959,286,1.00
ptg013087l,1946370,1946681,311,RepeatMasker,LINE,1946449,1946550,102,0.33
ptg013117l,2469383,2469685,302,RepeatMasker,LINE,2466008,2469694,302,1.00
ptg013117l,3803446,3803727,281,RepeatMasker,LINE,3803395,3803465,19,0.07
ptg013128l,967570,967888,318,RepeatMasker,LINE,967848,968071,41,0.13
ptg013133l,90561,90849,288,RepeatMasker,LINE,89172,90917,288,1.00
ptg013149l,80788,81089,301,RepeatMasker,LINE,79530,80835,47,0.16
ptg013161l,2789879,2790192,313,RepeatMasker,LINE,2789969,2791011,224,0.72
ptg013170l,423805,424122,317,RepeatMasker,LINE,423813,423858,46,0.15
ptg013170l,457663,457939,276,RepeatMasker,LINE,457199,457946,276,1.00
ptg013170l,457663,457939,276,RepeatMasker,LINE,457202,458173,276,1.00
ptg013170l,457663,457939,276,RepeatMasker,LINE,457526,459184,276,1.00
ptg013180l,512457,512733,276,RepeatMasker,LINE,510199,512490,33,0.12
ptg013183l,1083660,1083984,324,RepeatMasker,LINE,1083454,1083781,121,0.37
ptg013219l,790876,791190,314,RepeatMasker,LINE,790881,790964,84,0.27
ptg013219l,790876,791190,314,RepeatMasker,LINE,790900,790966,67,0.21
ptg013219l,790876,791190,314,RepeatMasker,LINE,791065,792554,126,0.40
ptg013240l,51860,52186,326,RepeatMasker,LINE,51297,51900,40,0.12
ptg013255l,463231,463547,316,RepeatMasker,LINE,463213,464090,316,1.00
ptg013279l,666861,667150,289,RepeatMasker,LINE,666979,667488,172,0.60
ptg013287l,202143,202425,282,RepeatMasker,LINE,202268,202315,48,0.17
ptg013298l,354829,355105,276,RepeatMasker,LINE,353084,354938,109,0.39
ptg013298l,354829,355105,276,RepeatMasker,LINE,354877,354959,83,0.30
ptg013318l,495518,495802,284,RepeatMasker,LINE,494804,495768,250,0.88
ptg013320l,526993,527298,305,RepeatMasker,LINE,527041,527104,64,0.21
ptg013320l,526993,527298,305,RepeatMasker,LINE,527204,527352,95,0.31
ptg013326l,1558031,1558315,284,RepeatMasker,LINE,1558127,1558596,189,0.67
ptg013348l,203189,203461,272,RepeatMasker,LINE,203109,204802,272,1.00
ptg013365l,50589,50887,298,RepeatMasker,LINE,50087,50840,251,0.84
ptg013365l,50589,50887,298,RepeatMasker,LINE,50222,50829,240,0.81
ptg013374l,1199276,1199538,262,RepeatMasker,LINE,1199265,1200203,262,1.00
ptg013376l,46464,46752,288,RepeatMasker,LINE,46188,46749,285,0.99
ptg013382l,204695,204989,294,RepeatMasker,LINE,204882,204937,56,0.19
ptg013387l,3017916,3018204,288,RepeatMasker,LINE,3017937,3018013,77,0.27
ptg013387l,3017916,3018204,288,RepeatMasker,LINE,3017951,3018066,116,0.40
ptg013387l,3017916,3018204,288,RepeatMasker,LINE,3018128,3020047,77,0.27
ptg013390l,641523,641818,295,RepeatMasker,LINE,641358,641535,12,0.04
ptg013390l,641523,641818,295,RepeatMasker,LINE,641531,641701,171,0.58
ptg013398l,1580154,1580484,330,RepeatMasker,LINE,1580157,1581625,328,0.99
ptg013401l,1706986,1707281,295,RepeatMasker,LINE,1707263,1707548,19,0.06
ptg013407l,141292,141618,326,RepeatMasker,LINE,140756,141336,44,0.13
ptg013423l,605993,606287,294,RepeatMasker,LINE,606161,606920,127,0.43
ptg013428l,535798,536081,283,RepeatMasker,LINE,535329,535948,150,0.53
ptg013429l,197322,197608,286,RepeatMasker,LINE,196789,198954,286,1.00
ptg013451l,1071228,1071510,282,RepeatMasker,LINE,1071164,1071334,106,0.38
ptg013468l,429426,429738,312,RepeatMasker,LINE,429474,429535,62,0.20
ptg013507l,2070130,2070454,324,RepeatMasker,LINE,2070028,2072030,324,1.00
ptg013513l,2914640,2914955,315,RepeatMasker,LINE,2914658,2914718,61,0.19
ptg013543l,1800420,1800696,276,RepeatMasker,LINE,1800243,1800735,276,1.00
ptg013579l,569021,569349,328,RepeatMasker,LINE,568723,569626,328,1.00
ptg013579l,767660,767990,330,RepeatMasker,LINE,767760,768862,231,0.70
ptg013582l,430899,431198,299,RepeatMasker,LINE,430905,430950,46,0.15
ptg013610l,1429846,1430174,328,RepeatMasker,LINE,1428922,1430582,328,1.00
ptg013614l,924907,925221,314,RepeatMasker,LINE,925105,925564,117,0.37
ptg013614l,3069311,3069592,281,RepeatMasker,LINE,3069407,3069460,54,0.19
ptg013620l,22000,22286,286,RepeatMasker,LINE,21987,22075,75,0.26
ptg013620l,22000,22286,286,RepeatMasker,LINE,22019,24136,268,0.94
ptg013653l,549351,549629,278,RepeatMasker,LINE,549334,549625,274,0.99
ptg013662l,192211,192485,274,RepeatMasker,LINE,192359,193034,127,0.46
ptg013663l,135223,135550,327,RepeatMasker,LINE,134936,135416,193,0.59
ptg013670l,776371,776707,336,RepeatMasker,LINE,775731,778906,336,1.00
ptg013670l,1095002,1095286,284,RepeatMasker,LINE,1095158,1095517,129,0.45
ptg013729l,145992,146294,302,RepeatMasker,LINE,146228,146870,67,0.22
ptg013731l,2522781,2523087,306,RepeatMasker,LINE,2519780,2523052,271,0.89
ptg013735l,294720,295007,287,RepeatMasker,LINE,294842,295321,166,0.58
ptg013745l,173310,173599,289,RepeatMasker,LINE,170859,173952,289,1.00
ptg013748l,510538,510817,279,RepeatMasker,LINE,510522,513244,279,1.00
ptg013748l,837800,838094,294,RepeatMasker,LINE,836781,837882,82,0.28
ptg013748l,837800,838094,294,RepeatMasker,LINE,837963,838105,132,0.45
ptg013748l,837800,838094,294,RepeatMasker,LINE,837999,838367,96,0.33
ptg013778l,469340,469670,330,RepeatMasker,LINE,469356,469435,80,0.24
ptg013780l,79065,79356,291,RepeatMasker,LINE,79299,79376,58,0.20
ptg013807l,49221,49488,267,RepeatMasker,LINE,49124,49359,138,0.52
ptg013810l,1898076,1898390,314,RepeatMasker,LINE,1897600,1898268,192,0.61
ptg013877l,1874680,1874998,318,RepeatMasker,LINE,1874698,1874957,260,0.82
ptg013900l,466215,466538,323,RepeatMasker,LINE,466433,466691,106,0.33
ptg013927l,687923,688226,303,RepeatMasker,LINE,686406,688839,303,1.00
ptg013930l,628651,628953,302,RepeatMasker,LINE,628630,628700,49,0.16
ptg013934l,1054820,1055077,257,RepeatMasker,LINE,1054532,1055013,193,0.75
ptg013934l,2693853,2694153,300,RepeatMasker,LINE,2694039,2697256,115,0.38
ptg013954l,154371,154688,317,RepeatMasker,LINE,154455,154511,57,0.18
ptg013957l,32660,32976,316,RepeatMasker,LINE,32925,33318,52,0.16
ptg013996l,245953,246243,290,RepeatMasker,LINE,245015,246189,236,0.81
ptg014041l,418411,418730,319,RepeatMasker,LINE,418647,422404,84,0.26
ptg014057l,1505480,1505770,290,RepeatMasker,LINE,1504460,1505788,290,1.00
ptg014060l,355293,355616,323,RepeatMasker,LINE,355572,356321,45,0.14
ptg014095l,529882,530168,286,RepeatMasker,LINE,530095,530155,61,0.21
ptg014122l,411607,411888,281,RepeatMasker,LINE,411169,411937,281,1.00
ptg014156l,582053,582356,303,RepeatMasker,LINE,581993,582468,303,1.00
ptg014159l,964668,964984,316,RepeatMasker,LINE,964561,964736,68,0.22
ptg014190l,1291088,1291399,311,RepeatMasker,LINE,1289658,1291105,17,0.05
ptg014190l,1291088,1291399,311,RepeatMasker,LINE,1291269,1291324,56,0.18
ptg014190l,1291088,1291399,311,RepeatMasker,LINE,1291371,1292145,29,0.09
ptg014191l,183085,183397,312,RepeatMasker,LINE,183244,183929,154,0.49
ptg014194l,1276685,1276970,285,RepeatMasker,LINE,1276024,1276755,70,0.25
ptg014194l,1276685,1276970,285,RepeatMasker,LINE,1276813,1278034,158,0.55
ptg014236l,807876,808153,277,RepeatMasker,LINE,808147,808758,7,0.03
ptg014238l,1229813,1230130,317,RepeatMasker,LINE,1229554,1232600,317,1.00
ptg014243l,3292108,3292387,279,RepeatMasker,LINE,3292057,3294048,279,1.00
ptg014244l,378925,379201,276,RepeatMasker,LINE,379019,379075,57,0.21
ptg014251l,153394,153720,326,RepeatMasker,LINE,153661,154564,60,0.18
ptg014252l,305863,306169,306,RepeatMasker,LINE,305683,306014,151,0.49
ptg014252l,305863,306169,306,RepeatMasker,LINE,305975,306051,77,0.25
ptg014264l,166144,166469,325,RepeatMasker,LINE,163292,169083,325,1.00
ptg014313l,32526,32891,365,RepeatMasker,LINE,32328,32694,168,0.46
ptg014313l,32526,32891,365,RepeatMasker,LINE,32872,32966,20,0.05
ptg014313l,32526,32891,365,RepeatMasker,LINE,32883,32961,9,0.02
ptg014342l,2481044,2481346,302,RepeatMasker,LINE,2479804,2481056,12,0.04
ptg014342l,3068369,3068677,308,RepeatMasker,LINE,3068265,3068382,13,0.04
ptg014342l,3068369,3068677,308,RepeatMasker,LINE,3068474,3068554,81,0.26
ptg014354l,139601,139883,282,RepeatMasker,LINE,139581,139757,156,0.55
ptg014354l,185783,186077,294,RepeatMasker,LINE,183781,185808,25,0.09
ptg014361l,1716946,1717225,279,RepeatMasker,LINE,1717225,1719651,1,0.00
ptg014368l,729196,729497,301,RepeatMasker,LINE,729333,729532,165,0.55
ptg014372l,329208,329530,322,RepeatMasker,LINE,328139,329291,83,0.26
ptg014376l,1352159,1352480,321,RepeatMasker,LINE,1352201,1352505,280,0.87
ptg014384l,657840,658159,319,RepeatMasker,LINE,658090,658165,70,0.22
ptg014384l,657840,658159,319,RepeatMasker,LINE,658098,659183,62,0.19
ptg014389l,427258,427587,329,RepeatMasker,LINE,426992,430260,329,1.00
ptg014392l,1157702,1157998,296,RepeatMasker,LINE,1155530,1157801,99,0.33
ptg014444l,1244557,1244864,307,RepeatMasker,LINE,1244733,1244897,132,0.43
ptg014459l,464872,465180,308,RepeatMasker,LINE,464879,464949,71,0.23
ptg014461l,55126,55460,334,RepeatMasker,LINE,54576,55212,86,0.26
ptg014476l,461990,462313,323,RepeatMasker,LINE,460940,462070,80,0.25
ptg014477l,1037871,1038160,289,RepeatMasker,LINE,1038057,1041295,104,0.36
ptg014484l,1481235,1481552,317,RepeatMasker,LINE,1481220,1484024,317,1.00
ptg014551l,1131863,1132140,277,RepeatMasker,LINE,1132086,1132128,43,0.16
ptg014563l,1130067,1130364,297,RepeatMasker,LINE,1128419,1131334,297,1.00
ptg014583l,83536,83841,305,RepeatMasker,LINE,82057,83634,98,0.32
ptg014631l,345329,345661,332,RepeatMasker,LINE,345360,345429,70,0.21
ptg014632l,479702,480018,316,RepeatMasker,LINE,479309,481281,316,1.00
ptg014645l,342392,342712,320,RepeatMasker,LINE,342427,342492,66,0.21
ptg014646l,1351276,1351590,314,RepeatMasker,LINE,1349977,1352234,314,1.00
ptg014650l,377382,377672,290,RepeatMasker,LINE,374878,378616,290,1.00
ptg014652l,659898,660171,273,RepeatMasker,LINE,659996,662846,176,0.64
ptg014657l,99017,99324,307,RepeatMasker,LINE,99217,99557,108,0.35
ptg014685l,1358821,1359112,291,RepeatMasker,LINE,1357768,1360052,291,1.00
ptg014723l,1865506,1865829,323,RepeatMasker,LINE,1865713,1866317,117,0.36
ptg014727l,771949,772259,310,RepeatMasker,LINE,772154,772346,106,0.34
ptg014735l,159318,159618,300,RepeatMasker,LINE,158498,161598,300,1.00
ptg014735l,159318,159618,300,RepeatMasker,LINE,158498,162269,300,1.00
ptg014774l,475656,475939,283,RepeatMasker,LINE,475794,476270,146,0.52
ptg014774l,749705,749998,293,RepeatMasker,LINE,749833,751094,166,0.57
ptg014793l,414899,415207,308,RepeatMasker,LINE,414715,415443,308,1.00
ptg014797l,3981695,3981981,286,RepeatMasker,LINE,3981674,3981770,75,0.26
ptg014797l,3981695,3981981,286,RepeatMasker,LINE,3981714,3981996,268,0.94
ptg014847l,440202,440512,310,RepeatMasker,LINE,439117,440337,135,0.44
ptg014847l,440202,440512,310,RepeatMasker,LINE,440378,441003,135,0.44
ptg014861l,41845,42170,325,RepeatMasker,LINE,39469,41856,11,0.03
ptg014894l,213371,213688,317,RepeatMasker,LINE,211969,213921,317,1.00
ptg014908l,417732,418050,318,RepeatMasker,LINE,417053,417770,38,0.12
ptg014975l,410800,411119,319,RepeatMasker,LINE,410235,411068,268,0.84
ptg015035l,958537,958843,306,RepeatMasker,LINE,957271,961030,306,1.00
ptg015061l,1235316,1235635,319,RepeatMasker,LINE,1234697,1235422,106,0.33
ptg015084l,2593707,2594012,305,RepeatMasker,LINE,2590707,2593983,276,0.90
ptg015112l,250334,250617,283,RepeatMasker,LINE,250441,253543,177,0.63
ptg015116l,105416,105731,315,RepeatMasker,LINE,105376,105554,138,0.44
ptg015166l,471765,472100,335,RepeatMasker,LINE,471973,472018,46,0.14
ptg015181l,825860,826201,341,RepeatMasker,LINE,825385,826253,341,1.00
ptg015188l,987905,988047,142,RepeatMasker,LINE,987928,991691,120,0.85
ptg015256l,1449504,1449811,307,RepeatMasker,LINE,1449731,1450757,81,0.26
ptg015257l,234956,235277,321,RepeatMasker,LINE,235143,235917,135,0.42
ptg015278l,82440,82760,320,RepeatMasker,LINE,82519,82753,235,0.73
ptg015283l,424429,424749,320,RepeatMasker,LINE,422225,425269,320,1.00
ptg015303l,472169,472457,288,RepeatMasker,LINE,468524,472525,288,1.00
ptg015344l,1910723,1911052,329,RepeatMasker,LINE,1910729,1911194,324,0.98
ptg015351l,283618,283933,315,RepeatMasker,LINE,283741,284538,193,0.61
ptg015360l,148480,148817,337,RepeatMasker,LINE,148080,149149,337,1.00
ptg015369l,1375639,1375962,323,RepeatMasker,LINE,1375621,1376251,323,1.00
ptg015386l,1221073,1221364,291,RepeatMasker,LINE,1221143,1222560,222,0.76
ptg015411l,574647,574976,329,RepeatMasker,LINE,574381,577661,329,1.00
ptg015418l,33726,34014,288,RepeatMasker,LINE,33363,33952,226,0.78
ptg015446l,281419,281729,310,RepeatMasker,LINE,281415,281509,90,0.29
ptg015446l,281419,281729,310,RepeatMasker,LINE,281459,281516,58,0.19
ptg015454l,646281,646582,301,RepeatMasker,LINE,646581,649286,2,0.01
ptg015476l,296921,297205,284,RepeatMasker,LINE,296929,296974,46,0.16
ptg015484l,757795,758115,320,RepeatMasker,LINE,757614,757894,99,0.31
ptg015484l,757795,758115,320,RepeatMasker,LINE,758024,758158,92,0.29
ptg015530l,1090881,1091192,311,RepeatMasker,LINE,1090978,1091323,215,0.69
ptg015540l,72963,73283,320,RepeatMasker,LINE,70759,73777,320,1.00
ptg015548l,293379,293678,299,RepeatMasker,LINE,293469,293514,46,0.15
ptg015588l,1273364,1273662,298,RepeatMasker,LINE,1272829,1273392,28,0.09
ptg015630l,460162,460473,311,RepeatMasker,LINE,460141,460211,49,0.16
ptg015666l,320974,321281,307,RepeatMasker,LINE,321155,321250,96,0.31
ptg015674l,18611,18920,309,RepeatMasker,LINE,18743,18806,64,0.21
ptg015674l,18611,18920,309,RepeatMasker,LINE,18746,18815,70,0.23
ptg015690l,337104,337379,275,RepeatMasker,LINE,336161,337459,275,1.00
ptg015696l,533659,533977,318,RepeatMasker,LINE,533732,534308,246,0.77
ptg015720l,459571,459906,335,RepeatMasker,LINE,458903,462074,335,1.00
ptg015731l,503618,503929,311,RepeatMasker,LINE,503702,506625,228,0.73
ptg015746l,980606,980925,319,RepeatMasker,LINE,980365,981354,319,1.00
ptg015746l,980606,980925,319,RepeatMasker,LINE,980522,982063,319,1.00
ptg015756l,119999,120303,304,RepeatMasker,LINE,120119,120274,156,0.51
ptg015798l,684531,684800,269,RepeatMasker,LINE,684660,687645,141,0.52
ptg015806l,572337,572650,313,RepeatMasker,LINE,571340,572575,238,0.76
ptg015806l,572337,572650,313,RepeatMasker,LINE,572595,572640,46,0.15
ptg015806l,572337,572650,313,RepeatMasker,LINE,572648,572804,3,0.01
ptg015874l,1222330,1222649,319,RepeatMasker,LINE,1220844,1223663,319,1.00
ptg015881l,319271,319559,288,RepeatMasker,LINE,316695,319516,245,0.85
ptg015881l,319271,319559,288,RepeatMasker,LINE,319436,319527,92,0.32
ptg015881l,1310014,1310289,275,RepeatMasker,LINE,1310171,1310840,119,0.43
ptg015923l,915040,915358,318,RepeatMasker,LINE,915026,915652,318,1.00
ptg015927l,714924,715234,310,RepeatMasker,LINE,714909,715004,80,0.26
ptg015938l,314984,315314,330,RepeatMasker,LINE,315186,315312,127,0.38
ptg015984l,265874,266177,303,RepeatMasker,LINE,265239,266246,303,1.00
ptg016031l,1227831,1228112,281,RepeatMasker,LINE,1228037,1228257,76,0.27
ptg016039l,347119,347444,325,RepeatMasker,LINE,346406,348904,325,1.00
ptg016042l,148532,148814,282,RepeatMasker,LINE,148325,148570,38,0.13
ptg016053l,1427449,1427732,283,RepeatMasker,LINE,1427522,1428530,211,0.75
ptg016062l,194339,194646,307,RepeatMasker,LINE,194618,195279,29,0.09
ptg016070l,691152,691436,284,RepeatMasker,LINE,691253,691313,61,0.21
ptg016070l,691152,691436,284,RepeatMasker,LINE,691253,691321,69,0.24
ptg016070l,1345852,1346179,327,RepeatMasker,LINE,1346050,1346609,130,0.40
ptg016075l,354610,354899,289,RepeatMasker,LINE,354851,354940,49,0.17
ptg016214l,190542,190822,280,RepeatMasker,LINE,189090,191091,280,1.00
ptg016238l,1119729,1120050,321,RepeatMasker,LINE,1119924,1119998,75,0.23
ptg016312l,959811,960091,280,RepeatMasker,LINE,957857,960100,280,1.00
ptg016325l,607332,607621,289,RepeatMasker,LINE,604295,607543,211,0.73
ptg016360l,254797,255098,301,RepeatMasker,LINE,254998,255107,101,0.34
ptg016361l,162759,163055,296,RepeatMasker,LINE,162789,163043,255,0.86
ptg016383l,188360,188649,289,RepeatMasker,LINE,187799,188504,144,0.50
ptg016399l,473531,473820,289,RepeatMasker,LINE,473734,474196,87,0.30
ptg016410l,587304,587611,307,RepeatMasker,LINE,586847,590790,307,1.00
ptg016436l,721108,721404,296,RepeatMasker,LINE,721155,721668,250,0.84
ptg016456l,21932,22234,302,RepeatMasker,LINE,21254,22008,76,0.25
ptg016456l,21932,22234,302,RepeatMasker,LINE,21336,22010,78,0.26
ptg016456l,21932,22234,302,RepeatMasker,LINE,22128,22289,107,0.35
ptg016463l,69851,70185,334,RepeatMasker,LINE,69998,70286,188,0.56
ptg016489l,518359,518684,325,RepeatMasker,LINE,515767,519032,325,1.00
ptg016501l,74987,75271,284,RepeatMasker,LINE,75011,75056,46,0.16
ptg016527l,46439,46779,340,RepeatMasker,LINE,46681,47907,99,0.29
ptg016582l,482660,482963,303,RepeatMasker,LINE,482933,483167,31,0.10
ptg016597l,627597,627886,289,RepeatMasker,LINE,626067,629340,289,1.00
ptg016599l,62614,62915,301,RepeatMasker,LINE,62576,62838,224,0.74
ptg016625l,1555527,1555804,277,RepeatMasker,LINE,1555518,1555644,117,0.42
ptg016625l,1555527,1555804,277,RepeatMasker,LINE,1555650,1556140,155,0.56
ptg016627l,308916,309238,322,RepeatMasker,LINE,308823,309796,322,1.00
ptg016628l,601114,601410,296,RepeatMasker,LINE,600429,601165,51,0.17
ptg016669l,175326,175600,274,RepeatMasker,LINE,174872,175514,188,0.69
ptg016705l,284680,284995,315,RepeatMasker,LINE,284672,284778,98,0.31
ptg016705l,284680,284995,315,RepeatMasker,LINE,284867,285140,129,0.41
ptg016705l,284680,284995,315,RepeatMasker,LINE,284869,285038,127,0.40
ptg016734l,27448,27753,305,RepeatMasker,LINE,27548,27710,163,0.53
ptg016755l,569424,569758,334,RepeatMasker,LINE,569407,572024,334,1.00
ptg016758l,1689333,1689630,297,RepeatMasker,LINE,1689139,1690589,297,1.00
ptg016874l,832048,832327,279,RepeatMasker,LINE,829177,832421,279,1.00
ptg016932l,127611,127900,289,RepeatMasker,LINE,126967,127927,289,1.00
ptg016951l,344310,344624,314,RepeatMasker,LINE,344470,345720,155,0.49
ptg016953l,167611,167899,288,RepeatMasker,LINE,167505,167723,112,0.39
ptg016981l,362442,362721,279,RepeatMasker,LINE,361856,363151,279,1.00
ptg016992l,2072556,2072849,293,RepeatMasker,LINE,2072563,2072703,141,0.48
ptg017005l,1053423,1053706,283,RepeatMasker,LINE,1050633,1054833,283,1.00
ptg017032l,234059,234310,251,RepeatMasker,LINE,233934,234355,251,1.00
ptg017067l,1016318,1016644,326,RepeatMasker,LINE,1015891,1016590,272,0.83
ptg017083l,280741,281064,323,RepeatMasker,LINE,279994,280799,58,0.18
ptg017102l,902743,903072,329,RepeatMasker,LINE,902769,902840,72,0.22
ptg017139l,383169,383473,304,RepeatMasker,LINE,382330,383396,227,0.75
ptg017151l,284609,284937,328,RepeatMasker,LINE,284689,284762,74,0.23
ptg017165l,682003,682311,308,RepeatMasker,LINE,681993,682078,75,0.24
ptg017211l,455840,456161,321,RepeatMasker,LINE,455371,456488,321,1.00
ptg017211l,455840,456161,321,RepeatMasker,LINE,455546,456617,321,1.00
ptg017218l,984037,984320,283,RepeatMasker,LINE,984110,986805,211,0.75
ptg017232l,1065841,1066142,301,RepeatMasker,LINE,1065964,1068832,179,0.59
ptg017258l,153491,153784,293,RepeatMasker,LINE,153413,153700,209,0.71
ptg017267l,1069691,1069995,304,RepeatMasker,LINE,1069316,1069734,43,0.14
ptg017277l,1425537,1425816,279,RepeatMasker,LINE,1425583,1425875,234,0.84
ptg017325l,3939245,3939521,276,RepeatMasker,LINE,3937408,3939463,218,0.79
ptg017389l,78993,79328,335,RepeatMasker,LINE,79005,79332,324,0.97
ptg017430l,479536,479847,311,RepeatMasker,LINE,479705,482978,143,0.46
ptg017437l,107618,107925,307,RepeatMasker,LINE,104480,107935,307,1.00
ptg017452l,100188,100528,340,RepeatMasker,LINE,99923,101273,340,1.00
ptg017457l,1734038,1734282,244,RepeatMasker,LINE,1734084,1734144,61,0.25
ptg017462l,998144,998435,291,RepeatMasker,LINE,998249,1000656,187,0.64
ptg017483l,720808,721122,314,RepeatMasker,LINE,719491,721012,204,0.65
ptg017484l,712589,712878,289,RepeatMasker,LINE,712435,712844,255,0.88
ptg017489l,43088,43371,283,RepeatMasker,LINE,43123,43156,34,0.12
ptg017505l,118167,118464,297,RepeatMasker,LINE,118208,119051,257,0.87
ptg017526l,1261117,1261423,306,RepeatMasker,LINE,1261041,1261948,306,1.00
ptg017544l,41591,41890,299,RepeatMasker,LINE,40685,42911,299,1.00
ptg017591l,398459,398741,282,RepeatMasker,LINE,398629,398921,113,0.40
ptg017608l,320654,320956,302,RepeatMasker,LINE,320630,320703,49,0.16
ptg017656l,2681,2977,296,RepeatMasker,LINE,2729,2782,54,0.18
ptg017656l,2681,2977,296,RepeatMasker,LINE,2729,2794,66,0.22
ptg017657l,49886,50178,292,RepeatMasker,LINE,48992,50300,292,1.00
ptg017665l,1160447,1160702,255,RepeatMasker,LINE,1160471,1160543,73,0.29
ptg017716l,420231,420532,301,RepeatMasker,LINE,420365,420519,155,0.51
ptg017768l,49946,50275,329,RepeatMasker,LINE,49712,52962,329,1.00
ptg017852l,1131268,1131557,289,RepeatMasker,LINE,1131539,1131824,19,0.07
ptg017880l,490733,491058,325,RepeatMasker,LINE,490835,491229,224,0.69
ptg017898l,3607268,3607571,303,RepeatMasker,LINE,3607442,3607520,79,0.26
ptg017912l,505468,505741,273,RepeatMasker,LINE,505591,505920,151,0.55
ptg017918l,348142,348464,322,RepeatMasker,LINE,348009,349238,322,1.00
ptg017922l,37372,37669,297,RepeatMasker,LINE,36145,38955,297,1.00
ptg017933l,1321173,1321481,308,RepeatMasker,LINE,1321407,1325141,75,0.24
ptg017941l,101773,102052,279,RepeatMasker,LINE,101919,104789,134,0.48
ptg017946l,1316582,1316913,331,RepeatMasker,LINE,1316898,1317481,16,0.05
ptg017949l,109749,110076,327,RepeatMasker,LINE,108041,110438,327,1.00
ptg017953l,433897,434188,291,RepeatMasker,LINE,434068,434170,103,0.35
ptg017988l,555091,555367,276,RepeatMasker,LINE,555263,557102,105,0.38
ptg018037l,750872,751179,307,RepeatMasker,LINE,751038,751521,142,0.46
ptg018076l,1188922,1189240,318,RepeatMasker,LINE,1188928,1188999,72,0.23
ptg018094l,615753,616061,308,RepeatMasker,LINE,614882,615889,136,0.44
ptg018098l,258839,259177,338,RepeatMasker,LINE,258796,258849,10,0.03
ptg018129l,2696780,2697106,326,RepeatMasker,LINE,2696697,2698198,326,1.00
ptg018158l,372301,372599,298,RepeatMasker,LINE,370631,372414,113,0.38
ptg018158l,372301,372599,298,RepeatMasker,LINE,372530,372582,53,0.18
ptg018201l,36688,36987,299,RepeatMasker,LINE,36863,39406,125,0.42
ptg018230l,324207,324542,335,RepeatMasker,LINE,323820,324450,243,0.73
ptg018231l,295828,296113,285,RepeatMasker,LINE,295422,296362,285,1.00
ptg018231l,295828,296113,285,RepeatMasker,LINE,295538,297454,285,1.00
ptg018231l,316289,316580,291,RepeatMasker,LINE,316481,316589,100,0.34
ptg018237l,806193,806486,293,RepeatMasker,LINE,806486,806523,1,0.00
ptg018250l,586143,586430,287,RepeatMasker,LINE,586200,586752,231,0.80
ptg018270l,6830001,6830330,329,RepeatMasker,LINE,6829740,6832991,329,1.00
ptg018405l,443707,443996,289,RepeatMasker,LINE,443734,443827,94,0.33
ptg018405l,443707,443996,289,RepeatMasker,LINE,443928,443987,60,0.21
ptg018405l,443707,443996,289,RepeatMasker,LINE,443994,445492,3,0.01
ptg018412l,499183,499493,310,RepeatMasker,LINE,499343,499515,151,0.49
ptg018412l,499183,499493,310,RepeatMasker,LINE,499451,499551,43,0.14
ptg018451l,809664,809956,292,RepeatMasker,LINE,809765,810006,192,0.66
ptg018471l,2168054,2168341,287,RepeatMasker,LINE,2167927,2168756,287,1.00
ptg018477l,352500,352796,296,RepeatMasker,LINE,351559,352548,48,0.16
ptg018490l,34491,34789,298,RepeatMasker,LINE,32987,34761,270,0.91
ptg018520l,4337495,4337782,287,RepeatMasker,LINE,4335959,4337978,287,1.00
ptg018521l,282559,282861,302,RepeatMasker,LINE,279154,283165,302,1.00
ptg018571l,1969890,1970171,281,RepeatMasker,LINE,1969947,1970014,68,0.24
ptg018571l,1969890,1970171,281,RepeatMasker,LINE,1970126,1970262,46,0.16
ptg018616l,129482,129792,310,RepeatMasker,LINE,129551,129590,40,0.13
ptg018631l,962880,963176,296,RepeatMasker,LINE,962437,962974,94,0.32
ptg018631l,962880,963176,296,RepeatMasker,LINE,962992,963437,185,0.63
ptg018659l,424553,424871,318,RepeatMasker,LINE,424685,424750,66,0.21
ptg018659l,424553,424871,318,RepeatMasker,LINE,424694,424760,67,0.21
ptg018743l,260670,260977,307,RepeatMasker,LINE,260213,264346,307,1.00
ptg018755l,321429,321758,329,RepeatMasker,LINE,321162,324427,329,1.00
ptg018773l,733019,733336,317,RepeatMasker,LINE,733328,733520,9,0.03
ptg018816l,1586345,1586646,301,RepeatMasker,LINE,1586594,1586711,53,0.18
ptg018857l,807500,807807,307,RepeatMasker,LINE,807274,807523,23,0.07
ptg018857l,807500,807807,307,RepeatMasker,LINE,807593,807958,215,0.70
ptg018869l,131818,132128,310,RepeatMasker,LINE,131534,132656,310,1.00
ptg018891l,4202284,4202598,314,RepeatMasker,LINE,4200281,4204025,314,1.00
ptg018893l,824562,824883,321,RepeatMasker,LINE,824662,824702,41,0.13
ptg018906l,405709,406030,321,RepeatMasker,LINE,406021,406303,10,0.03
ptg018931l,1238560,1238881,321,RepeatMasker,LINE,1238754,1239410,128,0.40
ptg018962l,152135,152449,314,RepeatMasker,LINE,152404,152518,46,0.15
ptg018962l,404645,404940,295,RepeatMasker,LINE,404701,405163,240,0.81
ptg018979l,219839,220168,329,RepeatMasker,LINE,219830,221068,329,1.00
ptg019042l,258681,258982,301,RepeatMasker,LINE,256093,258779,98,0.33
ptg019043l,736316,736618,302,RepeatMasker,LINE,736295,736366,50,0.17
ptg019075l,432367,432676,309,RepeatMasker,LINE,431929,432690,309,1.00
ptg019090l,556345,556666,321,RepeatMasker,LINE,556534,559783,133,0.41
ptg019097l,65765,66095,330,RepeatMasker,LINE,65715,65794,29,0.09
ptg019120l,343065,343378,313,RepeatMasker,LINE,343104,343147,44,0.14
ptg019156l,625813,626118,305,RepeatMasker,LINE,625761,625886,73,0.24
ptg019168l,87616,87923,307,RepeatMasker,LINE,86932,88305,307,1.00
ptg019203l,455547,455866,319,RepeatMasker,LINE,455635,455701,67,0.21
ptg019255l,709318,709640,322,RepeatMasker,LINE,709110,709404,86,0.27
ptg019258l,194083,194385,302,RepeatMasker,LINE,194178,195377,208,0.69
ptg019265l,944352,944634,282,RepeatMasker,LINE,944434,946940,201,0.71
ptg019266l,327579,327898,319,RepeatMasker,LINE,326002,328207,319,1.00
ptg019271l,147842,148163,321,RepeatMasker,LINE,148086,148852,78,0.24
ptg019283l,752369,752655,286,RepeatMasker,LINE,752163,752428,59,0.21
ptg019283l,752369,752655,286,RepeatMasker,LINE,752178,752479,110,0.38
ptg019294l,730751,731076,325,RepeatMasker,LINE,728162,731406,325,1.00
ptg019310l,286697,287013,316,RepeatMasker,LINE,286927,287339,87,0.28
ptg019320l,1086808,1087100,292,RepeatMasker,LINE,1087027,1087271,74,0.25
ptg019414l,237754,238056,302,RepeatMasker,LINE,237779,237835,57,0.19
ptg019414l,237754,238056,302,RepeatMasker,LINE,237932,238950,125,0.41
ptg019441l,31750,32070,320,RepeatMasker,LINE,31560,32183,320,1.00
ptg019462l,116000,116328,328,RepeatMasker,LINE,115833,116537,328,1.00
ptg019465l,1524070,1524393,323,RepeatMasker,LINE,1523407,1526278,323,1.00
ptg019475l,137302,137570,268,RepeatMasker,LINE,137484,137925,87,0.32
ptg019541l,660526,660812,286,RepeatMasker,LINE,660754,661015,59,0.21
ptg019541l,3268074,3268404,330,RepeatMasker,LINE,3268283,3268756,122,0.37
ptg019603l,939103,939432,329,RepeatMasker,LINE,938909,939269,166,0.50
ptg019684l,263145,263455,310,RepeatMasker,LINE,263299,263376,78,0.25
ptg019688l,645218,645546,328,RepeatMasker,LINE,645129,645740,328,1.00
ptg019691l,2121360,2121661,301,RepeatMasker,LINE,2121493,2121562,70,0.23
ptg019716l,860511,860796,285,RepeatMasker,LINE,860234,862198,285,1.00
ptg019716l,860511,860796,285,RepeatMasker,LINE,860245,861963,285,1.00
ptg019732l,149384,149709,325,RepeatMasker,LINE,149646,152854,64,0.20
ptg019732l,270850,271143,293,RepeatMasker,LINE,270779,271497,293,1.00
ptg019747l,412601,412920,319,RepeatMasker,LINE,412608,412653,46,0.14
ptg019747l,412601,412920,319,RepeatMasker,LINE,412611,412660,50,0.16
ptg019771l,1922593,1922901,308,RepeatMasker,LINE,1920160,1923243,308,1.00
ptg019785l,786757,787048,291,RepeatMasker,LINE,787000,787924,49,0.17
ptg019884l,732688,733007,319,RepeatMasker,LINE,730853,732982,294,0.92
ptg019899l,1730083,1730370,287,RepeatMasker,LINE,1729697,1730333,250,0.87
ptg019941l,371641,371952,311,RepeatMasker,LINE,371689,371741,53,0.17
ptg019983l,334705,335016,311,RepeatMasker,LINE,334656,335202,311,1.00
ptg020041l,354775,355058,283,RepeatMasker,LINE,354726,356186,283,1.00
ptg020163l,617952,618281,329,RepeatMasker,LINE,616941,619044,329,1.00
ptg020171l,227039,227346,307,RepeatMasker,LINE,227225,227815,122,0.40
ptg020171l,933712,934021,309,RepeatMasker,LINE,933715,933785,71,0.23
ptg020225l,243380,243659,279,RepeatMasker,LINE,243553,245382,107,0.38
ptg020243l,140327,140637,310,RepeatMasker,LINE,139529,141318,310,1.00
ptg020254l,354736,355056,320,RepeatMasker,LINE,355016,355114,41,0.13
ptg020261l,679810,680136,326,RepeatMasker,LINE,677541,680304,326,1.00
ptg020269l,275877,276193,316,RepeatMasker,LINE,272826,276422,316,1.00
ptg020325l,295461,295793,332,RepeatMasker,LINE,295272,295484,23,0.07
ptg020358l,282409,282715,306,RepeatMasker,LINE,281455,282513,104,0.34
ptg020367l,734970,735258,288,RepeatMasker,LINE,735162,738333,97,0.34
ptg020395l,488749,489077,328,RepeatMasker,LINE,489051,489106,27,0.08
ptg020441l,2312992,2313276,284,RepeatMasker,LINE,2312978,2313098,106,0.37
ptg020471l,1149513,1149805,292,RepeatMasker,LINE,1149799,1151075,7,0.02
ptg020472l,262127,262426,299,RepeatMasker,LINE,260791,262148,21,0.07
ptg020485l,154201,154526,325,RepeatMasker,LINE,153977,154384,183,0.56
ptg020492l,267809,268124,315,RepeatMasker,LINE,267816,267886,71,0.23
ptg020535l,387045,387330,285,RepeatMasker,LINE,387274,388576,57,0.20
ptg020548l,298911,299227,316,RepeatMasker,LINE,298758,299903,316,1.00
ptg020550l,778002,778320,318,RepeatMasker,LINE,778184,778758,137,0.43
ptg020572l,18450,18739,289,RepeatMasker,LINE,16824,18762,289,1.00
ptg020573l,340919,341227,308,RepeatMasker,LINE,339971,341204,285,0.93
ptg020628l,310530,310824,294,RepeatMasker,LINE,310650,310699,50,0.17
ptg020628l,310530,310824,294,RepeatMasker,LINE,310650,310712,63,0.21
ptg020641l,300816,301130,314,RepeatMasker,LINE,300828,300888,61,0.19
ptg020675l,126250,126583,333,RepeatMasker,LINE,123635,127098,333,1.00
ptg020765l,364691,364966,275,RepeatMasker,LINE,364825,365515,142,0.52
ptg020765l,364691,364966,275,RepeatMasker,LINE,364936,365699,31,0.11
ptg020808l,489515,489833,318,RepeatMasker,LINE,489772,490690,62,0.19
ptg020927l,391928,392229,301,RepeatMasker,LINE,392176,392662,54,0.18
ptg020996l,152270,152567,297,RepeatMasker,LINE,152478,153147,90,0.30
ptg021026l,872695,872992,297,RepeatMasker,LINE,872268,872800,105,0.35
ptg021037l,593409,593729,320,RepeatMasker,LINE,593463,593530,68,0.21
ptg021038l,841031,841341,310,RepeatMasker,LINE,840954,843481,310,1.00
ptg021044l,417119,417426,307,RepeatMasker,LINE,417389,417570,38,0.12
ptg021078l,247656,247980,324,RepeatMasker,LINE,247696,247767,72,0.22
ptg021083l,309709,310015,306,RepeatMasker,LINE,309495,309785,76,0.25
ptg021083l,309709,310015,306,RepeatMasker,LINE,309819,309876,58,0.19
ptg021096l,617166,617479,313,RepeatMasker,LINE,617327,617396,70,0.22
ptg021138l,109620,109928,308,RepeatMasker,LINE,107763,110797,308,1.00
ptg021222l,241602,241893,291,RepeatMasker,LINE,241420,241884,282,0.97
ptg021248l,247952,248276,324,RepeatMasker,LINE,247995,248299,282,0.87
ptg021350l,259390,259673,283,RepeatMasker,LINE,259574,259629,56,0.20
ptg021409l,201432,201749,317,RepeatMasker,LINE,201602,202058,148,0.47
ptg021442l,166388,166667,279,RepeatMasker,LINE,166326,169099,279,1.00
ptg021565l,172921,173205,284,RepeatMasker,LINE,172548,173198,277,0.98
ptg021569l,268364,268643,279,RepeatMasker,LINE,268082,268488,124,0.44
ptg021570l,30030,30364,334,RepeatMasker,LINE,29349,31453,334,1.00
ptg021575l,830766,831093,327,RepeatMasker,LINE,830696,832850,327,1.00
ptg021582l,614416,614735,319,RepeatMasker,LINE,614330,616609,319,1.00
ptg021642l,1050665,1050976,311,RepeatMasker,LINE,1050631,1050731,66,0.21
ptg021720l,202372,202650,278,RepeatMasker,LINE,202070,205807,278,1.00
ptg021766l,67402,67710,308,RepeatMasker,LINE,67422,67503,82,0.27
ptg021768l,119044,119383,339,RepeatMasker,LINE,119205,119374,170,0.50
ptg021778l,720996,721314,318,RepeatMasker,LINE,721035,721092,58,0.18
ptg021868l,355388,355649,261,RepeatMasker,LINE,355462,355529,68,0.26
ptg021870l,894711,895027,316,RepeatMasker,LINE,894667,895164,316,1.00
ptg021870l,894711,895027,316,RepeatMasker,LINE,894858,895341,170,0.54
ptg021870l,943000,943315,315,RepeatMasker,LINE,942600,943164,164,0.52
ptg021870l,943000,943315,315,RepeatMasker,LINE,942866,943295,295,0.94
ptg021871l,144658,144971,313,RepeatMasker,LINE,144705,144759,55,0.18
ptg021873l,146170,146479,309,RepeatMasker,LINE,146122,146474,304,0.98
ptg021873l,281547,281845,298,RepeatMasker,LINE,280999,281960,298,1.00
ptg021941l,296132,296415,283,RepeatMasker,LINE,295929,297583,283,1.00
ptg021943l,604621,604882,261,RepeatMasker,LINE,604820,604969,63,0.24
ptg022000l,118669,118958,289,RepeatMasker,LINE,117858,118719,50,0.17
ptg022019l,234213,234507,294,RepeatMasker,LINE,234396,234534,112,0.38
ptg022061l,303038,303343,305,RepeatMasker,LINE,299637,303351,305,1.00
ptg022061l,984250,984561,311,RepeatMasker,LINE,984297,984378,82,0.26
ptg022090l,492238,492558,320,RepeatMasker,LINE,491805,492600,320,1.00
ptg022112l,71597,71897,300,RepeatMasker,LINE,71306,71872,275,0.92
ptg022158l,136497,136830,333,RepeatMasker,LINE,135992,137584,333,1.00
ptg022171l,203416,203730,314,RepeatMasker,LINE,203494,203565,72,0.23
ptg022218l,517263,517572,309,RepeatMasker,LINE,516383,517557,294,0.95
ptg022247l,565940,566226,286,RepeatMasker,LINE,566142,567890,85,0.30
ptg022252l,118586,118904,318,RepeatMasker,LINE,116122,120005,318,1.00
ptg022285l,472006,472280,274,RepeatMasker,LINE,472064,472162,99,0.36
ptg022353l,213867,214167,300,RepeatMasker,LINE,213898,213958,61,0.20
ptg022353l,213867,214167,300,RepeatMasker,LINE,213901,213980,80,0.27
ptg022460l,31602,31928,326,RepeatMasker,LINE,30982,32084,326,1.00
ptg022467l,142592,142863,271,RepeatMasker,LINE,142772,142879,92,0.34
ptg022786l,349239,349510,271,RepeatMasker,LINE,349330,349427,98,0.36
ptg022844l,42992,43301,309,RepeatMasker,LINE,42995,43065,71,0.23
ptg022866l,21332,21644,312,RepeatMasker,LINE,21526,21644,119,0.38
ptg023140l,38854,39184,330,RepeatMasker,LINE,39092,39137,46,0.14
ptg023149l,109169,109458,289,RepeatMasker,LINE,107646,109298,129,0.45
ptg023149l,109169,109458,289,RepeatMasker,LINE,108580,109304,135,0.47
ptg023164l,197481,197770,289,RepeatMasker,LINE,197674,198318,97,0.34
ptg023168l,264966,265273,307,RepeatMasker,LINE,263007,265292,307,1.00
ptg023173l,790578,790906,328,RepeatMasker,LINE,790252,791395,328,1.00
ptg023190l,104831,105117,286,RepeatMasker,LINE,104654,105372,286,1.00
ptg023255l,318047,318352,305,RepeatMasker,LINE,317897,319832,305,1.00
ptg023361l,68741,69063,322,RepeatMasker,LINE,68290,69001,260,0.81
ptg023361l,68741,69063,322,RepeatMasker,LINE,69003,72237,61,0.19
ptg023455l,43847,44171,324,RepeatMasker,LINE,43591,46802,324,1.00
ptg023552l,945339,945663,324,RepeatMasker,LINE,945448,947568,216,0.67
ptg023607l,310593,310853,260,RepeatMasker,LINE,310751,310834,84,0.32
ptg023681l,197889,198223,334,RepeatMasker,LINE,197691,200485,334,1.00
ptg023755l,192496,192825,329,RepeatMasker,LINE,192226,195499,329,1.00
ptg023896l,543909,544216,307,RepeatMasker,LINE,543241,544376,307,1.00
ptg023896l,543909,544216,307,RepeatMasker,LINE,543241,544585,307,1.00
ptg024013l,375921,376211,290,RepeatMasker,LINE,376034,376593,178,0.61
ptg024031l,212400,212724,324,RepeatMasker,LINE,209912,213007,324,1.00
ptg024108l,57178,57469,291,RepeatMasker,LINE,57142,57194,16,0.05
ptg024146l,469777,470065,288,RepeatMasker,LINE,470021,470152,45,0.16
ptg024148l,850023,850343,320,RepeatMasker,LINE,850293,850887,51,0.16
ptg024159l,645769,646078,309,RepeatMasker,LINE,645095,645914,145,0.47
ptg024170l,43468,43779,311,RepeatMasker,LINE,43077,43690,222,0.71
ptg024211l,97454,97760,306,RepeatMasker,LINE,97623,97677,55,0.18
ptg024234l,226183,226487,304,RepeatMasker,LINE,225689,226400,217,0.71
ptg024412l,31838,32167,329,RepeatMasker,LINE,31810,32108,270,0.82
ptg024420l,840124,840398,274,RepeatMasker,LINE,839722,840195,71,0.26
ptg024433l,155017,155332,315,RepeatMasker,LINE,154850,155086,69,0.22
ptg024433l,155017,155332,315,RepeatMasker,LINE,155139,155877,194,0.62
ptg024453l,277940,278228,288,RepeatMasker,LINE,278076,278149,74,0.26
ptg024453l,277940,278228,288,RepeatMasker,LINE,278143,278218,76,0.26
ptg024500l,82852,83135,283,RepeatMasker,LINE,82876,82924,49,0.17
ptg024508l,459056,459363,307,RepeatMasker,LINE,458460,461613,307,1.00
ptg024529l,847372,847695,323,RepeatMasker,LINE,847176,847565,193,0.60
ptg024613l,483884,484151,267,RepeatMasker,LINE,484009,487291,143,0.54
ptg024626l,259834,260123,289,RepeatMasker,LINE,259553,260759,289,1.00
ptg024626l,259834,260123,289,RepeatMasker,LINE,259754,260759,289,1.00
ptg024724l,116021,116339,318,RepeatMasker,LINE,115585,116137,116,0.36
ptg024751l,138003,138315,312,RepeatMasker,LINE,137495,138130,127,0.41
ptg024753l,1527607,1527894,287,RepeatMasker,LINE,1527018,1527608,1,0.00
ptg024753l,1527607,1527894,287,RepeatMasker,LINE,1527764,1528050,131,0.46
ptg024832l,302124,302391,267,RepeatMasker,LINE,302368,302529,24,0.09
ptg025003l,1731033,1731345,312,RepeatMasker,LINE,1731007,1731126,93,0.30
ptg025003l,1731033,1731345,312,RepeatMasker,LINE,1731209,1731260,52,0.17
ptg025003l,1731033,1731345,312,RepeatMasker,LINE,1731321,1731437,25,0.08
ptg025010l,330499,330785,286,RepeatMasker,LINE,328881,331849,286,1.00
ptg025010l,330499,330785,286,RepeatMasker,LINE,329341,332013,286,1.00
ptg025010l,330499,330785,286,RepeatMasker,LINE,330508,332014,278,0.97
ptg025014l,317869,318179,310,RepeatMasker,LINE,318081,321320,99,0.32
ptg025045l,191711,192032,321,RepeatMasker,LINE,191843,193024,190,0.59
ptg025051l,192933,193220,287,RepeatMasker,LINE,191964,195730,287,1.00
ptg025059l,268115,268414,299,RepeatMasker,LINE,268156,268517,259,0.87
ptg025066l,80510,80786,276,RepeatMasker,LINE,80649,81325,138,0.50
ptg025083l,271966,272288,322,RepeatMasker,LINE,271685,272910,322,1.00
ptg025172l,381217,381539,322,RepeatMasker,LINE,380737,382308,322,1.00
ptg025217l,145443,145772,329,RepeatMasker,LINE,145175,148447,329,1.00
ptg025246l,451991,452287,296,RepeatMasker,LINE,452155,453650,133,0.45
ptg025266l,811291,811614,323,RepeatMasker,LINE,811229,811322,31,0.10
ptg025307l,46025,46332,307,RepeatMasker,LINE,44457,50233,307,1.00
ptg025330l,103281,103594,313,RepeatMasker,LINE,103303,103362,60,0.19
ptg025339l,225646,225926,280,RepeatMasker,LINE,225895,226460,32,0.11
ptg025376l,2824067,2824364,297,RepeatMasker,LINE,2824299,2824450,66,0.22
ptg025488l,589835,590138,303,RepeatMasker,LINE,588907,589942,107,0.35
ptg025578l,97459,97751,292,RepeatMasker,LINE,97367,97506,47,0.16
ptg025599l,817969,818237,268,RepeatMasker,LINE,818084,819449,154,0.57
ptg025623l,92408,92727,319,RepeatMasker,LINE,91874,94132,319,1.00
ptg025652l,532192,532505,313,RepeatMasker,LINE,531958,532710,313,1.00
ptg025695l,308985,309302,317,RepeatMasker,LINE,309015,309535,288,0.91
ptg025695l,777023,777314,291,RepeatMasker,LINE,777061,777115,55,0.19
ptg025732l,226073,226342,269,RepeatMasker,LINE,226251,226512,92,0.34
ptg025743l,847599,847923,324,RepeatMasker,LINE,847812,847858,47,0.15
ptg025767l,58589,58894,305,RepeatMasker,LINE,58568,58638,49,0.16
ptg025780l,82992,83318,326,RepeatMasker,LINE,83151,83945,168,0.52
ptg025787l,203774,204066,292,RepeatMasker,LINE,203806,204851,261,0.89
ptg025806l,101527,101842,315,RepeatMasker,LINE,101698,101944,145,0.46
ptg026022l,147064,147372,308,RepeatMasker,LINE,147191,148079,182,0.59
ptg026069l,1039924,1040202,278,RepeatMasker,LINE,1039709,1041270,278,1.00
ptg026306l,780556,780877,321,RepeatMasker,LINE,780095,781198,321,1.00
ptg026321l,218716,219028,312,RepeatMasker,LINE,218781,219271,248,0.79
ptg026382l,713411,713716,305,RepeatMasker,LINE,713103,714032,305,1.00
ptg026509l,48541,48849,308,RepeatMasker,LINE,48733,48786,54,0.18
ptg026580l,437462,437770,308,RepeatMasker,LINE,437631,440438,140,0.45
ptg026795l,120819,121119,300,RepeatMasker,LINE,121097,121253,23,0.08
ptg026815l,279992,280295,303,RepeatMasker,LINE,277545,280364,303,1.00
ptg026855l,1272539,1272829,290,RepeatMasker,LINE,1271946,1272657,118,0.41
ptg026875l,337962,338250,288,RepeatMasker,LINE,337718,339222,288,1.00
ptg026936l,576501,576824,323,RepeatMasker,LINE,576670,576856,155,0.48
ptg026937l,236478,236767,289,RepeatMasker,LINE,236511,236565,55,0.19
ptg026937l,236478,236767,289,RepeatMasker,LINE,236513,236573,61,0.21
ptg026968l,327985,328304,319,RepeatMasker,LINE,328172,331412,133,0.42
ptg026989l,327763,328061,298,RepeatMasker,LINE,328027,328194,35,0.12
ptg027300l,259829,260120,291,RepeatMasker,LINE,259039,260013,184,0.63
ptg027328l,37670,37949,279,RepeatMasker,LINE,37541,37952,279,1.00
ptg027349l,86101,86408,307,RepeatMasker,LINE,86055,87380,307,1.00
ptg027363l,585027,585324,297,RepeatMasker,LINE,585138,585208,71,0.24
ptg027768l,32848,33168,320,RepeatMasker,LINE,32958,34141,211,0.66
ptg027832l,182039,182325,286,RepeatMasker,LINE,181847,182153,114,0.40
ptg027888l,365791,366060,269,RepeatMasker,LINE,365707,365818,27,0.10
ptg027888l,365791,366060,269,RepeatMasker,LINE,365721,366244,269,1.00
ptg027901l,613493,613816,323,RepeatMasker,LINE,613653,613718,66,0.20
ptg027940l,80520,80820,300,RepeatMasker,LINE,80499,80569,49,0.16
ptg028040l,827458,827748,290,RepeatMasker,LINE,825872,829099,290,1.00
ptg028040l,876061,876370,309,RepeatMasker,LINE,876287,877929,84,0.27
ptg028147l,265053,265362,309,RepeatMasker,LINE,265056,265126,71,0.23
ptg028192l,78110,78417,307,RepeatMasker,LINE,78260,78714,158,0.51
ptg028298l,306581,306878,297,RepeatMasker,LINE,306373,308192,297,1.00
ptg028298l,446948,447217,269,RepeatMasker,LINE,447172,447241,46,0.17
ptg028394l,53138,53443,305,RepeatMasker,LINE,53143,53316,174,0.57
ptg028538l,85476,85801,325,RepeatMasker,LINE,85094,86002,325,1.00
ptg028768l,387895,388200,305,RepeatMasker,LINE,387778,388431,305,1.00
ptg028768l,387895,388200,305,RepeatMasker,LINE,387810,388717,305,1.00
ptg028773l,283729,284053,324,RepeatMasker,LINE,283815,284259,239,0.74
ptg028792l,102263,102535,272,RepeatMasker,LINE,102212,106276,272,1.00
ptg028849l,717799,718094,295,RepeatMasker,LINE,717841,718277,254,0.86
ptg028883l,96223,96514,291,RepeatMasker,LINE,95662,96320,97,0.33
ptg028883l,96223,96514,291,RepeatMasker,LINE,95675,96468,245,0.84
ptg028948l,35894,36191,297,RepeatMasker,LINE,35619,36010,116,0.39
ptg028959l,309379,309670,291,RepeatMasker,LINE,309532,309573,42,0.14
ptg029055l,485144,485454,310,RepeatMasker,LINE,483341,485213,69,0.22
ptg029100l,743250,743542,292,RepeatMasker,LINE,743280,744157,263,0.90
ptg029195l,380436,380711,275,RepeatMasker,LINE,378935,380519,83,0.30
ptg029224l,2269769,2270078,309,RepeatMasker,LINE,2269259,2269770,1,0.00
ptg029224l,2269769,2270078,309,RepeatMasker,LINE,2269850,2269914,65,0.21
ptg029224l,5340322,5340604,282,RepeatMasker,LINE,5340520,5340893,85,0.30
ptg029286l,66738,67047,309,RepeatMasker,LINE,66918,66963,46,0.15
ptg029286l,282995,283288,293,RepeatMasker,LINE,282979,283453,293,1.00
ptg029411l,65944,66269,325,RepeatMasker,LINE,65886,66196,252,0.78
ptg029440l,315290,315605,315,RepeatMasker,LINE,315064,315295,5,0.02
ptg029440l,315290,315605,315,RepeatMasker,LINE,315199,317165,315,1.00
ptg029925l,97590,97869,279,RepeatMasker,LINE,97380,97958,279,1.00
ptg030000l,176741,177051,310,RepeatMasker,LINE,176873,177522,179,0.58
ptg030075l,90869,91161,292,RepeatMasker,LINE,88749,92562,292,1.00
ptg030098l,282252,282569,317,RepeatMasker,LINE,282466,282583,104,0.33
ptg030266l,334954,335220,266,RepeatMasker,LINE,335007,335260,214,0.80
ptg030274l,49613,49917,304,RepeatMasker,LINE,49838,50074,80,0.26
ptg030283l,182413,182738,325,RepeatMasker,LINE,182075,183847,325,1.00
ptg030393l,459954,460245,291,RepeatMasker,LINE,459699,459974,20,0.07
ptg030413l,151145,151455,310,RepeatMasker,LINE,151265,151310,46,0.15
ptg030436l,59936,60204,268,RepeatMasker,LINE,59541,59993,57,0.21
ptg030766l,187823,188118,295,RepeatMasker,LINE,188044,188495,75,0.25
ptg030809l,191518,191826,308,RepeatMasker,LINE,190965,192387,308,1.00
ptg030863l,252934,253239,305,RepeatMasker,LINE,252982,253560,258,0.85
ptg030933l,31058,31386,328,RepeatMasker,LINE,31379,31474,8,0.02
ptg031218l,67126,67431,305,RepeatMasker,LINE,67368,67677,64,0.21
ptg031285l,138595,138916,321,RepeatMasker,LINE,137732,138608,13,0.04
ptg031654l,363959,364255,296,RepeatMasker,LINE,361171,363977,18,0.06
ptg031654l,363959,364261,302,RepeatMasker,LINE,361171,363977,18,0.06
ptg031893l,123718,124018,300,RepeatMasker,LINE,123723,123793,71,0.24
ptg032211l,402481,402746,265,RepeatMasker,LINE,402528,402591,64,0.24
ptg032310l,84214,84512,298,RepeatMasker,LINE,84319,86692,194,0.65
ptg032496l,821750,822067,317,RepeatMasker,LINE,821736,822421,317,1.00
ptg032538l,1307814,1308092,278,RepeatMasker,LINE,1305724,1308227,278,1.00
ptg032769l,466087,466398,311,RepeatMasker,LINE,466065,466136,49,0.16
ptg033419l,1419702,1420012,310,RepeatMasker,LINE,1419709,1419779,71,0.23
ptg033620l,74408,74736,328,RepeatMasker,LINE,71949,74589,181,0.55
ptg033620l,74408,74736,328,RepeatMasker,LINE,74101,74959,328,1.00
ptg033620l,74408,74736,328,RepeatMasker,LINE,74207,75090,328,1.00
ptg033634l,15017,15340,323,RepeatMasker,LINE,15028,15107,80,0.25
ptg033634l,15017,15340,323,RepeatMasker,LINE,15129,15191,63,0.20
ptg033634l,15017,15340,323,RepeatMasker,LINE,15196,16125,145,0.45
ptg033648l,466298,466590,292,RepeatMasker,LINE,464557,466416,118,0.40
ptg033735l,80626,80921,295,RepeatMasker,LINE,80921,81102,1,0.00
ptg034110l,93086,93389,303,RepeatMasker,LINE,93368,96316,22,0.07
ptg034755l,265028,265317,289,RepeatMasker,LINE,263633,265811,289,1.00
ptg034998l,133059,133395,336,RepeatMasker,LINE,133282,133398,114,0.34
ptg035022l,209608,209898,290,RepeatMasker,LINE,208542,209829,221,0.76
ptg035636l,2510466,2510780,314,RepeatMasker,LINE,2510116,2510637,171,0.54
ptg035724l,59585,59910,325,RepeatMasker,LINE,57884,60472,325,1.00
ptg035781l,57180,57323,143,RepeatMasker,LINE,57174,57247,67,0.47
ptg035781l,57180,57323,143,RepeatMasker,LINE,57187,57258,72,0.50
ptg035787l,342733,343045,312,RepeatMasker,LINE,341916,342855,122,0.39
ptg036051l,33581,33907,326,RepeatMasker,LINE,33637,33767,131,0.40
ptg036307l,182704,183015,311,RepeatMasker,LINE,182782,184408,234,0.75
ptg036488l,317493,317813,320,RepeatMasker,LINE,316555,317729,236,0.74
ptg037470l,71268,71555,287,RepeatMasker,LINE,70074,74214,287,1.00
ptg037893l,64910,65195,285,RepeatMasker,LINE,65095,67881,101,0.35
ptg037964l,24920,25221,301,RepeatMasker,LINE,24835,24928,8,0.03
ptg038185l,70319,70638,319,RepeatMasker,LINE,70207,70935,319,1.00
ptg038727l,10138,10433,295,RepeatMasker,LINE,9845,10198,60,0.20
ptg038884l,52009,52315,306,RepeatMasker,LINE,52311,52961,5,0.02
ptg039132l,114006,114336,330,RepeatMasker,LINE,114020,114304,285,0.86
ptg039491l,380707,381011,304,RepeatMasker,LINE,380957,381036,55,0.18
ptg039587l,265663,265938,275,RepeatMasker,LINE,265836,268818,103,0.37
ptg039662l,1387580,1387885,305,RepeatMasker,LINE,1386387,1387624,44,0.14
ptg039662l,1387580,1387885,305,RepeatMasker,LINE,1387629,1388897,257,0.84
ptg040038l,62896,63184,288,RepeatMasker,LINE,62883,63016,120,0.42
ptg040204l,2961503,2961813,310,RepeatMasker,LINE,2961539,2961632,94,0.30
ptg040380l,204124,204391,267,RepeatMasker,LINE,204292,204370,79,0.30
ptg040823l,1713,1993,280,RepeatMasker,LINE,1623,1988,275,0.98
ptg040823l,1713,1993,280,RepeatMasker,LINE,1756,2820,238,0.85
ptg040900l,5449,5763,314,RepeatMasker,LINE,5183,8465,314,1.00
ptg041436l,35333,35659,326,RepeatMasker,LINE,33517,35576,243,0.75
ptg041436l,35333,35659,326,RepeatMasker,LINE,35231,35632,299,0.92
ptg041564l,3779236,3779544,308,RepeatMasker,LINE,3778853,3779257,21,0.07
ptg041564l,3779236,3779544,308,RepeatMasker,LINE,3779445,3779502,58,0.19
ptg041570l,91956,92253,297,RepeatMasker,LINE,92243,92605,11,0.04
ptg041778l,1490852,1491132,280,RepeatMasker,LINE,1490265,1491020,168,0.60
ptg041891l,17774,18094,320,RepeatMasker,LINE,17985,18059,75,0.23
ptg041910l,42649,42935,286,RepeatMasker,LINE,40325,43942,286,1.00
ptg042030l,55592,55880,288,RepeatMasker,LINE,55372,59881,288,1.00
ptg043174l,85725,85986,261,RepeatMasker,LINE,85776,85837,62,0.24
ptg043615l,1085700,1085982,282,RepeatMasker,LINE,1085683,1085753,53,0.19
ptg044139l,46317,46614,297,RepeatMasker,LINE,46379,46439,61,0.21
ptg044404l,389958,390234,276,RepeatMasker,LINE,389970,390114,145,0.53
ptg044404l,439306,439582,276,RepeatMasker,LINE,439318,439462,145,0.53
ptg047629l,14984,15271,287,RepeatMasker,LINE,11566,15032,48,0.17
ptg047629l,14984,15271,287,RepeatMasker,LINE,15134,15204,71,0.25
ptg048334l,39963,40275,312,RepeatMasker,LINE,39987,40065,79,0.25
ptg048334l,39963,40275,312,RepeatMasker,LINE,40055,43228,221,0.71
ptg049337l,184450,184782,332,RepeatMasker,LINE,184642,184864,141,0.42
ptg049474l,15407,15686,279,RepeatMasker,LINE,15564,18428,123,0.44
ptg056002l,356827,357140,313,RepeatMasker,LINE,356875,356928,54,0.17
ptg057195l,1066621,1066943,322,RepeatMasker,LINE,1066640,1066710,71,0.22
ptg000005l,10035850,10036155,305,RepeatMasker,LINE,10035681,10036344,305,1.00
ptg000008l,118468,118781,313,RepeatMasker,LINE,117904,120187,313,1.00
ptg000021l,490537,490862,325,RepeatMasker,LINE,490191,493409,325,1.00
ptg000021l,900509,900832,323,RepeatMasker,LINE,900442,900674,165,0.51
ptg000024l,4263054,4263349,295,RepeatMasker,LINE,4263100,4263165,66,0.22
ptg000027l,776435,776750,315,RepeatMasker,LINE,776345,777579,315,1.00
ptg000034l,428139,428459,320,RepeatMasker,LINE,427525,428476,320,1.00
ptg000048l,15017701,15018008,307,RepeatMasker,LINE,15017856,15017908,53,0.17
ptg000055l,532563,532878,315,RepeatMasker,LINE,532703,532756,54,0.17
ptg000065l,1867881,1868177,296,RepeatMasker,LINE,1868128,1868198,50,0.17
ptg000070l,2739014,2739300,286,RepeatMasker,LINE,2738189,2739129,115,0.40
ptg000078l,4464208,4464526,318,RepeatMasker,LINE,4464430,4464501,72,0.23
ptg000080l,2567272,2567582,310,RepeatMasker,LINE,2567499,2568131,84,0.27
ptg000082l,4757924,4758233,309,RepeatMasker,LINE,4756043,4758247,309,1.00
ptg000082l,5743542,5743830,288,RepeatMasker,LINE,5743406,5743747,205,0.71
ptg000082l,5743542,5743830,288,RepeatMasker,LINE,5743751,5744965,80,0.28
ptg000084l,226260,226583,323,RepeatMasker,LINE,223846,226507,247,0.76
ptg000097l,639317,639641,324,RepeatMasker,LINE,638934,639826,324,1.00
ptg000104l,5600594,5600892,298,RepeatMasker,LINE,5599090,5601358,298,1.00
ptg000107l,5926241,5926566,325,RepeatMasker,LINE,5926426,5926478,53,0.16
ptg000111l,1254851,1255156,305,RepeatMasker,LINE,1252889,1257148,305,1.00
ptg000117l,107560,107851,291,RepeatMasker,LINE,107219,108134,291,1.00
ptg000119l,984936,985255,319,RepeatMasker,LINE,984808,987769,319,1.00
ptg000127l,3827458,3827767,309,RepeatMasker,LINE,3827173,3827676,218,0.71
ptg000131l,3103472,3103759,287,RepeatMasker,LINE,3103543,3103629,87,0.30
ptg000131l,3103472,3103759,287,RepeatMasker,LINE,3103710,3103816,50,0.17
ptg000131l,6589313,6589607,294,RepeatMasker,LINE,6589181,6590984,294,1.00
ptg000137l,181507,181806,299,RepeatMasker,LINE,181762,182167,45,0.15
ptg000147l,937258,937566,308,RepeatMasker,LINE,936885,937832,308,1.00
ptg000147l,2143292,2143591,299,RepeatMasker,LINE,2143362,2144407,230,0.77
ptg000153l,582851,583171,320,RepeatMasker,LINE,582903,583356,269,0.84
ptg000155l,2843709,2844022,313,RepeatMasker,LINE,2843459,2843721,12,0.04
ptg000156l,4191684,4191985,301,RepeatMasker,LINE,4190666,4192237,301,1.00
ptg000170l,2201292,2201600,308,RepeatMasker,LINE,2201574,2201667,27,0.09
ptg000186l,5898370,5898698,328,RepeatMasker,LINE,5898493,5898567,75,0.23
ptg000191l,531203,531482,279,RepeatMasker,LINE,530880,531250,47,0.17
ptg000191l,531203,531482,279,RepeatMasker,LINE,531286,532459,197,0.71
ptg000195l,1643673,1643955,282,RepeatMasker,LINE,1643086,1643773,100,0.35
ptg000197l,4695294,4695619,325,RepeatMasker,LINE,4694632,4698464,325,1.00
ptg000200l,1923964,1924293,329,RepeatMasker,LINE,1921286,1924550,329,1.00
ptg000211l,91795,92124,329,RepeatMasker,LINE,91475,92051,256,0.78
ptg000212l,1545283,1545605,322,RepeatMasker,LINE,1545348,1545645,258,0.80
ptg000227l,168008,168307,299,RepeatMasker,LINE,164912,168119,111,0.37
ptg000231l,436051,436345,294,RepeatMasker,LINE,436344,436623,2,0.01
ptg000232l,2734129,2734438,309,RepeatMasker,LINE,2734368,2734439,71,0.23
ptg000234l,927015,927319,304,RepeatMasker,LINE,927116,927245,130,0.43
ptg000234l,927015,927319,304,RepeatMasker,LINE,927173,927238,66,0.22
ptg000243l,1130447,1130741,294,RepeatMasker,LINE,1130608,1130669,62,0.21
ptg000244l,8415467,8415796,329,RepeatMasker,LINE,8413164,8416063,329,1.00
ptg000247l,1245945,1246236,291,RepeatMasker,LINE,1244522,1247442,291,1.00
ptg000251l,3972835,3973134,299,RepeatMasker,LINE,3972504,3972886,51,0.17
ptg000260l,265192,265515,323,RepeatMasker,LINE,265103,265760,323,1.00
ptg000264l,904932,905238,306,RepeatMasker,LINE,905055,907983,184,0.60
ptg000267l,3510897,3511206,309,RepeatMasker,LINE,3510904,3510972,69,0.22
ptg000282l,931827,932148,321,RepeatMasker,LINE,930496,932126,299,0.93
ptg000282l,931827,932148,321,RepeatMasker,LINE,930809,932115,288,0.90
ptg000283l,816769,817109,340,RepeatMasker,LINE,817038,817103,66,0.19
ptg000286l,4807866,4808148,282,RepeatMasker,LINE,4806719,4807974,108,0.38
ptg000297l,3932055,3932381,326,RepeatMasker,LINE,3932044,3932154,99,0.30
ptg000300l,1496044,1496342,298,RepeatMasker,LINE,1495956,1497064,298,1.00
ptg000310l,675538,675829,291,RepeatMasker,LINE,675522,675562,24,0.08
ptg000319l,466790,467071,281,RepeatMasker,LINE,466703,467652,281,1.00
ptg000323l,1571480,1571751,271,RepeatMasker,LINE,1571160,1571502,22,0.08
ptg000329l,219060,219391,331,RepeatMasker,LINE,219356,219533,36,0.11
ptg000356l,806799,807114,315,RepeatMasker,LINE,806861,806931,71,0.23
ptg000359l,3249903,3250216,313,RepeatMasker,LINE,3246773,3249941,38,0.12
ptg000360l,657245,657551,306,RepeatMasker,LINE,657010,658314,306,1.00
ptg000366l,964303,964632,329,RepeatMasker,LINE,961619,964908,329,1.00
ptg000384l,2633294,2633620,326,RepeatMasker,LINE,2630562,2634711,326,1.00
ptg000388l,745589,745902,313,RepeatMasker,LINE,745761,746231,142,0.45
ptg000393l,4911818,4912108,290,RepeatMasker,LINE,4912079,4912332,30,0.10
ptg000407l,6369652,6369937,285,RepeatMasker,LINE,6369185,6370118,285,1.00
ptg000410l,2022219,2022496,277,RepeatMasker,LINE,2021421,2023396,277,1.00
ptg000410l,2022219,2022496,277,RepeatMasker,LINE,2021428,2023610,277,1.00
ptg000411l,1488248,1488576,328,RepeatMasker,LINE,1487895,1488368,120,0.37
ptg000411l,1488248,1488576,328,RepeatMasker,LINE,1488483,1488551,69,0.21
ptg000412l,1261548,1261864,316,RepeatMasker,LINE,1261599,1261644,46,0.15
ptg000424l,88867,89199,332,RepeatMasker,LINE,89197,89381,3,0.01
ptg000439l,1917905,1918201,296,RepeatMasker,LINE,1917998,1918380,204,0.69
ptg000448l,2463373,2463691,318,RepeatMasker,LINE,2463226,2463485,112,0.35
ptg000452l,4439539,4439823,284,RepeatMasker,LINE,4437177,4439766,227,0.80
ptg000455l,1036997,1037307,310,RepeatMasker,LINE,1036661,1037034,37,0.12
ptg000457l,2091301,2091570,269,RepeatMasker,LINE,2091318,2091470,153,0.57
ptg000457l,2091301,2091570,269,RepeatMasker,LINE,2091464,2091612,107,0.40
ptg000472l,3819918,3820211,293,RepeatMasker,LINE,3819938,3820016,79,0.27
ptg000473l,1302525,1302828,303,RepeatMasker,LINE,1302456,1306204,303,1.00
ptg000475l,578554,578873,319,RepeatMasker,LINE,578591,578636,46,0.14
ptg000476l,94379,94712,333,RepeatMasker,LINE,91343,94624,245,0.74
ptg000480l,3457171,3457499,328,RepeatMasker,LINE,3454436,3457727,328,1.00
ptg000493l,377663,377974,311,RepeatMasker,LINE,375969,377987,311,1.00
ptg000494l,458621,458938,317,RepeatMasker,LINE,458882,458934,53,0.17
ptg000506l,3877788,3878110,322,RepeatMasker,LINE,3875620,3878783,322,1.00
ptg000507l,135925,136213,288,RepeatMasker,LINE,135156,136090,165,0.57
ptg000511l,8058707,8059018,311,RepeatMasker,LINE,8058427,8058836,129,0.41
ptg000519l,1775431,1775752,321,RepeatMasker,LINE,1775275,1775770,321,1.00
ptg000519l,12548387,12548667,280,RepeatMasker,LINE,12548381,12548951,280,1.00
ptg000523l,573267,573574,307,RepeatMasker,LINE,573433,573544,112,0.36
ptg000523l,4325155,4325448,293,RepeatMasker,LINE,4325419,4325875,30,0.10
ptg000523l,5527012,5527334,322,RepeatMasker,LINE,5525850,5527300,288,0.89
ptg000528l,2678364,2678699,335,RepeatMasker,LINE,2675428,2678697,333,0.99
ptg000531l,2103462,2103756,294,RepeatMasker,LINE,2101365,2103867,294,1.00
ptg000547l,558252,558548,296,RepeatMasker,LINE,558015,558329,77,0.26
ptg000553l,1336901,1337203,302,RepeatMasker,LINE,1336788,1337065,164,0.54
ptg000558l,2500403,2500722,319,RepeatMasker,LINE,2499489,2500783,319,1.00
ptg000566l,1030999,1031294,295,RepeatMasker,LINE,1031221,1032035,74,0.25
ptg000573l,695677,695970,293,RepeatMasker,LINE,695590,695769,92,0.31
ptg000576l,2983739,2984062,323,RepeatMasker,LINE,2984030,2984172,33,0.10
ptg000576l,3253945,3254273,328,RepeatMasker,LINE,3253305,3254396,328,1.00
ptg000577l,2481021,2481317,296,RepeatMasker,LINE,2481095,2481794,223,0.75
ptg000578l,183240,183544,304,RepeatMasker,LINE,183151,183375,135,0.44
ptg000581l,1333940,1334226,286,RepeatMasker,LINE,1331683,1334161,221,0.77
ptg000585l,1172904,1173229,325,RepeatMasker,LINE,1172582,1173429,325,1.00
ptg000590l,943300,943609,309,RepeatMasker,LINE,943549,943641,61,0.20
ptg000613l,3382092,3382390,298,RepeatMasker,LINE,3382088,3382596,298,1.00
ptg000614l,1381065,1381352,287,RepeatMasker,LINE,1379131,1382253,287,1.00
ptg000615l,982927,983240,313,RepeatMasker,LINE,983002,983706,239,0.76
ptg000620l,4000209,4000524,315,RepeatMasker,LINE,3999495,4003340,315,1.00
ptg000624l,91230,91527,297,RepeatMasker,LINE,90895,91249,19,0.06
ptg000632l,3756754,3757023,269,RepeatMasker,LINE,3756594,3756867,113,0.42
ptg000633l,4168095,4168380,285,RepeatMasker,LINE,4165860,4168196,101,0.35
ptg000636l,250929,251226,297,RepeatMasker,LINE,250827,251183,254,0.86
ptg000640l,1113203,1113485,282,RepeatMasker,LINE,1113194,1113303,100,0.35
ptg000640l,1435029,1435343,314,RepeatMasker,LINE,1435266,1435336,71,0.23
ptg000642l,1895572,1895871,299,RepeatMasker,LINE,1895822,1895894,50,0.17
ptg000645l,502970,503240,270,RepeatMasker,LINE,503067,503136,70,0.26
ptg000645l,2149831,2150148,317,RepeatMasker,LINE,2148268,2151595,317,1.00
ptg000660l,911836,912131,295,RepeatMasker,LINE,911278,912099,263,0.89
ptg000670l,4769463,4769742,279,RepeatMasker,LINE,4767953,4769793,279,1.00
ptg000672l,560493,560830,337,RepeatMasker,LINE,557643,560809,316,0.94
ptg000689l,2941906,2942215,309,RepeatMasker,LINE,2942033,2942859,183,0.59
ptg000695l,225270,225579,309,RepeatMasker,LINE,225212,225308,38,0.12
ptg000704l,1039204,1039521,317,RepeatMasker,LINE,1037581,1039455,251,0.79
ptg000709l,1428268,1428592,324,RepeatMasker,LINE,1428254,1428394,126,0.39
ptg000723l,4105691,4105985,294,RepeatMasker,LINE,4103010,4105798,107,0.36
ptg000723l,4105691,4105985,294,RepeatMasker,LINE,4105791,4106294,195,0.66
ptg000728l,351205,351474,269,RepeatMasker,LINE,349110,351349,144,0.54
ptg000735l,948864,949174,310,RepeatMasker,LINE,948440,949103,239,0.77
ptg000739l,4362778,4363069,291,RepeatMasker,LINE,4362733,4362793,15,0.05
ptg000741l,3955552,3955842,290,RepeatMasker,LINE,3955457,3955705,153,0.53
ptg000742l,2861787,2862088,301,RepeatMasker,LINE,2861460,2861913,126,0.42
ptg000748l,1225481,1225748,267,RepeatMasker,LINE,1223512,1225717,236,0.88
ptg000748l,1917623,1917931,308,RepeatMasker,LINE,1917280,1917811,188,0.61
ptg000748l,2068852,2069187,335,RepeatMasker,LINE,2068965,2069105,141,0.42
ptg000748l,2068852,2069187,335,RepeatMasker,LINE,2068974,2069094,121,0.36
ptg000751l,2233616,2233932,316,RepeatMasker,LINE,2233455,2233638,22,0.07
ptg000766l,2290214,2290539,325,RepeatMasker,LINE,2289856,2292574,325,1.00
ptg000769l,2151379,2151697,318,RepeatMasker,LINE,2151370,2151472,93,0.29
ptg000772l,1897560,1897870,310,RepeatMasker,LINE,1897554,1900461,310,1.00
ptg000776l,3316387,3316688,301,RepeatMasker,LINE,3316563,3316788,126,0.42
ptg000777l,404210,404543,333,RepeatMasker,LINE,404062,404306,96,0.29
ptg000781l,290930,291259,329,RepeatMasker,LINE,287798,291060,130,0.40
ptg000786l,1507733,1508067,334,RepeatMasker,LINE,1507316,1508069,334,1.00
ptg000789l,1684258,1684544,286,RepeatMasker,LINE,1684497,1684574,48,0.17
ptg000795l,2651190,2651485,295,RepeatMasker,LINE,2651335,2651688,151,0.51
ptg000805l,1663418,1663737,319,RepeatMasker,LINE,1662406,1663529,111,0.35
ptg000806l,207222,207486,264,RepeatMasker,LINE,207269,207336,68,0.26
ptg000806l,207222,207486,264,RepeatMasker,LINE,207447,207611,40,0.15
ptg000806l,1614523,1614791,268,RepeatMasker,LINE,1613992,1614534,11,0.04
ptg000819l,3207351,3207675,324,RepeatMasker,LINE,3207010,3209874,324,1.00
ptg000823l,1565226,1565543,317,RepeatMasker,LINE,1565454,1565524,71,0.22
ptg000823l,1565226,1565543,317,RepeatMasker,LINE,1565531,1566131,13,0.04
ptg000826l,297203,297480,277,RepeatMasker,LINE,297211,297306,96,0.35
ptg000836l,757713,758012,299,RepeatMasker,LINE,757842,757933,92,0.31
ptg000842l,1038718,1039045,327,RepeatMasker,LINE,1038781,1039060,265,0.81
ptg000851l,3181780,3182084,304,RepeatMasker,LINE,3180388,3182516,304,1.00
ptg000867l,1462985,1463299,314,RepeatMasker,LINE,1463085,1464416,215,0.68
ptg000874l,1289044,1289353,309,RepeatMasker,LINE,1289248,1289313,66,0.21
ptg000875l,436348,436645,297,RepeatMasker,LINE,436622,436717,24,0.08
ptg000878l,205749,206051,302,RepeatMasker,LINE,205730,208502,302,1.00
ptg000881l,2387285,2387550,265,RepeatMasker,LINE,2387365,2387427,63,0.24
ptg000881l,2387285,2387550,265,RepeatMasker,LINE,2387440,2387516,77,0.29
ptg000881l,2387285,2387550,265,RepeatMasker,LINE,2387450,2387794,101,0.38
ptg000883l,218015,218283,268,RepeatMasker,LINE,217877,218246,231,0.86
ptg000885l,3104517,3104828,311,RepeatMasker,LINE,3104391,3104689,172,0.55
ptg000885l,3104517,3104828,311,RepeatMasker,LINE,3104609,3105012,220,0.71
ptg000885l,3415073,3415335,262,RepeatMasker,LINE,3415271,3415497,65,0.25
ptg000888l,946970,947291,321,RepeatMasker,LINE,946280,947318,321,1.00
ptg000891l,715551,715888,337,RepeatMasker,LINE,715559,715840,282,0.84
ptg000891l,715551,715888,337,RepeatMasker,LINE,715603,716505,286,0.85
ptg000893l,1310813,1311100,287,RepeatMasker,LINE,1307877,1311264,287,1.00
ptg000896l,4123686,4123994,308,RepeatMasker,LINE,4123268,4126535,308,1.00
ptg000900l,216198,216505,307,RepeatMasker,LINE,215943,216640,307,1.00
ptg000917l,893543,893815,272,RepeatMasker,LINE,892180,894154,272,1.00
ptg000922l,438337,438625,288,RepeatMasker,LINE,436783,439582,288,1.00
ptg000925l,915850,916148,298,RepeatMasker,LINE,915654,915953,103,0.35
ptg000926l,3551810,3552101,291,RepeatMasker,LINE,3551222,3554494,291,1.00
ptg000929l,739076,739363,287,RepeatMasker,LINE,738740,739144,68,0.24
ptg000938l,1058700,1058971,271,RepeatMasker,LINE,1057334,1059259,271,1.00
ptg000944l,599069,599371,302,RepeatMasker,LINE,599269,599340,72,0.24
ptg000952l,275477,275790,313,RepeatMasker,LINE,273698,275839,313,1.00
ptg000958l,1622932,1623234,302,RepeatMasker,LINE,1622821,1626654,302,1.00
ptg000959l,2173285,2173568,283,RepeatMasker,LINE,2172336,2173495,210,0.74
ptg000961l,699170,699490,320,RepeatMasker,LINE,697948,699452,282,0.88
ptg000965l,813992,814298,306,RepeatMasker,LINE,814144,814241,98,0.32
ptg000966l,2880317,2880596,279,RepeatMasker,LINE,2878096,2880853,279,1.00
ptg000966l,3009668,3009975,307,RepeatMasker,LINE,3009739,3009794,56,0.18
ptg000966l,3009668,3009975,307,RepeatMasker,LINE,3009921,3012289,55,0.18
ptg000967l,858946,859240,294,RepeatMasker,LINE,859033,859114,82,0.28
ptg000967l,2668040,2668357,317,RepeatMasker,LINE,2667498,2668117,77,0.24
ptg000967l,4466888,4467201,313,RepeatMasker,LINE,4466130,4467193,305,0.97
ptg000975l,973295,973590,295,RepeatMasker,LINE,973359,973406,48,0.16
ptg000977l,2019531,2019807,276,RepeatMasker,LINE,2019704,2019765,62,0.22
ptg000979l,119530,119845,315,RepeatMasker,LINE,119391,119645,115,0.37
ptg000980l,751551,751847,296,RepeatMasker,LINE,751621,752135,227,0.77
ptg001000l,355796,356088,292,RepeatMasker,LINE,356016,356075,60,0.21
ptg001008l,48849,49165,316,RepeatMasker,LINE,48494,48875,26,0.08
ptg001019l,1672323,1672643,320,RepeatMasker,LINE,1671579,1675184,320,1.00
ptg001020l,848455,848758,303,RepeatMasker,LINE,848757,848826,2,0.01
ptg001033l,2111739,2112027,288,RepeatMasker,LINE,2111505,2112782,288,1.00
ptg001041l,581033,581348,315,RepeatMasker,LINE,581299,581369,50,0.16
ptg001041l,3633422,3633723,301,RepeatMasker,LINE,3633161,3633940,301,1.00
ptg001058l,984245,984532,287,RepeatMasker,LINE,984319,984639,214,0.75
ptg001068l,2251865,2252183,318,RepeatMasker,LINE,2251705,2253083,318,1.00
ptg001068l,2251865,2252183,318,RepeatMasker,LINE,2251840,2252934,318,1.00
ptg001075l,1047819,1048102,283,RepeatMasker,LINE,1047858,1047910,53,0.19
ptg001082l,130882,131210,328,RepeatMasker,LINE,131135,131207,73,0.22
ptg001083l,2721553,2721879,326,RepeatMasker,LINE,2721682,2721765,84,0.26
ptg001088l,1531483,1531783,300,RepeatMasker,LINE,1531756,1531857,28,0.09
ptg001093l,4761309,4761595,286,RepeatMasker,LINE,4759456,4761576,267,0.93
ptg001093l,4761309,4761595,286,RepeatMasker,LINE,4761520,4761615,76,0.27
ptg001094l,678978,679292,314,RepeatMasker,LINE,676308,679558,314,1.00
ptg001101l,2380514,2380834,320,RepeatMasker,LINE,2380259,2380708,194,0.61
ptg001101l,2380514,2380834,320,RepeatMasker,LINE,2380309,2380707,193,0.60
ptg001102l,422885,423191,306,RepeatMasker,LINE,423046,423125,80,0.26
ptg001106l,1608732,1609016,284,RepeatMasker,LINE,1608920,1609402,97,0.34
ptg001106l,2746933,2747227,294,RepeatMasker,LINE,2747105,2751026,123,0.42
ptg001115l,5233701,5233986,285,RepeatMasker,LINE,5233454,5234528,285,1.00
ptg001122l,2825335,2825656,321,RepeatMasker,LINE,2825069,2825674,321,1.00
ptg001131l,4719751,4720078,327,RepeatMasker,LINE,4719683,4719756,5,0.02
ptg001134l,294955,295243,288,RepeatMasker,LINE,295125,295627,119,0.41
ptg001134l,1199163,1199471,308,RepeatMasker,LINE,1198994,1199293,130,0.42
ptg001134l,1199163,1199471,308,RepeatMasker,LINE,1199034,1199314,151,0.49
ptg001138l,358240,358544,304,RepeatMasker,LINE,357750,359283,304,1.00
ptg001145l,239602,239911,309,RepeatMasker,LINE,239227,240242,309,1.00
ptg001145l,239602,239911,309,RepeatMasker,LINE,239656,240265,256,0.83
ptg001146l,4201361,4201649,288,RepeatMasker,LINE,4201510,4201742,140,0.49
ptg001154l,1031712,1031995,283,RepeatMasker,LINE,1031615,1031958,246,0.87
ptg001154l,1031712,1031995,283,RepeatMasker,LINE,1031694,1031925,213,0.75
ptg001161l,6840542,6840790,248,RepeatMasker,LINE,6840580,6840665,86,0.35
ptg001162l,4770576,4770873,297,RepeatMasker,LINE,4770723,4771083,151,0.51
ptg001164l,589930,590209,279,RepeatMasker,LINE,589127,590013,83,0.30
ptg001165l,1545182,1545507,325,RepeatMasker,LINE,1544842,1548077,325,1.00
ptg001175l,273902,274227,325,RepeatMasker,LINE,273752,276804,325,1.00
ptg001190l,223539,223824,285,RepeatMasker,LINE,223775,223846,50,0.18
ptg001211l,565517,565808,291,RepeatMasker,LINE,564491,565788,271,0.93
ptg001215l,9654358,9654649,291,RepeatMasker,LINE,9653880,9654402,44,0.15
ptg001223l,3958743,3959073,330,RepeatMasker,LINE,3958968,3959116,106,0.32
ptg001223l,4254271,4254596,325,RepeatMasker,LINE,4254449,4255710,148,0.46
ptg001232l,4934553,4934830,277,RepeatMasker,LINE,4934635,4934713,79,0.29
ptg001239l,555011,555327,316,RepeatMasker,LINE,555144,555239,96,0.30
ptg001248l,62065,62371,306,RepeatMasker,LINE,61564,64314,306,1.00
ptg001271l,207425,207711,286,RepeatMasker,LINE,207535,207803,177,0.62
ptg001271l,922713,923038,325,RepeatMasker,LINE,922111,924256,325,1.00
ptg001284l,3457359,3457670,311,RepeatMasker,LINE,3455523,3457392,33,0.11
ptg001288l,2334253,2334534,281,RepeatMasker,LINE,2333258,2334312,59,0.21
ptg001290l,3702369,3702695,326,RepeatMasker,LINE,3702039,3702595,226,0.69
ptg001292l,4047550,4047879,329,RepeatMasker,LINE,4047733,4048087,147,0.45
ptg001301l,683229,683542,313,RepeatMasker,LINE,683156,683294,65,0.21
ptg001301l,683229,683542,313,RepeatMasker,LINE,683406,683474,69,0.22
ptg001302l,924300,924607,307,RepeatMasker,LINE,923484,924318,18,0.06
ptg001305l,1055867,1056157,290,RepeatMasker,LINE,1055019,1057261,290,1.00
ptg001305l,3142714,3142996,282,RepeatMasker,LINE,3142335,3142875,161,0.57
ptg001305l,7204746,7205060,314,RepeatMasker,LINE,7204692,7206439,314,1.00
ptg001312l,606043,606311,268,RepeatMasker,LINE,606180,606266,87,0.32
ptg001313l,1829760,1830073,313,RepeatMasker,LINE,1829873,1830798,201,0.64
ptg001316l,1921161,1921460,299,RepeatMasker,LINE,1921182,1921233,52,0.17
ptg001316l,1921161,1921460,299,RepeatMasker,LINE,1921379,1921500,82,0.27
ptg001317l,1464777,1465054,277,RepeatMasker,LINE,1464695,1464939,162,0.58
ptg001342l,1104008,1104292,284,RepeatMasker,LINE,1104039,1104128,90,0.32
ptg001351l,2683319,2683595,276,RepeatMasker,LINE,2683304,2683373,54,0.20
ptg001351l,4166750,4167022,272,RepeatMasker,LINE,4163614,4166889,139,0.51
ptg001353l,519451,519780,329,RepeatMasker,LINE,517355,519987,329,1.00
ptg001353l,519451,519780,329,RepeatMasker,LINE,518797,519948,329,1.00
ptg001371l,2867128,2867447,319,RepeatMasker,LINE,2866910,2867229,101,0.32
ptg001371l,2867128,2867447,319,RepeatMasker,LINE,2867028,2867327,199,0.62
ptg001371l,4508281,4508568,287,RepeatMasker,LINE,4508445,4509454,124,0.43
ptg001371l,9693740,9694076,336,RepeatMasker,LINE,9692285,9694026,286,0.85
ptg001377l,376435,376748,313,RepeatMasker,LINE,373794,377541,313,1.00
ptg001379l,2323414,2323693,279,RepeatMasker,LINE,2323294,2323796,279,1.00
ptg001379l,2323414,2323693,279,RepeatMasker,LINE,2323313,2323743,279,1.00
ptg001381l,4643369,4643693,324,RepeatMasker,LINE,4643592,4643641,50,0.15
ptg001381l,4643369,4643693,324,RepeatMasker,LINE,4643598,4643643,46,0.14
ptg001382l,1226472,1226778,306,RepeatMasker,LINE,1226599,1226773,175,0.57
ptg001390l,4490130,4490447,317,RepeatMasker,LINE,4490323,4490368,46,0.15
ptg001393l,2926746,2927020,274,RepeatMasker,LINE,2925405,2927101,274,1.00
ptg001394l,649911,650219,308,RepeatMasker,LINE,649560,650133,222,0.72
ptg001401l,1014833,1015102,269,RepeatMasker,LINE,1014746,1014898,65,0.24
ptg001425l,726188,726492,304,RepeatMasker,LINE,726214,726921,279,0.92
ptg001429l,1773600,1773908,308,RepeatMasker,LINE,1773267,1773851,251,0.81
ptg001432l,1841588,1841907,319,RepeatMasker,LINE,1841716,1841786,71,0.22
ptg001432l,1841588,1841907,319,RepeatMasker,LINE,1841719,1841800,82,0.26
ptg001433l,812480,812749,269,RepeatMasker,LINE,811655,812543,63,0.23
ptg001440l,202648,202963,315,RepeatMasker,LINE,198978,202731,83,0.26
ptg001456l,1778226,1778562,336,RepeatMasker,LINE,1775968,1779241,336,1.00
ptg001456l,2581161,2581487,326,RepeatMasker,LINE,2581215,2582094,273,0.84
ptg001457l,2071933,2072256,323,RepeatMasker,LINE,2070924,2072733,323,1.00
ptg001461l,1603044,1603343,299,RepeatMasker,LINE,1603115,1603251,137,0.46
ptg001465l,207567,207889,322,RepeatMasker,LINE,207803,208154,87,0.27
ptg001465l,368756,369077,321,RepeatMasker,LINE,365616,368888,132,0.41
ptg001465l,867017,867313,296,RepeatMasker,LINE,867162,867217,56,0.19
ptg001478l,89260,89569,309,RepeatMasker,LINE,89245,89348,88,0.28
ptg001481l,1489700,1490016,316,RepeatMasker,LINE,1489225,1490800,316,1.00
ptg001481l,3481544,3481859,315,RepeatMasker,LINE,3480989,3481607,63,0.20
ptg001486l,310050,310342,292,RepeatMasker,LINE,310002,310063,13,0.04
ptg001500l,687126,687392,266,RepeatMasker,LINE,686002,687296,170,0.64
ptg001502l,2087096,2087417,321,RepeatMasker,LINE,2087417,2088271,1,0.00
ptg001505l,4573635,4573911,276,RepeatMasker,LINE,4572823,4573763,128,0.46
ptg001505l,4573635,4573911,276,RepeatMasker,LINE,4573613,4575361,276,1.00
ptg001509l,2499530,2499838,308,RepeatMasker,LINE,2499527,2500403,308,1.00
ptg001509l,2511073,2511381,308,RepeatMasker,LINE,2511070,2511684,308,1.00
ptg001513l,2964836,2965139,303,RepeatMasker,LINE,2965089,2966542,51,0.17
ptg001518l,2909100,2909386,286,RepeatMasker,LINE,2907243,2909367,267,0.93
ptg001518l,2909100,2909386,286,RepeatMasker,LINE,2909311,2909401,76,0.27
ptg001519l,2343686,2343991,305,RepeatMasker,LINE,2343596,2344656,305,1.00
ptg001525l,2715424,2715725,301,RepeatMasker,LINE,2715628,2716836,98,0.33
ptg001529l,234532,234845,313,RepeatMasker,LINE,234772,234842,71,0.23
ptg001529l,333736,334043,307,RepeatMasker,LINE,330821,333900,164,0.53
ptg001537l,487319,487621,302,RepeatMasker,LINE,487573,487648,49,0.16
ptg001556l,247917,248224,307,RepeatMasker,LINE,247885,250168,307,1.00
ptg001557l,252084,252405,321,RepeatMasker,LINE,252116,252182,67,0.21
ptg001564l,2293270,2293574,304,RepeatMasker,LINE,2293494,2293549,56,0.18
ptg001570l,631015,631330,315,RepeatMasker,LINE,630846,631057,42,0.13
ptg001575l,1847246,1847569,323,RepeatMasker,LINE,1847301,1847843,269,0.83
ptg001575l,2261733,2262031,298,RepeatMasker,LINE,2260646,2261815,82,0.28
ptg001577l,267897,268201,304,RepeatMasker,LINE,267537,267959,62,0.20
ptg001578l,3140916,3141246,330,RepeatMasker,LINE,3138236,3141497,330,1.00
ptg001583l,1342960,1343258,298,RepeatMasker,LINE,1343009,1343054,46,0.15
ptg001585l,189461,189771,310,RepeatMasker,LINE,189613,192042,159,0.51
ptg001588l,4965972,4966293,321,RepeatMasker,LINE,4962509,4966152,180,0.56
ptg001589l,3055150,3055465,315,RepeatMasker,LINE,3055165,3055314,150,0.48
ptg001590l,2598248,2598571,323,RepeatMasker,LINE,2595657,2598384,136,0.42
ptg001596l,810702,811004,302,RepeatMasker,LINE,810897,810950,54,0.18
ptg001598l,1377217,1377536,319,RepeatMasker,LINE,1376815,1377323,106,0.33
ptg001603l,23849,24125,276,RepeatMasker,LINE,24021,24606,105,0.38
ptg001603l,67743,68048,305,RepeatMasker,LINE,67179,67999,256,0.84
ptg001606l,1651929,1652255,326,RepeatMasker,LINE,1651726,1652048,119,0.37
ptg001609l,685302,685567,265,RepeatMasker,LINE,683497,685384,82,0.31
ptg001611l,209542,209822,280,RepeatMasker,LINE,209716,211165,107,0.38
ptg001614l,400023,400315,292,RepeatMasker,LINE,399819,400079,56,0.19
ptg001615l,3645279,3645570,291,RepeatMasker,LINE,3644537,3645868,291,1.00
ptg001619l,394213,394536,323,RepeatMasker,LINE,393878,395583,323,1.00
ptg001620l,2246851,2247148,297,RepeatMasker,LINE,2245157,2247307,297,1.00
ptg001637l,84228,84488,260,RepeatMasker,LINE,83180,84258,30,0.12
ptg001649l,719531,719825,294,RepeatMasker,LINE,719825,719894,1,0.00
ptg001649l,1273200,1273443,243,RepeatMasker,LINE,1271979,1273219,19,0.08
ptg001656l,3665076,3665374,298,RepeatMasker,LINE,3664753,3665262,186,0.62
ptg001656l,4271710,4272042,332,RepeatMasker,LINE,4269001,4272315,332,1.00
ptg001663l,6116430,6116739,309,RepeatMasker,LINE,6116106,6116669,239,0.77
ptg001666l,2377947,2378219,272,RepeatMasker,LINE,2377278,2378428,272,1.00
ptg001666l,5719771,5720062,291,RepeatMasker,LINE,5719880,5719941,62,0.21
ptg001666l,5719771,5720062,291,RepeatMasker,LINE,5719890,5721521,173,0.59
ptg001671l,6940671,6940970,299,RepeatMasker,LINE,6940437,6941094,299,1.00
ptg001671l,6940671,6940970,299,RepeatMasker,LINE,6940509,6941210,299,1.00
ptg001678l,655980,656297,317,RepeatMasker,LINE,656067,656626,231,0.73
ptg001681l,1005150,1005426,276,RepeatMasker,LINE,1005310,1005395,86,0.31
ptg001681l,1013824,1014159,335,RepeatMasker,LINE,1012247,1014149,325,0.97
ptg001681l,3976689,3976969,280,RepeatMasker,LINE,3975861,3978273,280,1.00
ptg001682l,2568937,2569253,316,RepeatMasker,LINE,2569182,2569227,46,0.15
ptg001687l,4273420,4273713,293,RepeatMasker,LINE,4273144,4273836,293,1.00
ptg001695l,40026,40357,331,RepeatMasker,LINE,39708,40093,67,0.20
ptg001695l,40026,40357,331,RepeatMasker,LINE,40094,41757,264,0.80
ptg001702l,2863675,2864016,341,RepeatMasker,LINE,2862548,2866744,341,1.00
ptg001704l,1112117,1112418,301,RepeatMasker,LINE,1111438,1112200,83,0.28
ptg001704l,3208004,3208279,275,RepeatMasker,LINE,3205241,3208166,162,0.59
ptg001704l,6416072,6416365,293,RepeatMasker,LINE,6415705,6417083,293,1.00
ptg001704l,6416072,6416365,293,RepeatMasker,LINE,6416171,6417193,195,0.67
ptg001714l,1960348,1960623,275,RepeatMasker,LINE,1959620,1960724,275,1.00
ptg001714l,1960348,1960623,275,RepeatMasker,LINE,1959791,1960489,141,0.51
ptg001714l,2095798,2096095,297,RepeatMasker,LINE,2093688,2097048,297,1.00
ptg001716l,520705,521005,300,RepeatMasker,LINE,520891,520946,56,0.19
ptg001718l,515368,515679,311,RepeatMasker,LINE,515537,518414,143,0.46
ptg001723l,603090,603392,302,RepeatMasker,LINE,603383,604490,10,0.03
ptg001732l,1833594,1833887,293,RepeatMasker,LINE,1833258,1834358,293,1.00
ptg001733l,2758482,2758797,315,RepeatMasker,LINE,2758523,2759312,275,0.87
ptg001740l,3990764,3991083,319,RepeatMasker,LINE,3990848,3990903,56,0.18
ptg001746l,5067240,5067548,308,RepeatMasker,LINE,5066850,5067336,96,0.31
ptg001750l,273390,273700,310,RepeatMasker,LINE,272881,273493,103,0.33
ptg001773l,2422032,2422318,286,RepeatMasker,LINE,2422114,2422701,205,0.72
ptg001773l,2422032,2422318,286,RepeatMasker,LINE,2422122,2422875,197,0.69
ptg001774l,1353247,1353531,284,RepeatMasker,LINE,1352974,1353405,158,0.56
ptg001792l,2444639,2444946,307,RepeatMasker,LINE,2443592,2444686,47,0.15
ptg001793l,1069622,1069939,317,RepeatMasker,LINE,1066157,1070198,317,1.00
ptg001794l,1097551,1097834,283,RepeatMasker,LINE,1097645,1098718,190,0.67
ptg001799l,6007287,6007568,281,RepeatMasker,LINE,6007466,6007592,103,0.37
ptg001815l,2146170,2146475,305,RepeatMasker,LINE,2146211,2148184,265,0.87
ptg001828l,182567,182870,303,RepeatMasker,LINE,182502,182637,70,0.23
ptg001837l,2580256,2580569,313,RepeatMasker,LINE,2578954,2580806,313,1.00
ptg001837l,2580256,2580569,313,RepeatMasker,LINE,2579145,2580802,313,1.00
ptg001837l,2624315,2624604,289,RepeatMasker,LINE,2624224,2626510,289,1.00
ptg001841l,1143679,1143975,296,RepeatMasker,LINE,1143252,1144933,296,1.00
ptg001844l,1308110,1308418,308,RepeatMasker,LINE,1307152,1308262,152,0.49
ptg001848l,1399335,1399611,276,RepeatMasker,LINE,1398436,1399744,276,1.00
ptg001859l,1188322,1188649,327,RepeatMasker,LINE,1185628,1188523,201,0.61
ptg001859l,1388052,1388380,328,RepeatMasker,LINE,1385798,1389025,328,1.00
ptg001878l,2106322,2106633,311,RepeatMasker,LINE,2103755,2106507,185,0.59
ptg001881l,594994,595297,303,RepeatMasker,LINE,595220,595772,78,0.26
ptg001890l,1217814,1218078,264,RepeatMasker,LINE,1217931,1217976,46,0.17
ptg001891l,4959418,4959694,276,RepeatMasker,LINE,4959509,4959982,186,0.67
ptg001901l,108346,108650,304,RepeatMasker,LINE,108385,108476,92,0.30
ptg001902l,1034835,1035150,315,RepeatMasker,LINE,1035066,1035222,85,0.27
ptg001905l,132109,132405,296,RepeatMasker,LINE,130477,132762,296,1.00
ptg001905l,132109,132405,296,RepeatMasker,LINE,130479,133440,296,1.00
ptg001918l,2364258,2364586,328,RepeatMasker,LINE,2363432,2364841,328,1.00
ptg001921l,1416728,1417008,280,RepeatMasker,LINE,1416875,1416920,46,0.16
ptg001934l,1850396,1850719,323,RepeatMasker,LINE,1850231,1850477,81,0.25
ptg001934l,1850396,1850719,323,RepeatMasker,LINE,1850231,1850515,119,0.37
ptg001934l,1850396,1850719,323,RepeatMasker,LINE,1850276,1850509,113,0.35
ptg001940l,1762945,1763239,294,RepeatMasker,LINE,1760042,1763030,85,0.29
ptg001944l,1174087,1174407,320,RepeatMasker,LINE,1174109,1174411,299,0.93
ptg001944l,1174087,1174407,320,RepeatMasker,LINE,1174128,1174631,280,0.88
ptg001953l,407069,407395,326,RepeatMasker,LINE,405774,407267,198,0.61
ptg001956l,112656,112974,318,RepeatMasker,LINE,112436,113065,318,1.00
ptg001958l,1117528,1117846,318,RepeatMasker,LINE,1116553,1120377,318,1.00
ptg001959l,570149,570435,286,RepeatMasker,LINE,567868,570157,8,0.03
ptg001964l,1572198,1572530,332,RepeatMasker,LINE,1572314,1573160,217,0.65
ptg001968l,450842,451155,313,RepeatMasker,LINE,451017,451062,46,0.15
ptg001974l,2957289,2957596,307,RepeatMasker,LINE,2957278,2958443,307,1.00
ptg001985l,1250671,1250939,268,RepeatMasker,LINE,1248596,1251141,268,1.00
ptg001987l,222200,222527,327,RepeatMasker,LINE,222287,223570,241,0.74
ptg001989l,1530291,1530594,303,RepeatMasker,LINE,1529957,1530500,209,0.69
ptg001992l,1800299,1800606,307,RepeatMasker,LINE,1800026,1801401,307,1.00
ptg001993l,2072098,2072430,332,RepeatMasker,LINE,2072232,2072328,97,0.29
ptg002015l,3194095,3194373,278,RepeatMasker,LINE,3194203,3194365,163,0.59
ptg002018l,1518261,1518554,293,RepeatMasker,LINE,1518362,1519548,193,0.66
ptg002024l,3949973,3950274,301,RepeatMasker,LINE,3949094,3950175,202,0.67
ptg002042l,127745,128051,306,RepeatMasker,LINE,127497,127782,37,0.12
ptg002042l,127745,128051,306,RepeatMasker,LINE,127569,127765,20,0.07
ptg002042l,127745,128051,306,RepeatMasker,LINE,127783,127860,78,0.25
ptg002043l,4217143,4217426,283,RepeatMasker,LINE,4216783,4217237,94,0.33
ptg002043l,4217143,4217426,283,RepeatMasker,LINE,4216972,4217317,174,0.61
ptg002043l,4449269,4449591,322,RepeatMasker,LINE,4447423,4449351,82,0.25
ptg002054l,567236,567518,282,RepeatMasker,LINE,565808,567469,233,0.83
ptg002055l,2503532,2503822,290,RepeatMasker,LINE,2503538,2503932,285,0.98
ptg002063l,1705985,1706292,307,RepeatMasker,LINE,1706070,1706158,89,0.29
ptg002063l,1804148,1804451,303,RepeatMasker,LINE,1803806,1804256,108,0.36
ptg002064l,841598,841882,284,RepeatMasker,LINE,840974,841624,26,0.09
ptg002064l,841598,841882,284,RepeatMasker,LINE,841473,841643,45,0.16
ptg002073l,1750355,1750654,299,RepeatMasker,LINE,1750605,1750680,50,0.17
ptg002079l,1025537,1025835,298,RepeatMasker,LINE,1025024,1025542,5,0.02
ptg002083l,1015193,1015519,326,RepeatMasker,LINE,1015333,1016010,187,0.57
ptg002086l,3367744,3368021,277,RepeatMasker,LINE,3366760,3367874,130,0.47
ptg002086l,3367744,3368021,277,RepeatMasker,LINE,3366912,3367916,172,0.62
ptg002087l,986548,986824,276,RepeatMasker,LINE,986716,986800,85,0.31
ptg002109l,1528489,1528822,333,RepeatMasker,LINE,1528591,1528677,87,0.26
ptg002121l,294522,294851,329,RepeatMasker,LINE,292674,295111,329,1.00
ptg002129l,4182664,4182964,300,RepeatMasker,LINE,4182776,4186025,189,0.63
ptg002134l,4770338,4770650,312,RepeatMasker,LINE,4770097,4770714,312,1.00
ptg002136l,1673274,1673586,312,RepeatMasker,LINE,1672941,1676168,312,1.00
ptg002146l,97427,97742,315,RepeatMasker,LINE,97737,97826,6,0.02
ptg002158l,3253261,3253556,295,RepeatMasker,LINE,3253551,3253640,6,0.02
ptg002174l,3717774,3718086,312,RepeatMasker,LINE,3717231,3718021,247,0.79
ptg002178l,1177407,1177686,279,RepeatMasker,LINE,1177305,1177429,22,0.08
ptg002192l,1499524,1499827,303,RepeatMasker,LINE,1499528,1499654,127,0.42
ptg002207l,718009,718329,320,RepeatMasker,LINE,717725,718152,143,0.45
ptg002217l,3089369,3089672,303,RepeatMasker,LINE,3089537,3090576,136,0.45
ptg002221l,6174780,6175056,276,RepeatMasker,LINE,6173187,6175003,223,0.81
ptg002221l,6174780,6175056,276,RepeatMasker,LINE,6174951,6175011,61,0.22
ptg002226l,679830,680136,306,RepeatMasker,LINE,680064,680133,70,0.23
ptg002233l,4238836,4239127,291,RepeatMasker,LINE,4239013,4239461,115,0.40
ptg002241l,1715823,1716137,314,RepeatMasker,LINE,1714519,1716368,314,1.00
ptg002251l,590267,590546,279,RepeatMasker,LINE,590387,590451,65,0.23
ptg002253l,1359944,1360246,302,RepeatMasker,LINE,1358864,1360144,200,0.66
ptg002268l,3036761,3037097,336,RepeatMasker,LINE,3036007,3039932,336,1.00
ptg002269l,269240,269527,287,RepeatMasker,LINE,266749,270492,287,1.00
ptg002298l,477348,477651,303,RepeatMasker,LINE,477230,477429,81,0.27
ptg002308l,2687244,2687569,325,RepeatMasker,LINE,2687272,2689407,298,0.92
ptg002309l,1856368,1856656,288,RepeatMasker,LINE,1852439,1856613,245,0.85
ptg002315l,1589718,1590023,305,RepeatMasker,LINE,1589663,1589839,121,0.40
ptg002322l,1104328,1104641,313,RepeatMasker,LINE,1104062,1104535,207,0.66
ptg002322l,1104328,1104641,313,RepeatMasker,LINE,1104071,1104351,23,0.07
ptg002322l,1104328,1104641,313,RepeatMasker,LINE,1104485,1104604,120,0.38
ptg002325l,1400291,1400589,298,RepeatMasker,LINE,1400135,1400455,164,0.55
ptg002325l,1400291,1400589,298,RepeatMasker,LINE,1400232,1400712,298,1.00
ptg002325l,1400291,1400589,298,RepeatMasker,LINE,1400549,1400668,41,0.14
ptg002325l,4409003,4409292,289,RepeatMasker,LINE,4408928,4409416,289,1.00
ptg002375l,4183066,4183345,279,RepeatMasker,LINE,4182267,4183149,83,0.30
ptg002376l,86168,86463,295,RepeatMasker,LINE,85794,86301,133,0.45
ptg002378l,1399238,1399547,309,RepeatMasker,LINE,1399363,1399797,185,0.60
ptg002379l,487933,488250,317,RepeatMasker,LINE,488008,488087,80,0.25
ptg002379l,1154954,1155230,276,RepeatMasker,LINE,1154985,1155257,246,0.89
ptg002380l,2076750,2077058,308,RepeatMasker,LINE,2073005,2076760,10,0.03
ptg002393l,917908,918201,293,RepeatMasker,LINE,918073,919241,129,0.44
ptg002397l,2180439,2180759,320,RepeatMasker,LINE,2180015,2181516,320,1.00
ptg002414l,1641378,1641689,311,RepeatMasker,LINE,1641489,1641560,72,0.23
ptg002415l,2099597,2099916,319,RepeatMasker,LINE,2098867,2099641,44,0.14
ptg002415l,2099597,2099916,319,RepeatMasker,LINE,2099667,2100088,250,0.78
ptg002417l,6138105,6138382,277,RepeatMasker,LINE,6138304,6138408,79,0.29
ptg002424l,3402004,3402320,316,RepeatMasker,LINE,3399321,3402585,316,1.00
ptg002431l,1501853,1502180,327,RepeatMasker,LINE,1501763,1502193,327,1.00
ptg002436l,406825,407113,288,RepeatMasker,LINE,407089,407722,25,0.09
ptg002436l,464272,464557,285,RepeatMasker,LINE,464141,464315,43,0.15
ptg002436l,464272,464557,285,RepeatMasker,LINE,464386,465006,172,0.60
ptg002436l,1761678,1761970,292,RepeatMasker,LINE,1760651,1761777,99,0.34
ptg002442l,1108052,1108372,320,RepeatMasker,LINE,1108143,1108197,55,0.17
ptg002444l,9218046,9218372,326,RepeatMasker,LINE,9217415,9218385,326,1.00
ptg002484l,740482,740773,291,RepeatMasker,LINE,740554,740599,46,0.16
ptg002488l,1473040,1473341,301,RepeatMasker,LINE,1472972,1476485,301,1.00
ptg002496l,1108468,1108759,291,RepeatMasker,LINE,1108259,1108528,60,0.21
ptg002502l,1179906,1180230,324,RepeatMasker,LINE,1180160,1180248,71,0.22
ptg002504l,1427727,1428025,298,RepeatMasker,LINE,1427836,1428007,172,0.58
ptg002504l,1427727,1428025,298,RepeatMasker,LINE,1427990,1428180,36,0.12
ptg002515l,1200600,1200897,297,RepeatMasker,LINE,1200328,1200717,117,0.39
ptg002515l,1200600,1200897,297,RepeatMasker,LINE,1200738,1201275,160,0.54
ptg002517l,3000050,3000335,285,RepeatMasker,LINE,2999923,3000481,285,1.00
ptg002518l,2346243,2346550,307,RepeatMasker,LINE,2346221,2346941,307,1.00
ptg002527l,649653,649934,281,RepeatMasker,LINE,648922,649779,126,0.45
ptg002527l,873340,873650,310,RepeatMasker,LINE,873361,873419,59,0.19
ptg002533l,2990026,2990340,314,RepeatMasker,LINE,2987341,2990606,314,1.00
ptg002540l,2216772,2217093,321,RepeatMasker,LINE,2216918,2216957,40,0.12
ptg002540l,3635827,3636109,282,RepeatMasker,LINE,3636007,3636075,69,0.24
ptg002552l,2690906,2691213,307,RepeatMasker,LINE,2690222,2691847,307,1.00
ptg002559l,752558,752851,293,RepeatMasker,LINE,752529,752599,41,0.14
ptg002559l,752558,752851,293,RepeatMasker,LINE,752603,752673,71,0.24
ptg002570l,4197153,4197471,318,RepeatMasker,LINE,4196536,4197307,154,0.48
ptg002571l,815482,815784,302,RepeatMasker,LINE,815476,815735,253,0.84
ptg002577l,1224755,1225087,332,RepeatMasker,LINE,1222074,1225347,332,1.00
ptg002577l,1796622,1796893,271,RepeatMasker,LINE,1796739,1796911,155,0.57
ptg002583l,5027844,5028174,330,RepeatMasker,LINE,5027477,5028356,330,1.00
ptg002585l,628185,628514,329,RepeatMasker,LINE,627130,629405,329,1.00
ptg002585l,628185,628514,329,RepeatMasker,LINE,628321,629399,194,0.59
ptg002590l,489558,489878,320,RepeatMasker,LINE,487311,489808,250,0.78
ptg002594l,4850258,4850576,318,RepeatMasker,LINE,4850478,4851685,99,0.31
ptg002596l,2213036,2213350,314,RepeatMasker,LINE,2213238,2213431,113,0.36
ptg002601l,1217743,1218052,309,RepeatMasker,LINE,1217975,1218045,71,0.23
ptg002605l,2680075,2680385,310,RepeatMasker,LINE,2679075,2681155,310,1.00
ptg002605l,2954736,2955040,304,RepeatMasker,LINE,2954340,2954876,140,0.46
ptg002617l,241562,241896,334,RepeatMasker,LINE,241098,241625,63,0.19
ptg002617l,241562,241896,334,RepeatMasker,LINE,241702,241903,195,0.58
ptg002618l,767228,767539,311,RepeatMasker,LINE,765353,767524,296,0.95
ptg002621l,4049078,4049413,335,RepeatMasker,LINE,4048259,4049429,335,1.00
ptg002626l,1607359,1607653,294,RepeatMasker,LINE,1604940,1607868,294,1.00
ptg002628l,1070585,1070870,285,RepeatMasker,LINE,1070693,1070792,100,0.35
ptg002640l,312562,312876,314,RepeatMasker,LINE,309880,313142,314,1.00
ptg002655l,2159526,2159828,302,RepeatMasker,LINE,2158097,2159950,302,1.00
ptg002659l,709092,709417,325,RepeatMasker,LINE,708793,710227,325,1.00
ptg002676l,262301,262596,295,RepeatMasker,LINE,259548,263259,295,1.00
ptg002680l,251076,251405,329,RepeatMasker,LINE,251103,251156,54,0.16
ptg002692l,832934,833261,327,RepeatMasker,LINE,833156,833226,71,0.22
ptg002692l,2499698,2499985,287,RepeatMasker,LINE,2499721,2500323,265,0.92
ptg002707l,2931831,2932124,293,RepeatMasker,LINE,2931878,2932225,247,0.84
ptg002707l,2931831,2932124,293,RepeatMasker,LINE,2931976,2932300,149,0.51
ptg002707l,2931831,2932124,293,RepeatMasker,LINE,2932057,2932659,68,0.23
ptg002707l,2931831,2932124,293,RepeatMasker,LINE,2932056,2932770,69,0.24
ptg002708l,1155728,1156007,279,RepeatMasker,LINE,1155473,1156058,279,1.00
ptg002708l,1155728,1156007,279,RepeatMasker,LINE,1155477,1156240,279,1.00
ptg002709l,349250,349573,323,RepeatMasker,LINE,349364,349406,43,0.13
ptg002713l,217291,217587,296,RepeatMasker,LINE,213532,217929,296,1.00
ptg002732l,8075165,8075437,272,RepeatMasker,LINE,8074182,8075382,217,0.80
ptg002732l,9207767,9208081,314,RepeatMasker,LINE,9207556,9208664,314,1.00
ptg002738l,429347,429665,318,RepeatMasker,LINE,428337,429518,171,0.54
ptg002778l,1976474,1976775,301,RepeatMasker,LINE,1976646,1976706,61,0.20
ptg002780l,1275357,1275672,315,RepeatMasker,LINE,1275425,1275504,80,0.25
ptg002780l,1275357,1275672,315,RepeatMasker,LINE,1275662,1276613,11,0.03
ptg002789l,2521902,2522203,301,RepeatMasker,LINE,2521568,2522161,259,0.86
ptg002789l,3668114,3668400,286,RepeatMasker,LINE,3667092,3668373,259,0.91
ptg002812l,285104,285412,308,RepeatMasker,LINE,284516,286224,308,1.00
ptg002813l,2724295,2724584,289,RepeatMasker,LINE,2724213,2724759,289,1.00
ptg002813l,4074916,4075199,283,RepeatMasker,LINE,4074410,4074987,71,0.25
ptg002814l,412714,413005,291,RepeatMasker,LINE,412431,412736,22,0.08
ptg002819l,103988,104319,331,RepeatMasker,LINE,103744,104934,331,1.00
ptg002824l,646548,646832,284,RepeatMasker,LINE,645831,646842,284,1.00
ptg002831l,1166578,1166892,314,RepeatMasker,LINE,1166732,1166787,56,0.18
ptg002831l,1166578,1166892,314,RepeatMasker,LINE,1166862,1167365,31,0.10
ptg002831l,2071973,2072257,284,RepeatMasker,LINE,2072016,2072071,56,0.20
ptg002852l,2474601,2474919,318,RepeatMasker,LINE,2473561,2476279,318,1.00
ptg002858l,1317912,1318229,317,RepeatMasker,LINE,1316688,1317929,17,0.05
ptg002858l,2896903,2897170,267,RepeatMasker,LINE,2896861,2896991,88,0.33
ptg002858l,4722523,4722796,273,RepeatMasker,LINE,4722595,4722665,71,0.26
ptg002864l,589621,589926,305,RepeatMasker,LINE,589653,590105,274,0.90
ptg002888l,1071704,1072013,309,RepeatMasker,LINE,1071199,1071825,121,0.39
ptg002890l,2782499,2782823,324,RepeatMasker,LINE,2780164,2783074,324,1.00
ptg002891l,1127301,1127592,291,RepeatMasker,LINE,1127558,1128026,35,0.12
ptg002893l,1114912,1115228,316,RepeatMasker,LINE,1114544,1115060,148,0.47
ptg002903l,3636447,3636759,312,RepeatMasker,LINE,3635979,3637333,312,1.00
ptg002906l,2916500,2916816,316,RepeatMasker,LINE,2916688,2916835,129,0.41
ptg002906l,2916500,2916816,316,RepeatMasker,LINE,2916711,2916985,106,0.34
ptg002911l,893243,893530,287,RepeatMasker,LINE,893052,893287,44,0.15
ptg002911l,1239813,1240113,300,RepeatMasker,LINE,1239499,1241123,300,1.00
ptg002911l,1595354,1595673,319,RepeatMasker,LINE,1595152,1595366,12,0.04
ptg002913l,675769,676077,308,RepeatMasker,LINE,674323,676744,308,1.00
ptg002925l,3371425,3371736,311,RepeatMasker,LINE,3367051,3371967,311,1.00
ptg002931l,860849,861183,334,RepeatMasker,LINE,861029,861127,99,0.30
ptg002932l,3289525,3289809,284,RepeatMasker,LINE,3289064,3293459,284,1.00
ptg002932l,5926120,5926407,287,RepeatMasker,LINE,5924322,5926234,114,0.40
ptg002932l,5926120,5926407,287,RepeatMasker,LINE,5926384,5926849,24,0.08
ptg002932l,5926120,5926407,287,RepeatMasker,LINE,5926402,5926633,6,0.02
ptg002938l,1034900,1035187,287,RepeatMasker,LINE,1033839,1035115,215,0.75
ptg002938l,1034900,1035187,287,RepeatMasker,LINE,1034878,1036922,287,1.00
ptg002944l,31895,32191,296,RepeatMasker,LINE,28750,32034,139,0.47
ptg002954l,1388124,1388434,310,RepeatMasker,LINE,1388211,1388833,224,0.72
ptg002959l,1094111,1094413,302,RepeatMasker,LINE,1094317,1094722,97,0.32
ptg002959l,1588508,1588805,297,RepeatMasker,LINE,1588696,1588920,110,0.37
ptg002967l,303025,303321,296,RepeatMasker,LINE,300106,303070,45,0.15
ptg002976l,535484,535772,288,RepeatMasker,LINE,535416,539421,288,1.00
ptg002984l,869152,869437,285,RepeatMasker,LINE,869010,872830,285,1.00
ptg002988l,151178,151499,321,RepeatMasker,LINE,150592,151484,306,0.95
ptg003017l,1982294,1982586,292,RepeatMasker,LINE,1982375,1982449,75,0.26
ptg003050l,639144,639419,275,RepeatMasker,LINE,636170,639336,192,0.70
ptg003050l,639144,639419,275,RepeatMasker,LINE,636648,639322,178,0.65
ptg003055l,109921,110233,312,RepeatMasker,LINE,109845,109970,49,0.16
ptg003076l,255184,255484,300,RepeatMasker,LINE,254809,255246,62,0.21
ptg003084l,1146078,1146399,321,RepeatMasker,LINE,1146267,1146921,133,0.41
ptg003094l,1099291,1099596,305,RepeatMasker,LINE,1098810,1099488,197,0.65
ptg003099l,1515394,1515717,323,RepeatMasker,LINE,1512992,1515734,323,1.00
ptg003118l,1350119,1350448,329,RepeatMasker,LINE,1347450,1350660,329,1.00
ptg003125l,1034088,1034364,276,RepeatMasker,LINE,1034204,1034252,49,0.18
ptg003125l,1034088,1034364,276,RepeatMasker,LINE,1034265,1034762,100,0.36
ptg003125l,1760001,1760306,305,RepeatMasker,LINE,1760029,1763231,278,0.91
ptg003134l,2522067,2522345,278,RepeatMasker,LINE,2520270,2523375,278,1.00
ptg003135l,210786,211095,309,RepeatMasker,LINE,208516,211781,309,1.00
ptg003137l,270420,270716,296,RepeatMasker,LINE,270569,270708,140,0.47
ptg003145l,2853877,2854202,325,RepeatMasker,LINE,2853542,2856814,325,1.00
ptg003151l,713293,713568,275,RepeatMasker,LINE,713088,713649,275,1.00
ptg003169l,1920039,1920356,317,RepeatMasker,LINE,1919713,1922932,317,1.00
ptg003186l,2343805,2344104,299,RepeatMasker,LINE,2343815,2344219,290,0.97
ptg003200l,269915,270204,289,RepeatMasker,LINE,269840,270075,160,0.55
ptg003200l,269915,270204,289,RepeatMasker,LINE,269886,270470,289,1.00
ptg003202l,4321797,4322098,301,RepeatMasker,LINE,4322024,4322094,71,0.24
ptg003207l,520567,520884,317,RepeatMasker,LINE,517891,521149,317,1.00
ptg003207l,871845,872130,285,RepeatMasker,LINE,870585,872145,285,1.00
ptg003207l,4214149,4214422,273,RepeatMasker,LINE,4214321,4214385,65,0.24
ptg003208l,2072967,2073274,307,RepeatMasker,LINE,2072688,2073219,252,0.82
ptg003209l,1393199,1393513,314,RepeatMasker,LINE,1393068,1393717,314,1.00
ptg003209l,1393199,1393513,314,RepeatMasker,LINE,1393247,1393907,267,0.85
ptg003215l,4249554,4249829,275,RepeatMasker,LINE,4249286,4249866,275,1.00
ptg003221l,3661448,3661768,320,RepeatMasker,LINE,3661131,3661721,273,0.85
ptg003222l,384670,384976,306,RepeatMasker,LINE,382707,386968,306,1.00
ptg003226l,22430,22704,274,RepeatMasker,LINE,22341,22561,131,0.48
ptg003227l,856798,857078,280,RepeatMasker,LINE,855610,856806,8,0.03
ptg003227l,856798,857078,280,RepeatMasker,LINE,856964,857511,115,0.41
ptg003261l,177061,177364,303,RepeatMasker,LINE,176648,177838,303,1.00
ptg003266l,860317,860598,281,RepeatMasker,LINE,860068,861259,281,1.00
ptg003266l,2067133,2067429,296,RepeatMasker,LINE,2066681,2067230,97,0.33
ptg003268l,124172,124495,323,RepeatMasker,LINE,124382,125520,114,0.35
ptg003283l,3569754,3570030,276,RepeatMasker,LINE,3570021,3570396,10,0.04
ptg003284l,1092781,1093087,306,RepeatMasker,LINE,1092714,1092853,72,0.24
ptg003287l,280131,280458,327,RepeatMasker,LINE,280392,280437,46,0.14
ptg003291l,1611921,1612209,288,RepeatMasker,LINE,1612101,1612187,87,0.30
ptg003291l,1611921,1612209,288,RepeatMasker,LINE,1612121,1612189,69,0.24
ptg003292l,183880,184192,312,RepeatMasker,LINE,184161,184234,32,0.10
ptg003292l,183880,184192,312,RepeatMasker,LINE,184185,184247,8,0.03
ptg003315l,1748073,1748378,305,RepeatMasker,LINE,1748081,1749126,298,0.98
ptg003317l,1728345,1728668,323,RepeatMasker,LINE,1728523,1728994,146,0.45
ptg003320l,1620211,1620532,321,RepeatMasker,LINE,1617325,1620549,321,1.00
ptg003324l,1369542,1369861,319,RepeatMasker,LINE,1369176,1369738,196,0.61
ptg003342l,63572,63891,319,RepeatMasker,LINE,63558,63595,23,0.07
ptg003344l,2167987,2168276,289,RepeatMasker,LINE,2168224,2169107,53,0.18
ptg003349l,2883319,2883653,334,RepeatMasker,LINE,2880576,2884680,334,1.00
ptg003361l,735295,735550,255,RepeatMasker,LINE,735378,735979,173,0.68
ptg003365l,273726,274042,316,RepeatMasker,LINE,272960,273874,148,0.47
ptg003365l,273726,274042,316,RepeatMasker,LINE,273086,274049,316,1.00
ptg003365l,273726,274042,316,RepeatMasker,LINE,273535,275316,316,1.00
ptg003372l,1195058,1195355,297,RepeatMasker,LINE,1193361,1197620,297,1.00
ptg003376l,1431422,1431715,293,RepeatMasker,LINE,1430609,1431519,97,0.33
ptg003376l,1431422,1431715,293,RepeatMasker,LINE,1431519,1431700,182,0.62
ptg003376l,1431422,1431715,293,RepeatMasker,LINE,1431685,1431779,31,0.11
ptg003383l,3068153,3068474,321,RepeatMasker,LINE,3068335,3068405,71,0.22
ptg003391l,3712132,3712420,288,RepeatMasker,LINE,3712079,3712444,288,1.00
ptg003398l,4566431,4566752,321,RepeatMasker,LINE,4565701,4566906,321,1.00
ptg003402l,1917302,1917624,322,RepeatMasker,LINE,1917245,1917322,20,0.06
ptg003403l,1807522,1807829,307,RepeatMasker,LINE,1807752,1807822,71,0.23
ptg003404l,2867804,2868110,306,RepeatMasker,LINE,2867867,2868010,144,0.47
ptg003405l,4962983,4963278,295,RepeatMasker,LINE,4960184,4963215,232,0.79
ptg003408l,673624,673948,324,RepeatMasker,LINE,673928,674012,21,0.06
ptg003410l,1576082,1576354,272,RepeatMasker,LINE,1576249,1576312,64,0.24
ptg003412l,1464192,1464517,325,RepeatMasker,LINE,1463831,1464919,325,1.00
ptg003414l,976012,976303,291,RepeatMasker,LINE,975871,976397,291,1.00
ptg003416l,367678,368018,340,RepeatMasker,LINE,366917,370872,340,1.00
ptg003423l,2693356,2693660,304,RepeatMasker,LINE,2693610,2693880,51,0.17
ptg003439l,2677999,2678307,308,RepeatMasker,LINE,2675070,2678277,278,0.90
ptg003445l,450060,450336,276,RepeatMasker,LINE,449150,450199,139,0.50
ptg003446l,4953767,4954068,301,RepeatMasker,LINE,4953680,4953832,65,0.22
ptg003449l,748440,748763,323,RepeatMasker,LINE,748354,749120,323,1.00
ptg003451l,67621,67898,277,RepeatMasker,LINE,67666,67788,123,0.44
ptg003457l,6271173,6271498,325,RepeatMasker,LINE,6271379,6271451,73,0.22
ptg003464l,1414965,1415261,296,RepeatMasker,LINE,1415188,1415258,71,0.24
ptg003468l,1621912,1622209,297,RepeatMasker,LINE,1621741,1621916,4,0.01
ptg003468l,1621912,1622209,297,RepeatMasker,LINE,1622050,1622102,53,0.18
ptg003468l,1621912,1622209,297,RepeatMasker,LINE,1621977,1622110,134,0.45
ptg003502l,287257,287583,326,RepeatMasker,LINE,285274,287503,246,0.75
ptg003511l,1910033,1910324,291,RepeatMasker,LINE,1910067,1910541,258,0.89
ptg003517l,1971176,1971435,259,RepeatMasker,LINE,1970786,1971205,29,0.11
ptg003530l,596290,596585,295,RepeatMasker,LINE,595043,596483,193,0.65
ptg003542l,446380,446669,289,RepeatMasker,LINE,445586,447739,289,1.00
ptg003544l,2111851,2112149,298,RepeatMasker,LINE,2111986,2112081,96,0.32
ptg003544l,2111851,2112149,298,RepeatMasker,LINE,2112002,2112690,148,0.50
ptg003547l,116843,117109,266,RepeatMasker,LINE,116698,118718,266,1.00
ptg003548l,1499163,1499445,282,RepeatMasker,LINE,1498432,1501161,282,1.00
ptg003552l,345651,345942,291,RepeatMasker,LINE,345818,346347,125,0.43
ptg003553l,815487,815814,327,RepeatMasker,LINE,815716,815786,71,0.22
ptg003555l,126089,126371,282,RepeatMasker,LINE,125424,128328,282,1.00
ptg003561l,4045530,4045820,290,RepeatMasker,LINE,4045626,4045686,61,0.21
ptg003561l,4045530,4045820,290,RepeatMasker,LINE,4045800,4045898,21,0.07
ptg003572l,254124,254418,294,RepeatMasker,LINE,254075,256372,294,1.00
ptg003577l,612592,612878,286,RepeatMasker,LINE,612745,612805,61,0.21
ptg003577l,930899,931195,296,RepeatMasker,LINE,930780,931664,296,1.00
ptg003580l,1724243,1724555,312,RepeatMasker,LINE,1724175,1724423,180,0.58
ptg003582l,297832,298153,321,RepeatMasker,LINE,297682,298208,321,1.00
ptg003588l,140692,141005,313,RepeatMasker,LINE,140527,140757,65,0.21
ptg003590l,560327,560632,305,RepeatMasker,LINE,557167,560447,120,0.39
ptg003594l,1086512,1086827,315,RepeatMasker,LINE,1086203,1086855,315,1.00
ptg003597l,837800,838096,296,RepeatMasker,LINE,837996,838064,69,0.23
ptg003601l,2505767,2506079,312,RepeatMasker,LINE,2502620,2506032,265,0.85
ptg003606l,2372010,2372317,307,RepeatMasker,LINE,2371999,2373163,307,1.00
ptg003607l,3264220,3264507,287,RepeatMasker,LINE,3264295,3266022,213,0.74
ptg003615l,817294,817589,295,RepeatMasker,LINE,817585,817671,5,0.02
ptg003620l,3742863,3743139,276,RepeatMasker,LINE,3743036,3743084,49,0.18
ptg003634l,5168708,5169032,324,RepeatMasker,LINE,5168364,5171637,324,1.00
ptg003643l,1494259,1494537,278,RepeatMasker,LINE,1491488,1494741,278,1.00
ptg003681l,3514558,3514858,300,RepeatMasker,LINE,3514482,3515107,300,1.00
ptg003697l,152507,152802,295,RepeatMasker,LINE,152696,152773,78,0.26
ptg003709l,1113325,1113625,300,RepeatMasker,LINE,1112623,1114043,300,1.00
ptg003709l,4705637,4705969,332,RepeatMasker,LINE,4704211,4706215,332,1.00
ptg003723l,1543655,1543976,321,RepeatMasker,LINE,1542882,1544113,321,1.00
ptg003727l,1090277,1090565,288,RepeatMasker,LINE,1090034,1094200,288,1.00
ptg003728l,1676843,1677165,322,RepeatMasker,LINE,1676765,1677202,322,1.00
ptg003729l,2025841,2026118,277,RepeatMasker,LINE,2025448,2025857,16,0.06
ptg003741l,481563,481842,279,RepeatMasker,LINE,481354,481893,279,1.00
ptg003741l,481563,481842,279,RepeatMasker,LINE,481367,482075,279,1.00
ptg003741l,874391,874704,313,RepeatMasker,LINE,874594,874670,77,0.25
ptg003755l,1642154,1642473,319,RepeatMasker,LINE,1642354,1642533,120,0.38
ptg003759l,907923,908191,268,RepeatMasker,LINE,908142,908724,50,0.19
ptg003760l,1096328,1096660,332,RepeatMasker,LINE,1094118,1096464,136,0.41
ptg003764l,532445,532755,310,RepeatMasker,LINE,532454,532517,64,0.21
ptg003767l,554844,555165,321,RepeatMasker,LINE,553004,554935,91,0.28
ptg003779l,3626062,3626363,301,RepeatMasker,LINE,3625361,3626427,301,1.00
ptg003784l,802451,802717,266,RepeatMasker,LINE,800782,802494,43,0.16
ptg003786l,1698679,1699008,329,RepeatMasker,LINE,1698932,1699804,77,0.23
ptg003814l,1091956,1092271,315,RepeatMasker,LINE,1092109,1092235,127,0.40
ptg003839l,7382413,7382703,290,RepeatMasker,LINE,7382667,7384696,37,0.13
ptg003850l,755277,755556,279,RepeatMasker,LINE,755262,756508,279,1.00
ptg003852l,1695110,1695404,294,RepeatMasker,LINE,1694949,1695578,294,1.00
ptg003859l,622470,622777,307,RepeatMasker,LINE,622697,623275,81,0.26
ptg003879l,185937,186220,283,RepeatMasker,LINE,185995,186242,226,0.80
ptg003880l,462318,462595,277,RepeatMasker,LINE,462507,463024,89,0.32
ptg003880l,993043,993364,321,RepeatMasker,LINE,990754,994652,321,1.00
ptg003898l,1988703,1989011,308,RepeatMasker,LINE,1988910,1988963,54,0.18
ptg003898l,2003997,2004281,284,RepeatMasker,LINE,2004112,2004409,170,0.60
ptg003900l,1088051,1088377,326,RepeatMasker,LINE,1084914,1088185,134,0.41
ptg003901l,122774,123075,301,RepeatMasker,LINE,121652,122817,43,0.14
ptg003925l,1510452,1510744,292,RepeatMasker,LINE,1510403,1510643,191,0.65
ptg003941l,31558,31877,319,RepeatMasker,LINE,31476,31704,146,0.46
ptg003944l,2337683,2337987,304,RepeatMasker,LINE,2337760,2337880,121,0.40
ptg003944l,2495137,2495464,327,RepeatMasker,LINE,2495360,2495776,105,0.32
ptg003950l,3817884,3818210,326,RepeatMasker,LINE,3816683,3817990,106,0.33
ptg003957l,1303112,1303416,304,RepeatMasker,LINE,1302616,1303935,304,1.00
ptg003957l,1303112,1303416,304,RepeatMasker,LINE,1303073,1303938,304,1.00
ptg003964l,1806598,1806893,295,RepeatMasker,LINE,1805150,1806705,107,0.36
ptg003968l,6066471,6066793,322,RepeatMasker,LINE,6066387,6066607,136,0.42
ptg003987l,466296,466574,278,RepeatMasker,LINE,466054,466564,268,0.96
ptg003990l,1910759,1911038,279,RepeatMasker,LINE,1910661,1911090,279,1.00
ptg003992l,1364141,1364464,323,RepeatMasker,LINE,1364069,1364206,65,0.20
ptg003994l,784835,785143,308,RepeatMasker,LINE,784687,784877,42,0.14
ptg003994l,784835,785143,308,RepeatMasker,LINE,785097,785245,47,0.15
ptg003994l,4846156,4846443,287,RepeatMasker,LINE,4846130,4847312,287,1.00
ptg003997l,1465386,1465660,274,RepeatMasker,LINE,1465463,1465909,198,0.72
ptg004000l,854096,854374,278,RepeatMasker,LINE,850949,854676,278,1.00
ptg004007l,324510,324789,279,RepeatMasker,LINE,321373,324616,106,0.38
ptg004007l,784253,784575,322,RepeatMasker,LINE,782782,784347,94,0.29
ptg004009l,6457363,6457692,329,RepeatMasker,LINE,6454674,6457955,329,1.00
ptg004014l,1944225,1944500,275,RepeatMasker,LINE,1943652,1944603,275,1.00
ptg004014l,1944225,1944500,275,RepeatMasker,LINE,1943656,1944749,275,1.00
ptg004014l,2630723,2630988,265,RepeatMasker,LINE,2630207,2631198,265,1.00
ptg004022l,2035524,2035844,320,RepeatMasker,LINE,2035689,2035808,120,0.38
ptg004030l,810376,810705,329,RepeatMasker,LINE,807687,810967,329,1.00
ptg004031l,165588,165878,290,RepeatMasker,LINE,164636,165616,28,0.10
ptg004033l,5191568,5191875,307,RepeatMasker,LINE,5190307,5191686,118,0.38
ptg004034l,848767,849068,301,RepeatMasker,LINE,848877,849428,192,0.64
ptg004038l,3433456,3433761,305,RepeatMasker,LINE,3433486,3433533,48,0.16
ptg004062l,2573803,2574132,329,RepeatMasker,LINE,2573203,2574991,329,1.00
ptg004062l,2979589,2979869,280,RepeatMasker,LINE,2979488,2979844,255,0.91
ptg004065l,1593470,1593794,324,RepeatMasker,LINE,1592785,1593518,48,0.15
ptg004068l,487377,487657,280,RepeatMasker,LINE,487509,487570,62,0.22
ptg004068l,487377,487657,280,RepeatMasker,LINE,487644,488801,14,0.05
ptg004071l,1730136,1730430,294,RepeatMasker,LINE,1729121,1730303,167,0.57
ptg004080l,3162610,3162932,322,RepeatMasker,LINE,3162575,3163133,322,1.00
ptg004080l,3162610,3162932,322,RepeatMasker,LINE,3162635,3162915,281,0.87
ptg004082l,2614869,2615175,306,RepeatMasker,LINE,2611570,2615507,306,1.00
ptg004082l,6667263,6667565,302,RepeatMasker,LINE,6667126,6667514,251,0.83
ptg004086l,928571,928873,302,RepeatMasker,LINE,927814,928723,152,0.50
ptg004086l,928571,928873,302,RepeatMasker,LINE,928722,928841,120,0.40
ptg004088l,1149224,1149520,296,RepeatMasker,LINE,1149354,1149409,56,0.19
ptg004091l,1735418,1735720,302,RepeatMasker,LINE,1735671,1735745,50,0.17
ptg004092l,4418434,4418725,291,RepeatMasker,LINE,4418271,4420737,291,1.00
ptg004092l,4423451,4423770,319,RepeatMasker,LINE,4422708,4423651,200,0.63
ptg004093l,880209,880494,285,RepeatMasker,LINE,878235,880381,172,0.60
ptg004102l,1176032,1176342,310,RepeatMasker,LINE,1176293,1176374,50,0.16
ptg004106l,18517,18805,288,RepeatMasker,LINE,18454,22449,288,1.00
ptg004107l,33819,34121,302,RepeatMasker,LINE,33908,36070,214,0.71
ptg004109l,1619956,1620248,292,RepeatMasker,LINE,1619422,1620187,231,0.79
ptg004111l,2793569,2793875,306,RepeatMasker,LINE,2793762,2793807,46,0.15
ptg004113l,543854,544136,282,RepeatMasker,LINE,543257,544757,282,1.00
ptg004117l,1965926,1966228,302,RepeatMasker,LINE,1965858,1965965,39,0.13
ptg004119l,1698618,1698916,298,RepeatMasker,LINE,1698787,1698879,93,0.31
ptg004125l,655752,656066,314,RepeatMasker,LINE,654936,655808,56,0.18
ptg004141l,2106093,2106421,328,RepeatMasker,LINE,2106295,2106888,127,0.39
ptg004144l,1072730,1073056,326,RepeatMasker,LINE,1072710,1073433,326,1.00
ptg004158l,545453,545770,317,RepeatMasker,LINE,542542,545791,317,1.00
ptg004162l,622655,622963,308,RepeatMasker,LINE,622662,622762,101,0.33
ptg004164l,1275164,1275456,292,RepeatMasker,LINE,1275254,1275389,136,0.47
ptg004167l,903683,903960,277,RepeatMasker,LINE,903825,903874,50,0.18
ptg004167l,2010658,2010953,295,RepeatMasker,LINE,2010869,2010979,85,0.29
ptg004172l,1319711,1320055,344,RepeatMasker,LINE,1319725,1319783,59,0.17
ptg004172l,4183336,4183662,326,RepeatMasker,LINE,4181146,4183467,131,0.40
ptg004174l,385763,386037,274,RepeatMasker,LINE,384779,388489,274,1.00
ptg004176l,616989,617320,331,RepeatMasker,LINE,614847,617998,331,1.00
ptg004179l,35024,35293,269,RepeatMasker,LINE,34604,35274,250,0.93
ptg004181l,774560,774888,328,RepeatMasker,LINE,774701,774800,100,0.30
ptg004182l,33335,33629,294,RepeatMasker,LINE,32778,33545,210,0.71
ptg004198l,899484,899777,293,RepeatMasker,LINE,899126,899997,293,1.00
ptg004199l,6263758,6264074,316,RepeatMasker,LINE,6262944,6263912,154,0.49
ptg004199l,7129571,7129898,327,RepeatMasker,LINE,7129537,7129645,74,0.23
ptg004199l,7129571,7129898,327,RepeatMasker,LINE,7129835,7130605,64,0.20
ptg004208l,5755314,5755622,308,RepeatMasker,LINE,5754984,5755340,26,0.08
ptg004222l,2823546,2823832,286,RepeatMasker,LINE,2823663,2823846,170,0.59
ptg004233l,571364,571704,340,RepeatMasker,LINE,571375,571444,70,0.21
ptg004245l,3048092,3048381,289,RepeatMasker,LINE,3048126,3048426,256,0.89
ptg004248l,445472,445748,276,RepeatMasker,LINE,443076,446336,276,1.00
ptg004248l,849526,849846,320,RepeatMasker,LINE,849722,850139,125,0.39
ptg004266l,1564517,1564825,308,RepeatMasker,LINE,1564541,1564687,147,0.48
ptg004266l,1654731,1655037,306,RepeatMasker,LINE,1654755,1654808,54,0.18
ptg004266l,2037500,2037810,310,RepeatMasker,LINE,2037346,2037585,85,0.27
ptg004269l,1407006,1407331,325,RepeatMasker,LINE,1407123,1407300,178,0.55
ptg004269l,1407006,1407331,325,RepeatMasker,LINE,1407314,1407546,18,0.06
ptg004270l,1107636,1107908,272,RepeatMasker,LINE,1107356,1108465,272,1.00
ptg004272l,572824,573131,307,RepeatMasker,LINE,571774,573018,194,0.63
ptg004280l,866649,866950,301,RepeatMasker,LINE,866722,866892,171,0.57
ptg004280l,866649,866950,301,RepeatMasker,LINE,866899,867050,52,0.17
ptg004281l,337213,337531,318,RepeatMasker,LINE,336272,337548,318,1.00
ptg004291l,3268408,3268723,315,RepeatMasker,LINE,3268579,3268631,53,0.17
ptg004300l,205672,205988,316,RepeatMasker,LINE,205988,206058,1,0.00
ptg004300l,853811,854080,269,RepeatMasker,LINE,853364,854046,235,0.87
ptg004300l,4170943,4171256,313,RepeatMasker,LINE,4170174,4172924,313,1.00
ptg004302l,3299106,3299374,268,RepeatMasker,LINE,3299190,3299282,93,0.35
ptg004319l,2916713,2917016,303,RepeatMasker,LINE,2914729,2916832,119,0.39
ptg004321l,4042246,4042551,305,RepeatMasker,LINE,4041449,4042710,305,1.00
ptg004328l,189116,189433,317,RepeatMasker,LINE,189100,189302,186,0.59
ptg004338l,30507,30793,286,RepeatMasker,LINE,29972,30717,210,0.73
ptg004353l,491984,492286,302,RepeatMasker,LINE,492238,492319,49,0.16
ptg004353l,491984,492286,302,RepeatMasker,LINE,492285,492369,2,0.01
ptg004357l,2591378,2591680,302,RepeatMasker,LINE,2591399,2591439,41,0.14
ptg004371l,732834,733160,326,RepeatMasker,LINE,731792,733043,209,0.64
ptg004392l,128575,128835,260,RepeatMasker,LINE,128688,128870,148,0.57
ptg004393l,682027,682348,321,RepeatMasker,LINE,681471,682190,163,0.51
ptg004401l,4269543,4269860,317,RepeatMasker,LINE,4269841,4270084,20,0.06
ptg004406l,593350,593669,319,RepeatMasker,LINE,593238,593492,142,0.45
ptg004406l,593350,593669,319,RepeatMasker,LINE,593635,594321,35,0.11
ptg004420l,1779202,1779484,282,RepeatMasker,LINE,1778126,1779628,282,1.00
ptg004428l,180317,180630,313,RepeatMasker,LINE,179938,181811,313,1.00
ptg004439l,189309,189615,306,RepeatMasker,LINE,189146,189314,5,0.02
ptg004446l,1186527,1186813,286,RepeatMasker,LINE,1184688,1186794,267,0.93
ptg004446l,1186527,1186813,286,RepeatMasker,LINE,1186738,1186832,76,0.27
ptg004449l,212243,212521,278,RepeatMasker,LINE,212352,212418,67,0.24
ptg004449l,1913143,1913468,325,RepeatMasker,LINE,1912834,1916053,325,1.00
ptg004458l,561406,561725,319,RepeatMasker,LINE,561612,561742,114,0.36
ptg004468l,2479601,2479895,294,RepeatMasker,LINE,2479749,2480229,147,0.50
ptg004468l,3841446,3841760,314,RepeatMasker,LINE,3839094,3841774,314,1.00
ptg004476l,59749,60027,278,RepeatMasker,LINE,59290,59881,132,0.47
ptg004476l,59749,60027,278,RepeatMasker,LINE,59380,60162,278,1.00
ptg004486l,2251059,2251392,333,RepeatMasker,LINE,2249143,2251409,333,1.00
ptg004489l,282491,282802,311,RepeatMasker,LINE,281955,282512,21,0.07
ptg004491l,2581713,2582030,317,RepeatMasker,LINE,2581226,2581740,27,0.09
ptg004495l,417570,417868,298,RepeatMasker,LINE,417697,417805,109,0.37
ptg004497l,4183006,4183304,298,RepeatMasker,LINE,4181920,4184020,298,1.00
ptg004500l,92106,92416,310,RepeatMasker,LINE,92234,92854,183,0.59
ptg004500l,2494007,2494283,276,RepeatMasker,LINE,2491962,2494067,60,0.22
ptg004500l,2828289,2828605,316,RepeatMasker,LINE,2828347,2828684,259,0.82
ptg004502l,499793,500101,308,RepeatMasker,LINE,499770,500028,235,0.76
ptg004522l,99667,99970,303,RepeatMasker,LINE,99148,99690,23,0.08
ptg004530l,3081590,3081909,319,RepeatMasker,LINE,3078879,3082084,319,1.00
ptg004530l,4017090,4017401,311,RepeatMasker,LINE,4016520,4017249,159,0.51
ptg004540l,438192,438517,325,RepeatMasker,LINE,436451,438542,325,1.00
ptg004542l,1465575,1465867,292,RepeatMasker,LINE,1464777,1468193,292,1.00
ptg004542l,1931002,1931316,314,RepeatMasker,LINE,1930528,1931197,195,0.62
ptg004567l,1928223,1928535,312,RepeatMasker,LINE,1928458,1928529,72,0.23
ptg004580l,129943,130244,301,RepeatMasker,LINE,128959,130284,301,1.00
ptg004581l,1256932,1257238,306,RepeatMasker,LINE,1257026,1257126,101,0.33
ptg004581l,1446826,1447108,282,RepeatMasker,LINE,1446126,1446996,170,0.60
ptg004586l,378200,378533,333,RepeatMasker,LINE,377892,378741,333,1.00
ptg004594l,236659,236983,324,RepeatMasker,LINE,235523,236880,221,0.68
ptg004602l,94241,94537,296,RepeatMasker,LINE,94276,94374,99,0.33
ptg004610l,1949692,1950023,331,RepeatMasker,LINE,1948623,1949721,29,0.09
ptg004619l,2877767,2877995,228,RepeatMasker,LINE,2877875,2877942,68,0.30
ptg004626l,3806756,3807081,325,RepeatMasker,LINE,3803619,3806892,136,0.42
ptg004639l,293701,294028,327,RepeatMasker,LINE,293358,293714,13,0.04
ptg004639l,864392,864703,311,RepeatMasker,LINE,864630,864702,73,0.23
ptg004645l,3140455,3140722,267,RepeatMasker,LINE,3140354,3140704,249,0.93
ptg004645l,3484352,3484680,328,RepeatMasker,LINE,3484075,3484567,215,0.66
ptg004646l,871588,871880,292,RepeatMasker,LINE,871610,871910,271,0.93
ptg004647l,486648,486975,327,RepeatMasker,LINE,486516,486811,163,0.50
ptg004649l,1266468,1266804,336,RepeatMasker,LINE,1265134,1267082,336,1.00
ptg004658l,2162539,2162837,298,RepeatMasker,LINE,2162699,2162796,98,0.33
ptg004661l,2179575,2179881,306,RepeatMasker,LINE,2179724,2179907,158,0.52
ptg004667l,1099143,1099431,288,RepeatMasker,LINE,1099204,1099326,123,0.43
ptg004667l,1099143,1099431,288,RepeatMasker,LINE,1099205,1099972,227,0.79
ptg004677l,464755,465045,290,RepeatMasker,LINE,464047,464807,52,0.18
ptg004682l,3262714,3263060,346,RepeatMasker,LINE,3262817,3263429,244,0.71
ptg004682l,3262714,3263060,346,RepeatMasker,LINE,3263024,3263698,37,0.11
ptg004692l,402427,402708,281,RepeatMasker,LINE,401212,402635,208,0.74
ptg004705l,1013019,1013318,299,RepeatMasker,LINE,1013229,1013474,90,0.30
ptg004708l,1437596,1437917,321,RepeatMasker,LINE,1437839,1438319,79,0.25
ptg004728l,1520321,1520628,307,RepeatMasker,LINE,1520392,1522026,237,0.77
ptg004728l,2475439,2475744,305,RepeatMasker,LINE,2475609,2476392,136,0.45
ptg004743l,1515804,1516102,298,RepeatMasker,LINE,1515857,1516681,246,0.83
ptg004749l,586210,586537,327,RepeatMasker,LINE,583131,586327,117,0.36
ptg004752l,1224661,1224984,323,RepeatMasker,LINE,1224247,1224691,30,0.09
ptg004754l,1295816,1296114,298,RepeatMasker,LINE,1293575,1295948,132,0.44
ptg004758l,594616,594924,308,RepeatMasker,LINE,594659,594975,266,0.86
ptg004769l,851763,852069,306,RepeatMasker,LINE,848872,852086,306,1.00
ptg004782l,2408389,2408704,315,RepeatMasker,LINE,2408476,2408564,89,0.28
ptg004787l,2245058,2245350,292,RepeatMasker,LINE,2245164,2245232,69,0.24
ptg004801l,576158,576491,333,RepeatMasker,LINE,576232,576629,260,0.78
ptg004816l,5977878,5978162,284,RepeatMasker,LINE,5978059,5978232,104,0.37
ptg004818l,546005,546304,299,RepeatMasker,LINE,546100,546917,205,0.69
ptg004818l,546005,546304,299,RepeatMasker,LINE,546115,546787,190,0.64
ptg004823l,858919,859222,303,RepeatMasker,LINE,858333,859134,215,0.71
ptg004823l,858919,859222,303,RepeatMasker,LINE,858526,859121,202,0.67
ptg004859l,1029417,1029703,286,RepeatMasker,LINE,1029330,1029584,167,0.58
ptg004871l,8612040,8612331,291,RepeatMasker,LINE,8611640,8614707,291,1.00
ptg004886l,383832,384122,290,RepeatMasker,LINE,384048,384742,75,0.26
ptg004890l,37011,37317,306,RepeatMasker,LINE,37233,37307,75,0.25
ptg004890l,37011,37317,306,RepeatMasker,LINE,37309,37581,9,0.03
ptg004890l,1240227,1240516,289,RepeatMasker,LINE,1240198,1241091,289,1.00
ptg004900l,1397913,1398230,317,RepeatMasker,LINE,1397397,1398473,317,1.00
ptg004900l,1689187,1689504,317,RepeatMasker,LINE,1688673,1689747,317,1.00
ptg004906l,332640,332922,282,RepeatMasker,LINE,332509,333888,282,1.00
ptg004906l,332640,332922,282,RepeatMasker,LINE,332844,333944,79,0.28
ptg004921l,6118808,6119120,312,RepeatMasker,LINE,6118629,6119461,312,1.00
ptg004926l,2318898,2319227,329,RepeatMasker,LINE,2318299,2319206,308,0.94
ptg004926l,2318898,2319227,329,RepeatMasker,LINE,2318685,2319399,329,1.00
ptg004927l,3646779,3647061,282,RepeatMasker,LINE,3645718,3646925,146,0.52
ptg004937l,2478660,2478956,296,RepeatMasker,LINE,2475522,2478782,122,0.41
ptg004947l,161555,161848,293,RepeatMasker,LINE,160538,161631,76,0.26
ptg004957l,569510,569826,316,RepeatMasker,LINE,569695,569774,80,0.25
ptg004968l,8838430,8838743,313,RepeatMasker,LINE,8838064,8838544,114,0.36
ptg004976l,229243,229511,268,RepeatMasker,LINE,229390,229455,66,0.25
ptg004977l,1007296,1007572,276,RepeatMasker,LINE,1007297,1007602,276,1.00
ptg004979l,549592,549867,275,RepeatMasker,LINE,549246,551054,275,1.00
ptg004988l,516733,517034,301,RepeatMasker,LINE,515927,516835,102,0.34
ptg004991l,709568,709851,283,RepeatMasker,LINE,709757,709820,64,0.23
ptg005031l,183122,183447,325,RepeatMasker,LINE,182781,186002,325,1.00
ptg005031l,515070,515385,315,RepeatMasker,LINE,515190,515658,196,0.62
ptg005056l,1479295,1479601,306,RepeatMasker,LINE,1479477,1485363,125,0.41
ptg005059l,2762088,2762396,308,RepeatMasker,LINE,2761747,2762219,131,0.43
ptg005074l,1525827,1526107,280,RepeatMasker,LINE,1525694,1528956,280,1.00
ptg005078l,775676,775965,289,RepeatMasker,LINE,775339,775799,123,0.43
ptg005078l,995962,996269,307,RepeatMasker,LINE,994713,996937,307,1.00
ptg005082l,754923,755235,312,RepeatMasker,LINE,755149,755263,87,0.28
ptg005091l,270684,271009,325,RepeatMasker,LINE,270681,270752,68,0.21
ptg005105l,3192939,3193243,304,RepeatMasker,LINE,3192773,3193333,304,1.00
ptg005108l,110912,111207,295,RepeatMasker,LINE,110485,111619,295,1.00
ptg005122l,1115955,1116251,296,RepeatMasker,LINE,1114880,1116403,296,1.00
ptg005123l,101716,102024,308,RepeatMasker,LINE,101401,101914,198,0.64
ptg005123l,1312029,1312323,294,RepeatMasker,LINE,1312072,1312136,65,0.22
ptg005123l,1312029,1312323,294,RepeatMasker,LINE,1312211,1313220,113,0.38
ptg005146l,1649233,1649544,311,RepeatMasker,LINE,1649437,1650784,108,0.35
ptg005152l,2439892,2440180,288,RepeatMasker,LINE,2439961,2440901,220,0.76
ptg005163l,355806,356124,318,RepeatMasker,LINE,355202,355926,120,0.38
ptg005164l,809103,809386,283,RepeatMasker,LINE,806122,809303,200,0.71
ptg005164l,809103,809386,283,RepeatMasker,LINE,806600,809313,210,0.74
ptg005165l,2487453,2487733,280,RepeatMasker,LINE,2487321,2490567,280,1.00
ptg005166l,929520,929812,292,RepeatMasker,LINE,929724,929791,68,0.23
ptg005166l,1035133,1035444,311,RepeatMasker,LINE,1035279,1035502,166,0.53
ptg005169l,1715492,1715816,324,RepeatMasker,LINE,1715570,1715709,140,0.43
ptg005227l,2806771,2807069,298,RepeatMasker,LINE,2806765,2806826,55,0.18
ptg005245l,3779601,3779879,278,RepeatMasker,LINE,3779443,3779623,22,0.08
ptg005245l,3779601,3779879,278,RepeatMasker,LINE,3779641,3781233,239,0.86
ptg005256l,279691,280013,322,RepeatMasker,LINE,279137,279948,257,0.80
ptg005269l,1524393,1524701,308,RepeatMasker,LINE,1524523,1524649,127,0.41
ptg005282l,2280997,2281315,318,RepeatMasker,LINE,2281178,2281243,66,0.21
ptg005288l,2570811,2571088,277,RepeatMasker,LINE,2570926,2570986,61,0.22
ptg005288l,2570811,2571088,277,RepeatMasker,LINE,2571078,2571912,11,0.04
ptg005308l,974135,974443,308,RepeatMasker,LINE,973933,974163,28,0.09
ptg005311l,2248953,2249233,280,RepeatMasker,LINE,2247868,2249061,108,0.39
ptg005319l,281690,281983,293,RepeatMasker,LINE,281929,282584,55,0.19
ptg005331l,596101,596409,308,RepeatMasker,LINE,596358,596470,52,0.17
ptg005334l,335517,335828,311,RepeatMasker,LINE,332616,335534,17,0.05
ptg005336l,928932,929236,304,RepeatMasker,LINE,929008,929055,48,0.16
ptg005336l,1521510,1521833,323,RepeatMasker,LINE,1521144,1524425,323,1.00
ptg005375l,61760,62044,284,RepeatMasker,LINE,61402,62613,284,1.00
ptg005385l,1359283,1359605,322,RepeatMasker,LINE,1359597,1359755,9,0.03
ptg005398l,276041,276343,302,RepeatMasker,LINE,276302,276468,42,0.14
ptg005428l,53888,54201,313,RepeatMasker,LINE,53932,55569,270,0.86
ptg005439l,74362,74691,329,RepeatMasker,LINE,73411,74475,113,0.34
ptg005443l,4072868,4073193,325,RepeatMasker,LINE,4072286,4073031,163,0.50
ptg005458l,768961,769239,278,RepeatMasker,LINE,768725,769032,71,0.26
ptg005461l,178654,178965,311,RepeatMasker,LINE,178098,178838,184,0.59
ptg005468l,1674416,1674719,303,RepeatMasker,LINE,1673921,1674541,125,0.41
ptg005471l,65603,65889,286,RepeatMasker,LINE,65766,67589,124,0.43
ptg005476l,930191,930494,303,RepeatMasker,LINE,930241,933501,254,0.84
ptg005476l,3631553,3631866,313,RepeatMasker,LINE,3631198,3631623,70,0.22
ptg005476l,3631553,3631866,313,RepeatMasker,LINE,3631313,3631626,73,0.23
ptg005478l,4869094,4869364,270,RepeatMasker,LINE,4869022,4869159,65,0.24
ptg005492l,579940,580266,326,RepeatMasker,LINE,580133,580655,134,0.41
ptg005504l,252927,253188,261,RepeatMasker,LINE,253124,253216,65,0.25
ptg005508l,2063501,2063784,283,RepeatMasker,LINE,2063187,2063539,38,0.13
ptg005510l,232381,232661,280,RepeatMasker,LINE,232292,232442,61,0.22
ptg005510l,232381,232661,280,RepeatMasker,LINE,232549,232609,61,0.22
ptg005515l,2445260,2445556,296,RepeatMasker,LINE,2445387,2445553,167,0.56
ptg005522l,1478348,1478660,312,RepeatMasker,LINE,1478599,1478654,56,0.18
ptg005533l,133362,133671,309,RepeatMasker,LINE,130212,133494,132,0.43
ptg005533l,1201698,1202012,314,RepeatMasker,LINE,1201874,1201937,64,0.20
ptg005548l,1544456,1544742,286,RepeatMasker,LINE,1543046,1545589,286,1.00
ptg005548l,1544456,1544742,286,RepeatMasker,LINE,1543640,1545884,286,1.00
ptg005554l,2747604,2747916,312,RepeatMasker,LINE,2745785,2749548,312,1.00
ptg005554l,2747604,2747916,312,RepeatMasker,LINE,2745787,2748872,312,1.00
ptg005554l,7387667,7387974,307,RepeatMasker,LINE,7387658,7388987,307,1.00
ptg005557l,163606,163895,289,RepeatMasker,LINE,163538,167546,289,1.00
ptg005562l,230739,231053,314,RepeatMasker,LINE,230873,231029,157,0.50
ptg005562l,283525,283828,303,RepeatMasker,LINE,280396,283552,27,0.09
ptg005570l,68195,68517,322,RepeatMasker,LINE,67086,68238,43,0.13
ptg005591l,1963090,1963385,295,RepeatMasker,LINE,1963384,1964061,2,0.01
ptg005602l,133594,133921,327,RepeatMasker,LINE,133805,134123,117,0.36
ptg005609l,325721,326017,296,RepeatMasker,LINE,324644,325811,90,0.30
ptg005615l,8379114,8379397,283,RepeatMasker,LINE,8375993,8379234,120,0.42
ptg005618l,1110197,1110477,280,RepeatMasker,LINE,1110450,1110577,28,0.10
ptg005622l,109255,109580,325,RepeatMasker,LINE,109315,109360,46,0.14
ptg005631l,84057,84359,302,RepeatMasker,LINE,83771,84488,302,1.00
ptg005642l,450880,451178,298,RepeatMasker,LINE,451096,451451,83,0.28
ptg005648l,4766376,4766690,314,RepeatMasker,LINE,4766250,4766473,97,0.31
ptg005655l,163932,164223,291,RepeatMasker,LINE,163996,164383,228,0.78
ptg005671l,45952,46255,303,RepeatMasker,LINE,45751,46011,59,0.19
ptg005671l,45952,46255,303,RepeatMasker,LINE,45968,46096,129,0.43
ptg005689l,477327,477598,271,RepeatMasker,LINE,477411,477463,53,0.20
ptg005689l,477327,477598,271,RepeatMasker,LINE,477519,477585,67,0.25
ptg005701l,1004349,1004674,325,RepeatMasker,LINE,1004136,1007232,325,1.00
ptg005701l,1848205,1848514,309,RepeatMasker,LINE,1848351,1848420,70,0.23
ptg005704l,75945,76252,307,RepeatMasker,LINE,76127,76186,60,0.20
ptg005706l,151298,151574,276,RepeatMasker,LINE,151365,151403,39,0.14
ptg005709l,814779,815088,309,RepeatMasker,LINE,815010,815083,74,0.24
ptg005720l,131270,131554,284,RepeatMasker,LINE,131316,131365,50,0.18
ptg005721l,4958704,4959027,323,RepeatMasker,LINE,4956453,4958845,141,0.44
ptg005731l,1224868,1225169,301,RepeatMasker,LINE,1225168,1225817,2,0.01
ptg005737l,5240984,5241305,321,RepeatMasker,LINE,5240498,5242857,321,1.00
ptg005761l,3258445,3258766,321,RepeatMasker,LINE,3258665,3258750,86,0.27
ptg005769l,567810,568074,264,RepeatMasker,LINE,567886,567930,45,0.17
ptg005774l,422498,422809,311,RepeatMasker,LINE,422721,422791,71,0.23
ptg005777l,5691532,5691854,322,RepeatMasker,LINE,5691439,5692992,322,1.00
ptg005786l,1572524,1572824,300,RepeatMasker,LINE,1572814,1574893,11,0.04
ptg005808l,328633,328920,287,RepeatMasker,LINE,328678,328799,122,0.43
ptg005808l,328633,328920,287,RepeatMasker,LINE,328738,329184,183,0.64
ptg005815l,2278536,2278829,293,RepeatMasker,LINE,2278796,2280298,34,0.12
ptg005820l,497435,497734,299,RepeatMasker,LINE,497663,497723,61,0.20
ptg005828l,1455931,1456227,296,RepeatMasker,LINE,1454806,1457126,296,1.00
ptg005833l,375377,375698,321,RepeatMasker,LINE,375054,375629,252,0.79
ptg005844l,2211959,2212292,333,RepeatMasker,LINE,2211995,2212946,298,0.89
ptg005876l,2429335,2429625,290,RepeatMasker,LINE,2429027,2429473,138,0.48
ptg005877l,403727,404017,290,RepeatMasker,LINE,403791,403858,68,0.23
ptg005882l,9786,10097,311,RepeatMasker,LINE,9811,10201,287,0.92
ptg005889l,83004,83280,276,RepeatMasker,LINE,83172,83224,53,0.19
ptg005899l,369555,369856,301,RepeatMasker,LINE,369345,370948,301,1.00
ptg005900l,767486,767795,309,RepeatMasker,LINE,767169,767741,255,0.83
ptg005907l,1810266,1810579,313,RepeatMasker,LINE,1810419,1810489,71,0.23
ptg005910l,205048,205359,311,RepeatMasker,LINE,205038,208760,311,1.00
ptg005920l,1748529,1748852,323,RepeatMasker,LINE,1748630,1748921,223,0.69
ptg005929l,3133849,3134168,319,RepeatMasker,LINE,3133851,3134246,318,1.00
ptg005946l,739997,740323,326,RepeatMasker,LINE,737740,740973,326,1.00
ptg005946l,3163065,3163350,285,RepeatMasker,LINE,3163174,3163237,64,0.22
ptg005946l,3163065,3163350,285,RepeatMasker,LINE,3163184,3164190,167,0.59
ptg005946l,3163065,3163350,285,RepeatMasker,LINE,3163340,3164161,11,0.04
ptg005947l,499716,500037,321,RepeatMasker,LINE,499558,499994,278,0.87
ptg005955l,345731,346022,291,RepeatMasker,LINE,345947,346017,71,0.24
ptg005956l,597687,597985,298,RepeatMasker,LINE,597375,597805,118,0.40
ptg005956l,597687,597985,298,RepeatMasker,LINE,597788,598016,198,0.66
ptg005960l,3004701,3004982,281,RepeatMasker,LINE,3004577,3004762,61,0.22
ptg005962l,2706380,2706680,300,RepeatMasker,LINE,2706575,2706640,66,0.22
ptg005967l,267435,267732,297,RepeatMasker,LINE,264546,267774,297,1.00
ptg005968l,550567,550877,310,RepeatMasker,LINE,550775,550828,54,0.17
ptg005969l,1077430,1077733,303,RepeatMasker,LINE,1077440,1077497,58,0.19
ptg005986l,93042,93353,311,RepeatMasker,LINE,91167,93301,259,0.83
ptg005994l,1805052,1805367,315,RepeatMasker,LINE,1805206,1805275,70,0.22
ptg006012l,1983411,1983718,307,RepeatMasker,LINE,1983296,1983714,303,0.99
ptg006026l,965621,965904,283,RepeatMasker,LINE,964454,965689,68,0.24
ptg006028l,2564645,2564964,319,RepeatMasker,LINE,2564701,2564792,92,0.29
ptg006029l,250501,250812,311,RepeatMasker,LINE,250484,251069,311,1.00
ptg006036l,364799,365097,298,RepeatMasker,LINE,364279,364959,160,0.54
ptg006050l,127497,127784,287,RepeatMasker,LINE,127632,127695,64,0.22
ptg006064l,323231,323531,300,RepeatMasker,LINE,323228,323296,65,0.22
ptg006080l,881201,881512,311,RepeatMasker,LINE,879745,881939,311,1.00
ptg006080l,881201,881512,311,RepeatMasker,LINE,880398,882133,311,1.00
ptg006081l,1859892,1860213,321,RepeatMasker,LINE,1858343,1860005,113,0.35
ptg006081l,1859892,1860213,321,RepeatMasker,LINE,1860006,1860170,165,0.51
ptg006084l,661966,662291,325,RepeatMasker,LINE,659273,662560,325,1.00
ptg006104l,3813017,3813325,308,RepeatMasker,LINE,3813294,3813607,32,0.10
ptg006107l,528517,528853,336,RepeatMasker,LINE,528556,528710,155,0.46
ptg006110l,2908678,2908971,293,RepeatMasker,LINE,2908589,2908713,35,0.12
ptg006110l,2908678,2908971,293,RepeatMasker,LINE,2908810,2908845,36,0.12
ptg006110l,2908678,2908971,293,RepeatMasker,LINE,2908947,2909017,25,0.09
ptg006114l,1936723,1937046,323,RepeatMasker,LINE,1936870,1937231,177,0.55
ptg006115l,2269509,2269833,324,RepeatMasker,LINE,2268467,2270170,324,1.00
ptg006145l,410219,410528,309,RepeatMasker,LINE,410432,410580,97,0.31
ptg006159l,4869481,4869758,277,RepeatMasker,LINE,4867853,4870454,277,1.00
ptg006164l,108300,108605,305,RepeatMasker,LINE,108543,108598,56,0.18
ptg006167l,1361315,1361604,289,RepeatMasker,LINE,1360276,1361371,56,0.19
ptg006172l,126219,126509,290,RepeatMasker,LINE,126093,126525,290,1.00
ptg006172l,1065448,1065770,322,RepeatMasker,LINE,1064828,1065565,117,0.36
ptg006173l,199342,199639,297,RepeatMasker,LINE,198979,199573,231,0.78
ptg006183l,2366848,2367126,278,RepeatMasker,LINE,2366845,2366915,67,0.24
ptg006193l,395386,395682,296,RepeatMasker,LINE,392668,395486,100,0.34
ptg006200l,2228200,2228507,307,RepeatMasker,LINE,2228189,2229390,307,1.00
ptg006205l,55686,55976,290,RepeatMasker,LINE,55593,55815,129,0.44
ptg006215l,812501,812827,326,RepeatMasker,LINE,811987,812843,326,1.00
ptg006217l,1004036,1004303,267,RepeatMasker,LINE,1003774,1004060,24,0.09
ptg006217l,1620453,1620767,314,RepeatMasker,LINE,1620666,1620719,54,0.17
ptg006219l,1643314,1643593,279,RepeatMasker,LINE,1643152,1643644,279,1.00
ptg006223l,3281900,3282242,342,RepeatMasker,LINE,3281726,3282111,211,0.62
ptg006233l,2719914,2720200,286,RepeatMasker,LINE,2720168,2720256,33,0.12
ptg006239l,473813,474101,288,RepeatMasker,LINE,472922,474008,195,0.68
ptg006240l,512830,513140,310,RepeatMasker,LINE,513103,513175,38,0.12
ptg006244l,659261,659593,332,RepeatMasker,LINE,659376,659693,218,0.66
ptg006260l,1252530,1252830,300,RepeatMasker,LINE,1252214,1252684,154,0.51
ptg006297l,1604831,1605162,331,RepeatMasker,LINE,1604512,1605464,331,1.00
ptg006298l,4914336,4914621,285,RepeatMasker,LINE,4913588,4914379,43,0.15
ptg006305l,1607542,1607835,293,RepeatMasker,LINE,1607750,1608226,86,0.29
ptg006314l,9137924,9138244,320,RepeatMasker,LINE,9138103,9138188,86,0.27
ptg006314l,9937767,9938095,328,RepeatMasker,LINE,9935096,9938343,328,1.00
ptg006320l,1129089,1129408,319,RepeatMasker,LINE,1129283,1131181,126,0.39
ptg006323l,568387,568696,309,RepeatMasker,LINE,568123,568496,109,0.35
ptg006332l,1059449,1059745,296,RepeatMasker,LINE,1059074,1059725,276,0.93
ptg006338l,1045399,1045668,269,RepeatMasker,LINE,1045275,1045453,54,0.20
ptg006338l,1045399,1045668,269,RepeatMasker,LINE,1045281,1045495,96,0.36
ptg006352l,368597,368879,282,RepeatMasker,LINE,368058,368624,27,0.10
ptg006355l,692543,692852,309,RepeatMasker,LINE,692379,694467,309,1.00
ptg006356l,608423,608754,331,RepeatMasker,LINE,607417,608546,123,0.37
ptg006361l,1918394,1918681,287,RepeatMasker,LINE,1918415,1918481,67,0.23
ptg006361l,1918394,1918681,287,RepeatMasker,LINE,1918648,1920068,34,0.12
ptg006366l,558984,559259,275,RepeatMasker,LINE,558435,559125,141,0.51
ptg006369l,190941,191238,297,RepeatMasker,LINE,190943,191246,296,1.00
ptg006372l,3569281,3569601,320,RepeatMasker,LINE,3569584,3572666,18,0.06
ptg006380l,9241127,9241397,270,RepeatMasker,LINE,9241040,9241190,63,0.23
ptg006380l,9241127,9241397,270,RepeatMasker,LINE,9241275,9241365,91,0.34
ptg006409l,1299885,1300181,296,RepeatMasker,LINE,1299793,1300271,296,1.00
ptg006411l,207681,207983,302,RepeatMasker,LINE,207931,208297,53,0.18
ptg006430l,177497,177809,312,RepeatMasker,LINE,177439,177539,42,0.13
ptg006441l,1478260,1478580,320,RepeatMasker,LINE,1478333,1478560,228,0.71
ptg006441l,1478260,1478580,320,RepeatMasker,LINE,1478559,1480403,22,0.07
ptg006468l,1062318,1062623,305,RepeatMasker,LINE,1062366,1064479,258,0.85
ptg006468l,3235511,3235804,293,RepeatMasker,LINE,3235676,3235747,72,0.25
ptg006473l,1014848,1015150,302,RepeatMasker,LINE,1014888,1014947,60,0.20
ptg006537l,4186194,4186515,321,RepeatMasker,LINE,4184275,4186304,110,0.34
ptg006538l,818774,819034,260,RepeatMasker,LINE,818740,818814,40,0.15
ptg006539l,1123730,1124049,319,RepeatMasker,LINE,1123967,1124042,76,0.24
ptg006542l,2505878,2506206,328,RepeatMasker,LINE,2503194,2506472,328,1.00
ptg006545l,1552705,1553017,312,RepeatMasker,LINE,1552191,1552989,284,0.91
ptg006553l,1637444,1637730,286,RepeatMasker,LINE,1637343,1637490,46,0.16
ptg006553l,1637444,1637730,286,RepeatMasker,LINE,1637496,1637624,129,0.45
ptg006572l,455542,455871,329,RepeatMasker,LINE,453240,456116,329,1.00
ptg006576l,236237,236490,253,RepeatMasker,LINE,235496,239199,253,1.00
ptg006590l,1146597,1146916,319,RepeatMasker,LINE,1146480,1146895,298,0.93
ptg006591l,172522,172830,308,RepeatMasker,LINE,171286,172808,286,0.93
ptg006607l,1527407,1527683,276,RepeatMasker,LINE,1527304,1530262,276,1.00
ptg006609l,1396371,1396680,309,RepeatMasker,LINE,1396185,1396438,67,0.22
ptg006623l,2393193,2393499,306,RepeatMasker,LINE,2392865,2393365,172,0.56
ptg006623l,3127866,3128194,328,RepeatMasker,LINE,3124421,3128030,164,0.50
ptg006636l,481378,481661,283,RepeatMasker,LINE,481299,481483,105,0.37
ptg006641l,17371,17671,300,RepeatMasker,LINE,15757,17413,42,0.14
ptg006654l,314710,314997,287,RepeatMasker,LINE,314230,317429,287,1.00
ptg006669l,437454,437759,305,RepeatMasker,LINE,436957,437497,43,0.14
ptg006672l,935554,935871,317,RepeatMasker,LINE,933384,937147,317,1.00
ptg006692l,313150,313419,269,RepeatMasker,LINE,313322,313379,58,0.22
ptg006711l,1647963,1648247,284,RepeatMasker,LINE,1647783,1648080,117,0.41
ptg006719l,530189,530460,271,RepeatMasker,LINE,530098,531299,271,1.00
ptg006728l,880826,881151,325,RepeatMasker,LINE,881062,881132,71,0.22
ptg006749l,227668,227972,304,RepeatMasker,LINE,227752,228904,221,0.73
ptg006752l,753640,753910,270,RepeatMasker,LINE,752886,753682,42,0.16
ptg006755l,1066553,1066838,285,RepeatMasker,LINE,1066789,1066860,50,0.18
ptg006758l,690160,690469,309,RepeatMasker,LINE,690394,690464,71,0.23
ptg006775l,1494067,1494358,291,RepeatMasker,LINE,1494314,1495135,45,0.15
ptg006788l,1305787,1306094,307,RepeatMasker,LINE,1305778,1306250,307,1.00
ptg006794l,14154,14459,305,RepeatMasker,LINE,11009,14275,121,0.40
ptg006805l,873001,873273,272,RepeatMasker,LINE,873112,873323,162,0.60
ptg006807l,291199,291531,332,RepeatMasker,LINE,291507,291597,25,0.08
ptg006809l,1388795,1389060,265,RepeatMasker,LINE,1388688,1389358,265,1.00
ptg006826l,1308026,1308352,326,RepeatMasker,LINE,1306533,1308470,326,1.00
ptg006838l,161284,161597,313,RepeatMasker,LINE,161446,162295,152,0.49
ptg006847l,964270,964584,314,RepeatMasker,LINE,964481,964781,104,0.33
ptg006860l,556070,556377,307,RepeatMasker,LINE,556146,556190,45,0.15
ptg006860l,556070,556377,307,RepeatMasker,LINE,556271,557566,107,0.35
ptg006867l,565201,565522,321,RepeatMasker,LINE,565078,565435,234,0.73
ptg006867l,565201,565522,321,RepeatMasker,LINE,565506,565587,17,0.05
ptg006870l,3081700,3081983,283,RepeatMasker,LINE,3081964,3083098,20,0.07
ptg006873l,4550822,4551121,299,RepeatMasker,LINE,4547925,4550845,23,0.08
ptg006875l,512258,512579,321,RepeatMasker,LINE,511480,512311,53,0.17
ptg006878l,2939743,2940057,314,RepeatMasker,LINE,2939000,2940116,314,1.00
ptg006880l,1170589,1170903,314,RepeatMasker,LINE,1170479,1170842,253,0.81
ptg006888l,1243540,1243825,285,RepeatMasker,LINE,1243717,1243821,105,0.37
ptg006903l,433741,434056,315,RepeatMasker,LINE,433861,434329,196,0.62
ptg006906l,522603,522905,302,RepeatMasker,LINE,522787,523111,119,0.39
ptg006915l,1152747,1153068,321,RepeatMasker,LINE,1152426,1152748,1,0.00
ptg006916l,193399,193677,278,RepeatMasker,LINE,193444,194346,234,0.84
ptg006930l,968328,968613,285,RepeatMasker,LINE,968348,968392,45,0.16
ptg006947l,1264948,1265283,335,RepeatMasker,LINE,1264612,1265173,225,0.67
ptg006948l,302104,302402,298,RepeatMasker,LINE,301416,303128,298,1.00
ptg006964l,976206,976533,327,RepeatMasker,LINE,973933,977210,327,1.00
ptg006969l,1142151,1142448,297,RepeatMasker,LINE,1141791,1142352,201,0.68
ptg006969l,1142151,1142448,297,RepeatMasker,LINE,1142013,1142346,195,0.66
ptg006969l,1142151,1142448,297,RepeatMasker,LINE,1142427,1144856,22,0.07
ptg006996l,238962,239261,299,RepeatMasker,LINE,239137,240941,125,0.42
ptg006996l,238962,239261,299,RepeatMasker,LINE,239172,241343,90,0.30
ptg006997l,666226,666528,302,RepeatMasker,LINE,666396,666477,82,0.27
ptg006997l,666226,666528,302,RepeatMasker,LINE,666428,666508,81,0.27
ptg007005l,795752,796081,329,RepeatMasker,LINE,793073,796248,329,1.00
ptg007012l,839010,839312,302,RepeatMasker,LINE,838611,839098,88,0.29
ptg007021l,2153345,2153680,335,RepeatMasker,LINE,2151092,2154323,335,1.00
ptg007037l,1758162,1758487,325,RepeatMasker,LINE,1757938,1760938,325,1.00
ptg007050l,89922,90236,314,RepeatMasker,LINE,90045,90222,178,0.57
ptg007050l,89922,90236,314,RepeatMasker,LINE,90229,90371,8,0.03
ptg007086l,6318129,6318421,292,RepeatMasker,LINE,6316218,6318301,172,0.59
ptg007101l,838197,838522,325,RepeatMasker,LINE,838329,838399,71,0.22
ptg007113l,78045,78341,296,RepeatMasker,LINE,77505,78147,102,0.34
ptg007123l,102773,103070,297,RepeatMasker,LINE,102624,102878,105,0.35
ptg007132l,340748,341058,310,RepeatMasker,LINE,341028,341303,31,0.10
ptg007135l,228026,228322,296,RepeatMasker,LINE,227785,228101,75,0.25
ptg007148l,2414813,2415098,285,RepeatMasker,LINE,2414581,2416518,285,1.00
ptg007176l,20974,21281,307,RepeatMasker,LINE,21010,21104,95,0.31
ptg007198l,1472937,1473077,140,RepeatMasker,LINE,1472921,1473062,125,0.89
ptg007198l,2123026,2123323,297,RepeatMasker,LINE,2122608,2123099,73,0.25
ptg007201l,294848,295134,286,RepeatMasker,LINE,294094,294912,64,0.22
ptg007201l,294848,295134,286,RepeatMasker,LINE,295046,295130,85,0.30
ptg007205l,1358460,1358781,321,RepeatMasker,LINE,1356959,1358531,71,0.22
ptg007212l,766597,766922,325,RepeatMasker,LINE,766259,766957,325,1.00
ptg007216l,1358250,1358534,284,RepeatMasker,LINE,1358007,1358383,133,0.47
ptg007218l,2819406,2819716,310,RepeatMasker,LINE,2818862,2822641,310,1.00
ptg007218l,3746705,3747017,312,RepeatMasker,LINE,3746557,3747666,312,1.00
ptg007228l,3153708,3154028,320,RepeatMasker,LINE,3153462,3153891,183,0.57
ptg007239l,1371895,1372191,296,RepeatMasker,LINE,1372089,1372277,103,0.35
ptg007248l,170171,170501,330,RepeatMasker,LINE,170141,170272,101,0.31
ptg007248l,170171,170501,330,RepeatMasker,LINE,170388,170444,57,0.17
ptg007258l,1308784,1309073,289,RepeatMasker,LINE,1309051,1309141,23,0.08
ptg007271l,1125823,1126097,274,RepeatMasker,LINE,1125587,1126051,228,0.83
ptg007276l,4212699,4212974,275,RepeatMasker,LINE,4211552,4212823,124,0.45
ptg007283l,1143214,1143480,266,RepeatMasker,LINE,1142863,1143297,83,0.31
ptg007287l,2662784,2663089,305,RepeatMasker,LINE,2662374,2662828,44,0.14
ptg007287l,2715310,2715593,283,RepeatMasker,LINE,2712852,2715520,210,0.74
ptg007287l,2715310,2715593,283,RepeatMasker,LINE,2713582,2715510,200,0.71
ptg007295l,799225,799539,314,RepeatMasker,LINE,799299,799609,241,0.77
ptg007316l,3462701,3463037,336,RepeatMasker,LINE,3459565,3462832,131,0.39
ptg007325l,450016,450310,294,RepeatMasker,LINE,450020,450580,291,0.99
ptg007325l,450016,450310,294,RepeatMasker,LINE,450245,450565,66,0.22
ptg007328l,605699,605983,284,RepeatMasker,LINE,605382,607001,284,1.00
ptg007343l,1000651,1000958,307,RepeatMasker,LINE,1000700,1001507,259,0.84
ptg007354l,57137,57446,309,RepeatMasker,LINE,57337,59277,110,0.36
ptg007378l,1968279,1968604,325,RepeatMasker,LINE,1968491,1968570,80,0.25
ptg007378l,1968279,1968604,325,RepeatMasker,LINE,1968504,1969942,101,0.31
ptg007385l,1122190,1122496,306,RepeatMasker,LINE,1121846,1122353,163,0.53
ptg007385l,1122190,1122496,306,RepeatMasker,LINE,1122088,1122350,160,0.52
ptg007385l,1122190,1122496,306,RepeatMasker,LINE,1122224,1122792,273,0.89
ptg007396l,2016509,2016815,306,RepeatMasker,LINE,2015301,2016535,26,0.08
ptg007397l,4489128,4489434,306,RepeatMasker,LINE,4489268,4489616,167,0.55
ptg007403l,385974,386257,283,RepeatMasker,LINE,383493,386184,210,0.74
ptg007413l,969371,969662,291,RepeatMasker,LINE,969466,970033,197,0.68
ptg007413l,969371,969662,291,RepeatMasker,LINE,969468,969974,195,0.67
ptg007453l,64642,64959,317,RepeatMasker,LINE,64675,64754,80,0.25
ptg007453l,64642,64959,317,RepeatMasker,LINE,64751,64983,209,0.66
ptg007456l,1267993,1268298,305,RepeatMasker,LINE,1268249,1268319,50,0.16
ptg007469l,492362,492678,316,RepeatMasker,LINE,492315,492372,10,0.03
ptg007470l,706268,706572,304,RepeatMasker,LINE,706523,706593,50,0.16
ptg007493l,899667,899980,313,RepeatMasker,LINE,899927,900001,54,0.17
ptg007504l,1215195,1215510,315,RepeatMasker,LINE,1215395,1215707,116,0.37
ptg007526l,197814,198096,282,RepeatMasker,LINE,197759,197851,37,0.13
ptg007526l,744388,744686,298,RepeatMasker,LINE,744486,744566,81,0.27
ptg007535l,1166249,1166529,280,RepeatMasker,LINE,1166492,1166676,38,0.14
ptg007539l,169155,169472,317,RepeatMasker,LINE,169444,171519,29,0.09
ptg007547l,1940952,1941246,294,RepeatMasker,LINE,1941166,1941233,68,0.23
ptg007556l,384038,384352,314,RepeatMasker,LINE,383747,384072,34,0.11
ptg007556l,384038,384352,314,RepeatMasker,LINE,383949,384071,33,0.11
ptg007566l,3233476,3233736,260,RepeatMasker,LINE,3233504,3233568,65,0.25
ptg007566l,3233476,3233736,260,RepeatMasker,LINE,3233726,3233970,11,0.04
ptg007570l,739655,739950,295,RepeatMasker,LINE,738803,739886,231,0.78
ptg007602l,1887102,1887393,291,RepeatMasker,LINE,1886610,1889297,291,1.00
ptg007608l,594572,594862,290,RepeatMasker,LINE,594849,595010,14,0.05
ptg007616l,438454,438751,297,RepeatMasker,LINE,438630,438799,122,0.41
ptg007623l,97433,97761,328,RepeatMasker,LINE,97300,99094,328,1.00
ptg007623l,1386423,1386717,294,RepeatMasker,LINE,1386617,1386680,64,0.22
ptg007626l,139549,139842,293,RepeatMasker,LINE,139431,139588,39,0.13
ptg007626l,139549,139842,293,RepeatMasker,LINE,139575,139799,225,0.77
ptg007636l,473621,473934,313,RepeatMasker,LINE,470456,474168,313,1.00
ptg007644l,71079,71377,298,RepeatMasker,LINE,70892,72099,298,1.00
ptg007649l,929016,929302,286,RepeatMasker,LINE,928161,929283,267,0.93
ptg007649l,929016,929302,286,RepeatMasker,LINE,929227,929318,76,0.27
ptg007657l,353551,353876,325,RepeatMasker,LINE,353526,355444,325,1.00
ptg007662l,62051,62360,309,RepeatMasker,LINE,62312,62381,49,0.16
ptg007680l,734333,734658,325,RepeatMasker,LINE,734246,737266,325,1.00
ptg007686l,832746,833073,327,RepeatMasker,LINE,831769,833687,327,1.00
ptg007713l,1024363,1024692,329,RepeatMasker,LINE,1024496,1024966,197,0.60
ptg007729l,3982677,3982974,297,RepeatMasker,LINE,3982870,3982980,105,0.35
ptg007740l,1024359,1024652,293,RepeatMasker,LINE,1024413,1024814,240,0.82
ptg007747l,63301,63628,327,RepeatMasker,LINE,60194,63433,132,0.40
ptg007773l,1351175,1351487,312,RepeatMasker,LINE,1351438,1351508,50,0.16
ptg007776l,177583,177903,320,RepeatMasker,LINE,177048,180400,320,1.00
ptg007784l,2511339,2511636,297,RepeatMasker,LINE,2511536,2511610,75,0.25
ptg007790l,450410,450705,295,RepeatMasker,LINE,450705,450760,1,0.00
ptg007792l,2122173,2122465,292,RepeatMasker,LINE,2122442,2122533,24,0.08
ptg007793l,1584846,1585147,301,RepeatMasker,LINE,1581708,1584890,44,0.15
ptg007807l,2604691,2604986,295,RepeatMasker,LINE,2604700,2604767,68,0.23
ptg007821l,3029242,3029553,311,RepeatMasker,LINE,3029256,3031399,298,0.96
ptg007824l,2571449,2571727,278,RepeatMasker,LINE,2571509,2571565,57,0.21
ptg007824l,3024527,3024840,313,RepeatMasker,LINE,3023857,3025374,313,1.00
ptg007831l,2799445,2799724,279,RepeatMasker,LINE,2798835,2799935,279,1.00
ptg007842l,658456,658758,302,RepeatMasker,LINE,655341,658586,130,0.43
ptg007844l,1356625,1356952,327,RepeatMasker,LINE,1354984,1357215,327,1.00
ptg007850l,155564,155884,320,RepeatMasker,LINE,155172,155623,59,0.18
ptg007850l,2553352,2553657,305,RepeatMasker,LINE,2553559,2553614,56,0.18
ptg007857l,499485,499784,299,RepeatMasker,LINE,499371,500696,299,1.00
ptg007865l,2627185,2627513,328,RepeatMasker,LINE,2627324,2627425,102,0.31
ptg007890l,169046,169364,318,RepeatMasker,LINE,169218,169341,124,0.39
ptg007898l,2410018,2410276,258,RepeatMasker,LINE,2410175,2410253,79,0.31
ptg007910l,929476,929782,306,RepeatMasker,LINE,929682,929751,70,0.23
ptg007917l,9688,10010,322,RepeatMasker,LINE,8927,9731,43,0.13
ptg007925l,4404417,4404684,267,RepeatMasker,LINE,4404640,4404818,45,0.17
ptg007934l,4429817,4430126,309,RepeatMasker,LINE,4428991,4431076,309,1.00
ptg007942l,1709975,1710253,278,RepeatMasker,LINE,1709662,1710555,278,1.00
ptg007953l,2058906,2059222,316,RepeatMasker,LINE,2058462,2059336,316,1.00
ptg007979l,605568,605867,299,RepeatMasker,LINE,605523,605895,299,1.00
ptg007979l,605568,605867,299,RepeatMasker,LINE,605831,605922,37,0.12
ptg008002l,308437,308739,302,RepeatMasker,LINE,308533,308574,42,0.14
ptg008017l,1547520,1547850,330,RepeatMasker,LINE,1547489,1547721,201,0.61
ptg008031l,832552,832870,318,RepeatMasker,LINE,832680,832787,108,0.34
ptg008031l,832552,832870,318,RepeatMasker,LINE,832693,833150,178,0.56
ptg008043l,174567,174869,302,RepeatMasker,LINE,174454,178100,302,1.00
ptg008043l,676264,676555,291,RepeatMasker,LINE,676031,677168,291,1.00
ptg008044l,432998,433289,291,RepeatMasker,LINE,433244,433674,46,0.16
ptg008050l,120617,120935,318,RepeatMasker,LINE,120401,120893,276,0.87
ptg008051l,95692,95981,289,RepeatMasker,LINE,95918,96658,64,0.22
ptg008054l,1993824,1994151,327,RepeatMasker,LINE,1993803,1994726,327,1.00
ptg008063l,4661291,4661570,279,RepeatMasker,LINE,4661397,4661539,143,0.51
ptg008066l,546581,546890,309,RepeatMasker,LINE,546841,546915,50,0.16
ptg008067l,1915368,1915692,324,RepeatMasker,LINE,1915334,1915529,161,0.50
ptg008084l,635224,635532,308,RepeatMasker,LINE,635310,635989,223,0.72
ptg008084l,3022834,3023126,292,RepeatMasker,LINE,3022972,3023014,43,0.15
ptg008106l,1274467,1274798,331,RepeatMasker,LINE,1274139,1274630,163,0.49
ptg008112l,798977,799263,286,RepeatMasker,LINE,797795,799057,80,0.28
ptg008112l,3206678,3206959,281,RepeatMasker,LINE,3206349,3206835,157,0.56
ptg008122l,2540462,2540741,279,RepeatMasker,LINE,2540272,2541214,279,1.00
ptg008127l,351220,351514,294,RepeatMasker,LINE,351340,351509,170,0.58
ptg008137l,3832496,3832807,311,RepeatMasker,LINE,3832758,3832832,50,0.16
ptg008145l,928492,928824,332,RepeatMasker,LINE,928167,928579,87,0.26
ptg008145l,928492,928824,332,RepeatMasker,LINE,928216,928642,150,0.45
ptg008163l,724722,725020,298,RepeatMasker,LINE,724353,725242,298,1.00
ptg008179l,45402,45718,316,RepeatMasker,LINE,45404,45900,315,1.00
ptg008199l,189511,189789,278,RepeatMasker,LINE,189131,190093,278,1.00
ptg008217l,783623,783905,282,RepeatMasker,LINE,783582,784482,282,1.00
ptg008233l,123669,123971,302,RepeatMasker,LINE,123904,123947,44,0.15
ptg008239l,2064417,2064711,294,RepeatMasker,LINE,2064299,2064532,115,0.39
ptg008251l,100718,101058,340,RepeatMasker,LINE,99956,103913,340,1.00
ptg008255l,365379,365681,302,RepeatMasker,LINE,365561,365606,46,0.15
ptg008255l,2964091,2964384,293,RepeatMasker,LINE,2963975,2964417,293,1.00
ptg008255l,2964091,2964384,293,RepeatMasker,LINE,2964356,2964422,29,0.10
ptg008271l,3052811,3053136,325,RepeatMasker,LINE,3050718,3053150,325,1.00
ptg008279l,68744,69056,312,RepeatMasker,LINE,68812,68902,91,0.29
ptg008280l,1260560,1260846,286,RepeatMasker,LINE,1260199,1260734,174,0.61
ptg008288l,515953,516239,286,RepeatMasker,LINE,515744,516011,58,0.20
ptg008320l,406109,406415,306,RepeatMasker,LINE,404892,406233,124,0.41
ptg008333l,1253657,1253982,325,RepeatMasker,LINE,1253837,1254237,146,0.45
ptg008336l,333893,334227,334,RepeatMasker,LINE,334000,334075,76,0.23
ptg008338l,36885,37171,286,RepeatMasker,LINE,36931,37114,184,0.64
ptg008351l,940463,940761,298,RepeatMasker,LINE,940497,940542,46,0.15
ptg008353l,2124710,2125018,308,RepeatMasker,LINE,2124505,2124867,157,0.51
ptg008360l,477447,477727,280,RepeatMasker,LINE,477567,477649,83,0.30
ptg008360l,477447,477727,280,RepeatMasker,LINE,477614,477719,106,0.38
ptg008363l,2439840,2440105,265,RepeatMasker,LINE,2436997,2440121,265,1.00
ptg008393l,462398,462730,332,RepeatMasker,LINE,460716,462685,287,0.86
ptg008400l,1749330,1749606,276,RepeatMasker,LINE,1749277,1749373,43,0.16
ptg008404l,175362,175658,296,RepeatMasker,LINE,175585,175655,71,0.24
ptg008405l,268205,268492,287,RepeatMasker,LINE,267970,269433,287,1.00
ptg008415l,610491,610781,290,RepeatMasker,LINE,610461,612276,290,1.00
ptg008436l,791581,791885,304,RepeatMasker,LINE,788438,791716,135,0.44
ptg008440l,1947101,1947410,309,RepeatMasker,LINE,1947079,1947167,66,0.21
ptg008440l,1947101,1947410,309,RepeatMasker,LINE,1947386,1950028,25,0.08
ptg008459l,415596,415885,289,RepeatMasker,LINE,415726,415786,61,0.21
ptg008460l,1126693,1127023,330,RepeatMasker,LINE,1126650,1126833,140,0.42
ptg008460l,3289797,3290074,277,RepeatMasker,LINE,3289915,3289960,46,0.17
ptg008465l,24223,24517,294,RepeatMasker,LINE,24345,24430,86,0.29
ptg008465l,24223,24517,294,RepeatMasker,LINE,24506,24815,12,0.04
ptg008482l,1750830,1751155,325,RepeatMasker,LINE,1750467,1753506,325,1.00
ptg008484l,3117497,3117802,305,RepeatMasker,LINE,3117237,3117562,65,0.21
ptg008494l,1032025,1032324,299,RepeatMasker,LINE,1032154,1032600,171,0.57
ptg008496l,1469493,1469809,316,RepeatMasker,LINE,1469266,1469695,202,0.64
ptg008507l,326617,326900,283,RepeatMasker,LINE,323455,326725,108,0.38
ptg008515l,496769,497054,285,RepeatMasker,LINE,497019,497226,36,0.13
ptg008531l,656690,657007,317,RepeatMasker,LINE,656863,656986,124,0.39
ptg008559l,7314184,7314507,323,RepeatMasker,LINE,7313076,7314520,323,1.00
ptg008563l,631333,631660,327,RepeatMasker,LINE,631399,632986,262,0.80
ptg008566l,478999,479315,316,RepeatMasker,LINE,479294,479457,22,0.07
ptg008583l,1065420,1065732,312,RepeatMasker,LINE,1065609,1065946,124,0.40
ptg008617l,1095986,1096310,324,RepeatMasker,LINE,1095661,1098893,324,1.00
ptg008635l,491872,492185,313,RepeatMasker,LINE,491883,492234,303,0.97
ptg008635l,491872,492185,313,RepeatMasker,LINE,490050,492190,313,1.00
ptg008655l,1013384,1013662,278,RepeatMasker,LINE,1012582,1013467,83,0.30
ptg008661l,279848,280177,329,RepeatMasker,LINE,277154,280438,329,1.00
ptg008673l,139648,139968,320,RepeatMasker,LINE,139237,139716,68,0.21
ptg008679l,3351378,3351673,295,RepeatMasker,LINE,3351459,3352098,215,0.73
ptg008700l,4136810,4137098,288,RepeatMasker,LINE,4136484,4136882,72,0.25
ptg008713l,558345,558626,281,RepeatMasker,LINE,557559,558402,57,0.20
ptg008726l,317878,318165,287,RepeatMasker,LINE,317994,318099,106,0.37
ptg008726l,317878,318165,287,RepeatMasker,LINE,318098,318171,68,0.24
ptg008727l,483358,483670,312,RepeatMasker,LINE,483119,485092,312,1.00
ptg008746l,688489,688778,289,RepeatMasker,LINE,687910,691172,289,1.00
ptg008747l,1742357,1742662,305,RepeatMasker,LINE,1741568,1744462,305,1.00
ptg008788l,1218701,1219037,336,RepeatMasker,LINE,1216444,1219422,336,1.00
ptg008806l,1322225,1322540,315,RepeatMasker,LINE,1322368,1322478,111,0.35
ptg008838l,201586,201858,272,RepeatMasker,LINE,201692,201768,77,0.28
ptg008855l,1267057,1267362,305,RepeatMasker,LINE,1267076,1268524,287,0.94
ptg008910l,1196836,1197164,328,RepeatMasker,LINE,1195598,1198510,328,1.00
ptg008928l,1371412,1371730,318,RepeatMasker,LINE,1371256,1371488,76,0.24
ptg008954l,316847,317127,280,RepeatMasker,LINE,315345,318173,280,1.00
ptg008973l,110122,110429,307,RepeatMasker,LINE,109578,113344,307,1.00
ptg008991l,1679663,1679929,266,RepeatMasker,LINE,1679670,1679736,67,0.25
ptg008991l,1679663,1679929,266,RepeatMasker,LINE,1679678,1679743,66,0.25
ptg009005l,319467,319753,286,RepeatMasker,LINE,318230,319744,277,0.97
ptg009014l,373232,373527,295,RepeatMasker,LINE,373133,373327,95,0.32
ptg009029l,3432420,3432748,328,RepeatMasker,LINE,3431480,3432740,320,0.98
ptg009033l,290135,290442,307,RepeatMasker,LINE,290354,290638,89,0.29
ptg009039l,572856,573169,313,RepeatMasker,LINE,569713,572985,129,0.41
ptg009039l,1479449,1479745,296,RepeatMasker,LINE,1479723,1479833,23,0.08
ptg009047l,1179766,1180056,290,RepeatMasker,LINE,1179790,1179843,54,0.19
ptg009047l,1179766,1180056,290,RepeatMasker,LINE,1180016,1180659,41,0.14
ptg009047l,1179766,1180056,290,RepeatMasker,LINE,1180016,1180760,41,0.14
ptg009117l,141863,142168,305,RepeatMasker,LINE,141903,142043,141,0.46
ptg009132l,1852673,1852983,310,RepeatMasker,LINE,1852834,1852895,62,0.20
ptg009151l,1078696,1078998,302,RepeatMasker,LINE,1078949,1079025,50,0.17
ptg009171l,709110,709405,295,RepeatMasker,LINE,709373,709972,33,0.11
ptg009188l,590549,590835,286,RepeatMasker,LINE,589495,590705,156,0.55
ptg009206l,2619972,2620266,294,RepeatMasker,LINE,2619650,2620257,285,0.97
ptg009221l,2137249,2137569,320,RepeatMasker,LINE,2134114,2137318,69,0.22
ptg009223l,1327862,1328163,301,RepeatMasker,LINE,1328116,1328947,48,0.16
ptg009224l,4114583,4114901,318,RepeatMasker,LINE,4114777,4114843,67,0.21
ptg009254l,187433,187710,277,RepeatMasker,LINE,187143,188824,277,1.00
ptg009267l,430744,431064,320,RepeatMasker,LINE,430313,431081,320,1.00
ptg009271l,265359,265686,327,RepeatMasker,LINE,265383,265453,71,0.22
ptg009271l,5163507,5163810,303,RepeatMasker,LINE,5163686,5163888,125,0.41
ptg009285l,884497,884818,321,RepeatMasker,LINE,883464,885043,321,1.00
ptg009288l,819930,820227,297,RepeatMasker,LINE,817365,820225,295,0.99
ptg009298l,600805,601062,257,RepeatMasker,LINE,601015,601286,48,0.19
ptg009305l,506351,506645,294,RepeatMasker,LINE,506429,506502,74,0.25
ptg009309l,2145376,2145679,303,RepeatMasker,LINE,2144228,2148434,303,1.00
ptg009318l,5470913,5471208,295,RepeatMasker,LINE,5470250,5471330,295,1.00
ptg009318l,5909405,5909668,263,RepeatMasker,LINE,5909390,5909885,263,1.00
ptg009326l,1110779,1111070,291,RepeatMasker,LINE,1110080,1110947,168,0.58
ptg009335l,758603,758889,286,RepeatMasker,LINE,758770,759389,120,0.42
ptg009347l,1060401,1060697,296,RepeatMasker,LINE,1060656,1061378,42,0.14
ptg009355l,436781,437074,293,RepeatMasker,LINE,436973,437026,54,0.18
ptg009357l,590049,590374,325,RepeatMasker,LINE,589716,592960,325,1.00
ptg009373l,2991408,2991693,285,RepeatMasker,LINE,2991506,2991619,114,0.40
ptg009387l,4243771,4244060,289,RepeatMasker,LINE,4243703,4244028,257,0.89
ptg009387l,4579120,4579423,303,RepeatMasker,LINE,4579286,4579389,104,0.34
ptg009395l,627826,628132,306,RepeatMasker,LINE,627951,628122,172,0.56
ptg009395l,627826,628132,306,RepeatMasker,LINE,628109,628293,24,0.08
ptg009395l,1303976,1304285,309,RepeatMasker,LINE,1304028,1304100,73,0.24
ptg009395l,1303976,1304285,309,RepeatMasker,LINE,1304052,1304097,46,0.15
ptg009423l,269568,269879,311,RepeatMasker,LINE,266589,269605,37,0.12
ptg009441l,592326,592616,290,RepeatMasker,LINE,591987,592348,22,0.08
ptg009467l,219482,219802,320,RepeatMasker,LINE,219600,219665,66,0.21
ptg009471l,1924700,1925002,302,RepeatMasker,LINE,1924716,1924910,195,0.65
ptg009478l,1581978,1582287,309,RepeatMasker,LINE,1578879,1582113,135,0.44
ptg009491l,340065,340340,275,RepeatMasker,LINE,338060,340227,162,0.59
ptg009494l,275513,275807,294,RepeatMasker,LINE,275289,275572,59,0.20
ptg009496l,144954,145284,330,RepeatMasker,LINE,145158,145228,71,0.22
ptg009509l,2325267,2325558,291,RepeatMasker,LINE,2325095,2325276,9,0.03
ptg009540l,92589,92891,302,RepeatMasker,LINE,92869,92935,23,0.08
ptg009546l,2537525,2537811,286,RepeatMasker,LINE,2537030,2538560,286,1.00
ptg009588l,432245,432538,293,RepeatMasker,LINE,432283,432738,256,0.87
ptg009588l,512560,512843,283,RepeatMasker,LINE,512615,512773,159,0.56
ptg009599l,265197,265487,290,RepeatMasker,LINE,265319,265368,50,0.17
ptg009627l,1001547,1001828,281,RepeatMasker,LINE,1001463,1001763,216,0.77
ptg009643l,6872,7189,317,RepeatMasker,LINE,6835,7325,317,1.00
ptg009653l,1608295,1608607,312,RepeatMasker,LINE,1607237,1608572,277,0.89
ptg009682l,330809,331118,309,RepeatMasker,LINE,330434,330912,103,0.33
ptg009682l,330809,331118,309,RepeatMasker,LINE,331058,331103,46,0.15
ptg009683l,1230772,1231094,322,RepeatMasker,LINE,1230419,1233681,322,1.00
ptg009688l,1110499,1110825,326,RepeatMasker,LINE,1110722,1110777,56,0.17
ptg009694l,156512,156820,308,RepeatMasker,LINE,155417,156648,136,0.44
ptg009700l,199684,200010,326,RepeatMasker,LINE,198580,200020,326,1.00
ptg009710l,853783,854097,314,RepeatMasker,LINE,852267,854397,314,1.00
ptg009710l,1616054,1616371,317,RepeatMasker,LINE,1615272,1617649,317,1.00
ptg009714l,1247272,1247579,307,RepeatMasker,LINE,1247313,1247994,267,0.87
ptg009718l,250310,250614,304,RepeatMasker,LINE,250567,250626,48,0.16
ptg009735l,117718,118005,287,RepeatMasker,LINE,116849,117801,83,0.29
ptg009758l,5249183,5249476,293,RepeatMasker,LINE,5249168,5249730,293,1.00
ptg009758l,5249183,5249476,293,RepeatMasker,LINE,5249282,5250057,195,0.67
ptg009771l,1852453,1852731,278,RepeatMasker,LINE,1852698,1853115,34,0.12
ptg009778l,635967,636243,276,RepeatMasker,LINE,635863,636112,145,0.53
ptg009797l,1412548,1412842,294,RepeatMasker,LINE,1412528,1412624,76,0.26
ptg009839l,272879,273182,303,RepeatMasker,LINE,273039,273083,45,0.15
ptg009852l,749327,749630,303,RepeatMasker,LINE,749238,752988,303,1.00
ptg009884l,1082743,1083051,308,RepeatMasker,LINE,1081826,1083116,308,1.00
ptg009893l,478560,478870,310,RepeatMasker,LINE,478582,478710,129,0.42
ptg009893l,1985557,1985874,317,RepeatMasker,LINE,1983426,1987130,317,1.00
ptg009914l,622169,622518,349,RepeatMasker,LINE,622016,622266,97,0.28
ptg009918l,801311,801597,286,RepeatMasker,LINE,799859,801671,286,1.00
ptg009919l,1720819,1721126,307,RepeatMasker,LINE,1720823,1721075,253,0.82
ptg009919l,1720819,1721126,307,RepeatMasker,LINE,1720869,1721165,258,0.84
ptg009923l,191595,191899,304,RepeatMasker,LINE,191888,192287,12,0.04
ptg009971l,1019422,1019720,298,RepeatMasker,LINE,1019411,1022173,298,1.00
ptg009996l,1146547,1146835,288,RepeatMasker,LINE,1146315,1146714,167,0.58
ptg009996l,1146547,1146835,288,RepeatMasker,LINE,1146390,1146793,246,0.85
ptg009999l,916083,916334,251,RepeatMasker,LINE,916038,916619,251,1.00
ptg010000l,983645,983952,307,RepeatMasker,LINE,982617,984112,307,1.00
ptg010042l,1133755,1134043,288,RepeatMasker,LINE,1133852,1133962,111,0.39
ptg010063l,748214,748511,297,RepeatMasker,LINE,746521,748311,97,0.33
ptg010063l,748214,748511,297,RepeatMasker,LINE,748310,748484,175,0.59
ptg010063l,3145593,3145894,301,RepeatMasker,LINE,3143436,3145632,39,0.13
ptg010064l,897208,897510,302,RepeatMasker,LINE,896896,897261,53,0.18
ptg010064l,897208,897510,302,RepeatMasker,LINE,897045,897369,161,0.53
ptg010075l,1139870,1140126,256,RepeatMasker,LINE,1140013,1140092,80,0.31
ptg010075l,1139870,1140126,256,RepeatMasker,LINE,1140025,1140095,71,0.28
ptg010075l,2220679,2221011,332,RepeatMasker,LINE,2220828,2221864,184,0.55
ptg010089l,1625683,1625965,282,RepeatMasker,LINE,1625314,1625795,112,0.40
ptg010105l,1097639,1097965,326,RepeatMasker,LINE,1095009,1098233,326,1.00
ptg010106l,1411744,1412057,313,RepeatMasker,LINE,1411980,1412053,74,0.24
ptg010135l,1718031,1718302,271,RepeatMasker,LINE,1717703,1718048,17,0.06
ptg010168l,824761,825056,295,RepeatMasker,LINE,824790,825158,267,0.91
ptg010171l,844423,844726,303,RepeatMasker,LINE,844565,844618,54,0.18
ptg010176l,109914,110202,288,RepeatMasker,LINE,109990,110056,67,0.23
ptg010176l,109914,110202,288,RepeatMasker,LINE,109997,110067,71,0.25
ptg010182l,1413777,1414048,271,RepeatMasker,LINE,1413271,1413857,80,0.30
ptg010185l,1554241,1554541,300,RepeatMasker,LINE,1553772,1554339,98,0.33
ptg010192l,1856919,1857265,346,RepeatMasker,LINE,1857039,1857098,60,0.17
ptg010198l,835049,835345,296,RepeatMasker,LINE,835074,835264,191,0.65
ptg010198l,835049,835345,296,RepeatMasker,LINE,835251,835427,95,0.32
ptg010226l,461777,462073,296,RepeatMasker,LINE,460875,462290,296,1.00
ptg010226l,461777,462073,296,RepeatMasker,LINE,460979,461868,91,0.31
ptg010231l,619357,619663,306,RepeatMasker,LINE,619416,619517,102,0.33
ptg010247l,36151,36436,285,RepeatMasker,LINE,36293,36354,62,0.22
ptg010248l,2035301,2035577,276,RepeatMasker,LINE,2035478,2035531,54,0.20
ptg010251l,5188580,5188868,288,RepeatMasker,LINE,5187469,5189908,288,1.00
ptg010251l,5384786,5385083,297,RepeatMasker,LINE,5385069,5385171,15,0.05
ptg010254l,607260,607587,327,RepeatMasker,LINE,607575,607914,13,0.04
ptg010276l,804704,804989,285,RepeatMasker,LINE,804503,804895,191,0.67
ptg010276l,2029691,2030023,332,RepeatMasker,LINE,2029738,2030077,286,0.86
ptg010282l,71821,72101,280,RepeatMasker,LINE,71763,72307,280,1.00
ptg010285l,387507,387781,274,RepeatMasker,LINE,386910,387522,15,0.05
ptg010290l,661587,661874,287,RepeatMasker,LINE,661728,662534,147,0.51
ptg010291l,945829,946126,297,RepeatMasker,LINE,945263,945949,120,0.40
ptg010304l,861470,861753,283,RepeatMasker,LINE,861587,861641,55,0.19
ptg010311l,724577,724880,303,RepeatMasker,LINE,724734,724794,61,0.20
ptg010311l,2303863,2304154,291,RepeatMasker,LINE,2304084,2304486,71,0.24
ptg010311l,2303863,2304154,291,RepeatMasker,LINE,2304106,2304237,49,0.17
ptg010321l,74076,74387,311,RepeatMasker,LINE,73410,74324,248,0.80
ptg010330l,256767,257066,299,RepeatMasker,LINE,256640,256966,199,0.67
ptg010341l,1161709,1162043,334,RepeatMasker,LINE,1161841,1162317,203,0.61
ptg010373l,663869,664164,295,RepeatMasker,LINE,661054,664202,295,1.00
ptg010404l,807603,807930,327,RepeatMasker,LINE,807583,808176,327,1.00
ptg010416l,1760379,1760668,289,RepeatMasker,LINE,1760021,1763294,289,1.00
ptg010421l,396730,397019,289,RepeatMasker,LINE,396829,396954,126,0.44
ptg010427l,1018486,1018768,282,RepeatMasker,LINE,1018564,1019860,205,0.73
ptg010459l,869677,869979,302,RepeatMasker,LINE,869890,869972,83,0.27
ptg010460l,2937776,2938043,267,RepeatMasker,LINE,2937376,2937903,127,0.48
ptg010472l,1152619,1152911,292,RepeatMasker,LINE,1152795,1152926,117,0.40
ptg010485l,213009,213299,290,RepeatMasker,LINE,213087,213301,213,0.73
ptg010498l,117299,117623,324,RepeatMasker,LINE,117309,117697,315,0.97
ptg010518l,1266399,1266700,301,RepeatMasker,LINE,1266651,1266721,50,0.17
ptg010520l,457935,458210,275,RepeatMasker,LINE,457677,458008,73,0.27
ptg010532l,1300969,1301260,291,RepeatMasker,LINE,1300469,1301064,95,0.33
ptg010548l,1369146,1369446,300,RepeatMasker,LINE,1369285,1369512,162,0.54
ptg010592l,174407,174735,328,RepeatMasker,LINE,173921,174451,44,0.13
ptg010613l,2212271,2212574,303,RepeatMasker,LINE,2212188,2212336,65,0.21
ptg010613l,2212271,2212574,303,RepeatMasker,LINE,2212443,2212516,74,0.24
ptg010613l,2809376,2809697,321,RepeatMasker,LINE,2809391,2809471,81,0.25
ptg010613l,2809376,2809697,321,RepeatMasker,LINE,2809555,2810641,143,0.45
ptg010613l,3017925,3018226,301,RepeatMasker,LINE,3017505,3019228,301,1.00
ptg010618l,1383843,1384156,313,RepeatMasker,LINE,1380576,1384325,313,1.00
ptg010624l,227211,227535,324,RepeatMasker,LINE,226997,227221,10,0.03
ptg010642l,169043,169361,318,RepeatMasker,LINE,168978,169080,37,0.12
ptg010642l,684127,684439,312,RepeatMasker,LINE,683971,684276,149,0.48
ptg010649l,866427,866743,316,RepeatMasker,LINE,866327,866794,316,1.00
ptg010652l,219845,220129,284,RepeatMasker,LINE,220029,220110,82,0.29
ptg010654l,62420,62717,297,RepeatMasker,LINE,62544,64499,174,0.59
ptg010659l,283033,283340,307,RepeatMasker,LINE,283082,283981,259,0.84
ptg010671l,181336,181639,303,RepeatMasker,LINE,180600,181422,86,0.28
ptg010678l,1188271,1188578,307,RepeatMasker,LINE,1188457,1189276,122,0.40
ptg010678l,4401256,4401570,314,RepeatMasker,LINE,4400436,4401346,90,0.29
ptg010683l,111741,112045,304,RepeatMasker,LINE,111978,112048,68,0.22
ptg010685l,137820,138137,317,RepeatMasker,LINE,136348,139412,317,1.00
ptg010720l,2804682,2805003,321,RepeatMasker,LINE,2804923,2804993,71,0.22
ptg010737l,2683854,2684157,303,RepeatMasker,LINE,2684019,2684093,75,0.25
ptg010761l,2318667,2318985,318,RepeatMasker,LINE,2318603,2318775,108,0.34
ptg010764l,968280,968599,319,RepeatMasker,LINE,967768,968331,51,0.16
ptg010765l,739546,739847,301,RepeatMasker,LINE,739166,740738,301,1.00
ptg010787l,1379833,1380132,299,RepeatMasker,LINE,1380080,1380125,46,0.15
ptg010793l,2701895,2702219,324,RepeatMasker,LINE,2702062,2702846,158,0.49
ptg010796l,737513,737809,296,RepeatMasker,LINE,737329,737687,174,0.59
ptg010837l,1584748,1585066,318,RepeatMasker,LINE,1584209,1585083,318,1.00
ptg010849l,404194,404499,305,RepeatMasker,LINE,403881,404312,118,0.39
ptg010866l,113454,113766,312,RepeatMasker,LINE,113171,113650,196,0.63
ptg010866l,113454,113766,312,RepeatMasker,LINE,113270,113682,228,0.73
ptg010880l,275780,276104,324,RepeatMasker,LINE,275427,278695,324,1.00
ptg010896l,600086,600356,270,RepeatMasker,LINE,598146,601970,270,1.00
ptg010898l,1542433,1542710,277,RepeatMasker,LINE,1542226,1542875,277,1.00
ptg010899l,1236029,1236341,312,RepeatMasker,LINE,1236218,1236292,75,0.24
ptg010909l,1917807,1918106,299,RepeatMasker,LINE,1917096,1918534,299,1.00
ptg010920l,658553,658874,321,RepeatMasker,LINE,658497,658648,95,0.30
ptg010941l,1058359,1058653,294,RepeatMasker,LINE,1057889,1062295,294,1.00
ptg010951l,1561511,1561787,276,RepeatMasker,LINE,1561167,1561840,276,1.00
ptg010951l,1561511,1561787,276,RepeatMasker,LINE,1561239,1561930,276,1.00
ptg010964l,1311964,1312280,316,RepeatMasker,LINE,1312014,1312091,78,0.25
ptg010966l,50642,50973,331,RepeatMasker,LINE,50593,51073,331,1.00
ptg010971l,287652,287923,271,RepeatMasker,LINE,287766,288377,158,0.58
ptg010974l,272340,272655,315,RepeatMasker,LINE,272057,272431,91,0.29
ptg010976l,1585435,1585749,314,RepeatMasker,LINE,1584799,1585559,124,0.39
ptg011010l,233475,233803,328,RepeatMasker,LINE,232034,234542,328,1.00
ptg011010l,340592,340910,318,RepeatMasker,LINE,340475,340892,300,0.94
ptg011016l,555972,556297,325,RepeatMasker,LINE,555612,558844,325,1.00
ptg011034l,1287482,1287768,286,RepeatMasker,LINE,1286443,1287773,286,1.00
ptg011062l,1687346,1687636,290,RepeatMasker,LINE,1687528,1687587,60,0.21
ptg011080l,55969,56305,336,RepeatMasker,LINE,52830,56100,131,0.39
ptg011084l,1459672,1459977,305,RepeatMasker,LINE,1459413,1460267,305,1.00
ptg011092l,56399,56705,306,RepeatMasker,LINE,55544,56631,232,0.76
ptg011092l,2238685,2238994,309,RepeatMasker,LINE,2238921,2238991,71,0.23
ptg011102l,784767,785070,303,RepeatMasker,LINE,783614,786137,303,1.00
ptg011105l,1085264,1085568,304,RepeatMasker,LINE,1085450,1085515,66,0.22
ptg011113l,587565,587880,315,RepeatMasker,LINE,584422,587657,92,0.29
ptg011153l,1653506,1653804,298,RepeatMasker,LINE,1653552,1653603,52,0.17
ptg011157l,389906,390235,329,RepeatMasker,LINE,389938,389978,41,0.12
ptg011163l,470613,470919,306,RepeatMasker,LINE,470597,470668,55,0.18
ptg011163l,2802544,2802860,316,RepeatMasker,LINE,2802778,2802819,42,0.13
ptg011219l,123588,123867,279,RepeatMasker,LINE,123501,123595,7,0.03
ptg011223l,364444,364732,288,RepeatMasker,LINE,364363,364526,82,0.28
ptg011224l,1137405,1137715,310,RepeatMasker,LINE,1136834,1139318,310,1.00
ptg011224l,1137405,1137715,310,RepeatMasker,LINE,1137341,1140643,310,1.00
ptg011236l,1536213,1536532,319,RepeatMasker,LINE,1534887,1536295,82,0.26
ptg011241l,744502,744784,282,RepeatMasker,LINE,743470,745718,282,1.00
ptg011246l,1301346,1301666,320,RepeatMasker,LINE,1299082,1301390,44,0.14
ptg011258l,1794844,1795129,285,RepeatMasker,LINE,1794986,1795047,62,0.22
ptg011270l,3340500,3340805,305,RepeatMasker,LINE,3340030,3340589,89,0.29
ptg011279l,3034639,3034955,316,RepeatMasker,LINE,3034607,3035252,316,1.00
ptg011290l,222538,222853,315,RepeatMasker,LINE,222760,223979,94,0.30
ptg011294l,6558885,6559202,317,RepeatMasker,LINE,6559137,6559216,66,0.21
ptg011311l,502742,503034,292,RepeatMasker,LINE,502933,503114,102,0.35
ptg011330l,943475,943791,316,RepeatMasker,LINE,942615,943670,195,0.62
ptg011330l,1327619,1327912,293,RepeatMasker,LINE,1327296,1327635,16,0.05
ptg011337l,708788,709080,292,RepeatMasker,LINE,708947,709915,134,0.46
ptg011341l,480034,480318,284,RepeatMasker,LINE,479427,481330,284,1.00
ptg011345l,372706,372982,276,RepeatMasker,LINE,372514,374646,276,1.00
ptg011356l,240807,241105,298,RepeatMasker,LINE,240332,241828,298,1.00
ptg011356l,693373,693650,277,RepeatMasker,LINE,693308,693839,277,1.00
ptg011358l,524201,524517,316,RepeatMasker,LINE,521059,524233,32,0.10
ptg011366l,71413,71693,280,RepeatMasker,LINE,71492,72401,202,0.72
ptg011395l,221251,221535,284,RepeatMasker,LINE,221210,221361,110,0.39
ptg011395l,221251,221535,284,RepeatMasker,LINE,221297,222278,239,0.84
ptg011405l,1773271,1773543,272,RepeatMasker,LINE,1773527,1774674,17,0.06
ptg011414l,787604,787938,334,RepeatMasker,LINE,787872,787914,43,0.13
ptg011414l,1018101,1018395,294,RepeatMasker,LINE,1018075,1018652,294,1.00
ptg011414l,1018101,1018395,294,RepeatMasker,LINE,1018292,1018692,104,0.35
ptg011423l,840985,841254,269,RepeatMasker,LINE,840869,841012,27,0.10
ptg011423l,1186953,1187272,319,RepeatMasker,LINE,1187089,1189724,184,0.58
ptg011440l,843298,843588,290,RepeatMasker,LINE,842824,843522,224,0.77
ptg011446l,530919,531207,288,RepeatMasker,LINE,531081,532711,127,0.44
ptg011448l,547724,548011,287,RepeatMasker,LINE,544789,548534,287,1.00
ptg011449l,505684,505988,304,RepeatMasker,LINE,505853,506824,136,0.45
ptg011531l,1612303,1612598,295,RepeatMasker,LINE,1612255,1612352,49,0.17
ptg011531l,1612303,1612598,295,RepeatMasker,LINE,1612577,1612979,22,0.07
ptg011532l,1161983,1162280,297,RepeatMasker,LINE,1162280,1163735,1,0.00
ptg011546l,1754826,1755116,290,RepeatMasker,LINE,1753572,1755020,194,0.67
ptg011548l,245671,245988,317,RepeatMasker,LINE,245414,246221,317,1.00
ptg011569l,601950,602262,312,RepeatMasker,LINE,598736,602440,312,1.00
ptg011571l,176248,176564,316,RepeatMasker,LINE,175383,176338,90,0.28
ptg011575l,606769,607060,291,RepeatMasker,LINE,606921,606994,74,0.25
ptg011580l,1003207,1003500,293,RepeatMasker,LINE,1002127,1003367,160,0.55
ptg011635l,189178,189494,316,RepeatMasker,LINE,189244,190313,251,0.79
ptg011685l,284491,284787,296,RepeatMasker,LINE,284523,284594,72,0.24
ptg011713l,884804,885118,314,RepeatMasker,LINE,884672,884819,15,0.05
ptg011716l,384946,385267,321,RepeatMasker,LINE,384827,385026,80,0.25
ptg011721l,387131,387449,318,RepeatMasker,LINE,385905,388204,318,1.00
ptg011721l,1045075,1045375,300,RepeatMasker,LINE,1044514,1045114,39,0.13
ptg011721l,1045075,1045375,300,RepeatMasker,LINE,1045116,1045540,260,0.87
ptg011726l,1060289,1060599,310,RepeatMasker,LINE,1059953,1060456,167,0.54
ptg011746l,98222,98514,292,RepeatMasker,LINE,98394,98586,121,0.41
ptg011782l,422911,423187,276,RepeatMasker,LINE,421820,423053,142,0.51
ptg011818l,800927,801243,316,RepeatMasker,LINE,801099,801169,71,0.22
ptg011832l,273857,274188,331,RepeatMasker,LINE,272782,274792,331,1.00
ptg011861l,810555,810808,253,RepeatMasker,LINE,807196,810580,25,0.10
ptg011864l,3639563,3639862,299,RepeatMasker,LINE,3639236,3639978,299,1.00
ptg011888l,3170604,3170920,316,RepeatMasker,LINE,3170637,3170712,76,0.24
ptg011888l,3316545,3316831,286,RepeatMasker,LINE,3316281,3317148,286,1.00
ptg011895l,768490,768815,325,RepeatMasker,LINE,768127,771414,325,1.00
ptg011909l,263253,263552,299,RepeatMasker,LINE,263258,263365,108,0.36
ptg011909l,263253,263552,299,RepeatMasker,LINE,263465,264280,88,0.29
ptg011918l,288827,289152,325,RepeatMasker,LINE,286916,289169,325,1.00
ptg011933l,141641,141929,288,RepeatMasker,LINE,140683,142574,288,1.00
ptg011938l,919406,919704,298,RepeatMasker,LINE,918705,920611,298,1.00
ptg011948l,187131,187415,284,RepeatMasker,LINE,186801,187231,100,0.35
ptg011963l,34482,34783,301,RepeatMasker,LINE,33002,34750,268,0.89
ptg011989l,2225585,2225868,283,RepeatMasker,LINE,2225818,2225890,51,0.18
ptg011990l,80527,80818,291,RepeatMasker,LINE,80652,80714,63,0.22
ptg012052l,1255296,1255600,304,RepeatMasker,LINE,1253417,1255623,304,1.00
ptg012059l,456922,457229,307,RepeatMasker,LINE,456911,460400,307,1.00
ptg012064l,1070930,1071255,325,RepeatMasker,LINE,1070926,1073861,325,1.00
ptg012117l,2880050,2880332,282,RepeatMasker,LINE,2880158,2881061,175,0.62
ptg012134l,213612,213928,316,RepeatMasker,LINE,213928,213998,1,0.00
ptg012134l,2106831,2107126,295,RepeatMasker,LINE,2105506,2107597,295,1.00
ptg012146l,638911,639210,299,RepeatMasker,LINE,637701,639162,251,0.84
ptg012171l,1593667,1593963,296,RepeatMasker,LINE,1593553,1594841,296,1.00
ptg012217l,452617,452894,277,RepeatMasker,LINE,449698,452728,111,0.40
ptg012217l,452617,452894,277,RepeatMasker,LINE,452722,452891,170,0.61
ptg012249l,2360512,2360821,309,RepeatMasker,LINE,2360747,2360817,71,0.23
ptg012280l,534124,534399,275,RepeatMasker,LINE,533055,535145,275,1.00
ptg012294l,2640587,2640865,278,RepeatMasker,LINE,2640687,2640761,75,0.27
ptg012294l,2640587,2640865,278,RepeatMasker,LINE,2640854,2642857,12,0.04
ptg012296l,900756,901064,308,RepeatMasker,LINE,900361,900950,194,0.63
ptg012299l,2808809,2809125,316,RepeatMasker,LINE,2808817,2809039,223,0.71
ptg012299l,2808809,2809125,316,RepeatMasker,LINE,2808876,2809030,155,0.49
ptg012307l,1636789,1637090,301,RepeatMasker,LINE,1637026,1640044,65,0.22
ptg012343l,17122,17449,327,RepeatMasker,LINE,16138,19390,327,1.00
ptg012375l,420849,421130,281,RepeatMasker,LINE,420918,421023,106,0.38
ptg012422l,492572,492887,315,RepeatMasker,LINE,492668,492704,37,0.12
ptg012422l,492572,492887,315,RepeatMasker,LINE,492701,492857,157,0.50
ptg012422l,492572,492887,315,RepeatMasker,LINE,489668,492680,108,0.34
ptg012423l,818465,818785,320,RepeatMasker,LINE,817082,818650,185,0.58
ptg012430l,787996,788294,298,RepeatMasker,LINE,787067,788200,204,0.68
ptg012444l,919805,920122,317,RepeatMasker,LINE,919949,920019,71,0.22
ptg012449l,1044202,1044474,272,RepeatMasker,LINE,1044108,1044390,188,0.69
ptg012483l,1360508,1360836,328,RepeatMasker,LINE,1357823,1360930,328,1.00
ptg012499l,325280,325596,316,RepeatMasker,LINE,325366,325476,111,0.35
ptg012555l,123865,124165,300,RepeatMasker,LINE,123963,124459,203,0.68
ptg012594l,1038988,1039312,324,RepeatMasker,LINE,1037394,1039276,288,0.89
ptg012607l,103797,104120,323,RepeatMasker,LINE,103048,104035,238,0.74
ptg012623l,491075,491400,325,RepeatMasker,LINE,490713,491918,325,1.00
ptg012624l,46442,46757,315,RepeatMasker,LINE,46575,50207,183,0.58
ptg012624l,403330,403656,326,RepeatMasker,LINE,400662,403915,326,1.00
ptg012634l,1235319,1235607,288,RepeatMasker,LINE,1235409,1235599,191,0.66
ptg012634l,1235319,1235607,288,RepeatMasker,LINE,1235415,1235569,155,0.54
ptg012652l,499628,499943,315,RepeatMasker,LINE,499150,499771,143,0.45
ptg012662l,220849,221137,288,RepeatMasker,LINE,220379,222130,288,1.00
ptg012675l,25217,25512,295,RepeatMasker,LINE,25267,25312,46,0.16
ptg012675l,701600,701921,321,RepeatMasker,LINE,701283,703810,321,1.00
ptg012746l,1255557,1255848,291,RepeatMasker,LINE,1253687,1255824,267,0.92
ptg012751l,994234,994554,320,RepeatMasker,LINE,993595,994611,320,1.00
ptg012758l,1479995,1480317,322,RepeatMasker,LINE,1480190,1480465,128,0.40
ptg012764l,1538510,1538814,304,RepeatMasker,LINE,1538185,1538722,212,0.70
ptg012835l,1596547,1596828,281,RepeatMasker,LINE,1596813,1596874,16,0.06
ptg012853l,237340,237647,307,RepeatMasker,LINE,237398,237498,101,0.33
ptg012853l,237340,237647,307,RepeatMasker,LINE,237530,237567,38,0.12
ptg012861l,1019071,1019377,306,RepeatMasker,LINE,1016852,1019310,239,0.78
ptg012874l,188885,189216,331,RepeatMasker,LINE,188750,189039,154,0.47
ptg012877l,210272,210575,303,RepeatMasker,LINE,208458,210339,67,0.22
ptg012884l,3062530,3062848,318,RepeatMasker,LINE,3060286,3062697,167,0.53
ptg012901l,838098,838379,281,RepeatMasker,LINE,838379,838673,1,0.00
ptg012919l,587858,588163,305,RepeatMasker,LINE,588042,588128,87,0.29
ptg012927l,768749,769028,279,RepeatMasker,LINE,766012,768867,118,0.42
ptg012930l,429447,429750,303,RepeatMasker,LINE,429701,429771,50,0.17
ptg012941l,456601,456885,284,RepeatMasker,LINE,456267,458181,284,1.00
ptg012945l,291250,291543,293,RepeatMasker,LINE,291159,291421,171,0.58
ptg012947l,845997,846317,320,RepeatMasker,LINE,845913,846047,50,0.16
ptg012947l,845997,846317,320,RepeatMasker,LINE,846114,846597,204,0.64
ptg012995l,391509,391837,328,RepeatMasker,LINE,388822,392093,328,1.00
ptg013010l,1450151,1450480,329,RepeatMasker,LINE,1447476,1450746,329,1.00
ptg013020l,1916897,1917216,319,RepeatMasker,LINE,1917196,1920376,21,0.07
ptg013031l,2099361,2099636,275,RepeatMasker,LINE,2098469,2099523,162,0.59
ptg013031l,2099361,2099636,275,RepeatMasker,LINE,2098469,2099673,275,1.00
ptg013039l,1203008,1203289,281,RepeatMasker,LINE,1202593,1203118,110,0.39
ptg013042l,401233,401543,310,RepeatMasker,LINE,401112,401386,153,0.49
ptg013045l,474529,474789,260,RepeatMasker,LINE,474573,474964,217,0.83
ptg013045l,837449,837760,311,RepeatMasker,LINE,837711,837785,50,0.16
ptg013048l,81974,82248,274,RepeatMasker,LINE,81879,82095,121,0.44
ptg013079l,309579,309907,328,RepeatMasker,LINE,309773,310209,135,0.41
ptg013084l,589745,590037,292,RepeatMasker,LINE,587400,589764,19,0.07
ptg013087l,1406203,1406533,330,RepeatMasker,LINE,1405209,1408493,330,1.00
ptg013089l,459851,460156,305,RepeatMasker,LINE,459980,460151,172,0.56
ptg013097l,4046087,4046393,306,RepeatMasker,LINE,4046214,4046301,88,0.29
ptg013097l,5467917,5468234,317,RepeatMasker,LINE,5467934,5468008,75,0.24
ptg013097l,5467917,5468234,317,RepeatMasker,LINE,5467943,5468036,94,0.30
ptg013097l,5467917,5468234,317,RepeatMasker,LINE,5467952,5468017,66,0.21
ptg013125l,1075481,1075782,301,RepeatMasker,LINE,1074647,1075786,301,1.00
ptg013142l,58762,59080,318,RepeatMasker,LINE,58909,58962,54,0.17
ptg013142l,58762,59080,318,RepeatMasker,LINE,58916,59002,87,0.27
ptg013159l,517786,518078,292,RepeatMasker,LINE,517710,517787,1,0.00
ptg013180l,393247,393536,289,RepeatMasker,LINE,392751,394117,289,1.00
ptg013183l,134485,134803,318,RepeatMasker,LINE,134393,134616,131,0.41
ptg013206l,329677,329985,308,RepeatMasker,LINE,329837,330149,149,0.48
ptg013221l,176614,176886,272,RepeatMasker,LINE,176073,176975,272,1.00
ptg013221l,2622090,2622403,313,RepeatMasker,LINE,2621474,2622256,166,0.53
ptg013251l,1439398,1439665,267,RepeatMasker,LINE,1439486,1439549,64,0.24
ptg013251l,1439398,1439665,267,RepeatMasker,LINE,1439553,1439705,113,0.42
ptg013255l,33658,33952,294,RepeatMasker,LINE,33164,36050,294,1.00
ptg013263l,1015300,1015607,307,RepeatMasker,LINE,1014102,1015307,7,0.02
ptg013265l,272181,272504,323,RepeatMasker,LINE,269516,272767,323,1.00
ptg013265l,325734,326045,311,RepeatMasker,LINE,323687,325771,37,0.12
ptg013294l,392418,392721,303,RepeatMasker,LINE,392584,393445,138,0.46
ptg013332l,3811469,3811771,302,RepeatMasker,LINE,3811193,3814486,302,1.00
ptg013428l,425651,425949,298,RepeatMasker,LINE,422523,425786,135,0.45
ptg013449l,1037404,1037691,287,RepeatMasker,LINE,1036929,1037457,53,0.18
ptg013473l,3044589,3044886,297,RepeatMasker,LINE,3044429,3044628,39,0.13
ptg013485l,757616,757932,316,RepeatMasker,LINE,756776,757740,124,0.39
ptg013491l,656073,656378,305,RepeatMasker,LINE,656070,656147,74,0.24
ptg013491l,656073,656378,305,RepeatMasker,LINE,656087,656166,80,0.26
ptg013491l,656073,656378,305,RepeatMasker,LINE,656297,657030,82,0.27
ptg013491l,1560823,1561151,328,RepeatMasker,LINE,1560200,1561739,328,1.00
ptg013526l,3090465,3090801,336,RepeatMasker,LINE,3088222,3091480,336,1.00
ptg013541l,2230654,2230929,275,RepeatMasker,LINE,2230401,2231031,275,1.00
ptg013542l,1071803,1072089,286,RepeatMasker,LINE,1072025,1072612,65,0.23
ptg013545l,527938,528217,279,RepeatMasker,LINE,526251,528025,87,0.31
ptg013546l,1010019,1010344,325,RepeatMasker,LINE,1009742,1010856,325,1.00
ptg013549l,1246062,1246348,286,RepeatMasker,LINE,1245639,1246353,286,1.00
ptg013601l,295480,295793,313,RepeatMasker,LINE,295517,295562,46,0.15
ptg013607l,827676,827986,310,RepeatMasker,LINE,827796,828191,191,0.62
ptg013607l,827676,827986,310,RepeatMasker,LINE,827796,828264,191,0.62
ptg013607l,827676,827986,310,RepeatMasker,LINE,827809,828067,178,0.57
ptg013614l,1231207,1231509,302,RepeatMasker,LINE,1231460,1231538,50,0.17
ptg013622l,40505,40822,317,RepeatMasker,LINE,37401,40620,115,0.36
ptg013670l,776048,776374,326,RepeatMasker,LINE,775731,778906,326,1.00
ptg013691l,395111,395406,295,RepeatMasker,LINE,394296,395392,281,0.95
ptg013691l,395111,395406,295,RepeatMasker,LINE,394481,395520,295,1.00
ptg013699l,181355,181653,298,RepeatMasker,LINE,181183,181975,298,1.00
ptg013699l,534938,535210,272,RepeatMasker,LINE,533342,535103,165,0.61
ptg013705l,316858,317130,272,RepeatMasker,LINE,316700,317135,272,1.00
ptg013731l,2522461,2522787,326,RepeatMasker,LINE,2519780,2523052,326,1.00
ptg013749l,193973,194275,302,RepeatMasker,LINE,194040,194112,73,0.24
ptg013800l,794327,794602,275,RepeatMasker,LINE,793214,794655,275,1.00
ptg013800l,794327,794602,275,RepeatMasker,LINE,793216,794489,162,0.59
ptg013844l,1283614,1283902,288,RepeatMasker,LINE,1283091,1285083,288,1.00
ptg013880l,532137,532452,315,RepeatMasker,LINE,529877,532324,187,0.59
ptg013881l,80134,80422,288,RepeatMasker,LINE,79759,82931,288,1.00
ptg013881l,80134,80422,288,RepeatMasker,LINE,79968,82587,288,1.00
ptg013890l,2836420,2836697,277,RepeatMasker,LINE,2835433,2836544,124,0.45
ptg013906l,277699,278008,309,RepeatMasker,LINE,277276,278291,309,1.00
ptg013923l,162382,162675,293,RepeatMasker,LINE,160496,163009,293,1.00
ptg013937l,570824,571143,319,RepeatMasker,LINE,570991,571046,56,0.18
ptg013957l,1293787,1294110,323,RepeatMasker,LINE,1293984,1294029,46,0.14
ptg013963l,436643,436972,329,RepeatMasker,LINE,436305,437112,329,1.00
ptg013968l,1129808,1130120,312,RepeatMasker,LINE,1129887,1130521,234,0.75
ptg013982l,1461406,1461708,302,RepeatMasker,LINE,1461323,1462913,302,1.00
ptg014021l,686875,687169,294,RepeatMasker,LINE,686925,687059,135,0.46
ptg014053l,358279,358569,290,RepeatMasker,LINE,357538,361049,290,1.00
ptg014053l,358279,358569,290,RepeatMasker,LINE,358208,361049,290,1.00
ptg014061l,163401,163729,328,RepeatMasker,LINE,161800,163720,319,0.97
ptg014123l,419644,419924,280,RepeatMasker,LINE,419320,419869,225,0.80
ptg014128l,1469174,1469466,292,RepeatMasker,LINE,1468930,1469213,39,0.13
ptg014181l,128323,128586,263,RepeatMasker,LINE,126976,128517,194,0.74
ptg014194l,667139,667411,272,RepeatMasker,LINE,665838,667179,40,0.15
ptg014196l,252237,252538,301,RepeatMasker,LINE,249430,253261,301,1.00
ptg014235l,1101805,1102134,329,RepeatMasker,LINE,1101925,1101999,75,0.23
ptg014243l,2682361,2682674,313,RepeatMasker,LINE,2682259,2682464,103,0.33
ptg014244l,525093,525367,274,RepeatMasker,LINE,525348,527371,20,0.07
ptg014260l,241874,242162,288,RepeatMasker,LINE,241997,242486,166,0.58
ptg014263l,832953,833271,318,RepeatMasker,LINE,833259,834425,13,0.04
ptg014353l,276242,276541,299,RepeatMasker,LINE,275706,276359,117,0.39
ptg014381l,2684349,2684659,310,RepeatMasker,LINE,2683786,2684452,103,0.33
ptg014398l,366025,366345,320,RepeatMasker,LINE,365792,366357,320,1.00
ptg014403l,678853,679173,320,RepeatMasker,LINE,678733,679740,320,1.00
ptg014403l,678853,679173,320,RepeatMasker,LINE,678832,679573,320,1.00
ptg014422l,1069446,1069781,335,RepeatMasker,LINE,1067194,1069906,335,1.00
ptg014480l,1110245,1110568,323,RepeatMasker,LINE,1109895,1113125,323,1.00
ptg014485l,811468,811768,300,RepeatMasker,LINE,811628,811702,75,0.25
ptg014493l,266249,266574,325,RepeatMasker,LINE,266487,266543,57,0.18
ptg014520l,88691,88996,305,RepeatMasker,LINE,88401,90164,305,1.00
ptg014599l,1887552,1887863,311,RepeatMasker,LINE,1884907,1888087,311,1.00
ptg014632l,1503124,1503419,295,RepeatMasker,LINE,1502957,1504111,295,1.00
ptg014632l,1503124,1503419,295,RepeatMasker,LINE,1503001,1504506,295,1.00
ptg014636l,218619,218919,300,RepeatMasker,LINE,218742,218798,57,0.19
ptg014637l,1174692,1174971,279,RepeatMasker,LINE,1174769,1174849,81,0.29
ptg014645l,2677679,2677970,291,RepeatMasker,LINE,2677936,2678440,35,0.12
ptg014645l,2677679,2677970,291,RepeatMasker,LINE,2677936,2678511,35,0.12
ptg014648l,1014110,1014439,329,RepeatMasker,LINE,1011859,1015126,329,1.00
ptg014669l,534246,534545,299,RepeatMasker,LINE,533573,534263,17,0.06
ptg014673l,54346,54661,315,RepeatMasker,LINE,54445,54502,58,0.18
ptg014675l,648905,649199,294,RepeatMasker,LINE,646216,649165,260,0.88
ptg014694l,406021,406348,327,RepeatMasker,LINE,405726,406048,27,0.08
ptg014700l,248162,248473,311,RepeatMasker,LINE,248033,248494,311,1.00
ptg014703l,2444662,2444986,324,RepeatMasker,LINE,2444792,2444863,72,0.22
ptg014704l,22404,22709,305,RepeatMasker,LINE,22670,22835,40,0.13
ptg014777l,278594,278873,279,RepeatMasker,LINE,276169,278886,279,1.00
ptg014777l,278594,278873,279,RepeatMasker,LINE,277756,279123,279,1.00
ptg014807l,474954,475226,272,RepeatMasker,LINE,474840,475084,130,0.48
ptg014819l,285937,286217,280,RepeatMasker,LINE,285915,286588,280,1.00
ptg014819l,416523,416800,277,RepeatMasker,LINE,416009,416654,131,0.47
ptg014819l,1611156,1611482,326,RepeatMasker,LINE,1611260,1612008,223,0.68
ptg014824l,2320046,2320348,302,RepeatMasker,LINE,2319613,2320218,172,0.57
ptg014846l,796299,796598,299,RepeatMasker,LINE,796530,796633,69,0.23
ptg014859l,842960,843270,310,RepeatMasker,LINE,841394,845103,310,1.00
ptg014877l,919511,919826,315,RepeatMasker,LINE,919649,919813,165,0.52
ptg014887l,98120,98418,298,RepeatMasker,LINE,97491,99139,298,1.00
ptg014892l,137671,137960,289,RepeatMasker,LINE,137617,137767,96,0.33
ptg014912l,609793,610072,279,RepeatMasker,LINE,610067,610294,6,0.02
ptg014924l,2324752,2325030,278,RepeatMasker,LINE,2324548,2324778,26,0.09
ptg014935l,253991,254263,272,RepeatMasker,LINE,253771,254466,272,1.00
ptg014960l,732873,733207,334,RepeatMasker,LINE,732396,732970,97,0.29
ptg014993l,937024,937309,285,RepeatMasker,LINE,933235,938485,285,1.00
ptg015041l,1200870,1201159,289,RepeatMasker,LINE,1201050,1202148,110,0.38
ptg015061l,1339868,1340146,278,RepeatMasker,LINE,1340071,1340310,76,0.27
ptg015065l,491030,491323,293,RepeatMasker,LINE,491208,491308,101,0.34
ptg015093l,249438,249709,271,RepeatMasker,LINE,249686,250083,24,0.09
ptg015116l,24056,24345,289,RepeatMasker,LINE,24159,24241,83,0.29
ptg015126l,197185,197489,304,RepeatMasker,LINE,197476,199245,14,0.05
ptg015216l,449374,449682,308,RepeatMasker,LINE,448557,450242,308,1.00
ptg015229l,225116,225399,283,RepeatMasker,LINE,225357,226508,43,0.15
ptg015245l,767892,768219,327,RepeatMasker,LINE,768046,768414,174,0.53
ptg015246l,51524,51853,329,RepeatMasker,LINE,48827,52115,329,1.00
ptg015260l,779207,779530,323,RepeatMasker,LINE,779256,779335,80,0.25
ptg015263l,939770,940076,306,RepeatMasker,LINE,939671,940388,306,1.00
ptg015268l,747102,747416,314,RepeatMasker,LINE,747316,747403,88,0.28
ptg015271l,1753480,1753803,323,RepeatMasker,LINE,1753768,1755050,36,0.11
ptg015277l,36809,37099,290,RepeatMasker,LINE,36728,37742,290,1.00
ptg015277l,36809,37099,290,RepeatMasker,LINE,36780,37676,290,1.00
ptg015281l,963189,963520,331,RepeatMasker,LINE,960055,963284,95,0.29
ptg015297l,3471840,3472155,315,RepeatMasker,LINE,3470224,3472333,315,1.00
ptg015318l,609063,609360,297,RepeatMasker,LINE,609149,610036,212,0.71
ptg015320l,36886,37169,283,RepeatMasker,LINE,33252,37247,283,1.00
ptg015339l,433894,434209,315,RepeatMasker,LINE,434123,434176,54,0.17
ptg015350l,1354261,1354580,319,RepeatMasker,LINE,1354233,1354562,301,0.94
ptg015352l,1312180,1312490,310,RepeatMasker,LINE,1309488,1312276,96,0.31
ptg015374l,560168,560463,295,RepeatMasker,LINE,557542,560233,65,0.22
ptg015374l,560168,560463,295,RepeatMasker,LINE,560184,560251,68,0.23
ptg015396l,385558,385877,319,RepeatMasker,LINE,383099,385682,124,0.39
ptg015396l,600674,600963,289,RepeatMasker,LINE,599889,601176,289,1.00
ptg015405l,123019,123323,304,RepeatMasker,LINE,123048,123112,65,0.21
ptg015406l,699661,699988,327,RepeatMasker,LINE,699241,700413,327,1.00
ptg015423l,432903,433198,295,RepeatMasker,LINE,432779,433309,295,1.00
ptg015443l,374696,374999,303,RepeatMasker,LINE,374989,378797,11,0.04
ptg015468l,1436153,1436442,289,RepeatMasker,LINE,1436204,1436678,239,0.83
ptg015472l,441543,441849,306,RepeatMasker,LINE,441142,442516,306,1.00
ptg015484l,757486,757798,312,RepeatMasker,LINE,757614,757894,185,0.59
ptg015493l,542712,543008,296,RepeatMasker,LINE,540656,543353,296,1.00
ptg015505l,634844,635161,317,RepeatMasker,LINE,634885,635558,277,0.87
ptg015505l,634844,635161,317,RepeatMasker,LINE,635091,635546,71,0.22
ptg015506l,3353904,3354183,279,RepeatMasker,LINE,3350549,3354398,279,1.00
ptg015521l,160710,160985,275,RepeatMasker,LINE,160463,162351,275,1.00
ptg015522l,944212,944520,308,RepeatMasker,LINE,941735,944508,296,0.96
ptg015527l,16483,16801,318,RepeatMasker,LINE,16665,16842,137,0.43
ptg015538l,536177,536463,286,RepeatMasker,LINE,536199,537379,265,0.93
ptg015546l,177770,178096,326,RepeatMasker,LINE,178060,178242,37,0.11
ptg015576l,220699,220984,285,RepeatMasker,LINE,220819,220893,75,0.26
ptg015576l,220699,220984,285,RepeatMasker,LINE,220834,221103,151,0.53
ptg015588l,1188650,1188961,311,RepeatMasker,LINE,1188574,1188656,6,0.02
ptg015595l,171581,171869,288,RepeatMasker,LINE,171817,172538,53,0.18
ptg015596l,36620,36931,311,RepeatMasker,LINE,36849,36918,70,0.23
ptg015602l,1307070,1307357,287,RepeatMasker,LINE,1307007,1307095,25,0.09
ptg015610l,721151,721433,282,RepeatMasker,LINE,720623,721530,282,1.00
ptg015610l,721151,721433,282,RepeatMasker,LINE,720632,721350,199,0.71
ptg015631l,910645,910952,307,RepeatMasker,LINE,910557,913001,307,1.00
ptg015640l,72213,72535,322,RepeatMasker,LINE,72081,72318,105,0.33
ptg015641l,642204,642490,286,RepeatMasker,LINE,641315,642577,286,1.00
ptg015654l,649409,649703,294,RepeatMasker,LINE,649475,649520,46,0.16
ptg015656l,1242260,1242549,289,RepeatMasker,LINE,1242000,1242325,65,0.22
ptg015664l,34591,34916,325,RepeatMasker,LINE,34223,37513,325,1.00
ptg015704l,331827,332128,301,RepeatMasker,LINE,331654,331863,36,0.12
ptg015704l,331827,332128,301,RepeatMasker,LINE,331876,333014,253,0.84
ptg015707l,154505,154833,328,RepeatMasker,LINE,154748,155212,86,0.26
ptg015756l,67354,67662,308,RepeatMasker,LINE,67415,68331,248,0.81
ptg015759l,919053,919339,286,RepeatMasker,LINE,919096,919609,244,0.85
ptg015760l,1240388,1240712,324,RepeatMasker,LINE,1240537,1241011,176,0.54
ptg015760l,1240388,1240712,324,RepeatMasker,LINE,1240542,1240953,171,0.53
ptg015766l,1092234,1092521,287,RepeatMasker,LINE,1092065,1092267,33,0.11
ptg015774l,356806,357096,290,RepeatMasker,LINE,356826,356916,91,0.31
ptg015774l,356806,357096,290,RepeatMasker,LINE,356843,356913,71,0.24
ptg015820l,301547,301844,297,RepeatMasker,LINE,301485,301622,75,0.25
ptg015820l,301547,301844,297,RepeatMasker,LINE,301627,301702,76,0.26
ptg015820l,301547,301844,297,RepeatMasker,LINE,301773,301842,70,0.24
ptg015822l,563640,563949,309,RepeatMasker,LINE,563682,563795,114,0.37
ptg015835l,130702,130989,287,RepeatMasker,LINE,129640,130859,157,0.55
ptg015835l,734030,734305,275,RepeatMasker,LINE,734096,734167,72,0.26
ptg015853l,105448,105755,307,RepeatMasker,LINE,104733,106467,307,1.00
ptg015862l,584467,584793,326,RepeatMasker,LINE,584351,585575,326,1.00
ptg015928l,105805,106081,276,RepeatMasker,LINE,104924,107893,276,1.00
ptg015954l,5239,5535,296,RepeatMasker,LINE,5369,5447,79,0.27
ptg015956l,157825,158121,296,RepeatMasker,LINE,157579,157913,88,0.30
ptg016018l,189881,190170,289,RepeatMasker,LINE,189553,189957,76,0.26
ptg016036l,415796,416127,331,RepeatMasker,LINE,415582,415809,13,0.04
ptg016036l,415796,416127,331,RepeatMasker,LINE,416001,416071,71,0.21
ptg016053l,1247848,1248131,283,RepeatMasker,LINE,1247459,1248058,210,0.74
ptg016106l,378471,378807,336,RepeatMasker,LINE,376582,379058,336,1.00
ptg016121l,147428,147736,308,RepeatMasker,LINE,146305,147771,308,1.00
ptg016127l,451659,451943,284,RepeatMasker,LINE,451407,451870,211,0.74
ptg016140l,1375269,1375543,274,RepeatMasker,LINE,1375478,1375737,66,0.24
ptg016168l,474005,474337,332,RepeatMasker,LINE,473120,474067,62,0.19
ptg016178l,676301,676581,280,RepeatMasker,LINE,676225,680046,280,1.00
ptg016259l,75918,76236,318,RepeatMasker,LINE,75356,75933,15,0.05
ptg016262l,263964,264262,298,RepeatMasker,LINE,263123,265002,298,1.00
ptg016274l,243167,243477,310,RepeatMasker,LINE,240345,243276,109,0.35
ptg016282l,8342,8661,319,RepeatMasker,LINE,8278,8699,319,1.00
ptg016296l,645072,645398,326,RepeatMasker,LINE,645252,645744,147,0.45
ptg016312l,2336895,2337189,294,RepeatMasker,LINE,2337068,2338211,122,0.41
ptg016363l,1041215,1041502,287,RepeatMasker,LINE,1040907,1041344,129,0.45
ptg016379l,1926351,1926593,242,RepeatMasker,LINE,1926521,1927179,73,0.30
ptg016407l,154906,155197,291,RepeatMasker,LINE,155179,155355,19,0.07
ptg016408l,125035,125330,295,RepeatMasker,LINE,124808,125236,201,0.68
ptg016408l,125035,125330,295,RepeatMasker,LINE,124828,125293,258,0.87
ptg016408l,125035,125330,295,RepeatMasker,LINE,125287,127936,44,0.15
ptg016428l,74990,75277,287,RepeatMasker,LINE,73984,75042,52,0.18
ptg016428l,74990,75277,287,RepeatMasker,LINE,74021,75420,287,1.00
ptg016466l,3156280,3156595,315,RepeatMasker,LINE,3154005,3157253,315,1.00
ptg016491l,2204967,2205256,289,RepeatMasker,LINE,2205112,2205157,46,0.16
ptg016517l,437126,437444,318,RepeatMasker,LINE,437367,437437,71,0.22
ptg016521l,223909,224198,289,RepeatMasker,LINE,223680,224567,289,1.00
ptg016528l,899137,899471,334,RepeatMasker,LINE,898779,899607,334,1.00
ptg016529l,161882,162190,308,RepeatMasker,LINE,161963,162657,228,0.74
ptg016601l,468066,468395,329,RepeatMasker,LINE,468004,470473,329,1.00
ptg016633l,382261,382561,300,RepeatMasker,LINE,381255,382462,201,0.67
ptg016638l,1340364,1340695,331,RepeatMasker,LINE,1340376,1340636,261,0.79
ptg016638l,1340364,1340695,331,RepeatMasker,LINE,1340378,1340587,210,0.63
ptg016638l,1340364,1340695,331,RepeatMasker,LINE,1340533,1340622,90,0.27
ptg016638l,1340364,1340695,331,RepeatMasker,LINE,1340536,1340588,53,0.16
ptg016642l,131744,132057,313,RepeatMasker,LINE,131673,131965,221,0.71
ptg016728l,698265,698601,336,RepeatMasker,LINE,696008,699278,336,1.00
ptg016737l,1688387,1688705,318,RepeatMasker,LINE,1688415,1688553,139,0.44
ptg016750l,164422,164723,301,RepeatMasker,LINE,163091,164605,183,0.61
ptg016755l,764564,764857,293,RepeatMasker,LINE,764755,764795,41,0.14
ptg016765l,393494,393793,299,RepeatMasker,LINE,393629,393718,90,0.30
ptg016765l,627787,628092,305,RepeatMasker,LINE,627798,627987,190,0.62
ptg016777l,234442,234734,292,RepeatMasker,LINE,230954,234682,240,0.82
ptg016779l,646008,646345,337,RepeatMasker,LINE,646088,646465,258,0.77
ptg016807l,222056,222338,282,RepeatMasker,LINE,220812,222247,191,0.68
ptg016824l,319760,320057,297,RepeatMasker,LINE,316624,319895,135,0.45
ptg016826l,1177217,1177503,286,RepeatMasker,LINE,1177143,1177902,286,1.00
ptg016848l,437229,437549,320,RepeatMasker,LINE,434280,437507,278,0.87
ptg016882l,1044500,1044810,310,RepeatMasker,LINE,1044353,1044546,46,0.15
ptg016895l,535777,536056,279,RepeatMasker,LINE,535964,536048,85,0.30
ptg016910l,536524,536801,277,RepeatMasker,LINE,534479,537742,277,1.00
ptg016910l,637530,637854,324,RepeatMasker,LINE,637646,637713,68,0.21
ptg016910l,637530,637854,324,RepeatMasker,LINE,637811,637951,44,0.14
ptg016928l,313596,313888,292,RepeatMasker,LINE,313819,314775,70,0.24
ptg016928l,313596,313888,292,RepeatMasker,LINE,313854,314776,35,0.12
ptg016942l,962358,962659,301,RepeatMasker,LINE,962396,963324,264,0.88
ptg016971l,1368278,1368604,326,RepeatMasker,LINE,1367759,1368588,310,0.95
ptg016971l,1368278,1368604,326,RepeatMasker,LINE,1367914,1368605,326,1.00
ptg017033l,1189173,1189463,290,RepeatMasker,LINE,1188332,1190185,290,1.00
ptg017061l,634569,634883,314,RepeatMasker,LINE,634251,634829,260,0.83
ptg017104l,203194,203526,332,RepeatMasker,LINE,200142,203326,132,0.40
ptg017105l,223644,223930,286,RepeatMasker,LINE,223442,224235,286,1.00
ptg017151l,627373,627688,315,RepeatMasker,LINE,627212,627464,91,0.29
ptg017165l,898114,898413,299,RepeatMasker,LINE,898230,898292,63,0.21
ptg017165l,898114,898413,299,RepeatMasker,LINE,898239,898382,144,0.48
ptg017165l,971952,972252,300,RepeatMasker,LINE,971606,972143,191,0.64
ptg017193l,2224150,2224459,309,RepeatMasker,LINE,2220573,2224297,147,0.48
ptg017196l,1021879,1022201,322,RepeatMasker,LINE,1021628,1022779,322,1.00
ptg017215l,262243,262552,309,RepeatMasker,LINE,262500,262545,46,0.15
ptg017257l,928718,928996,278,RepeatMasker,LINE,928672,928768,50,0.18
ptg017260l,462375,462685,310,RepeatMasker,LINE,462411,462486,76,0.25
ptg017273l,1017779,1018110,331,RepeatMasker,LINE,1017813,1017878,66,0.20
ptg017273l,1017779,1018110,331,RepeatMasker,LINE,1017841,1017883,43,0.13
ptg017303l,1272784,1273082,298,RepeatMasker,LINE,1272961,1273033,73,0.24
ptg017303l,1272784,1273082,298,RepeatMasker,LINE,1272973,1273034,62,0.21
ptg017303l,1272784,1273082,298,RepeatMasker,LINE,1272978,1273042,65,0.22
ptg017342l,74007,74339,332,RepeatMasker,LINE,73852,74293,286,0.86
ptg017372l,337000,337328,328,RepeatMasker,LINE,337289,337389,40,0.12
ptg017387l,401237,401541,304,RepeatMasker,LINE,401145,401525,288,0.95
ptg017432l,567701,568006,305,RepeatMasker,LINE,564563,567837,136,0.45
ptg017441l,925762,926093,331,RepeatMasker,LINE,925958,926724,136,0.41
ptg017459l,981496,981789,293,RepeatMasker,LINE,980528,981636,140,0.48
ptg017509l,1143380,1143661,281,RepeatMasker,LINE,1143300,1143675,281,1.00
ptg017509l,1143380,1143661,281,RepeatMasker,LINE,1143313,1143737,281,1.00
ptg017526l,1333205,1333537,332,RepeatMasker,LINE,1333078,1333337,132,0.40
ptg017544l,33233,33549,316,RepeatMasker,LINE,32497,34126,316,1.00
ptg017545l,522501,522817,316,RepeatMasker,LINE,522622,522667,46,0.15
ptg017569l,1321495,1321785,290,RepeatMasker,LINE,1319489,1321562,67,0.23
ptg017569l,1321495,1321785,290,RepeatMasker,LINE,1321740,1321808,46,0.16
ptg017572l,1194873,1195202,329,RepeatMasker,LINE,1192196,1195461,329,1.00
ptg017591l,225359,225655,296,RepeatMasker,LINE,225271,225521,162,0.55
ptg017630l,160519,160824,305,RepeatMasker,LINE,159723,163058,305,1.00
ptg017635l,52283,52594,311,RepeatMasker,LINE,52110,52284,1,0.00
ptg017639l,198080,198392,312,RepeatMasker,LINE,196703,198330,250,0.80
ptg017640l,447975,448280,305,RepeatMasker,LINE,448280,448344,1,0.00
ptg017641l,406622,406919,297,RepeatMasker,LINE,406107,406640,18,0.06
ptg017665l,1329391,1329678,287,RepeatMasker,LINE,1328885,1330881,287,1.00
ptg017666l,278048,278360,312,RepeatMasker,LINE,277994,278895,312,1.00
ptg017678l,164086,164364,278,RepeatMasker,LINE,164030,164095,9,0.03
ptg017678l,251774,252060,286,RepeatMasker,LINE,250419,253635,286,1.00
ptg017705l,120485,120820,335,RepeatMasker,LINE,120740,120805,66,0.20
ptg017721l,230790,231104,314,RepeatMasker,LINE,230477,230809,19,0.06
ptg017783l,735354,735657,303,RepeatMasker,LINE,734294,735534,180,0.59
ptg017784l,287861,288156,295,RepeatMasker,LINE,287523,288528,295,1.00
ptg017794l,663910,664234,324,RepeatMasker,LINE,663932,665043,303,0.94
ptg017810l,362976,363293,317,RepeatMasker,LINE,361973,363248,272,0.86
ptg017831l,237154,237486,332,RepeatMasker,LINE,237352,237397,46,0.14
ptg017868l,503733,504012,279,RepeatMasker,LINE,503164,503790,57,0.20
ptg017889l,6824982,6825274,292,RepeatMasker,LINE,6825007,6825202,196,0.67
ptg017912l,505738,506035,297,RepeatMasker,LINE,505591,505920,182,0.61
ptg017912l,663388,663694,306,RepeatMasker,LINE,661893,663458,70,0.23
ptg017923l,773516,773792,276,RepeatMasker,LINE,770357,774095,276,1.00
ptg017939l,402586,402879,293,RepeatMasker,LINE,402696,403469,184,0.63
ptg017953l,428668,428974,306,RepeatMasker,LINE,428846,429367,129,0.42
ptg017978l,1053208,1053520,312,RepeatMasker,LINE,1052765,1053518,310,0.99
ptg017978l,1053208,1053520,312,RepeatMasker,LINE,1052856,1053370,162,0.52
ptg017986l,446848,447159,311,RepeatMasker,LINE,446348,447603,311,1.00
ptg018008l,292208,292502,294,RepeatMasker,LINE,290971,293271,294,1.00
ptg018010l,116006,116319,313,RepeatMasker,LINE,115939,116688,313,1.00
ptg018010l,116006,116319,313,RepeatMasker,LINE,115939,116797,313,1.00
ptg018048l,133243,133518,275,RepeatMasker,LINE,133346,133405,60,0.22
ptg018048l,133243,133518,275,RepeatMasker,LINE,133357,135848,162,0.59
ptg018058l,530887,531196,309,RepeatMasker,LINE,530982,531529,215,0.70
ptg018058l,889336,889644,308,RepeatMasker,LINE,889047,889360,24,0.08
ptg018068l,166413,166732,319,RepeatMasker,LINE,165920,166661,248,0.78
ptg018068l,166413,166732,319,RepeatMasker,LINE,166656,166924,77,0.24
ptg018115l,1011421,1011719,298,RepeatMasker,LINE,1011327,1011789,298,1.00
ptg018122l,712682,713000,318,RepeatMasker,LINE,712048,713111,318,1.00
ptg018149l,956686,957003,317,RepeatMasker,LINE,956877,958108,127,0.40
ptg018189l,1540687,1540985,298,RepeatMasker,LINE,1540461,1541328,298,1.00
ptg018270l,3902451,3902731,280,RepeatMasker,LINE,3900034,3903814,280,1.00
ptg018290l,465416,465706,290,RepeatMasker,LINE,465321,465875,290,1.00
ptg018407l,204835,205135,300,RepeatMasker,LINE,204777,204955,120,0.40
ptg018418l,1202625,1202926,301,RepeatMasker,LINE,1202278,1202765,140,0.47
ptg018427l,677397,677725,328,RepeatMasker,LINE,677062,677421,24,0.07
ptg018427l,677397,677725,328,RepeatMasker,LINE,677404,680275,322,0.98
ptg018451l,837450,837764,314,RepeatMasker,LINE,837645,838065,120,0.38
ptg018480l,79132,79451,319,RepeatMasker,LINE,79112,79165,33,0.10
ptg018520l,3404231,3404547,316,RepeatMasker,LINE,3404180,3404295,64,0.20
ptg018522l,12970,13291,321,RepeatMasker,LINE,10050,13286,316,0.98
ptg018525l,716170,716497,327,RepeatMasker,LINE,716121,716212,42,0.13
ptg018543l,494716,495025,309,RepeatMasker,LINE,493753,494728,12,0.04
ptg018550l,704974,705299,325,RepeatMasker,LINE,704658,707883,325,1.00
ptg018625l,427913,428236,323,RepeatMasker,LINE,427323,428206,293,0.91
ptg018625l,427913,428236,323,RepeatMasker,LINE,428209,428878,28,0.09
ptg018675l,669662,669971,309,RepeatMasker,LINE,669212,670979,309,1.00
ptg018675l,669662,669971,309,RepeatMasker,LINE,669759,670980,213,0.69
ptg018715l,799147,799451,304,RepeatMasker,LINE,798910,799190,43,0.14
ptg018726l,183036,183348,312,RepeatMasker,LINE,183083,183500,266,0.85
ptg018790l,236494,236816,322,RepeatMasker,LINE,236490,236533,39,0.12
ptg018870l,1086868,1087160,292,RepeatMasker,LINE,1087098,1087153,56,0.19
ptg018887l,1531764,1532061,297,RepeatMasker,LINE,1531717,1534504,297,1.00
ptg018915l,89899,90208,309,RepeatMasker,LINE,87499,90022,123,0.40
ptg018919l,119660,119965,305,RepeatMasker,LINE,118196,119842,182,0.60
ptg018920l,192129,192436,307,RepeatMasker,LINE,191664,193437,307,1.00
ptg018941l,965272,965568,296,RepeatMasker,LINE,965304,965475,172,0.58
ptg018991l,1477145,1477421,276,RepeatMasker,LINE,1476576,1477472,276,1.00
ptg019008l,705865,706137,272,RepeatMasker,LINE,706026,706084,59,0.22
ptg019069l,287610,287861,251,RepeatMasker,LINE,286517,287715,105,0.42
ptg019070l,138343,138655,312,RepeatMasker,LINE,138530,138961,126,0.40
ptg019095l,435367,435641,274,RepeatMasker,LINE,435560,437164,82,0.30
ptg019099l,372391,372721,330,RepeatMasker,LINE,372449,373249,273,0.83
ptg019107l,20013,20304,291,RepeatMasker,LINE,19946,20507,291,1.00
ptg019120l,379824,380116,292,RepeatMasker,LINE,379969,380650,148,0.51
ptg019131l,594225,594504,279,RepeatMasker,LINE,594471,594511,34,0.12
ptg019146l,358937,359269,332,RepeatMasker,LINE,358659,359126,189,0.57
ptg019180l,1460591,1460904,313,RepeatMasker,LINE,1459187,1460758,167,0.53
ptg019180l,1460591,1460904,313,RepeatMasker,LINE,1459378,1460758,167,0.53
ptg019194l,235749,236013,264,RepeatMasker,LINE,235969,236146,45,0.17
ptg019211l,1750055,1750334,279,RepeatMasker,LINE,1749994,1750138,83,0.30
ptg019214l,1010113,1010417,304,RepeatMasker,LINE,1008421,1012532,304,1.00
ptg019230l,144140,144467,327,RepeatMasker,LINE,144079,146075,327,1.00
ptg019238l,525756,526034,278,RepeatMasker,LINE,522606,526349,278,1.00
ptg019244l,1748956,1749249,293,RepeatMasker,LINE,1745946,1749030,74,0.25
ptg019290l,910659,910956,297,RepeatMasker,LINE,910649,910727,68,0.23
ptg019333l,1146123,1146428,305,RepeatMasker,LINE,1146230,1147331,199,0.65
ptg019403l,271240,271538,298,RepeatMasker,LINE,269638,271732,298,1.00
ptg019422l,451438,451743,305,RepeatMasker,LINE,449467,453735,305,1.00
ptg019422l,906602,906915,313,RepeatMasker,LINE,906662,906735,74,0.24
ptg019422l,906602,906915,313,RepeatMasker,LINE,906672,907116,244,0.78
ptg019429l,757252,757575,323,RepeatMasker,LINE,757257,757459,203,0.63
ptg019429l,757252,757575,323,RepeatMasker,LINE,757264,757441,178,0.55
ptg019507l,387323,387605,282,RepeatMasker,LINE,387145,387456,133,0.47
ptg019523l,795108,795434,326,RepeatMasker,LINE,794589,795418,310,0.95
ptg019523l,795108,795434,326,RepeatMasker,LINE,794775,795435,326,1.00
ptg019530l,219345,219670,325,RepeatMasker,LINE,218985,222265,325,1.00
ptg019541l,3191181,3191481,300,RepeatMasker,LINE,3189436,3191270,89,0.30
ptg019551l,575185,575466,281,RepeatMasker,LINE,572817,575282,97,0.35
ptg019592l,555187,555482,295,RepeatMasker,LINE,554437,555392,205,0.69
ptg019592l,555187,555482,295,RepeatMasker,LINE,554483,555299,112,0.38
ptg019592l,555187,555482,295,RepeatMasker,LINE,554797,555515,295,1.00
ptg019622l,587850,588160,310,RepeatMasker,LINE,587134,587926,76,0.25
ptg019632l,186393,186675,282,RepeatMasker,LINE,186494,186576,83,0.29
ptg019672l,579740,580038,298,RepeatMasker,LINE,579992,580101,47,0.16
ptg019672l,579740,580038,298,RepeatMasker,LINE,580038,580111,1,0.00
ptg019688l,485879,486204,325,RepeatMasker,LINE,486152,486197,46,0.14
ptg019691l,829748,830061,313,RepeatMasker,LINE,829829,829918,90,0.29
ptg019691l,829748,830061,313,RepeatMasker,LINE,829837,829942,106,0.34
ptg019716l,860217,860514,297,RepeatMasker,LINE,860234,862198,281,0.95
ptg019716l,860217,860514,297,RepeatMasker,LINE,860245,861963,270,0.91
ptg019742l,341728,342051,323,RepeatMasker,LINE,341714,341773,45,0.14
ptg019748l,738899,739175,276,RepeatMasker,LINE,738481,738911,12,0.04
ptg019766l,346626,346924,298,RepeatMasker,LINE,345629,349417,298,1.00
ptg019766l,1355771,1356100,329,RepeatMasker,LINE,1353088,1356366,329,1.00
ptg019771l,1922260,1922596,336,RepeatMasker,LINE,1920160,1923243,336,1.00
ptg019781l,391343,391638,295,RepeatMasker,LINE,390955,391535,192,0.65
ptg019794l,142651,142945,294,RepeatMasker,LINE,142859,142969,87,0.30
ptg019810l,1067214,1067553,339,RepeatMasker,LINE,1067458,1067523,66,0.19
ptg019813l,158451,158774,323,RepeatMasker,LINE,158344,158601,150,0.46
ptg019821l,364129,364420,291,RepeatMasker,LINE,363533,366816,291,1.00
ptg019885l,323090,323374,284,RepeatMasker,LINE,323207,323371,165,0.58
ptg019962l,1556810,1557107,297,RepeatMasker,LINE,1556827,1556873,47,0.16
ptg019987l,1447708,1448033,325,RepeatMasker,LINE,1447934,1448008,75,0.23
ptg020078l,472751,473085,334,RepeatMasker,LINE,472427,472950,199,0.60
ptg020078l,472751,473085,334,RepeatMasker,LINE,472946,473934,140,0.42
ptg020102l,460434,460755,321,RepeatMasker,LINE,460668,460720,53,0.17
ptg020102l,460434,460755,321,RepeatMasker,LINE,460669,460734,66,0.21
ptg020141l,1556138,1556468,330,RepeatMasker,LINE,1556075,1556167,29,0.09
ptg020155l,906444,906769,325,RepeatMasker,LINE,906303,906645,201,0.62
ptg020207l,587083,587349,266,RepeatMasker,LINE,587154,587245,92,0.35
ptg020207l,1694205,1694492,287,RepeatMasker,LINE,1693927,1695754,287,1.00
ptg020207l,1694205,1694492,287,RepeatMasker,LINE,1693974,1695575,287,1.00
ptg020207l,1694205,1694492,287,RepeatMasker,LINE,1694263,1695562,230,0.80
ptg020219l,1166157,1166443,286,RepeatMasker,LINE,1166320,1168560,124,0.43
ptg020223l,480624,480953,329,RepeatMasker,LINE,480021,480932,308,0.94
ptg020245l,290315,290615,300,RepeatMasker,LINE,290594,290772,22,0.07
ptg020247l,500338,500603,265,RepeatMasker,LINE,500415,500490,76,0.29
ptg020304l,1219357,1219636,279,RepeatMasker,LINE,1219243,1219531,174,0.62
ptg020304l,1219357,1219636,279,RepeatMasker,LINE,1219635,1220158,2,0.01
ptg020335l,566213,566504,291,RepeatMasker,LINE,566291,566426,136,0.47
ptg020367l,1903739,1904035,296,RepeatMasker,LINE,1903788,1904429,248,0.84
ptg020378l,1286543,1286837,294,RepeatMasker,LINE,1285926,1286569,26,0.09
ptg020379l,316894,317195,301,RepeatMasker,LINE,313616,316969,75,0.25
ptg020429l,447273,447582,309,RepeatMasker,LINE,447321,447393,73,0.24
ptg020480l,43860,44154,294,RepeatMasker,LINE,43939,44608,216,0.73
ptg020516l,283892,284206,314,RepeatMasker,LINE,283839,283947,55,0.18
ptg020570l,793973,794280,307,RepeatMasker,LINE,793925,795988,307,1.00
ptg020579l,3646151,3646439,288,RepeatMasker,LINE,3646284,3646335,52,0.18
ptg020579l,3646151,3646439,288,RepeatMasker,LINE,3646284,3646346,63,0.22
ptg020618l,1815360,1815662,302,RepeatMasker,LINE,1815405,1815775,258,0.85
ptg020620l,30306,30618,312,RepeatMasker,LINE,29213,30312,6,0.02
ptg020682l,572218,572535,317,RepeatMasker,LINE,569197,572466,248,0.78
ptg020733l,17318,17628,310,RepeatMasker,LINE,17481,19313,148,0.48
ptg020841l,214583,214847,264,RepeatMasker,LINE,214634,214701,68,0.26
ptg020915l,692443,692771,328,RepeatMasker,LINE,692677,692747,71,0.22
ptg020940l,428137,428440,303,RepeatMasker,LINE,428300,428723,141,0.47
ptg021028l,118612,118897,285,RepeatMasker,LINE,118668,118734,67,0.24
ptg021091l,2246860,2247174,314,RepeatMasker,LINE,2247126,2247196,49,0.16
ptg021111l,226075,226353,278,RepeatMasker,LINE,223578,226685,278,1.00
ptg021133l,182753,183041,288,RepeatMasker,LINE,182858,182964,107,0.37
ptg021146l,141013,141326,313,RepeatMasker,LINE,140510,141557,313,1.00
ptg021146l,238323,238647,324,RepeatMasker,LINE,237246,238425,102,0.31
ptg021226l,31709,31973,264,RepeatMasker,LINE,28979,31864,155,0.59
ptg021297l,343912,344220,308,RepeatMasker,LINE,344158,344196,39,0.13
ptg021297l,343912,344220,308,RepeatMasker,LINE,344213,344352,8,0.03
ptg021348l,27833,28114,281,RepeatMasker,LINE,27940,28072,133,0.47
ptg021385l,502996,503314,318,RepeatMasker,LINE,502454,503120,124,0.39
ptg021411l,910470,910754,284,RepeatMasker,LINE,910405,910974,284,1.00
ptg021412l,298175,298496,321,RepeatMasker,LINE,298406,298476,71,0.22
ptg021446l,492159,492478,319,RepeatMasker,LINE,492339,492523,140,0.44
ptg021492l,890807,891095,288,RepeatMasker,LINE,890438,891539,288,1.00
ptg021522l,576334,576652,318,RepeatMasker,LINE,575294,578015,318,1.00
ptg021541l,826156,826475,319,RepeatMasker,LINE,825958,826185,29,0.09
ptg021588l,802714,803012,298,RepeatMasker,LINE,802617,805642,298,1.00
ptg021609l,174337,174635,298,RepeatMasker,LINE,171209,174376,39,0.13
ptg021737l,370957,371237,280,RepeatMasker,LINE,371125,371213,89,0.32
ptg021737l,580520,580827,307,RepeatMasker,LINE,580427,580650,130,0.42
ptg021752l,595399,595660,261,RepeatMasker,LINE,595340,595464,65,0.25
ptg021763l,1307188,1307512,324,RepeatMasker,LINE,1307054,1307306,118,0.36
ptg021809l,189012,189330,318,RepeatMasker,LINE,185972,189148,136,0.43
ptg021848l,418800,419123,323,RepeatMasker,LINE,418827,420234,297,0.92
ptg021899l,501867,502194,327,RepeatMasker,LINE,499620,502875,327,1.00
ptg021941l,432704,433006,302,RepeatMasker,LINE,432701,432886,182,0.60
ptg021996l,620032,620344,312,RepeatMasker,LINE,620064,620109,46,0.15
ptg021996l,620032,620344,312,RepeatMasker,LINE,620153,620235,83,0.27
ptg021996l,620032,620344,312,RepeatMasker,LINE,620193,620320,128,0.41
ptg022022l,1100220,1100542,322,RepeatMasker,LINE,1100464,1100521,58,0.18
ptg022051l,673746,674040,294,RepeatMasker,LINE,673991,674061,50,0.17
ptg022061l,1688670,1688969,299,RepeatMasker,LINE,1688571,1689104,299,1.00
ptg022071l,127894,128201,307,RepeatMasker,LINE,127811,128061,167,0.54
ptg022071l,127894,128201,307,RepeatMasker,LINE,127929,128139,211,0.69
ptg022134l,282005,282280,275,RepeatMasker,LINE,281918,282383,275,1.00
ptg022163l,153995,154325,330,RepeatMasker,LINE,153974,154058,63,0.19
ptg022174l,726375,726659,284,RepeatMasker,LINE,723252,726386,11,0.04
ptg022174l,726375,726659,284,RepeatMasker,LINE,724387,726504,129,0.45
ptg022227l,53149,53430,281,RepeatMasker,LINE,53241,53812,190,0.68
ptg022232l,502821,503150,329,RepeatMasker,LINE,502875,503508,276,0.84
ptg022278l,1610573,1610866,293,RepeatMasker,LINE,1608370,1611760,293,1.00
ptg022340l,3110,3402,292,RepeatMasker,LINE,3381,3471,22,0.08
ptg022353l,213587,213870,283,RepeatMasker,LINE,212462,213797,210,0.74
ptg022357l,546413,546735,322,RepeatMasker,LINE,546162,547311,322,1.00
ptg022436l,300163,300476,313,RepeatMasker,LINE,298994,302202,313,1.00
ptg022452l,206558,206863,305,RepeatMasker,LINE,206059,206690,132,0.43
ptg022532l,34399,34725,326,RepeatMasker,LINE,31736,34928,326,1.00
ptg022601l,229352,229649,297,RepeatMasker,LINE,229459,230804,191,0.64
ptg022641l,99220,99533,313,RepeatMasker,LINE,99447,99517,71,0.23
ptg022727l,97036,97365,329,RepeatMasker,LINE,94350,97637,329,1.00
ptg022737l,179244,179524,280,RepeatMasker,LINE,178215,179575,280,1.00
ptg022737l,179244,179524,280,RepeatMasker,LINE,178437,179574,280,1.00
ptg022810l,264579,264877,298,RepeatMasker,LINE,264806,265092,72,0.24
ptg022813l,337797,338081,284,RepeatMasker,LINE,337927,338012,86,0.30
ptg022835l,688512,688821,309,RepeatMasker,LINE,688488,688656,144,0.47
ptg022889l,444854,445149,295,RepeatMasker,LINE,444765,445250,295,1.00
ptg023096l,426618,426899,281,RepeatMasker,LINE,425438,426712,94,0.33
ptg023102l,740025,740310,285,RepeatMasker,LINE,740080,740144,65,0.23
ptg023160l,145957,146232,275,RepeatMasker,LINE,145056,146114,157,0.57
ptg023190l,256148,256456,308,RepeatMasker,LINE,255766,256273,125,0.41
ptg023210l,308229,308502,273,RepeatMasker,LINE,308359,308765,144,0.53
ptg023224l,13380,13674,294,RepeatMasker,LINE,13194,15687,294,1.00
ptg023260l,22511,22810,299,RepeatMasker,LINE,22447,24328,299,1.00
ptg023265l,534411,534689,278,RepeatMasker,LINE,533933,534898,278,1.00
ptg023308l,223960,224291,331,RepeatMasker,LINE,223944,224062,102,0.31
ptg023324l,218010,218282,272,RepeatMasker,LINE,218198,219738,85,0.31
ptg023473l,377698,377985,287,RepeatMasker,LINE,377562,377924,226,0.79
ptg023473l,377698,377985,287,RepeatMasker,LINE,377649,379164,287,1.00
ptg023488l,172588,172891,303,RepeatMasker,LINE,172130,173005,303,1.00
ptg023550l,612527,612850,323,RepeatMasker,LINE,611592,614523,323,1.00
ptg023597l,173481,173779,298,RepeatMasker,LINE,172467,173507,26,0.09
ptg023616l,56845,57159,314,RepeatMasker,LINE,56277,57415,314,1.00
ptg023624l,162652,162967,315,RepeatMasker,LINE,162862,163416,106,0.34
ptg023709l,791554,791886,332,RepeatMasker,LINE,791851,792074,36,0.11
ptg023713l,821761,822093,332,RepeatMasker,LINE,819501,822313,332,1.00
ptg023768l,162788,163116,328,RepeatMasker,LINE,162449,165554,328,1.00
ptg023815l,1992406,1992720,314,RepeatMasker,LINE,1991240,1994399,314,1.00
ptg023904l,913902,914188,286,RepeatMasker,LINE,913858,913998,96,0.34
ptg023952l,1091542,1091805,263,RepeatMasker,LINE,1091609,1091668,60,0.23
ptg023953l,724410,724681,271,RepeatMasker,LINE,722676,724457,47,0.17
ptg023960l,141292,141576,284,RepeatMasker,LINE,141559,142160,18,0.06
ptg023975l,732375,732677,302,RepeatMasker,LINE,732207,734590,302,1.00
ptg024042l,1060251,1060580,329,RepeatMasker,LINE,1060076,1060439,188,0.57
ptg024045l,329939,330261,322,RepeatMasker,LINE,326823,330078,139,0.43
ptg024070l,59798,60107,309,RepeatMasker,LINE,59996,60244,112,0.36
ptg024072l,932783,933108,325,RepeatMasker,LINE,932855,933092,238,0.73
ptg024129l,143046,143340,294,RepeatMasker,LINE,142795,143383,294,1.00
ptg024148l,460528,460839,311,RepeatMasker,LINE,460198,460677,149,0.48
ptg024380l,28669,28952,283,RepeatMasker,LINE,27542,31741,283,1.00
ptg024400l,402393,402667,274,RepeatMasker,LINE,402428,402571,144,0.53
ptg024479l,117036,117327,291,RepeatMasker,LINE,116020,117089,53,0.18
ptg024718l,2620822,2621117,295,RepeatMasker,LINE,2620958,2621037,80,0.27
ptg024764l,163447,163739,292,RepeatMasker,LINE,160830,163541,94,0.32
ptg024783l,265887,266162,275,RepeatMasker,LINE,265965,266253,198,0.72
ptg024802l,75558,75887,329,RepeatMasker,LINE,72876,76080,329,1.00
ptg024871l,945976,946293,317,RepeatMasker,LINE,946215,946285,71,0.22
ptg024875l,522063,522372,309,RepeatMasker,LINE,518923,522151,88,0.28
ptg024890l,518653,518937,284,RepeatMasker,LINE,518821,518899,79,0.28
ptg024982l,81403,81725,322,RepeatMasker,LINE,81617,82150,109,0.34
ptg025014l,405164,405485,321,RepeatMasker,LINE,404547,405665,321,1.00
ptg025027l,213060,213391,331,RepeatMasker,LINE,212148,214070,331,1.00
ptg025031l,325047,325373,326,RepeatMasker,LINE,322563,325390,326,1.00
ptg025105l,730929,731247,318,RepeatMasker,LINE,730986,733098,262,0.82
ptg025111l,173931,174247,316,RepeatMasker,LINE,174053,174133,81,0.26
ptg025217l,145144,145446,302,RepeatMasker,LINE,145175,148447,272,0.90
ptg025255l,178801,179120,319,RepeatMasker,LINE,178742,178983,182,0.57
ptg025270l,131256,131537,281,RepeatMasker,LINE,131216,131271,15,0.05
ptg025376l,1626895,1627168,273,RepeatMasker,LINE,1626559,1627124,229,0.84
ptg025587l,148727,149006,279,RepeatMasker,LINE,148666,148810,83,0.30
ptg025615l,118255,118541,286,RepeatMasker,LINE,116394,118522,267,0.93
ptg025616l,390918,391234,316,RepeatMasker,LINE,390678,391258,316,1.00
ptg025625l,188238,188538,300,RepeatMasker,LINE,187866,188243,5,0.02
ptg025639l,146731,147006,275,RepeatMasker,LINE,145647,146893,162,0.59
ptg025639l,146731,147006,275,RepeatMasker,LINE,145697,147109,275,1.00
ptg025639l,146731,147006,275,RepeatMasker,LINE,145783,147043,275,1.00
ptg025743l,787113,787435,322,RepeatMasker,LINE,784569,790346,322,1.00
ptg025842l,147085,147376,291,RepeatMasker,LINE,147240,148569,137,0.47
ptg025848l,239025,239332,307,RepeatMasker,LINE,239119,239189,71,0.23
ptg025853l,96064,96376,312,RepeatMasker,LINE,96247,96352,106,0.34
ptg025903l,913605,913898,293,RepeatMasker,LINE,913649,915430,250,0.85
ptg025909l,488302,488615,313,RepeatMasker,LINE,488541,488606,66,0.21
ptg026022l,323262,323577,315,RepeatMasker,LINE,323365,323428,64,0.20
ptg026059l,1531342,1531652,310,RepeatMasker,LINE,1531582,1532488,71,0.23
ptg026198l,374355,374656,301,RepeatMasker,LINE,374027,374420,65,0.22
ptg026236l,42698,42977,279,RepeatMasker,LINE,39954,42820,122,0.44
ptg026264l,977055,977366,311,RepeatMasker,LINE,975226,979374,311,1.00
ptg026390l,356258,356569,311,RepeatMasker,LINE,355941,356561,303,0.97
ptg026451l,818800,819089,289,RepeatMasker,LINE,818886,821623,204,0.71
ptg026482l,165803,166088,285,RepeatMasker,LINE,165554,167857,285,1.00
ptg026482l,165803,166088,285,RepeatMasker,LINE,165831,167814,258,0.91
ptg026536l,319496,319821,325,RepeatMasker,LINE,319397,319997,325,1.00
ptg026645l,451936,452227,291,RepeatMasker,LINE,451961,452018,58,0.20
ptg026662l,141548,141834,286,RepeatMasker,LINE,141801,142933,34,0.12
ptg026677l,33057,33365,308,RepeatMasker,LINE,32379,33630,308,1.00
ptg027143l,627436,627725,289,RepeatMasker,LINE,627528,627899,198,0.69
ptg027154l,270566,270861,295,RepeatMasker,LINE,270491,271179,295,1.00
ptg027224l,2577304,2577617,313,RepeatMasker,LINE,2576844,2577677,313,1.00
ptg027224l,2577304,2577617,313,RepeatMasker,LINE,2577199,2578316,313,1.00
ptg027224l,2577304,2577617,313,RepeatMasker,LINE,2577298,2578286,313,1.00
ptg027350l,11132,11442,310,RepeatMasker,LINE,10789,11388,256,0.83
ptg027439l,1375991,1376247,256,RepeatMasker,LINE,1376235,1376413,13,0.05
ptg027449l,459887,460162,275,RepeatMasker,LINE,459833,459925,38,0.14
ptg027460l,544877,545199,322,RepeatMasker,LINE,544902,545190,289,0.90
ptg027603l,105339,105659,320,RepeatMasker,LINE,104270,105640,301,0.94
ptg027603l,410599,410888,289,RepeatMasker,LINE,410675,410751,77,0.27
ptg027603l,416538,416836,298,RepeatMasker,LINE,415697,417558,298,1.00
ptg027637l,275501,275837,336,RepeatMasker,LINE,275076,276514,336,1.00
ptg027740l,74652,74971,319,RepeatMasker,LINE,74878,75388,94,0.29
ptg027797l,94299,94598,299,RepeatMasker,LINE,93172,94405,106,0.35
ptg027884l,78912,79194,282,RepeatMasker,LINE,78047,79291,282,1.00
ptg027884l,78912,79194,282,RepeatMasker,LINE,78082,79115,203,0.72
ptg028031l,93201,93500,299,RepeatMasker,LINE,90908,93353,152,0.51
ptg028089l,180394,180692,298,RepeatMasker,LINE,179385,180511,117,0.39
ptg028089l,180394,180692,298,RepeatMasker,LINE,179845,180610,216,0.72
ptg028183l,96882,97181,299,RepeatMasker,LINE,96881,97343,299,1.00
ptg028236l,720686,720972,286,RepeatMasker,LINE,720533,720777,91,0.32
ptg028236l,720686,720972,286,RepeatMasker,LINE,720785,720946,162,0.57
ptg028322l,83034,83319,285,RepeatMasker,LINE,81629,83298,264,0.93
ptg028322l,83034,83319,285,RepeatMasker,LINE,81864,83570,285,1.00
ptg028362l,309200,309526,326,RepeatMasker,LINE,306429,309334,134,0.41
ptg028392l,112174,112471,297,RepeatMasker,LINE,112397,112471,75,0.25
ptg028392l,112174,112471,297,RepeatMasker,LINE,112471,113159,1,0.00
ptg028394l,145866,146155,289,RepeatMasker,LINE,145924,146040,117,0.40
ptg028402l,143443,143726,283,RepeatMasker,LINE,142368,143564,121,0.43
ptg028457l,49500,49760,260,RepeatMasker,LINE,49662,49712,51,0.20
ptg028624l,293733,294042,309,RepeatMasker,LINE,290105,293816,83,0.27
ptg028635l,183932,184249,317,RepeatMasker,LINE,183778,184776,317,1.00
ptg028719l,98275,98576,301,RepeatMasker,LINE,97796,98331,56,0.19
ptg028796l,454504,454818,314,RepeatMasker,LINE,454240,455523,314,1.00
ptg028871l,318467,318773,306,RepeatMasker,LINE,318457,318704,237,0.77
ptg028946l,455868,456167,299,RepeatMasker,LINE,455477,455921,53,0.18
ptg029151l,333027,333340,313,RepeatMasker,LINE,333013,333509,313,1.00
ptg029154l,219103,219404,301,RepeatMasker,LINE,219264,219335,72,0.24
ptg029205l,1240786,1241108,322,RepeatMasker,LINE,1240546,1241143,322,1.00
ptg029209l,337957,338282,325,RepeatMasker,LINE,337604,340868,325,1.00
ptg029440l,1055780,1056066,286,RepeatMasker,LINE,1053881,1056250,286,1.00
ptg029708l,328989,329304,315,RepeatMasker,LINE,328980,329080,91,0.29
ptg029724l,177336,177621,285,RepeatMasker,LINE,176183,178977,285,1.00
ptg029780l,149853,150131,278,RepeatMasker,LINE,149719,152974,278,1.00
ptg029807l,511717,512020,303,RepeatMasker,LINE,508576,511851,134,0.44
ptg029846l,354347,354672,325,RepeatMasker,LINE,353995,356882,325,1.00
ptg030044l,783666,783991,325,RepeatMasker,LINE,783328,786587,325,1.00
ptg030249l,3191447,3191777,330,RepeatMasker,LINE,3191588,3191641,54,0.16
ptg030515l,108535,108813,278,RepeatMasker,LINE,107335,109151,278,1.00
ptg030732l,373957,374237,280,RepeatMasker,LINE,371677,374429,280,1.00
ptg030979l,80857,81156,299,RepeatMasker,LINE,80764,83997,299,1.00
ptg031210l,729352,729688,336,RepeatMasker,LINE,727097,730305,336,1.00
ptg031367l,98271,98558,287,RepeatMasker,LINE,98467,98572,92,0.32
ptg031367l,98271,98558,287,RepeatMasker,LINE,98304,98383,80,0.28
ptg031433l,228090,228374,284,RepeatMasker,LINE,227972,228207,117,0.41
ptg031734l,1122481,1122785,304,RepeatMasker,LINE,1122174,1122564,83,0.27
ptg031734l,1122481,1122785,304,RepeatMasker,LINE,1122632,1123114,154,0.51
ptg031736l,236826,237106,280,RepeatMasker,LINE,236049,237448,280,1.00
ptg031842l,18942,19257,315,RepeatMasker,LINE,18462,18961,19,0.06
ptg031900l,94760,95094,334,RepeatMasker,LINE,94959,95195,136,0.41
ptg032136l,155936,156272,336,RepeatMasker,LINE,153390,156067,131,0.39
ptg032406l,39283,39605,322,RepeatMasker,LINE,39325,39710,281,0.87
ptg032635l,87367,87682,315,RepeatMasker,LINE,86927,88994,315,1.00
ptg032767l,359624,359914,290,RepeatMasker,LINE,358908,359707,83,0.29
ptg032789l,108864,109155,291,RepeatMasker,LINE,108046,108964,100,0.34
ptg033024l,219034,219349,315,RepeatMasker,LINE,215275,219462,315,1.00
ptg033028l,478619,478889,270,RepeatMasker,LINE,478301,478831,212,0.79
ptg033043l,914545,914858,313,RepeatMasker,LINE,914221,915304,313,1.00
ptg033092l,508300,508626,326,RepeatMasker,LINE,507967,508627,326,1.00
ptg033092l,508300,508626,326,RepeatMasker,LINE,507781,508610,310,0.95
ptg033120l,161623,161918,295,RepeatMasker,LINE,161661,162256,258,0.87
ptg033120l,283717,284052,335,RepeatMasker,LINE,280801,283885,168,0.50
ptg033153l,137789,138113,324,RepeatMasker,LINE,137852,138493,262,0.81
ptg033153l,137789,138113,324,RepeatMasker,LINE,137874,138277,240,0.74
ptg033169l,84469,84775,306,RepeatMasker,LINE,81317,84589,120,0.39
ptg033186l,247361,247695,334,RepeatMasker,LINE,246315,247716,334,1.00
ptg033210l,80041,80329,288,RepeatMasker,LINE,80256,80301,46,0.16
ptg033290l,9540,9831,291,RepeatMasker,LINE,8485,9595,55,0.19
ptg033290l,9540,9831,291,RepeatMasker,LINE,8867,9719,179,0.62
ptg033291l,307949,308264,315,RepeatMasker,LINE,308190,308240,51,0.16
ptg033343l,7344,7639,295,RepeatMasker,LINE,6328,10056,295,1.00
ptg033427l,117875,118164,289,RepeatMasker,LINE,118147,118342,18,0.06
ptg033437l,70159,70436,277,RepeatMasker,LINE,70026,73298,277,1.00
ptg033707l,258269,258585,316,RepeatMasker,LINE,257321,258646,316,1.00
ptg033750l,126530,126845,315,RepeatMasker,LINE,126770,127232,76,0.24
ptg033822l,89014,89319,305,RepeatMasker,LINE,87799,89221,207,0.68
ptg033870l,134036,134340,304,RepeatMasker,LINE,133942,134580,304,1.00
ptg033917l,29339,29617,278,RepeatMasker,LINE,29166,29932,278,1.00
ptg034184l,67449,67762,313,RepeatMasker,LINE,67653,67836,110,0.35
ptg034244l,79378,79648,270,RepeatMasker,LINE,79095,79516,138,0.51
ptg034295l,333980,334285,305,RepeatMasker,LINE,334081,334204,124,0.41
ptg034400l,581200,581482,282,RepeatMasker,LINE,578288,581288,88,0.31
ptg034460l,34744,35023,279,RepeatMasker,LINE,33993,35101,279,1.00
ptg034572l,282495,282799,304,RepeatMasker,LINE,282585,283722,215,0.71
ptg034581l,23409,23705,296,RepeatMasker,LINE,22757,24855,296,1.00
ptg034598l,435440,435759,319,RepeatMasker,LINE,433399,435628,188,0.59
ptg034788l,25655,25942,287,RepeatMasker,LINE,25424,26802,287,1.00
ptg034788l,25655,25942,287,RepeatMasker,LINE,25672,26802,271,0.94
ptg034927l,189614,189918,304,RepeatMasker,LINE,189311,189752,138,0.45
ptg034991l,60464,60773,309,RepeatMasker,LINE,59573,60652,188,0.61
ptg035469l,234366,234646,280,RepeatMasker,LINE,234388,234953,259,0.93
ptg035669l,544180,544494,314,RepeatMasker,LINE,544484,544933,11,0.04
ptg035687l,37917,38204,287,RepeatMasker,LINE,37606,38193,276,0.96
ptg035911l,80175,80487,312,RepeatMasker,LINE,80438,80508,50,0.16
ptg036266l,219383,219682,299,RepeatMasker,LINE,219437,219635,199,0.67
ptg036366l,172523,172839,316,RepeatMasker,LINE,172227,172726,203,0.64
ptg036511l,54394,54689,295,RepeatMasker,LINE,53042,54415,21,0.07
ptg036557l,17931,18226,295,RepeatMasker,LINE,17975,18604,252,0.85
ptg037317l,23173,23490,317,RepeatMasker,LINE,19702,23748,317,1.00
ptg037615l,4335179,4335465,286,RepeatMasker,LINE,4335119,4335347,168,0.59
ptg037841l,47145,47446,301,RepeatMasker,LINE,45498,47784,301,1.00
ptg037842l,429032,429350,318,RepeatMasker,LINE,429087,429461,264,0.83
ptg038073l,104478,104771,293,RepeatMasker,LINE,104154,104543,65,0.22
ptg038151l,142596,142879,283,RepeatMasker,LINE,141962,143548,283,1.00
ptg038259l,123777,124101,324,RepeatMasker,LINE,123633,124659,324,1.00
ptg038357l,245292,245603,311,RepeatMasker,LINE,245554,245624,50,0.16
ptg038721l,4080,4368,288,RepeatMasker,LINE,3281,4138,58,0.20
ptg038886l,185301,185600,299,RepeatMasker,LINE,184700,186172,299,1.00
ptg038915l,141939,142263,324,RepeatMasker,LINE,141822,141969,30,0.09
ptg039132l,216021,216329,308,RepeatMasker,LINE,215690,216880,308,1.00
ptg039170l,123447,123760,313,RepeatMasker,LINE,123644,123712,69,0.22
ptg039252l,93518,93828,310,RepeatMasker,LINE,93792,94510,37,0.12
ptg039491l,325217,325540,323,RepeatMasker,LINE,324043,325912,323,1.00
ptg039934l,105963,106254,291,RepeatMasker,LINE,104595,106041,78,0.27
ptg040230l,85768,86075,307,RepeatMasker,LINE,85877,85955,79,0.26
ptg040499l,42222,42501,279,RepeatMasker,LINE,42450,42522,52,0.19
ptg041337l,44545,44871,326,RepeatMasker,LINE,44030,44855,310,0.95
ptg041337l,44545,44871,326,RepeatMasker,LINE,44212,44872,326,1.00
ptg041483l,42152,42467,315,RepeatMasker,LINE,41957,42193,41,0.13
ptg041822l,62810,63103,293,RepeatMasker,LINE,62001,62912,102,0.35
ptg041924l,168230,168532,302,RepeatMasker,LINE,167926,171941,302,1.00
ptg043615l,1088671,1088981,310,RepeatMasker,LINE,1088878,1088932,55,0.18
ptg044076l,64450,64743,293,RepeatMasker,LINE,64081,64963,293,1.00
ptg044481l,164025,164326,301,RepeatMasker,LINE,164269,164476,58,0.19
ptg044481l,549619,549939,320,RepeatMasker,LINE,549854,550179,86,0.27
ptg044998l,68320,68642,322,RepeatMasker,LINE,65185,68437,117,0.36
ptg045273l,648476,648802,326,RepeatMasker,LINE,648797,648857,6,0.02
ptg046141l,168687,168962,275,RepeatMasker,LINE,167657,168811,124,0.45
ptg046538l,1074731,1075063,332,RepeatMasker,LINE,1072040,1074801,70,0.21
ptg050150l,69505,69827,322,RepeatMasker,LINE,69185,69744,239,0.74
ptg054484l,59755,60023,268,RepeatMasker,LINE,59613,59775,20,0.07
ptg054602l,5439,5766,327,RepeatMasker,LINE,3198,5757,318,0.97
ptg057195l,1392505,1392789,284,RepeatMasker,LINE,1392714,1392784,71,0.25
ptg059703l,20199,20509,310,RepeatMasker,LINE,20151,20887,310,1.00
ptg060587l,7127,7450,323,RepeatMasker,LINE,7413,8656,38,0.12
ptg000002l,4292029,4292314,285,RepeatMasker,LTR,4291364,4292434,285,1.00
ptg000004l,1337400,1337559,159,RepeatMasker,LTR,1336114,1337402,2,0.01
ptg000004l,2601875,2602156,281,RepeatMasker,LTR,2601493,2602168,281,1.00
ptg000004l,2609283,2609563,280,RepeatMasker,LTR,2608899,2609575,280,1.00
ptg000005l,5891081,5891411,330,RepeatMasker,LTR,5891380,5891430,32,0.10
ptg000009l,589336,589617,281,RepeatMasker,LTR,588289,590409,281,1.00
ptg000009l,1191032,1191312,280,RepeatMasker,LTR,1190650,1192111,280,1.00
ptg000012l,1573577,1573858,281,RepeatMasker,LTR,1572532,1574494,281,1.00
ptg000017l,1979642,1979950,308,RepeatMasker,LTR,1979761,1979926,166,0.54
ptg000020l,427444,427728,284,RepeatMasker,LTR,427266,427780,284,1.00
ptg000020l,1011094,1011391,297,RepeatMasker,LTR,1011074,1011425,297,1.00
ptg000020l,4060367,4060661,294,RepeatMasker,LTR,4060347,4060391,24,0.08
ptg000020l,4060367,4060661,294,RepeatMasker,LTR,4060388,4064442,274,0.93
ptg000027l,73617,73933,316,RepeatMasker,LTR,73873,73911,39,0.12
ptg000035l,3058589,3058886,297,RepeatMasker,LTR,3058569,3058920,297,1.00
ptg000035l,3692458,3692757,299,RepeatMasker,LTR,3692417,3692809,299,1.00
ptg000035l,3862496,3862769,273,RepeatMasker,LTR,3862723,3864939,47,0.17
ptg000035l,4054247,4054545,298,RepeatMasker,LTR,4054206,4054597,298,1.00
ptg000037l,4650641,4650951,310,RepeatMasker,LTR,4650879,4651123,73,0.24
ptg000047l,10825,11146,321,RepeatMasker,LTR,9767,11173,321,1.00
ptg000048l,13621206,13621505,299,RepeatMasker,LTR,13620913,13622307,299,1.00
ptg000052l,273103,273385,282,RepeatMasker,LTR,273082,273126,23,0.08
ptg000053l,1552389,1552673,284,RepeatMasker,LTR,1552381,1552412,23,0.08
ptg000054l,747127,747406,279,RepeatMasker,LTR,745979,747419,279,1.00
ptg000065l,73318,73617,299,RepeatMasker,LTR,73121,73664,299,1.00
ptg000065l,318334,318629,295,RepeatMasker,LTR,318156,318681,295,1.00
ptg000065l,407348,407647,299,RepeatMasker,LTR,407140,407699,299,1.00
ptg000065l,774050,774344,294,RepeatMasker,LTR,773970,774396,294,1.00
ptg000065l,805164,805463,299,RepeatMasker,LTR,805084,805515,299,1.00
ptg000065l,1129441,1129740,299,RepeatMasker,LTR,1129247,1129792,299,1.00
ptg000065l,1157593,1157892,299,RepeatMasker,LTR,1157513,1157944,299,1.00
ptg000065l,1840748,1841043,295,RepeatMasker,LTR,1840570,1841095,295,1.00
ptg000065l,1857981,1858281,300,RepeatMasker,LTR,1857803,1858333,300,1.00
ptg000065l,1986559,1986858,299,RepeatMasker,LTR,1986479,1986910,299,1.00
ptg000065l,2308663,2308958,295,RepeatMasker,LTR,2308455,2309010,295,1.00
ptg000065l,2966452,2966749,297,RepeatMasker,LTR,2966274,2966801,297,1.00
ptg000068l,2540355,2540671,316,RepeatMasker,LTR,2540038,2540688,316,1.00
ptg000069l,206396,206695,299,RepeatMasker,LTR,206355,206747,299,1.00
ptg000075l,1455198,1455514,316,RepeatMasker,LTR,1454881,1455531,316,1.00
ptg000080l,1768520,1768800,280,RepeatMasker,LTR,1767370,1768813,280,1.00
ptg000082l,405557,405873,316,RepeatMasker,LTR,405651,405992,223,0.71
ptg000082l,5249344,5249626,282,RepeatMasker,LTR,5248238,5249501,157,0.56
ptg000082l,5249344,5249626,282,RepeatMasker,LTR,5249518,5249915,109,0.39
ptg000086l,700918,701227,309,RepeatMasker,LTR,701114,701180,67,0.22
ptg000086l,1101198,1101482,284,RepeatMasker,LTR,1101320,1108374,163,0.57
ptg000087l,173247,173541,294,RepeatMasker,LTR,173039,173588,294,1.00
ptg000090l,362948,363261,313,RepeatMasker,LTR,362620,363071,123,0.39
ptg000090l,362948,363261,313,RepeatMasker,LTR,363038,367267,224,0.72
ptg000091l,355123,355404,281,RepeatMasker,LTR,353999,356037,281,1.00
ptg000096l,1742518,1742830,312,RepeatMasker,LTR,1742699,1745139,132,0.42
ptg000096l,3655902,3656215,313,RepeatMasker,LTR,3655818,3658621,313,1.00
ptg000097l,639638,639939,301,RepeatMasker,LTR,639766,639842,77,0.26
ptg000098l,277599,277929,330,RepeatMasker,LTR,277037,277625,26,0.08
ptg000098l,3433758,3434089,331,RepeatMasker,LTR,3433918,3434425,172,0.52
ptg000099l,1755712,1756006,294,RepeatMasker,LTR,1755376,1755792,80,0.27
ptg000099l,2613986,2614280,294,RepeatMasker,LTR,2613663,2616863,294,1.00
ptg000104l,6099437,6099744,307,RepeatMasker,LTR,6097564,6100996,307,1.00
ptg000104l,10344210,10344532,322,RepeatMasker,LTR,10344351,10351381,182,0.57
ptg000108l,399043,399339,296,RepeatMasker,LTR,396041,400503,296,1.00
ptg000108l,399043,399339,296,RepeatMasker,LTR,398518,401819,296,1.00
ptg000110l,2109526,2109820,294,RepeatMasker,LTR,2108973,2109853,294,1.00
ptg000113l,1632062,1632349,287,RepeatMasker,LTR,1630492,1633198,287,1.00
ptg000117l,2353412,2353711,299,RepeatMasker,LTR,2353234,2353763,299,1.00
ptg000118l,2114922,2115203,281,RepeatMasker,LTR,2114584,2115236,281,1.00
ptg000121l,800886,801187,301,RepeatMasker,LTR,800559,801200,301,1.00
ptg000123l,5501802,5502100,298,RepeatMasker,LTR,5501624,5502152,298,1.00
ptg000132l,1343749,1344047,298,RepeatMasker,LTR,1341888,1345001,298,1.00
ptg000142l,15729,16038,309,RepeatMasker,LTR,15600,16899,309,1.00
ptg000142l,3191449,3191732,283,RepeatMasker,LTR,3191275,3191544,95,0.34
ptg000144l,981922,982235,313,RepeatMasker,LTR,981088,982250,313,1.00
ptg000148l,361237,361514,277,RepeatMasker,LTR,361337,361462,126,0.45
ptg000156l,5252829,5253116,287,RepeatMasker,LTR,5253088,5254169,29,0.10
ptg000156l,8568031,8568312,281,RepeatMasker,LTR,8568086,8568591,227,0.81
ptg000161l,1972130,1972413,283,RepeatMasker,LTR,1969336,1973031,283,1.00
ptg000168l,397840,398142,302,RepeatMasker,LTR,397979,399230,164,0.54
ptg000177l,2709021,2709339,318,RepeatMasker,LTR,2708543,2709132,111,0.35
ptg000177l,2709021,2709339,318,RepeatMasker,LTR,2709124,2711394,216,0.68
ptg000180l,338554,338865,311,RepeatMasker,LTR,338743,339002,123,0.40
ptg000180l,338554,338865,311,RepeatMasker,LTR,338773,339064,93,0.30
ptg000180l,338554,338865,311,RepeatMasker,LTR,338863,339151,3,0.01
ptg000183l,1303591,1303880,289,RepeatMasker,LTR,1303633,1303718,86,0.30
ptg000183l,1303591,1303880,289,RepeatMasker,LTR,1303651,1303775,125,0.43
ptg000185l,91739,92052,313,RepeatMasker,LTR,91357,92457,313,1.00
ptg000186l,1288522,1288808,286,RepeatMasker,LTR,1288123,1291118,286,1.00
ptg000186l,4329049,4329341,292,RepeatMasker,LTR,4328154,4329096,47,0.16
ptg000186l,4684665,4684953,288,RepeatMasker,LTR,4684501,4685167,288,1.00
ptg000186l,6901530,6901827,297,RepeatMasker,LTR,6900395,6901840,297,1.00
ptg000188l,1446782,1447081,299,RepeatMasker,LTR,1446601,1447133,299,1.00
ptg000195l,1395633,1395929,296,RepeatMasker,LTR,1394867,1397495,296,1.00
ptg000195l,1395633,1395935,302,RepeatMasker,LTR,1394867,1397495,302,1.00
ptg000200l,3456621,3456898,277,RepeatMasker,LTR,3456236,3456913,277,1.00
ptg000203l,1707759,1708040,281,RepeatMasker,LTR,1707874,1708406,167,0.59
ptg000204l,364848,365134,286,RepeatMasker,LTR,363448,365991,286,1.00
ptg000206l,3657355,3657653,298,RepeatMasker,LTR,3656235,3658289,298,1.00
ptg000209l,1224239,1224501,262,RepeatMasker,LTR,1221225,1224283,44,0.17
ptg000210l,3193310,3193600,290,RepeatMasker,LTR,3193532,3194006,69,0.24
ptg000211l,1101767,1102090,323,RepeatMasker,LTR,1101635,1101773,6,0.02
ptg000211l,1101767,1102090,323,RepeatMasker,LTR,1101774,1101933,160,0.50
ptg000211l,1101767,1102090,323,RepeatMasker,LTR,1101823,1101984,162,0.50
ptg000211l,1101767,1102090,323,RepeatMasker,LTR,1101983,1102334,108,0.33
ptg000217l,1716006,1716327,321,RepeatMasker,LTR,1715982,1716692,321,1.00
ptg000219l,2515734,2516011,277,RepeatMasker,LTR,2512303,2516001,267,0.96
ptg000219l,2515734,2516011,277,RepeatMasker,LTR,2516002,2516133,10,0.04
ptg000219l,3772436,3772733,297,RepeatMasker,LTR,3772228,3772785,297,1.00
ptg000231l,1199856,1200148,292,RepeatMasker,LTR,1199514,1201312,292,1.00
ptg000235l,2239229,2239516,287,RepeatMasker,LTR,2234557,2240369,287,1.00
ptg000238l,834419,834699,280,RepeatMasker,LTR,831268,834959,280,1.00
ptg000240l,1092399,1092716,317,RepeatMasker,LTR,1092609,1093821,108,0.34
ptg000244l,447940,448243,303,RepeatMasker,LTR,448023,449389,221,0.73
ptg000248l,1620399,1620696,297,RepeatMasker,LTR,1620449,1622242,248,0.84
ptg000248l,1842040,1842339,299,RepeatMasker,LTR,1841861,1842391,299,1.00
ptg000249l,2176820,2177100,280,RepeatMasker,LTR,2175752,2177897,280,1.00
ptg000250l,5460385,5460675,290,RepeatMasker,LTR,5459492,5460428,43,0.15
ptg000250l,5460385,5460675,290,RepeatMasker,LTR,5460378,5460434,49,0.17
ptg000254l,2429418,2429730,312,RepeatMasker,LTR,2427482,2429762,312,1.00
ptg000254l,2481264,2481556,292,RepeatMasker,LTR,2481424,2481789,133,0.46
ptg000257l,2305481,2305807,326,RepeatMasker,LTR,2305188,2306708,326,1.00
ptg000258l,3068566,3068847,281,RepeatMasker,LTR,3068181,3069480,281,1.00
ptg000261l,1456544,1456860,316,RepeatMasker,LTR,1456801,1456876,60,0.19
ptg000267l,1673449,1673757,308,RepeatMasker,LTR,1673722,1673786,36,0.12
ptg000267l,9456752,9457063,311,RepeatMasker,LTR,9455968,9459705,311,1.00
ptg000271l,4066852,4067152,300,RepeatMasker,LTR,4062229,4068014,300,1.00
ptg000276l,4471647,4471927,280,RepeatMasker,LTR,4470596,4471949,280,1.00
ptg000276l,4478804,4479084,280,RepeatMasker,LTR,4477673,4479097,280,1.00
ptg000280l,1659457,1659756,299,RepeatMasker,LTR,1656560,1659881,299,1.00
ptg000283l,87167,87447,280,RepeatMasker,LTR,86778,87459,280,1.00
ptg000283l,4802463,4802755,292,RepeatMasker,LTR,4802222,4802953,292,1.00
ptg000284l,894530,894817,287,RepeatMasker,LTR,894562,896074,256,0.89
ptg000286l,5843812,5844117,305,RepeatMasker,LTR,5844076,5844439,42,0.14
ptg000286l,8390209,8390520,311,RepeatMasker,LTR,8389961,8390442,233,0.75
ptg000286l,8390209,8390520,311,RepeatMasker,LTR,8390080,8390483,274,0.88
ptg000293l,1057176,1057488,312,RepeatMasker,LTR,1057301,1059444,188,0.60
ptg000300l,278651,278937,286,RepeatMasker,LTR,278384,279131,286,1.00
ptg000300l,772149,772434,285,RepeatMasker,LTR,772249,772347,99,0.35
ptg000304l,706488,706787,299,RepeatMasker,LTR,706323,706839,299,1.00
ptg000304l,7180771,7181070,299,RepeatMasker,LTR,7180616,7181117,299,1.00
ptg000306l,2712807,2713113,306,RepeatMasker,LTR,2712556,2713590,306,1.00
ptg000306l,2712807,2713113,306,RepeatMasker,LTR,2713004,2713867,110,0.36
ptg000306l,5497818,5498095,277,RepeatMasker,LTR,5498085,5498167,11,0.04
ptg000307l,7238542,7238842,300,RepeatMasker,LTR,7237634,7238605,63,0.21
ptg000311l,1225139,1225403,264,RepeatMasker,LTR,1223927,1225848,264,1.00
ptg000314l,1652020,1652327,307,RepeatMasker,LTR,1651668,1652803,307,1.00
ptg000321l,992313,992619,306,RepeatMasker,LTR,991929,992631,306,1.00
ptg000322l,2342369,2342668,299,RepeatMasker,LTR,2342516,2342772,153,0.51
ptg000323l,2378451,2378730,279,RepeatMasker,LTR,2377321,2382209,279,1.00
ptg000323l,2410926,2411225,299,RepeatMasker,LTR,2410748,2411277,299,1.00
ptg000325l,68525,68835,310,RepeatMasker,LTR,68810,70250,26,0.08
ptg000325l,2229553,2229851,298,RepeatMasker,LTR,2227088,2232058,298,1.00
ptg000326l,865231,865568,337,RepeatMasker,LTR,865444,865665,125,0.37
ptg000327l,2250337,2250642,305,RepeatMasker,LTR,2248260,2251212,305,1.00
ptg000330l,4225952,4226272,320,RepeatMasker,LTR,4226056,4228731,217,0.68
ptg000337l,106785,107071,286,RepeatMasker,LTR,105170,106936,151,0.53
ptg000337l,106785,107071,286,RepeatMasker,LTR,106897,107031,135,0.47
ptg000337l,5756806,5757105,299,RepeatMasker,LTR,5756598,5757157,299,1.00
ptg000337l,13183756,13184078,322,RepeatMasker,LTR,13183455,13184750,322,1.00
ptg000343l,170949,171229,280,RepeatMasker,LTR,170560,172035,280,1.00
ptg000347l,885440,885735,295,RepeatMasker,LTR,883216,885733,293,0.99
ptg000348l,1430039,1430316,277,RepeatMasker,LTR,1429987,1430111,72,0.26
ptg000349l,690027,690347,320,RepeatMasker,LTR,689517,691134,320,1.00
ptg000352l,716026,716340,314,RepeatMasker,LTR,709871,716128,102,0.32
ptg000352l,716026,716340,314,RepeatMasker,LTR,716125,716152,28,0.09
ptg000358l,1312486,1312798,312,RepeatMasker,LTR,1312609,1312666,58,0.19
ptg000361l,945059,945373,314,RepeatMasker,LTR,944806,945241,182,0.58
ptg000365l,656988,657302,314,RepeatMasker,LTR,656511,657080,92,0.29
ptg000367l,719663,719935,272,RepeatMasker,LTR,719649,720177,272,1.00
ptg000373l,1390392,1390690,298,RepeatMasker,LTR,1390169,1390727,298,1.00
ptg000375l,2024624,2024911,287,RepeatMasker,LTR,2019976,2025765,287,1.00
ptg000377l,78946,79228,282,RepeatMasker,LTR,77368,80062,282,1.00
ptg000382l,1711849,1712144,295,RepeatMasker,LTR,1711769,1712196,295,1.00
ptg000385l,2321860,2322193,333,RepeatMasker,LTR,2321717,2322109,249,0.75
ptg000385l,2339595,2339913,318,RepeatMasker,LTR,2338708,2339687,92,0.29
ptg000389l,504523,504822,299,RepeatMasker,LTR,504482,504868,299,1.00
ptg000389l,1205679,1206004,325,RepeatMasker,LTR,1205775,1205816,42,0.13
ptg000389l,1205679,1206004,325,RepeatMasker,LTR,1205778,1205848,71,0.22
ptg000391l,1670642,1670911,269,RepeatMasker,LTR,1670875,1671129,37,0.14
ptg000395l,315603,315899,296,RepeatMasker,LTR,315873,322659,27,0.09
ptg000397l,1908910,1909208,298,RepeatMasker,LTR,1907897,1909844,298,1.00
ptg000397l,1908910,1909208,298,RepeatMasker,LTR,1907995,1909221,298,1.00
ptg000397l,2858397,2858695,298,RepeatMasker,LTR,2858219,2858745,298,1.00
ptg000405l,935475,935755,280,RepeatMasker,LTR,934430,935768,280,1.00
ptg000406l,563740,564041,301,RepeatMasker,LTR,563953,564353,89,0.30
ptg000406l,746850,747130,280,RepeatMasker,LTR,746435,747768,280,1.00
ptg000407l,4074271,4074600,329,RepeatMasker,LTR,4073769,4074844,329,1.00
ptg000407l,6456850,6457149,299,RepeatMasker,LTR,6456770,6457201,299,1.00
ptg000408l,2219755,2220048,293,RepeatMasker,LTR,2219560,2220100,293,1.00
ptg000413l,636390,636677,287,RepeatMasker,LTR,636370,636414,24,0.08
ptg000413l,636390,636677,287,RepeatMasker,LTR,636605,636688,73,0.25
ptg000413l,636390,636677,287,RepeatMasker,LTR,636618,636688,60,0.21
ptg000413l,795681,795989,308,RepeatMasker,LTR,794606,795954,273,0.89
ptg000414l,3639996,3640288,292,RepeatMasker,LTR,3639628,3640321,292,1.00
ptg000414l,3647104,3647385,281,RepeatMasker,LTR,3646712,3647418,281,1.00
ptg000430l,2397114,2397419,305,RepeatMasker,LTR,2395575,2397800,305,1.00
ptg000433l,1165562,1165861,299,RepeatMasker,LTR,1165352,1165913,299,1.00
ptg000449l,335667,335966,299,RepeatMasker,LTR,335647,336018,299,1.00
ptg000450l,863265,863553,288,RepeatMasker,LTR,862768,863456,191,0.66
ptg000450l,863265,863553,288,RepeatMasker,LTR,863330,863558,224,0.78
ptg000452l,413684,413993,309,RepeatMasker,LTR,413097,413986,302,0.98
ptg000454l,1517346,1517630,284,RepeatMasker,LTR,1516099,1519668,284,1.00
ptg000455l,480932,481219,287,RepeatMasker,LTR,476289,481740,287,1.00
ptg000469l,1400976,1401300,324,RepeatMasker,LTR,1401100,1402137,201,0.62
ptg000473l,1099124,1099403,279,RepeatMasker,LTR,1098742,1099416,279,1.00
ptg000485l,1335646,1335941,295,RepeatMasker,LTR,1335468,1335993,295,1.00
ptg000486l,175548,175856,308,RepeatMasker,LTR,175772,176272,85,0.28
ptg000487l,304209,304523,314,RepeatMasker,LTR,304168,305122,314,1.00
ptg000490l,173629,173943,314,RepeatMasker,LTR,169049,174096,314,1.00
ptg000490l,173629,173943,314,RepeatMasker,LTR,172934,174352,314,1.00
ptg000491l,2117561,2117860,299,RepeatMasker,LTR,2117458,2117580,19,0.06
ptg000496l,714632,714926,294,RepeatMasker,LTR,713750,717319,294,1.00
ptg000499l,153228,153517,289,RepeatMasker,LTR,152341,153264,36,0.12
ptg000502l,2303567,2303879,312,RepeatMasker,LTR,2303428,2304609,312,1.00
ptg000504l,3421555,3421832,277,RepeatMasker,LTR,3418125,3421822,267,0.96
ptg000504l,3421555,3421832,277,RepeatMasker,LTR,3421494,3421988,277,1.00
ptg000506l,2400927,2401214,287,RepeatMasker,LTR,2397047,2401677,287,1.00
ptg000508l,2127866,2128136,270,RepeatMasker,LTR,2128051,2128140,86,0.32
ptg000508l,2127866,2128136,270,RepeatMasker,LTR,2128097,2128146,40,0.15
ptg000508l,2322168,2322471,303,RepeatMasker,LTR,2322259,2322814,213,0.70
ptg000511l,7130110,7130406,296,RepeatMasker,LTR,7128741,7131454,296,1.00
ptg000518l,643593,643866,273,RepeatMasker,LTR,643624,643695,72,0.26
ptg000521l,142842,143123,281,RepeatMasker,LTR,142592,143763,281,1.00
ptg000523l,635161,635477,316,RepeatMasker,LTR,632743,635212,51,0.16
ptg000523l,1198748,1199043,295,RepeatMasker,LTR,1198570,1199095,295,1.00
ptg000523l,1251397,1251696,299,RepeatMasker,LTR,1251317,1251748,299,1.00
ptg000525l,439005,439286,281,RepeatMasker,LTR,437851,439299,281,1.00
ptg000528l,3305130,3305411,281,RepeatMasker,LTR,3305195,3305387,193,0.69
ptg000532l,1024273,1024542,269,RepeatMasker,LTR,1023883,1025189,269,1.00
ptg000537l,2736853,2737134,281,RepeatMasker,LTR,2735796,2737917,281,1.00
ptg000539l,6247213,6247513,300,RepeatMasker,LTR,6247034,6247565,300,1.00
ptg000544l,441094,441383,289,RepeatMasker,LTR,440892,441435,289,1.00
ptg000551l,775320,775600,280,RepeatMasker,LTR,774275,775613,280,1.00
ptg000551l,782499,782780,281,RepeatMasker,LTR,781363,782793,281,1.00
ptg000555l,437759,438057,298,RepeatMasker,LTR,438019,438145,39,0.13
ptg000555l,960262,960580,318,RepeatMasker,LTR,960066,960296,34,0.11
ptg000555l,960262,960580,318,RepeatMasker,LTR,960081,960359,97,0.31
ptg000559l,1510894,1511179,285,RepeatMasker,LTR,1510873,1510917,23,0.08
ptg000567l,1393856,1394143,287,RepeatMasker,LTR,1392300,1395004,287,1.00
ptg000576l,2313610,2313898,288,RepeatMasker,LTR,2313162,2313801,191,0.66
ptg000576l,2313610,2313898,288,RepeatMasker,LTR,2313675,2313901,224,0.78
ptg000583l,1677479,1677772,293,RepeatMasker,LTR,1677597,1677876,176,0.60
ptg000595l,1525668,1525949,281,RepeatMasker,LTR,1525278,1525982,281,1.00
ptg000599l,328863,329189,326,RepeatMasker,LTR,328762,329169,306,0.94
ptg000599l,328863,329189,326,RepeatMasker,LTR,329182,330270,8,0.02
ptg000602l,946942,947222,280,RepeatMasker,LTR,945896,947860,280,1.00
ptg000603l,313140,313445,305,RepeatMasker,LTR,311772,314079,305,1.00
ptg000604l,997591,997868,277,RepeatMasker,LTR,997545,999734,277,1.00
ptg000604l,3407684,3407958,274,RepeatMasker,LTR,3407719,3407936,218,0.80
ptg000605l,1396274,1396601,327,RepeatMasker,LTR,1396325,1396414,90,0.28
ptg000605l,1396274,1396601,327,RepeatMasker,LTR,1396484,1396519,36,0.11
ptg000605l,2177779,2178061,282,RepeatMasker,LTR,2176727,2178074,282,1.00
ptg000605l,2182109,2182389,280,RepeatMasker,LTR,2182034,2182402,280,1.00
ptg000609l,468499,468824,325,RepeatMasker,LTR,467638,470160,325,1.00
ptg000609l,593164,593445,281,RepeatMasker,LTR,592112,594083,281,1.00
ptg000610l,978938,979231,293,RepeatMasker,LTR,978858,979283,293,1.00
ptg000613l,1867544,1867860,316,RepeatMasker,LTR,1864172,1867595,51,0.16
ptg000613l,2737540,2737832,292,RepeatMasker,LTR,2737413,2737692,152,0.52
ptg000614l,201223,201514,291,RepeatMasker,LTR,201353,208371,162,0.56
ptg000620l,3567740,3568032,292,RepeatMasker,LTR,3567982,3568417,51,0.17
ptg000620l,3733047,3733343,296,RepeatMasker,LTR,3733225,3734053,119,0.40
ptg000620l,4993463,4993770,307,RepeatMasker,LTR,4993756,4994312,15,0.05
ptg000627l,3659298,3659601,303,RepeatMasker,LTR,3659560,3659612,42,0.14
ptg000627l,3659298,3659601,303,RepeatMasker,LTR,3659576,3659626,26,0.09
ptg000629l,2020668,2020961,293,RepeatMasker,LTR,2020480,2020839,171,0.58
ptg000630l,358230,358510,280,RepeatMasker,LTR,357841,358522,280,1.00
ptg000632l,2675389,2675703,314,RepeatMasker,LTR,2675357,2676301,314,1.00
ptg000633l,8200355,8200648,293,RepeatMasker,LTR,8199277,8201421,293,1.00
ptg000635l,350760,351040,280,RepeatMasker,LTR,350370,351686,280,1.00
ptg000637l,3532375,3532704,329,RepeatMasker,LTR,3532632,3533494,73,0.22
ptg000642l,790739,791023,284,RepeatMasker,LTR,791007,791259,17,0.06
ptg000647l,13224,13510,286,RepeatMasker,LTR,9093,14364,286,1.00
ptg000648l,332162,332443,281,RepeatMasker,LTR,331780,333089,281,1.00
ptg000652l,5594,5893,299,RepeatMasker,LTR,5731,5910,163,0.55
ptg000654l,915104,915385,281,RepeatMasker,LTR,914049,915418,281,1.00
ptg000664l,2315321,2315603,282,RepeatMasker,LTR,2315501,2315782,103,0.37
ptg000665l,2375165,2375446,281,RepeatMasker,LTR,2374783,2375459,281,1.00
ptg000665l,2869964,2870220,256,RepeatMasker,LTR,2869852,2870127,163,0.64
ptg000665l,3219384,3219698,314,RepeatMasker,LTR,3219348,3219889,314,1.00
ptg000665l,10235206,10235519,313,RepeatMasker,LTR,10234629,10235512,306,0.98
ptg000670l,1132902,1133238,336,RepeatMasker,LTR,1132947,1133135,189,0.56
ptg000672l,365869,366162,293,RepeatMasker,LTR,365561,366594,293,1.00
ptg000674l,1567198,1567484,286,RepeatMasker,LTR,1566335,1568200,286,1.00
ptg000674l,1567198,1567484,286,RepeatMasker,LTR,1566440,1568763,286,1.00
ptg000678l,444852,445171,319,RepeatMasker,LTR,445122,449458,50,0.16
ptg000680l,619704,619976,272,RepeatMasker,LTR,618766,619874,170,0.63
ptg000680l,619704,619976,272,RepeatMasker,LTR,619876,620939,101,0.37
ptg000687l,2548223,2548526,303,RepeatMasker,LTR,2548221,2548985,303,1.00
ptg000688l,580394,580675,281,RepeatMasker,LTR,580005,581329,281,1.00
ptg000689l,1893834,1894127,293,RepeatMasker,LTR,1892716,1894140,293,1.00
ptg000690l,3244589,3244886,297,RepeatMasker,LTR,3244090,3245756,297,1.00
ptg000696l,306368,306694,326,RepeatMasker,LTR,306530,313608,165,0.51
ptg000697l,3124973,3125268,295,RepeatMasker,LTR,3124893,3125320,295,1.00
ptg000697l,4766164,4766455,291,RepeatMasker,LTR,4766430,4767420,26,0.09
ptg000703l,2243058,2243339,281,RepeatMasker,LTR,2242667,2243351,281,1.00
ptg000707l,869286,869583,297,RepeatMasker,LTR,868986,869334,48,0.16
ptg000707l,869286,869583,297,RepeatMasker,LTR,869036,869576,290,0.98
ptg000710l,1561119,1561435,316,RepeatMasker,LTR,1561270,1563690,166,0.53
ptg000719l,3246819,3247118,299,RepeatMasker,LTR,3246625,3247170,299,1.00
ptg000720l,1041078,1041419,341,RepeatMasker,LTR,1040602,1041107,29,0.09
ptg000720l,2508256,2508583,327,RepeatMasker,LTR,2508236,2509383,327,1.00
ptg000721l,540868,541196,328,RepeatMasker,LTR,540921,541346,276,0.84
ptg000722l,949539,949834,295,RepeatMasker,LTR,949519,949886,295,1.00
ptg000722l,1533279,1533578,299,RepeatMasker,LTR,1533259,1533630,299,1.00
ptg000722l,2732737,2733025,288,RepeatMasker,LTR,2727820,2733897,288,1.00
ptg000722l,4018700,4019002,302,RepeatMasker,LTR,4018522,4019054,302,1.00
ptg000723l,632966,633248,282,RepeatMasker,LTR,632648,633461,282,1.00
ptg000724l,4593336,4593622,286,RepeatMasker,LTR,4590744,4594383,286,1.00
ptg000724l,4857583,4857882,299,RepeatMasker,LTR,4857409,4857934,299,1.00
ptg000726l,825802,826119,317,RepeatMasker,LTR,825820,825865,46,0.15
ptg000726l,3320259,3320540,281,RepeatMasker,LTR,3319948,3320573,281,1.00
ptg000727l,902427,902724,297,RepeatMasker,LTR,901712,902502,75,0.25
ptg000727l,902427,902724,297,RepeatMasker,LTR,902503,903098,222,0.75
ptg000732l,537992,538269,277,RepeatMasker,LTR,538216,538280,54,0.19
ptg000732l,537992,538269,277,RepeatMasker,LTR,538244,538296,26,0.09
ptg000732l,1506974,1507248,274,RepeatMasker,LTR,1507191,1507456,58,0.21
ptg000733l,1529222,1529511,289,RepeatMasker,LTR,1529248,1529489,242,0.84
ptg000733l,1529222,1529511,289,RepeatMasker,LTR,1529258,1529432,175,0.61
ptg000735l,2098534,2098832,298,RepeatMasker,LTR,2098514,2098884,298,1.00
ptg000735l,2244602,2244901,299,RepeatMasker,LTR,2244522,2244953,299,1.00
ptg000739l,5901438,5901715,277,RepeatMasker,LTR,5901706,5901837,10,0.04
ptg000739l,5901438,5901715,277,RepeatMasker,LTR,5898009,5901705,267,0.96
ptg000739l,8016584,8016902,318,RepeatMasker,LTR,8016794,8018096,109,0.34
ptg000741l,180495,180772,277,RepeatMasker,LTR,179971,180535,40,0.14
ptg000741l,1811371,1811648,277,RepeatMasker,LTR,1811587,1811659,62,0.22
ptg000741l,1811371,1811648,277,RepeatMasker,LTR,1811623,1811674,26,0.09
ptg000742l,1895563,1895872,309,RepeatMasker,LTR,1894537,1896661,309,1.00
ptg000742l,3397437,3397738,301,RepeatMasker,LTR,3396966,3397521,84,0.28
ptg000742l,3397437,3397738,301,RepeatMasker,LTR,3397711,3401284,28,0.09
ptg000742l,3864482,3864768,286,RepeatMasker,LTR,3864446,3864505,23,0.08
ptg000742l,4570682,4570964,282,RepeatMasker,LTR,4570661,4570705,23,0.08
ptg000748l,5686020,5686319,299,RepeatMasker,LTR,5685812,5686371,299,1.00
ptg000751l,4603705,4604007,302,RepeatMasker,LTR,4603845,4604325,163,0.54
ptg000760l,1497873,1498172,299,RepeatMasker,LTR,1497665,1498224,299,1.00
ptg000762l,1355678,1355959,281,RepeatMasker,LTR,1355270,1356776,281,1.00
ptg000762l,1556648,1556928,280,RepeatMasker,LTR,1556266,1557714,280,1.00
ptg000767l,855272,855566,294,RepeatMasker,LTR,855094,855618,294,1.00
ptg000771l,1314173,1314483,310,RepeatMasker,LTR,1313781,1315897,310,1.00
ptg000794l,1361799,1362131,332,RepeatMasker,LTR,1361597,1362646,332,1.00
ptg000795l,1383743,1384072,329,RepeatMasker,LTR,1381497,1390996,329,1.00
ptg000801l,1136211,1136517,306,RepeatMasker,LTR,1135894,1136383,172,0.56
ptg000801l,1136211,1136517,306,RepeatMasker,LTR,1136294,1138657,224,0.73
ptg000801l,1154719,1155023,304,RepeatMasker,LTR,1154731,1154974,244,0.80
ptg000802l,918821,919120,299,RepeatMasker,LTR,918643,919172,299,1.00
ptg000802l,7761448,7761759,311,RepeatMasker,LTR,7760871,7761752,304,0.98
ptg000804l,712085,712415,330,RepeatMasker,LTR,711731,712359,274,0.83
ptg000805l,203664,203940,276,RepeatMasker,LTR,203458,203913,249,0.90
ptg000805l,694425,694730,305,RepeatMasker,LTR,693359,695367,305,1.00
ptg000806l,1561720,1562005,285,RepeatMasker,LTR,1560505,1563219,285,1.00
ptg000811l,2448800,2449102,302,RepeatMasker,LTR,2447901,2448846,46,0.15
ptg000813l,590369,590665,296,RepeatMasker,LTR,590191,590717,296,1.00
ptg000817l,2754373,2754672,299,RepeatMasker,LTR,2754353,2754706,299,1.00
ptg000819l,1394581,1394895,314,RepeatMasker,LTR,1394554,1395489,314,1.00
ptg000819l,2003240,2003561,321,RepeatMasker,LTR,2003268,2004504,294,0.92
ptg000824l,3322736,3323035,299,RepeatMasker,LTR,3322716,3323087,299,1.00
ptg000824l,3608126,3608422,296,RepeatMasker,LTR,3607948,3608474,296,1.00
ptg000836l,1819232,1819518,286,RepeatMasker,LTR,1818835,1821833,286,1.00
ptg000837l,2190536,2190826,290,RepeatMasker,LTR,2190248,2190556,20,0.07
ptg000837l,2190536,2190826,290,RepeatMasker,LTR,2190597,2191176,230,0.79
ptg000837l,5071008,5071296,288,RepeatMasker,LTR,5070511,5071199,191,0.66
ptg000837l,5071008,5071296,288,RepeatMasker,LTR,5071084,5071343,213,0.74
ptg000838l,438868,439188,320,RepeatMasker,LTR,439138,442300,51,0.16
ptg000840l,73749,74069,320,RepeatMasker,LTR,73778,74709,292,0.91
ptg000844l,6618176,6618488,312,RepeatMasker,LTR,6616725,6619101,312,1.00
ptg000845l,1055026,1055308,282,RepeatMasker,LTR,1054099,1055073,47,0.17
ptg000847l,4291021,4291348,327,RepeatMasker,LTR,4291137,4291299,163,0.50
ptg000847l,4291021,4291348,327,RepeatMasker,LTR,4291323,4291578,26,0.08
ptg000850l,1684486,1684780,294,RepeatMasker,LTR,1684466,1684814,294,1.00
ptg000851l,3263973,3264281,308,RepeatMasker,LTR,3263986,3265082,296,0.96
ptg000852l,310613,310895,282,RepeatMasker,LTR,310875,311860,21,0.07
ptg000853l,4272728,4273053,325,RepeatMasker,LTR,4267876,4275248,325,1.00
ptg000853l,5612321,5612620,299,RepeatMasker,LTR,5611957,5613415,299,1.00
ptg000853l,5627113,5627411,298,RepeatMasker,LTR,5626748,5628049,298,1.00
ptg000855l,3629910,3630219,309,RepeatMasker,LTR,3626641,3631066,309,1.00
ptg000858l,234076,234357,281,RepeatMasker,LTR,233694,234990,281,1.00
ptg000867l,780848,781133,285,RepeatMasker,LTR,780827,780871,23,0.08
ptg000867l,4933328,4933646,318,RepeatMasker,LTR,4933160,4933928,318,1.00
ptg000867l,5576012,5576311,299,RepeatMasker,LTR,5575834,5576363,299,1.00
ptg000873l,213884,214167,283,RepeatMasker,LTR,213146,214603,283,1.00
ptg000873l,1690715,1691012,297,RepeatMasker,LTR,1690681,1690724,9,0.03
ptg000875l,4352488,4352798,310,RepeatMasker,LTR,4351798,4352848,310,1.00
ptg000877l,1028376,1028678,302,RepeatMasker,LTR,1028548,1028645,98,0.32
ptg000877l,1854001,1854287,286,RepeatMasker,LTR,1852467,1854282,281,0.98
ptg000877l,1854001,1854287,286,RepeatMasker,LTR,1850352,1854043,42,0.15
ptg000878l,379188,379490,302,RepeatMasker,LTR,378988,379542,302,1.00
ptg000878l,450696,450995,299,RepeatMasker,LTR,450515,451029,299,1.00
ptg000878l,455880,456176,296,RepeatMasker,LTR,455680,456228,296,1.00
ptg000879l,438968,439258,290,RepeatMasker,LTR,435412,439958,290,1.00
ptg000883l,2119850,2120165,315,RepeatMasker,LTR,2119893,2120021,129,0.41
ptg000885l,1271876,1272160,284,RepeatMasker,LTR,1271853,1271899,23,0.08
ptg000886l,259985,260277,292,RepeatMasker,LTR,259525,260080,95,0.33
ptg000886l,259985,260277,292,RepeatMasker,LTR,260127,260495,151,0.52
ptg000886l,4427131,4427450,319,RepeatMasker,LTR,4427236,4427275,40,0.13
ptg000886l,5284406,5284704,298,RepeatMasker,LTR,5284542,5284766,163,0.55
ptg000890l,1558429,1558742,313,RepeatMasker,LTR,1557124,1561236,313,1.00
ptg000907l,432528,432832,304,RepeatMasker,LTR,432744,432963,89,0.29
ptg000909l,549949,550235,286,RepeatMasker,LTR,549856,550680,286,1.00
ptg000909l,2049606,2049908,302,RepeatMasker,LTR,2049369,2049836,230,0.76
ptg000915l,2669854,2670130,276,RepeatMasker,LTR,2669826,2669857,3,0.01
ptg000915l,2669854,2670130,276,RepeatMasker,LTR,2670006,2670038,33,0.12
ptg000915l,5763372,5763665,293,RepeatMasker,LTR,5763165,5763717,293,1.00
ptg000918l,549023,549337,314,RepeatMasker,LTR,549046,549348,292,0.93
ptg000919l,1257100,1257428,328,RepeatMasker,LTR,1257220,1258043,209,0.64
ptg000928l,5512522,5512806,284,RepeatMasker,LTR,5511484,5513443,284,1.00
ptg000929l,912574,912854,280,RepeatMasker,LTR,912195,913657,280,1.00
ptg000929l,3211555,3211836,281,RepeatMasker,LTR,3210412,3212472,281,1.00
ptg000930l,152375,152671,296,RepeatMasker,LTR,147475,155967,296,1.00
ptg000931l,529624,529912,288,RepeatMasker,LTR,528663,529772,148,0.51
ptg000931l,529624,529912,288,RepeatMasker,LTR,529772,530042,141,0.49
ptg000933l,794045,794319,274,RepeatMasker,LTR,794182,795222,138,0.50
ptg000934l,132850,133147,297,RepeatMasker,LTR,132809,133199,297,1.00
ptg000934l,656437,656736,299,RepeatMasker,LTR,656413,656788,299,1.00
ptg000937l,3948665,3948988,323,RepeatMasker,LTR,3948139,3948741,76,0.24
ptg000942l,2135987,2136282,295,RepeatMasker,LTR,2135792,2136334,295,1.00
ptg000942l,2585294,2585589,295,RepeatMasker,LTR,2585129,2585641,295,1.00
ptg000942l,2825696,2825991,295,RepeatMasker,LTR,2825531,2826040,295,1.00
ptg000942l,2902735,2903039,304,RepeatMasker,LTR,2899351,2904887,304,1.00
ptg000943l,508836,509116,280,RepeatMasker,LTR,507805,509129,280,1.00
ptg000947l,1195872,1196171,299,RepeatMasker,LTR,1195792,1196223,299,1.00
ptg000948l,2266551,2266878,327,RepeatMasker,LTR,2266572,2266615,44,0.13
ptg000951l,480684,480962,278,RepeatMasker,LTR,480315,481763,278,1.00
ptg000954l,959519,959831,312,RepeatMasker,LTR,958124,959695,176,0.56
ptg000957l,3942140,3942460,320,RepeatMasker,LTR,3942216,3942261,46,0.14
ptg000957l,3942140,3942460,320,RepeatMasker,LTR,3942377,3942409,33,0.10
ptg000957l,5609991,5610283,292,RepeatMasker,LTR,5609660,5613107,292,1.00
ptg000957l,7987399,7987696,297,RepeatMasker,LTR,7987244,7987748,297,1.00
ptg000957l,8068920,8069210,290,RepeatMasker,LTR,8068840,8069262,290,1.00
ptg000958l,64430,64710,280,RepeatMasker,LTR,64335,65349,280,1.00
ptg000958l,4038424,4038707,283,RepeatMasker,LTR,4038025,4044830,283,1.00
ptg000960l,825068,825397,329,RepeatMasker,LTR,824562,825246,178,0.54
ptg000960l,825068,825397,329,RepeatMasker,LTR,825142,825369,228,0.69
ptg000960l,825068,825397,329,RepeatMasker,LTR,825341,825965,57,0.17
ptg000962l,625003,625284,281,RepeatMasker,LTR,624622,625297,281,1.00
ptg000967l,1580863,1581141,278,RepeatMasker,LTR,1580979,1582237,163,0.59
ptg000967l,1580863,1581141,278,RepeatMasker,LTR,1580979,1582668,163,0.59
ptg000967l,3353390,3353680,290,RepeatMasker,LTR,3353427,3353602,176,0.61
ptg000967l,3353390,3353680,290,RepeatMasker,LTR,3353501,3353685,180,0.62
ptg000967l,4171769,4172103,334,RepeatMasker,LTR,4171274,4171920,151,0.45
ptg000968l,525122,525411,289,RepeatMasker,LTR,524920,525463,289,1.00
ptg000975l,403477,403769,292,RepeatMasker,LTR,403107,404560,292,1.00
ptg000977l,3235791,3236090,299,RepeatMasker,LTR,3235626,3236142,299,1.00
ptg000980l,1796598,1796886,288,RepeatMasker,LTR,1796714,1796862,149,0.52
ptg000981l,1357177,1357464,287,RepeatMasker,LTR,1352583,1358325,287,1.00
ptg000986l,2256130,2256430,300,RepeatMasker,LTR,2256318,2256438,113,0.38
ptg000988l,1148352,1148660,308,RepeatMasker,LTR,1148653,1148860,8,0.03
ptg000988l,1769331,1769630,299,RepeatMasker,LTR,1768885,1769440,109,0.36
ptg000991l,203026,203313,287,RepeatMasker,LTR,201494,204171,287,1.00
ptg000991l,508592,508918,326,RepeatMasker,LTR,506224,508796,204,0.63
ptg000991l,508592,508918,326,RepeatMasker,LTR,506991,508793,201,0.62
ptg000993l,380255,380582,327,RepeatMasker,LTR,380331,380505,175,0.54
ptg000994l,236367,236679,312,RepeatMasker,LTR,236520,236696,160,0.51
ptg000996l,1556438,1556738,300,RepeatMasker,LTR,1556351,1556548,110,0.37
ptg000996l,1556438,1556738,300,RepeatMasker,LTR,1556398,1556692,254,0.85
ptg000996l,4022121,4022411,290,RepeatMasker,LTR,4021610,4023128,290,1.00
ptg001001l,1462355,1462650,295,RepeatMasker,LTR,1461333,1462561,206,0.70
ptg001001l,1928624,1928923,299,RepeatMasker,LTR,1928446,1928956,299,1.00
ptg001004l,979308,979606,298,RepeatMasker,LTR,979126,979658,298,1.00
ptg001006l,505411,505731,320,RepeatMasker,LTR,505681,506029,51,0.16
ptg001007l,2248196,2248512,316,RepeatMasker,LTR,2247313,2248232,36,0.11
ptg001013l,555380,555695,315,RepeatMasker,LTR,555528,556819,168,0.53
ptg001016l,753107,753416,309,RepeatMasker,LTR,750125,753717,309,1.00
ptg001017l,714916,715211,295,RepeatMasker,LTR,714855,714939,23,0.08
ptg001019l,456596,456895,299,RepeatMasker,LTR,456576,456929,299,1.00
ptg001019l,2089436,2089735,299,RepeatMasker,LTR,2089258,2089787,299,1.00
ptg001024l,443233,443542,309,RepeatMasker,LTR,443234,443280,47,0.15
ptg001026l,1707639,1707974,335,RepeatMasker,LTR,1707605,1707847,208,0.62
ptg001026l,1707639,1707974,335,RepeatMasker,LTR,1707844,1707890,47,0.14
ptg001027l,862482,862780,298,RepeatMasker,LTR,862424,862580,98,0.33
ptg001027l,1939694,1939970,276,RepeatMasker,LTR,1939670,1939717,23,0.08
ptg001030l,1054222,1054521,299,RepeatMasker,LTR,1054202,1054555,299,1.00
ptg001030l,2492581,2492895,314,RepeatMasker,LTR,2492729,2493021,167,0.53
ptg001031l,3055862,3056148,286,RepeatMasker,LTR,3055146,3056673,286,1.00
ptg001033l,1769641,1769919,278,RepeatMasker,LTR,1768502,1770558,278,1.00
ptg001033l,2208022,2208344,322,RepeatMasker,LTR,2208035,2210616,310,0.96
ptg001040l,1916894,1917208,314,RepeatMasker,LTR,1917180,1919814,29,0.09
ptg001040l,1916894,1917208,314,RepeatMasker,LTR,1916418,1916972,78,0.25
ptg001044l,473192,473478,286,RepeatMasker,LTR,470432,477386,286,1.00
ptg001050l,106659,106940,281,RepeatMasker,LTR,106277,106973,281,1.00
ptg001056l,1434865,1435177,312,RepeatMasker,LTR,1432958,1435459,312,1.00
ptg001064l,347013,347305,292,RepeatMasker,LTR,346679,350131,292,1.00
ptg001064l,443054,443334,280,RepeatMasker,LTR,442672,443367,280,1.00
ptg001070l,758181,758460,279,RepeatMasker,LTR,757117,759244,279,1.00
ptg001070l,1049667,1049947,280,RepeatMasker,LTR,1049285,1050728,280,1.00
ptg001077l,4193440,4193757,317,RepeatMasker,LTR,4193360,4193809,317,1.00
ptg001077l,7030933,7031220,287,RepeatMasker,LTR,7026287,7031821,287,1.00
ptg001084l,1360812,1361107,295,RepeatMasker,LTR,1360604,1361159,295,1.00
ptg001091l,656155,656461,306,RepeatMasker,LTR,656324,656704,138,0.45
ptg001091l,1832293,1832573,280,RepeatMasker,LTR,1831912,1833222,280,1.00
ptg001093l,1944642,1944941,299,RepeatMasker,LTR,1944464,1944993,299,1.00
ptg001093l,5782989,5783316,327,RepeatMasker,LTR,5782431,5783044,55,0.17
ptg001093l,6455481,6455742,261,RepeatMasker,LTR,6455666,6455713,48,0.18
ptg001094l,441952,442265,313,RepeatMasker,LTR,441362,442258,306,0.98
ptg001094l,840630,840918,288,RepeatMasker,LTR,840896,840943,23,0.08
ptg001094l,1886940,1887221,281,RepeatMasker,LTR,1885781,1887858,281,1.00
ptg001097l,1923284,1923565,281,RepeatMasker,LTR,1921910,1924006,281,1.00
ptg001099l,464886,465166,280,RepeatMasker,LTR,463837,465179,280,1.00
ptg001099l,899746,900038,292,RepeatMasker,LTR,899851,905244,188,0.64
ptg001101l,69494,69783,289,RepeatMasker,LTR,69293,69835,289,1.00
ptg001102l,2500371,2500664,293,RepeatMasker,LTR,2500162,2500716,293,1.00
ptg001102l,2558095,2558388,293,RepeatMasker,LTR,2558054,2558440,293,1.00
ptg001102l,3076549,3076844,295,RepeatMasker,LTR,3076341,3076896,295,1.00
ptg001102l,3123973,3124269,296,RepeatMasker,LTR,3123893,3124321,296,1.00
ptg001102l,3548400,3548697,297,RepeatMasker,LTR,3548320,3548749,297,1.00
ptg001102l,4214005,4214302,297,RepeatMasker,LTR,4213964,4214354,297,1.00
ptg001103l,1822685,1822982,297,RepeatMasker,LTR,1822664,1822708,23,0.08
ptg001105l,69269,69566,297,RepeatMasker,LTR,69061,69618,297,1.00
ptg001109l,220798,221119,321,RepeatMasker,LTR,220512,221455,321,1.00
ptg001110l,1629244,1629537,293,RepeatMasker,LTR,1626838,1631571,293,1.00
ptg001118l,536056,536346,290,RepeatMasker,LTR,536118,536182,65,0.22
ptg001118l,1946012,1946292,280,RepeatMasker,LTR,1944963,1946315,280,1.00
ptg001118l,1953220,1953500,280,RepeatMasker,LTR,1952085,1953523,280,1.00
ptg001124l,614515,614763,248,RepeatMasker,LTR,610352,619812,248,1.00
ptg001124l,966478,966767,289,RepeatMasker,LTR,966378,967017,289,1.00
ptg001124l,966478,966767,289,RepeatMasker,LTR,966381,966717,239,0.83
ptg001128l,52157,52440,283,RepeatMasker,LTR,50182,52861,283,1.00
ptg001134l,856342,856622,280,RepeatMasker,LTR,855960,857401,280,1.00
ptg001134l,1509327,1509607,280,RepeatMasker,LTR,1508932,1510236,280,1.00
ptg001135l,450017,450328,311,RepeatMasker,LTR,447337,450038,21,0.07
ptg001138l,1508426,1508710,284,RepeatMasker,LTR,1508480,1509358,231,0.81
ptg001142l,279522,279835,313,RepeatMasker,LTR,279528,279595,68,0.22
ptg001142l,279522,279835,313,RepeatMasker,LTR,279596,281993,240,0.77
ptg001142l,279522,279835,313,RepeatMasker,LTR,275854,279528,6,0.02
ptg001143l,621992,622289,297,RepeatMasker,LTR,621815,622341,297,1.00
ptg001143l,1434695,1434983,288,RepeatMasker,LTR,1432002,1436686,288,1.00
ptg001145l,741921,742250,329,RepeatMasker,LTR,740041,744776,329,1.00
ptg001146l,1342800,1343122,322,RepeatMasker,LTR,1341969,1343235,322,1.00
ptg001146l,1342800,1343122,322,RepeatMasker,LTR,1342131,1343238,322,1.00
ptg001155l,1068714,1068992,278,RepeatMasker,LTR,1068375,1068808,94,0.34
ptg001155l,1068714,1068992,278,RepeatMasker,LTR,1068421,1068819,105,0.38
ptg001157l,625930,626250,320,RepeatMasker,LTR,626200,629411,51,0.16
ptg001161l,3376724,3377011,287,RepeatMasker,LTR,3376930,3377084,82,0.29
ptg001161l,10881429,10881739,310,RepeatMasker,LTR,10881603,10881706,104,0.34
ptg001166l,3547440,3547720,280,RepeatMasker,LTR,3547057,3548515,280,1.00
ptg001170l,691383,691682,299,RepeatMasker,LTR,691303,691734,299,1.00
ptg001171l,1583245,1583528,283,RepeatMasker,LTR,1583353,1584672,176,0.62
ptg001175l,2272029,2272324,295,RepeatMasker,LTR,2271949,2272376,295,1.00
ptg001181l,774277,774557,280,RepeatMasker,LTR,773154,775197,280,1.00
ptg001182l,537666,537946,280,RepeatMasker,LTR,537273,537978,280,1.00
ptg001182l,581131,581440,309,RepeatMasker,LTR,580744,581452,309,1.00
ptg001188l,376514,376797,283,RepeatMasker,LTR,376762,377762,36,0.13
ptg001189l,958554,958842,288,RepeatMasker,LTR,958077,958664,110,0.38
ptg001190l,631009,631308,299,RepeatMasker,LTR,630814,631360,299,1.00
ptg001190l,2497930,2498226,296,RepeatMasker,LTR,2497641,2498144,214,0.72
ptg001193l,979502,979818,316,RepeatMasker,LTR,978327,979606,104,0.33
ptg001193l,4226673,4226979,306,RepeatMasker,LTR,4226603,4228138,306,1.00
ptg001193l,4226673,4226979,306,RepeatMasker,LTR,4226897,4227675,83,0.27
ptg001196l,747873,748182,309,RepeatMasker,LTR,747094,748440,309,1.00
ptg001204l,548978,549259,281,RepeatMasker,LTR,548576,549904,281,1.00
ptg001204l,1433320,1433600,280,RepeatMasker,LTR,1432938,1434390,280,1.00
ptg001208l,488797,489075,278,RepeatMasker,LTR,488415,489870,278,1.00
ptg001208l,496673,496954,281,RepeatMasker,LTR,496291,496967,281,1.00
ptg001208l,1455391,1455657,266,RepeatMasker,LTR,1455645,1455693,13,0.05
ptg001208l,1455391,1455657,266,RepeatMasker,LTR,1455651,1455873,7,0.03
ptg001208l,2273650,2273921,271,RepeatMasker,LTR,2273707,2274061,215,0.79
ptg001208l,4054374,4054663,289,RepeatMasker,LTR,4051000,4054510,136,0.47
ptg001208l,4054374,4054663,289,RepeatMasker,LTR,4052511,4054593,219,0.76
ptg001208l,5238104,5238385,281,RepeatMasker,LTR,5237058,5239024,281,1.00
ptg001210l,190438,190724,286,RepeatMasker,LTR,190039,193556,286,1.00
ptg001215l,2878616,2878944,328,RepeatMasker,LTR,2878653,2883249,292,0.89
ptg001215l,4321798,4322079,281,RepeatMasker,LTR,4321409,4322722,281,1.00
ptg001215l,4632445,4632738,293,RepeatMasker,LTR,4632385,4633372,293,1.00
ptg001218l,4750454,4750755,301,RepeatMasker,LTR,4750278,4750807,301,1.00
ptg001218l,4885762,4886061,299,RepeatMasker,LTR,4885721,4886113,299,1.00
ptg001221l,481344,481643,299,RepeatMasker,LTR,480965,483443,299,1.00
ptg001226l,716108,716396,288,RepeatMasker,LTR,714432,716361,253,0.88
ptg001229l,718388,718687,299,RepeatMasker,LTR,718210,718739,299,1.00
ptg001232l,7914017,7914304,287,RepeatMasker,LTR,7909409,7915156,287,1.00
ptg001241l,1518969,1519250,281,RepeatMasker,LTR,1517915,1519263,281,1.00
ptg001241l,1539451,1539768,317,RepeatMasker,LTR,1539680,1539799,89,0.28
ptg001243l,261276,261559,283,RepeatMasker,LTR,259656,262174,283,1.00
ptg001245l,1517522,1517816,294,RepeatMasker,LTR,1517145,1517828,294,1.00
ptg001247l,1350000,1350282,282,RepeatMasker,LTR,1348196,1351058,282,1.00
ptg001248l,3834000,3834285,285,RepeatMasker,LTR,3833211,3835137,285,1.00
ptg001248l,5837223,5837522,299,RepeatMasker,LTR,5836463,5837896,299,1.00
ptg001248l,7914823,7915103,280,RepeatMasker,LTR,7914435,7915740,280,1.00
ptg001252l,273006,273287,281,RepeatMasker,LTR,272618,273320,281,1.00
ptg001260l,1340281,1340556,275,RepeatMasker,LTR,1340221,1340357,76,0.28
ptg001261l,1421467,1421758,291,RepeatMasker,LTR,1421743,1424994,16,0.05
ptg001261l,5642551,5642853,302,RepeatMasker,LTR,5642234,5643450,302,1.00
ptg001273l,542164,542496,332,RepeatMasker,LTR,542447,543107,50,0.15
ptg001278l,867492,867779,287,RepeatMasker,LTR,867143,868638,287,1.00
ptg001286l,58135,58417,282,RepeatMasker,LTR,56984,58430,282,1.00
ptg001288l,654118,654405,287,RepeatMasker,LTR,654384,654531,22,0.08
ptg001290l,2566437,2566767,330,RepeatMasker,LTR,2566566,2566936,202,0.61
ptg001291l,166081,166361,280,RepeatMasker,LTR,165699,166994,280,1.00
ptg001293l,3129106,3129404,298,RepeatMasker,LTR,3128741,3130048,298,1.00
ptg001293l,5217198,5217479,281,RepeatMasker,LTR,5217357,5217411,55,0.20
ptg001293l,5246734,5247036,302,RepeatMasker,LTR,5246391,5247301,302,1.00
ptg001295l,1767224,1767523,299,RepeatMasker,LTR,1767016,1767575,299,1.00
ptg001295l,2160579,2160860,281,RepeatMasker,LTR,2160193,2161506,281,1.00
ptg001298l,748695,748997,302,RepeatMasker,LTR,748517,749049,302,1.00
ptg001301l,424637,424933,296,RepeatMasker,LTR,424459,424985,296,1.00
ptg001305l,3472965,3473245,280,RepeatMasker,LTR,3472882,3475643,280,1.00
ptg001305l,5412079,5412371,292,RepeatMasker,LTR,5411737,5415203,292,1.00
ptg001309l,1959389,1959716,327,RepeatMasker,LTR,1958933,1959495,106,0.32
ptg001309l,1959389,1959716,327,RepeatMasker,LTR,1959688,1963314,29,0.09
ptg001312l,1115752,1116032,280,RepeatMasker,LTR,1115370,1116044,280,1.00
ptg001314l,1369466,1369788,322,RepeatMasker,LTR,1369693,1369764,72,0.22
ptg001314l,1453879,1454160,281,RepeatMasker,LTR,1453492,1454180,281,1.00
ptg001317l,409937,410244,307,RepeatMasker,LTR,408098,410345,307,1.00
ptg001317l,729111,729399,288,RepeatMasker,LTR,726322,729549,288,1.00
ptg001323l,3172133,3172453,320,RepeatMasker,LTR,3172403,3177976,51,0.16
ptg001328l,2822828,2823161,333,RepeatMasker,LTR,2822999,2823487,163,0.49
ptg001332l,1051033,1051348,315,RepeatMasker,LTR,1049634,1051194,161,0.51
ptg001332l,1051033,1051348,315,RepeatMasker,LTR,1051187,1053931,162,0.51
ptg001335l,694569,694894,325,RepeatMasker,LTR,694707,694965,188,0.58
ptg001335l,832804,833133,329,RepeatMasker,LTR,832597,833410,329,1.00
ptg001336l,1082198,1082488,290,RepeatMasker,LTR,1082157,1082534,290,1.00
ptg001349l,1123974,1124255,281,RepeatMasker,LTR,1123589,1124288,281,1.00
ptg001350l,3440987,3441267,280,RepeatMasker,LTR,3439949,3441280,280,1.00
ptg001352l,1866532,1866825,293,RepeatMasker,LTR,1866775,1871411,51,0.17
ptg001352l,2584595,2584885,290,RepeatMasker,LTR,2583001,2585174,290,1.00
ptg001354l,255580,255886,306,RepeatMasker,LTR,255037,256351,306,1.00
ptg001354l,255580,255886,306,RepeatMasker,LTR,255545,256756,306,1.00
ptg001358l,3969231,3969548,317,RepeatMasker,LTR,3967322,3969282,51,0.16
ptg001359l,627929,628210,281,RepeatMasker,LTR,626887,628223,281,1.00
ptg001359l,957005,957285,280,RepeatMasker,LTR,956989,957300,280,1.00
ptg001362l,897344,897624,280,RepeatMasker,LTR,897303,897637,280,1.00
ptg001362l,904503,904783,280,RepeatMasker,LTR,904107,904796,280,1.00
ptg001366l,385278,385578,300,RepeatMasker,LTR,384936,388399,300,1.00
ptg001369l,5919752,5920053,301,RepeatMasker,LTR,5919962,5921611,92,0.31
ptg001369l,5919752,5920053,301,RepeatMasker,LTR,5919972,5921304,82,0.27
ptg001370l,2009730,2010045,315,RepeatMasker,LTR,2009337,2009772,42,0.13
ptg001370l,2009730,2010045,315,RepeatMasker,LTR,2009770,2011422,276,0.88
ptg001371l,1177777,1178067,290,RepeatMasker,LTR,1177262,1178632,290,1.00
ptg001371l,4044610,4044933,323,RepeatMasker,LTR,4044650,4044820,171,0.53
ptg001371l,9048999,9049298,299,RepeatMasker,LTR,9048818,9049331,299,1.00
ptg001371l,11776904,11777204,300,RepeatMasker,LTR,11776359,11778961,300,1.00
ptg001372l,1392499,1392813,314,RepeatMasker,LTR,1392024,1392714,215,0.68
ptg001372l,1392499,1392813,314,RepeatMasker,LTR,1392590,1392817,224,0.71
ptg001373l,1313636,1313914,278,RepeatMasker,LTR,1313709,1314369,206,0.74
ptg001374l,1417646,1417944,298,RepeatMasker,LTR,1416906,1418055,298,1.00
ptg001387l,5792583,5792882,299,RepeatMasker,LTR,5792405,5792934,299,1.00
ptg001390l,4975168,4975472,304,RepeatMasker,LTR,4975472,4976549,1,0.00
ptg001391l,2696360,2696654,294,RepeatMasker,LTR,2696028,2699228,294,1.00
ptg001398l,2078127,2078445,318,RepeatMasker,LTR,2078302,2078413,112,0.35
ptg001417l,1607570,1607882,312,RepeatMasker,LTR,1607437,1607639,69,0.22
ptg001420l,1138754,1139056,302,RepeatMasker,LTR,1138924,1140314,133,0.44
ptg001424l,111781,112062,281,RepeatMasker,LTR,111480,112095,281,1.00
ptg001424l,3728216,3728497,281,RepeatMasker,LTR,3727171,3729287,281,1.00
ptg001426l,2651025,2651334,309,RepeatMasker,LTR,2651297,2655427,38,0.12
ptg001435l,13627,13924,297,RepeatMasker,LTR,13264,14569,297,1.00
ptg001435l,510706,510958,252,RepeatMasker,LTR,506504,516626,252,1.00
ptg001438l,791899,792208,309,RepeatMasker,LTR,791818,792640,309,1.00
ptg001439l,2017398,2017697,299,RepeatMasker,LTR,2017426,2017749,272,0.91
ptg001444l,3235415,3235710,295,RepeatMasker,LTR,3235440,3235656,217,0.74
ptg001449l,2270284,2270586,302,RepeatMasker,LTR,2269768,2270921,302,1.00
ptg001451l,258055,258358,303,RepeatMasker,LTR,257407,258705,303,1.00
ptg001460l,1000702,1001003,301,RepeatMasker,LTR,1000950,1000986,37,0.12
ptg001464l,2144965,2145256,291,RepeatMasker,LTR,2145207,2146972,50,0.17
ptg001468l,318325,318605,280,RepeatMasker,LTR,318004,318617,280,1.00
ptg001473l,1140067,1140345,278,RepeatMasker,LTR,1139322,1140250,183,0.66
ptg001475l,465176,465506,330,RepeatMasker,LTR,465071,466054,330,1.00
ptg001480l,350344,350640,296,RepeatMasker,LTR,350002,353223,296,1.00
ptg001480l,2810263,2810562,299,RepeatMasker,LTR,2810085,2810614,299,1.00
ptg001480l,3311938,3312236,298,RepeatMasker,LTR,3311897,3312288,298,1.00
ptg001480l,4078610,4078893,283,RepeatMasker,LTR,4077456,4079535,283,1.00
ptg001483l,1400667,1400989,322,RepeatMasker,LTR,1400249,1400683,16,0.05
ptg001483l,1416159,1416444,285,RepeatMasker,LTR,1416132,1416182,23,0.08
ptg001484l,167247,167560,313,RepeatMasker,LTR,166797,167298,51,0.16
ptg001491l,836525,836808,283,RepeatMasker,LTR,833740,837429,283,1.00
ptg001499l,1111125,1111418,293,RepeatMasker,LTR,1110391,1111892,293,1.00
ptg001499l,1111125,1111424,299,RepeatMasker,LTR,1110391,1111892,299,1.00
ptg001500l,101940,102242,302,RepeatMasker,LTR,101198,103131,302,1.00
ptg001500l,101940,102242,302,RepeatMasker,LTR,102110,103137,133,0.44
ptg001502l,3270002,3270310,308,RepeatMasker,LTR,3268111,3270050,48,0.16
ptg001505l,9126880,9127178,298,RepeatMasker,LTR,9126801,9127230,298,1.00
ptg001505l,9615721,9616041,320,RepeatMasker,LTR,9611761,9616052,320,1.00
ptg001509l,945201,945500,299,RepeatMasker,LTR,945121,945552,299,1.00
ptg001509l,5779280,5779608,328,RepeatMasker,LTR,5779462,5779680,147,0.45
ptg001516l,1203574,1203867,293,RepeatMasker,LTR,1203494,1203919,293,1.00
ptg001516l,2211803,2212099,296,RepeatMasker,LTR,2211622,2212151,296,1.00
ptg001516l,2456576,2456860,284,RepeatMasker,LTR,2456173,2456785,209,0.74
ptg001522l,216699,217017,318,RepeatMasker,LTR,216905,218293,113,0.36
ptg001522l,927882,928162,280,RepeatMasker,LTR,924618,928515,280,1.00
ptg001531l,5255055,5255357,302,RepeatMasker,LTR,5255127,5255259,133,0.44
ptg001536l,90125,90441,316,RepeatMasker,LTR,90380,90452,62,0.20
ptg001536l,90125,90441,316,RepeatMasker,LTR,90416,90466,26,0.08
ptg001551l,3446102,3446399,297,RepeatMasker,LTR,3445199,3446148,46,0.15
ptg001552l,1303064,1303377,313,RepeatMasker,LTR,1303166,1304601,212,0.68
ptg001555l,213211,213492,281,RepeatMasker,LTR,212829,214297,281,1.00
ptg001560l,60841,61159,318,RepeatMasker,LTR,60875,61182,285,0.90
ptg001560l,143390,143689,299,RepeatMasker,LTR,143212,143741,299,1.00
ptg001560l,257438,257733,295,RepeatMasker,LTR,257266,257785,295,1.00
ptg001560l,414434,414733,299,RepeatMasker,LTR,414354,414785,299,1.00
ptg001560l,1158090,1158399,309,RepeatMasker,LTR,1156073,1158314,224,0.72
ptg001567l,902716,903023,307,RepeatMasker,LTR,902861,903359,163,0.53
ptg001574l,456307,456618,311,RepeatMasker,LTR,455297,456465,158,0.51
ptg001574l,456307,456618,311,RepeatMasker,LTR,456472,457657,147,0.47
ptg001577l,4600065,4600363,298,RepeatMasker,LTR,4599910,4600415,298,1.00
ptg001577l,4783843,4784143,300,RepeatMasker,LTR,4783631,4784195,300,1.00
ptg001577l,6282559,6282871,312,RepeatMasker,LTR,6281812,6282665,106,0.34
ptg001577l,6282559,6282871,312,RepeatMasker,LTR,6282661,6282988,211,0.68
ptg001578l,1931542,1931828,286,RepeatMasker,LTR,1929978,1932683,286,1.00
ptg001578l,2060437,2060755,318,RepeatMasker,LTR,2060506,2060806,250,0.79
ptg001578l,2060437,2060755,318,RepeatMasker,LTR,2060622,2060985,134,0.42
ptg001578l,4391608,4391906,298,RepeatMasker,LTR,4390850,4392900,298,1.00
ptg001579l,1469043,1469342,299,RepeatMasker,LTR,1468835,1469394,299,1.00
ptg001583l,1398868,1399148,280,RepeatMasker,LTR,1397733,1399161,280,1.00
ptg001585l,1221115,1221403,288,RepeatMasker,LTR,1220343,1221340,225,0.78
ptg001585l,5929390,5929686,296,RepeatMasker,LTR,5929650,5933050,37,0.13
ptg001589l,2663333,2663615,282,RepeatMasker,LTR,2663513,2663647,103,0.37
ptg001589l,3443708,3444021,313,RepeatMasker,LTR,3443859,3444357,163,0.52
ptg001593l,745576,745914,338,RepeatMasker,LTR,745831,746301,84,0.25
ptg001599l,1918772,1919055,283,RepeatMasker,LTR,1918278,1920371,283,1.00
ptg001600l,9728,10038,310,RepeatMasker,LTR,9592,9803,75,0.24
ptg001600l,9728,10038,310,RepeatMasker,LTR,9812,10090,227,0.73
ptg001600l,278336,278632,296,RepeatMasker,LTR,278179,278684,296,1.00
ptg001600l,403861,404163,302,RepeatMasker,LTR,403934,404746,230,0.76
ptg001605l,367807,368129,322,RepeatMasker,LTR,368058,368659,72,0.22
ptg001606l,615198,615492,294,RepeatMasker,LTR,615008,618856,294,1.00
ptg001606l,615198,615492,294,RepeatMasker,LTR,615013,618053,294,1.00
ptg001612l,281,582,301,RepeatMasker,LTR,418,1708,165,0.55
ptg001613l,399849,400161,312,RepeatMasker,LTR,395279,401024,312,1.00
ptg001614l,301526,301806,280,RepeatMasker,LTR,300485,301818,280,1.00
ptg001621l,895418,895690,272,RepeatMasker,LTR,895530,895596,67,0.25
ptg001621l,895418,895690,272,RepeatMasker,LTR,895530,895607,78,0.29
ptg001621l,3254002,3254312,310,RepeatMasker,LTR,3254033,3254678,280,0.90
ptg001621l,5278287,5278581,294,RepeatMasker,LTR,5278206,5278950,294,1.00
ptg001622l,717291,717579,288,RepeatMasker,LTR,717416,717528,113,0.39
ptg001622l,1047101,1047382,281,RepeatMasker,LTR,1046049,1047411,281,1.00
ptg001622l,1054237,1054563,326,RepeatMasker,LTR,1053111,1054239,2,0.01
ptg001622l,1054237,1054563,326,RepeatMasker,LTR,1053247,1054591,326,1.00
ptg001622l,2087725,2088011,286,RepeatMasker,LTR,2087202,2088864,286,1.00
ptg001627l,998351,998633,282,RepeatMasker,LTR,998330,998374,23,0.08
ptg001627l,1971267,1971570,303,RepeatMasker,LTR,1968286,1973282,303,1.00
ptg001627l,3361683,3361983,300,RepeatMasker,LTR,3361471,3362035,300,1.00
ptg001628l,1756664,1756946,282,RepeatMasker,LTR,1756162,1756670,6,0.02
ptg001630l,421584,421883,299,RepeatMasker,LTR,421376,421935,299,1.00
ptg001630l,1210603,1210891,288,RepeatMasker,LTR,1209724,1211021,288,1.00
ptg001631l,7164846,7165132,286,RepeatMasker,LTR,7165041,7165180,92,0.32
ptg001631l,7247608,7247901,293,RepeatMasker,LTR,7247667,7248054,235,0.80
ptg001631l,8011833,8012113,280,RepeatMasker,LTR,8011766,8012125,280,1.00
ptg001642l,2075330,2075629,299,RepeatMasker,LTR,2075179,2075681,299,1.00
ptg001645l,473704,473986,282,RepeatMasker,LTR,473282,474628,282,1.00
ptg001651l,339361,339675,314,RepeatMasker,LTR,339320,340052,314,1.00
ptg001658l,3763263,3763564,301,RepeatMasker,LTR,3763362,3763432,71,0.24
ptg001659l,1358033,1358332,299,RepeatMasker,LTR,1357857,1358384,299,1.00
ptg001660l,5723528,5723827,299,RepeatMasker,LTR,5723350,5723879,299,1.00
ptg001661l,4354776,4355081,305,RepeatMasker,LTR,4354976,4355335,106,0.35
ptg001663l,6211688,6211987,299,RepeatMasker,LTR,6211510,6212033,299,1.00
ptg001663l,7064323,7064606,283,RepeatMasker,LTR,7063828,7064347,24,0.08
ptg001663l,7064323,7064606,283,RepeatMasker,LTR,7064327,7064361,35,0.12
ptg001663l,7064323,7064606,283,RepeatMasker,LTR,7064352,7066511,255,0.90
ptg001663l,9016394,9016720,326,RepeatMasker,LTR,9016613,9017139,108,0.33
ptg001663l,10383978,10384282,304,RepeatMasker,LTR,10383548,10384076,98,0.32
ptg001666l,5418007,5418306,299,RepeatMasker,LTR,5417799,5418358,299,1.00
ptg001666l,10286641,10286956,315,RepeatMasker,LTR,10286668,10288056,289,0.92
ptg001669l,1009255,1009536,281,RepeatMasker,LTR,1008223,1010148,281,1.00
ptg001671l,941615,941909,294,RepeatMasker,LTR,938614,944415,294,1.00
ptg001671l,5704077,5704380,303,RepeatMasker,LTR,5702048,5704930,303,1.00
ptg001672l,108491,108789,298,RepeatMasker,LTR,108279,108841,298,1.00
ptg001672l,4462974,4463269,295,RepeatMasker,LTR,4462797,4463321,295,1.00
ptg001672l,4521957,4522247,290,RepeatMasker,LTR,4521762,4522299,290,1.00
ptg001672l,4836719,4837018,299,RepeatMasker,LTR,4836544,4837070,299,1.00
ptg001677l,1030263,1030583,320,RepeatMasker,LTR,1030572,1030794,12,0.04
ptg001681l,3969342,3969643,301,RepeatMasker,LTR,3968379,3969904,301,1.00
ptg001684l,1641070,1641385,315,RepeatMasker,LTR,1641197,1641311,115,0.37
ptg001685l,506504,506798,294,RepeatMasker,LTR,506501,506607,103,0.35
ptg001685l,2302155,2302435,280,RepeatMasker,LTR,2302139,2303069,280,1.00
ptg001692l,305034,305335,301,RepeatMasker,LTR,304647,305986,301,1.00
ptg001695l,2000196,2000511,315,RepeatMasker,LTR,2000188,2000437,241,0.77
ptg001695l,2000196,2000511,315,RepeatMasker,LTR,2000438,2001841,74,0.23
ptg001701l,812864,813171,307,RepeatMasker,LTR,813049,813813,123,0.40
ptg001701l,4302571,4302896,325,RepeatMasker,LTR,4302868,4303012,29,0.09
ptg001702l,6570216,6570514,298,RepeatMasker,LTR,6569027,6571906,298,1.00
ptg001704l,1593511,1593825,314,RepeatMasker,LTR,1593795,1594743,31,0.10
ptg001704l,2635933,2636252,319,RepeatMasker,LTR,2636202,2637032,51,0.16
ptg001704l,3507280,3507560,280,RepeatMasker,LTR,3506215,3507573,280,1.00
ptg001704l,5894411,5894716,305,RepeatMasker,LTR,5894596,5895278,121,0.40
ptg001705l,562665,562968,303,RepeatMasker,LTR,560270,565355,303,1.00
ptg001708l,4013440,4013687,247,RepeatMasker,LTR,4009228,4018745,247,1.00
ptg001711l,2607924,2608204,280,RepeatMasker,LTR,2607607,2608238,280,1.00
ptg001711l,4087831,4088134,303,RepeatMasker,LTR,4087505,4088167,303,1.00
ptg001714l,699980,700275,295,RepeatMasker,LTR,699900,700327,295,1.00
ptg001720l,1872578,1872889,311,RepeatMasker,LTR,1872830,1873379,60,0.19
ptg001724l,1815020,1815313,293,RepeatMasker,LTR,1814842,1815365,293,1.00
ptg001732l,1007248,1007519,271,RepeatMasker,LTR,1007234,1007621,271,1.00
ptg001733l,1177938,1178223,285,RepeatMasker,LTR,1177754,1178467,285,1.00
ptg001734l,937662,937967,305,RepeatMasker,LTR,937697,937766,70,0.23
ptg001735l,336119,336418,299,RepeatMasker,LTR,336039,336470,299,1.00
ptg001735l,1534835,1535127,292,RepeatMasker,LTR,1534469,1537958,292,1.00
ptg001740l,687888,688136,248,RepeatMasker,LTR,685601,693192,248,1.00
ptg001741l,746762,747085,323,RepeatMasker,LTR,747079,747307,7,0.02
ptg001741l,1659163,1659445,282,RepeatMasker,LTR,1659260,1661116,186,0.66
ptg001741l,1700432,1700744,312,RepeatMasker,LTR,1699483,1700810,312,1.00
ptg001742l,2098180,2098494,314,RepeatMasker,LTR,2098316,2098413,98,0.31
ptg001745l,673414,673691,277,RepeatMasker,LTR,673022,674339,277,1.00
ptg001746l,3850259,3850545,286,RepeatMasker,LTR,3850064,3850372,113,0.40
ptg001749l,603629,603910,281,RepeatMasker,LTR,603128,606532,281,1.00
ptg001760l,267580,267897,317,RepeatMasker,LTR,267655,267760,106,0.33
ptg001762l,5087441,5087720,279,RepeatMasker,LTR,5087059,5088514,279,1.00
ptg001771l,1687675,1687987,312,RepeatMasker,LTR,1686790,1687876,201,0.64
ptg001773l,766545,766870,325,RepeatMasker,LTR,766754,767095,117,0.36
ptg001773l,766545,766870,325,RepeatMasker,LTR,766781,766974,90,0.28
ptg001773l,766545,766870,325,RepeatMasker,LTR,766781,767052,90,0.28
ptg001777l,293347,293673,326,RepeatMasker,LTR,292335,294259,326,1.00
ptg001779l,1007534,1007814,280,RepeatMasker,LTR,1004908,1007996,280,1.00
ptg001782l,1334435,1334721,286,RepeatMasker,LTR,1334685,1336753,37,0.13
ptg001785l,1569334,1569633,299,RepeatMasker,LTR,1569071,1569376,42,0.14
ptg001786l,4422232,4422545,313,RepeatMasker,LTR,4421715,4422252,20,0.06
ptg001786l,5562540,5562850,310,RepeatMasker,LTR,5559575,5564913,310,1.00
ptg001786l,6166631,6166917,286,RepeatMasker,LTR,6161991,6167775,286,1.00
ptg001789l,203920,204200,280,RepeatMasker,LTR,203529,204838,280,1.00
ptg001789l,475010,475315,305,RepeatMasker,LTR,474015,475109,99,0.32
ptg001791l,2888671,2888985,314,RepeatMasker,LTR,2888948,2890267,38,0.12
ptg001792l,1530557,1530871,314,RepeatMasker,LTR,1530817,1530881,55,0.18
ptg001794l,302723,303007,284,RepeatMasker,LTR,302912,302952,41,0.14
ptg001809l,627448,627729,281,RepeatMasker,LTR,626311,627748,281,1.00
ptg001814l,4546804,4547118,314,RepeatMasker,LTR,4546326,4547111,307,0.98
ptg001815l,2511817,2512097,280,RepeatMasker,LTR,2510762,2512104,280,1.00
ptg001815l,4088465,4088746,281,RepeatMasker,LTR,4088081,4089392,281,1.00
ptg001815l,4218002,4218283,281,RepeatMasker,LTR,4217615,4218927,281,1.00
ptg001816l,3866876,3867174,298,RepeatMasker,LTR,3866209,3868332,298,1.00
ptg001820l,4798912,4799197,285,RepeatMasker,LTR,4797876,4799979,285,1.00
ptg001834l,1549369,1549671,302,RepeatMasker,LTR,1549161,1549723,302,1.00
ptg001834l,1894370,1894684,314,RepeatMasker,LTR,1893997,1895133,314,1.00
ptg001834l,1894370,1894684,314,RepeatMasker,LTR,1894180,1895143,314,1.00
ptg001834l,2105537,2105860,323,RepeatMasker,LTR,2104585,2106351,323,1.00
ptg001836l,3024844,3025138,294,RepeatMasker,LTR,3025116,3025334,23,0.08
ptg001837l,435653,435975,322,RepeatMasker,LTR,435601,436402,322,1.00
ptg001837l,684326,684606,280,RepeatMasker,LTR,684305,684349,23,0.08
ptg001840l,587552,587852,300,RepeatMasker,LTR,587357,587904,300,1.00
ptg001842l,4935758,4936006,248,RepeatMasker,LTR,4931566,4941057,248,1.00
ptg001850l,200340,200629,289,RepeatMasker,LTR,200430,200468,39,0.13
ptg001858l,1431918,1432198,280,RepeatMasker,LTR,1431609,1432601,280,1.00
ptg001862l,374542,374841,299,RepeatMasker,LTR,374501,374893,299,1.00
ptg001863l,3358052,3358349,297,RepeatMasker,LTR,3358199,3358879,151,0.51
ptg001863l,3879370,3879701,331,RepeatMasker,LTR,3879374,3879752,328,0.99
ptg001863l,7849080,7849379,299,RepeatMasker,LTR,7849104,7849524,276,0.92
ptg001867l,1240229,1240531,302,RepeatMasker,LTR,1240308,1240593,224,0.74
ptg001867l,2185029,2185276,247,RepeatMasker,LTR,2185044,2185104,61,0.25
ptg001867l,2185029,2185276,247,RepeatMasker,LTR,2185055,2185173,119,0.48
ptg001867l,2684797,2685086,289,RepeatMasker,LTR,2679181,2684845,48,0.17
ptg001867l,2684797,2685086,289,RepeatMasker,LTR,2682242,2685192,289,1.00
ptg001868l,1711622,1711916,294,RepeatMasker,LTR,1711457,1711950,294,1.00
ptg001869l,627531,627828,297,RepeatMasker,LTR,622312,628122,297,1.00
ptg001872l,1166629,1166954,325,RepeatMasker,LTR,1166792,1174231,163,0.50
ptg001875l,115302,115597,295,RepeatMasker,LTR,115094,115649,295,1.00
ptg001878l,6208851,6209158,307,RepeatMasker,LTR,6208872,6209171,287,0.93
ptg001904l,1054969,1055253,284,RepeatMasker,LTR,1054589,1056054,284,1.00
ptg001906l,1342569,1342877,308,RepeatMasker,LTR,1342454,1343446,308,1.00
ptg001910l,121688,121989,301,RepeatMasker,LTR,121542,121820,132,0.44
ptg001911l,1475636,1475917,281,RepeatMasker,LTR,1475262,1475930,281,1.00
ptg001918l,202934,203240,306,RepeatMasker,LTR,202618,206369,306,1.00
ptg001925l,706253,706549,296,RepeatMasker,LTR,706530,706623,20,0.07
ptg001925l,3909067,3909392,325,RepeatMasker,LTR,3905442,3909384,317,0.98
ptg001925l,3909067,3909392,325,RepeatMasker,LTR,3909386,3909600,7,0.02
ptg001925l,4083999,4084315,316,RepeatMasker,LTR,4082359,4084032,33,0.10
ptg001933l,2892824,2893111,287,RepeatMasker,LTR,2888144,2893920,287,1.00
ptg001938l,124581,124878,297,RepeatMasker,LTR,121525,124730,149,0.50
ptg001938l,124581,124878,297,RepeatMasker,LTR,124731,125175,148,0.50
ptg001938l,1525853,1526167,314,RepeatMasker,LTR,1526129,1528667,39,0.12
ptg001942l,988765,989060,295,RepeatMasker,LTR,988558,989107,295,1.00
ptg001942l,2189944,2190235,291,RepeatMasker,LTR,2187625,2190347,291,1.00
ptg001942l,2726081,2726376,295,RepeatMasker,LTR,2725907,2726428,295,1.00
ptg001943l,648640,648920,280,RepeatMasker,LTR,648258,649568,280,1.00
ptg001943l,4178585,4178902,317,RepeatMasker,LTR,4178721,4183630,182,0.57
ptg001944l,624538,624854,316,RepeatMasker,LTR,623632,624581,43,0.14
ptg001944l,624538,624854,316,RepeatMasker,LTR,624542,624588,47,0.15
ptg001946l,557796,558076,280,RepeatMasker,LTR,557415,558879,280,1.00
ptg001950l,1491873,1492170,297,RepeatMasker,LTR,1492042,1492497,129,0.43
ptg001950l,3234189,3234486,297,RepeatMasker,LTR,3234219,3234462,244,0.82
ptg001950l,3234189,3234486,297,RepeatMasker,LTR,3234462,3234511,25,0.08
ptg001954l,74225,74526,301,RepeatMasker,LTR,74380,74823,147,0.49
ptg001957l,3171625,3171899,274,RepeatMasker,LTR,3171863,3172387,37,0.14
ptg001958l,654197,654502,305,RepeatMasker,LTR,653161,655287,305,1.00
ptg001958l,1391029,1391333,304,RepeatMasker,LTR,1390888,1391466,304,1.00
ptg001958l,1574241,1574538,297,RepeatMasker,LTR,1574451,1574508,58,0.20
ptg001959l,1531757,1532056,299,RepeatMasker,LTR,1531677,1532108,299,1.00
ptg001965l,1638814,1639113,299,RepeatMasker,LTR,1638622,1639165,299,1.00
ptg001965l,7089907,7090192,285,RepeatMasker,LTR,7089264,7090633,285,1.00
ptg001969l,1960397,1960683,286,RepeatMasker,LTR,1955751,1961507,286,1.00
ptg001972l,1955525,1955825,300,RepeatMasker,LTR,1955347,1955877,300,1.00
ptg001972l,2865324,2865611,287,RepeatMasker,LTR,2865244,2865663,287,1.00
ptg001985l,5813464,5813744,280,RepeatMasker,LTR,5813086,5814513,280,1.00
ptg001993l,244044,244337,293,RepeatMasker,LTR,244024,244371,293,1.00
ptg001993l,681040,681320,280,RepeatMasker,LTR,680630,682103,280,1.00
ptg001993l,1620565,1620846,281,RepeatMasker,LTR,1620737,1620858,110,0.39
ptg001996l,946582,946920,338,RepeatMasker,LTR,946553,947476,338,1.00
ptg001999l,1149389,1149682,293,RepeatMasker,LTR,1149056,1152514,293,1.00
ptg001999l,1314391,1314681,290,RepeatMasker,LTR,1314462,1314523,62,0.21
ptg001999l,1314391,1314681,290,RepeatMasker,LTR,1314567,1314733,115,0.40
ptg002014l,2579735,2580051,316,RepeatMasker,LTR,2579550,2580133,316,1.00
ptg002017l,443443,443733,290,RepeatMasker,LTR,441951,444884,290,1.00
ptg002018l,2021580,2021908,328,RepeatMasker,LTR,2021358,2021847,267,0.81
ptg002022l,4308270,4308553,283,RepeatMasker,LTR,4307320,4311780,283,1.00
ptg002027l,766758,767075,317,RepeatMasker,LTR,766907,767218,169,0.53
ptg002029l,256857,257118,261,RepeatMasker,LTR,256956,264018,163,0.62
ptg002039l,34955,35284,329,RepeatMasker,LTR,34959,35335,326,0.99
ptg002042l,1132520,1132839,319,RepeatMasker,LTR,1132789,1136524,51,0.16
ptg002043l,6596350,6596603,253,RepeatMasker,LTR,6596334,6596389,39,0.15
ptg002047l,677751,678058,307,RepeatMasker,LTR,676603,677910,159,0.52
ptg002048l,578077,578403,326,RepeatMasker,LTR,577816,578955,326,1.00
ptg002048l,3880798,3881085,287,RepeatMasker,LTR,3876091,3880898,100,0.35
ptg002048l,3880798,3881085,287,RepeatMasker,LTR,3878899,3881937,287,1.00
ptg002048l,4220908,4221213,305,RepeatMasker,LTR,4220537,4223449,305,1.00
ptg002064l,5660014,5660318,304,RepeatMasker,LTR,5660088,5664405,231,0.76
ptg002065l,289237,289517,280,RepeatMasker,LTR,288855,290159,280,1.00
ptg002069l,855421,855723,302,RepeatMasker,LTR,855392,856707,302,1.00
ptg002072l,610408,610688,280,RepeatMasker,LTR,610026,611325,280,1.00
ptg002072l,3761736,3762026,290,RepeatMasker,LTR,3761174,3761748,12,0.04
ptg002072l,3761736,3762026,290,RepeatMasker,LTR,3761989,3767920,38,0.13
ptg002073l,2707939,2708226,287,RepeatMasker,LTR,2706372,2709088,287,1.00
ptg002075l,1888541,1888840,299,RepeatMasker,LTR,1888346,1888892,299,1.00
ptg002079l,1903483,1903786,303,RepeatMasker,LTR,1903751,1903795,36,0.12
ptg002083l,3524459,3524763,304,RepeatMasker,LTR,3524163,3525599,304,1.00
ptg002084l,820081,820378,297,RepeatMasker,LTR,819883,820430,297,1.00
ptg002085l,7578768,7579086,318,RepeatMasker,LTR,7578733,7581421,318,1.00
ptg002090l,908625,908923,298,RepeatMasker,LTR,908419,908974,298,1.00
ptg002091l,2870948,2871260,312,RepeatMasker,LTR,2871195,2871457,66,0.21
ptg002094l,1466275,1466570,295,RepeatMasker,LTR,1466097,1466622,295,1.00
ptg002100l,3639638,3639932,294,RepeatMasker,LTR,3636583,3642718,294,1.00
ptg002102l,545221,545519,298,RepeatMasker,LTR,542216,547941,298,1.00
ptg002102l,2960953,2961248,295,RepeatMasker,LTR,2960775,2961300,295,1.00
ptg002103l,2484957,2485256,299,RepeatMasker,LTR,2484834,2486128,299,1.00
ptg002113l,13813,14094,281,RepeatMasker,LTR,12676,14731,281,1.00
ptg002116l,2533521,2533826,305,RepeatMasker,LTR,2533702,2537683,125,0.41
ptg002118l,3255475,3255771,296,RepeatMasker,LTR,3255248,3255823,296,1.00
ptg002124l,175966,176258,292,RepeatMasker,LTR,175624,179091,292,1.00
ptg002125l,472738,473039,301,RepeatMasker,LTR,472822,473144,218,0.72
ptg002134l,119732,120013,281,RepeatMasker,LTR,118679,120025,281,1.00
ptg002134l,461872,462163,291,RepeatMasker,LTR,461801,463002,291,1.00
ptg002134l,2015358,2015638,280,RepeatMasker,LTR,2014212,2015651,280,1.00
ptg002134l,5068860,5069174,314,RepeatMasker,LTR,5067379,5069409,314,1.00
ptg002136l,1166495,1166782,287,RepeatMasker,LTR,1161843,1167616,287,1.00
ptg002139l,199562,199858,296,RepeatMasker,LTR,199521,199910,296,1.00
ptg002141l,3215141,3215436,295,RepeatMasker,LTR,3215031,3216220,295,1.00
ptg002141l,4369243,4369568,325,RepeatMasker,LTR,4369394,4369449,56,0.17
ptg002155l,701277,701553,276,RepeatMasker,LTR,701233,701300,23,0.08
ptg002158l,513731,514048,317,RepeatMasker,LTR,512279,514540,317,1.00
ptg002158l,513731,514048,317,RepeatMasker,LTR,513175,514541,317,1.00
ptg002159l,5929490,5929788,298,RepeatMasker,LTR,5929586,5929653,68,0.23
ptg002163l,3168472,3168781,309,RepeatMasker,LTR,3168390,3168671,199,0.64
ptg002163l,3168472,3168781,309,RepeatMasker,LTR,3168673,3169190,109,0.35
ptg002168l,649432,649729,297,RepeatMasker,LTR,649391,649779,297,1.00
ptg002171l,358451,358757,306,RepeatMasker,LTR,357632,359220,306,1.00
ptg002171l,1163725,1164006,281,RepeatMasker,LTR,1162677,1164491,281,1.00
ptg002171l,1226101,1226382,281,RepeatMasker,LTR,1225712,1226395,281,1.00
ptg002173l,2960829,2961126,297,RepeatMasker,LTR,2961039,2961102,64,0.22
ptg002174l,3659232,3659543,311,RepeatMasker,LTR,3658803,3660038,311,1.00
ptg002180l,2057218,2057528,310,RepeatMasker,LTR,2055163,2057297,79,0.25
ptg002182l,145721,146000,279,RepeatMasker,LTR,145324,146012,279,1.00
ptg002184l,5172987,5173282,295,RepeatMasker,LTR,5172809,5173334,295,1.00
ptg002186l,1862310,1862606,296,RepeatMasker,LTR,1862089,1862658,296,1.00
ptg002187l,530279,530599,320,RepeatMasker,LTR,530576,531698,24,0.08
ptg002188l,1081217,1081514,297,RepeatMasker,LTR,1081366,1081570,149,0.50
ptg002188l,1081217,1081514,297,RepeatMasker,LTR,1081281,1081562,234,0.79
ptg002190l,1131278,1131607,329,RepeatMasker,LTR,1131538,1131834,70,0.21
ptg002191l,110093,110374,281,RepeatMasker,LTR,109689,111176,281,1.00
ptg002194l,349454,349735,281,RepeatMasker,LTR,349073,350381,281,1.00
ptg002196l,413589,413887,298,RepeatMasker,LTR,413411,413939,298,1.00
ptg002197l,1958059,1958335,276,RepeatMasker,LTR,1958038,1958083,24,0.09
ptg002206l,336068,336379,311,RepeatMasker,LTR,336179,336286,108,0.35
ptg002206l,336068,336379,311,RepeatMasker,LTR,336244,336308,65,0.21
ptg002211l,1758449,1758751,302,RepeatMasker,LTR,1755641,1758827,302,1.00
ptg002214l,812188,812496,308,RepeatMasker,LTR,810612,812191,3,0.01
ptg002214l,812188,812496,308,RepeatMasker,LTR,812365,812644,132,0.43
ptg002214l,1987127,1987450,323,RepeatMasker,LTR,1986408,1987647,323,1.00
ptg002214l,2250621,2250941,320,RepeatMasker,LTR,2250891,2253565,51,0.16
ptg002217l,1270103,1270377,274,RepeatMasker,LTR,1269736,1270297,194,0.71
ptg002217l,1809835,1810132,297,RepeatMasker,LTR,1810106,1813414,27,0.09
ptg002219l,3282094,3282369,275,RepeatMasker,LTR,3282112,3283030,258,0.94
ptg002221l,4275413,4275712,299,RepeatMasker,LTR,4275220,4275764,299,1.00
ptg002221l,4432797,4433084,287,RepeatMasker,LTR,4428958,4433933,287,1.00
ptg002221l,4587203,4587502,299,RepeatMasker,LTR,4587335,4587658,168,0.56
ptg002224l,249640,249948,308,RepeatMasker,LTR,249804,250780,145,0.47
ptg002224l,1422419,1422700,281,RepeatMasker,LTR,1422033,1422734,281,1.00
ptg002225l,4706180,4706460,280,RepeatMasker,LTR,4705790,4707263,280,1.00
ptg002226l,1909366,1909646,280,RepeatMasker,LTR,1909586,1909653,61,0.22
ptg002228l,1437072,1437346,274,RepeatMasker,LTR,1437110,1437345,236,0.86
ptg002233l,177124,177425,301,RepeatMasker,LTR,177239,177287,49,0.16
ptg002233l,746627,746905,278,RepeatMasker,LTR,746357,750520,278,1.00
ptg002233l,3153258,3153572,314,RepeatMasker,LTR,3152403,3154108,314,1.00
ptg002233l,3153258,3153572,314,RepeatMasker,LTR,3153546,3153906,27,0.09
ptg002233l,3690004,3690284,280,RepeatMasker,LTR,3689529,3690344,280,1.00
ptg002239l,130996,131284,288,RepeatMasker,LTR,124831,134073,288,1.00
ptg002240l,1525054,1525364,310,RepeatMasker,LTR,1524960,1525164,110,0.35
ptg002241l,241829,242140,311,RepeatMasker,LTR,241810,241853,24,0.08
ptg002249l,1612304,1612584,280,RepeatMasker,LTR,1611922,1613221,280,1.00
ptg002253l,319271,319577,306,RepeatMasker,LTR,319542,321735,36,0.12
ptg002253l,337515,337798,283,RepeatMasker,LTR,334459,338654,283,1.00
ptg002257l,446835,447125,290,RepeatMasker,LTR,446078,447755,290,1.00
ptg002257l,2046255,2046554,299,RepeatMasker,LTR,2045694,2047036,299,1.00
ptg002259l,1646170,1646448,278,RepeatMasker,LTR,1646136,1646182,12,0.04
ptg002262l,3785234,3785520,286,RepeatMasker,LTR,3785488,3785536,33,0.12
ptg002266l,1779560,1779859,299,RepeatMasker,LTR,1779519,1779911,299,1.00
ptg002271l,4597,4906,309,RepeatMasker,LTR,1894,4900,303,0.98
ptg002271l,4597,4906,309,RepeatMasker,LTR,4900,5113,7,0.02
ptg002274l,345186,345510,324,RepeatMasker,LTR,345293,345460,168,0.52
ptg002274l,983065,983367,302,RepeatMasker,LTR,982311,984932,302,1.00
ptg002275l,574252,574556,304,RepeatMasker,LTR,574283,574913,274,0.90
ptg002277l,472779,473073,294,RepeatMasker,LTR,472294,473167,294,1.00
ptg002277l,1753488,1753788,300,RepeatMasker,LTR,1753333,1753840,300,1.00
ptg002277l,1781473,1781787,314,RepeatMasker,LTR,1780902,1781982,314,1.00
ptg002277l,1781473,1781787,314,RepeatMasker,LTR,1781066,1781982,314,1.00
ptg002278l,34500,34787,287,RepeatMasker,LTR,29781,35641,287,1.00
ptg002281l,1747735,1748031,296,RepeatMasker,LTR,1748005,1753066,27,0.09
ptg002284l,1941155,1941480,325,RepeatMasker,LTR,1936895,1942562,325,1.00
ptg002284l,1941155,1941480,325,RepeatMasker,LTR,1939959,1942899,325,1.00
ptg002286l,197046,197340,294,RepeatMasker,LTR,196657,197352,294,1.00
ptg002289l,3100092,3100406,314,RepeatMasker,LTR,3099939,3100227,135,0.43
ptg002290l,311048,311346,298,RepeatMasker,LTR,311017,311071,23,0.08
ptg002291l,507377,507677,300,RepeatMasker,LTR,507169,507729,300,1.00
ptg002295l,244840,245160,320,RepeatMasker,LTR,245110,246857,51,0.16
ptg002296l,78917,79198,281,RepeatMasker,LTR,77869,79992,281,1.00
ptg002296l,735121,735402,281,RepeatMasker,LTR,734743,736048,281,1.00
ptg002297l,224581,224913,332,RepeatMasker,LTR,224377,228597,332,1.00
ptg002297l,753588,753885,297,RepeatMasker,LTR,753771,754269,115,0.39
ptg002297l,2098402,2098732,330,RepeatMasker,LTR,2098254,2098595,193,0.58
ptg002302l,842701,842980,279,RepeatMasker,LTR,841561,845491,279,1.00
ptg002302l,1355387,1355668,281,RepeatMasker,LTR,1355004,1356452,281,1.00
ptg002310l,1109054,1109355,301,RepeatMasker,LTR,1108321,1110604,301,1.00
ptg002311l,3920124,3920423,299,RepeatMasker,LTR,3919946,3920475,299,1.00
ptg002321l,490588,490887,299,RepeatMasker,LTR,490405,490939,299,1.00
ptg002321l,1493880,1494161,281,RepeatMasker,LTR,1492635,1495715,281,1.00
ptg002325l,698934,699214,280,RepeatMasker,LTR,698381,699274,280,1.00
ptg002325l,1189064,1189379,315,RepeatMasker,LTR,1188955,1190167,315,1.00
ptg002325l,1795648,1795947,299,RepeatMasker,LTR,1795628,1795999,299,1.00
ptg002325l,2867004,2867307,303,RepeatMasker,LTR,2866979,2867272,268,0.88
ptg002327l,634020,634301,281,RepeatMasker,LTR,633647,634333,281,1.00
ptg002332l,973228,973539,311,RepeatMasker,LTR,973324,973405,82,0.26
ptg002336l,2704479,2704786,307,RepeatMasker,LTR,2704677,2707885,110,0.36
ptg002338l,6498912,6499220,308,RepeatMasker,LTR,6499044,6500003,177,0.57
ptg002345l,3020838,3021112,274,RepeatMasker,LTR,3019692,3024838,274,1.00
ptg002347l,4553170,4553460,290,RepeatMasker,LTR,4552699,4553677,290,1.00
ptg002349l,405639,405919,280,RepeatMasker,LTR,405269,405930,280,1.00
ptg002349l,405639,405919,280,RepeatMasker,LTR,405340,406710,280,1.00
ptg002349l,2468735,2469015,280,RepeatMasker,LTR,2467675,2469028,280,1.00
ptg002351l,1407087,1407375,288,RepeatMasker,LTR,1403981,1407209,122,0.42
ptg002353l,204637,204924,287,RepeatMasker,LTR,203068,204995,287,1.00
ptg002353l,204637,204924,287,RepeatMasker,LTR,204874,205824,51,0.18
ptg002356l,1993499,1993779,280,RepeatMasker,LTR,1993117,1994570,280,1.00
ptg002356l,2101823,2102104,281,RepeatMasker,LTR,2101808,2102751,281,1.00
ptg002356l,2103225,2103507,282,RepeatMasker,LTR,2102778,2103537,282,1.00
ptg002356l,2103225,2103507,282,RepeatMasker,LTR,2102901,2103520,282,1.00
ptg002356l,2118285,2118567,282,RepeatMasker,LTR,2117954,2119371,282,1.00
ptg002358l,4679694,4680008,314,RepeatMasker,LTR,4679621,4679781,87,0.28
ptg002358l,4679694,4680008,314,RepeatMasker,LTR,4679980,4682788,29,0.09
ptg002369l,920741,921044,303,RepeatMasker,LTR,920717,920764,23,0.08
ptg002375l,4591272,4591592,320,RepeatMasker,LTR,4591543,4592236,50,0.16
ptg002378l,2522790,2523081,291,RepeatMasker,LTR,2522573,2522870,80,0.27
ptg002379l,165272,165571,299,RepeatMasker,LTR,165094,165605,299,1.00
ptg002379l,227820,228119,299,RepeatMasker,LTR,227625,228171,299,1.00
ptg002379l,380484,380783,299,RepeatMasker,LTR,380287,380835,299,1.00
ptg002381l,1151024,1151355,331,RepeatMasker,LTR,1150828,1155931,331,1.00
ptg002382l,892068,892363,295,RepeatMasker,LTR,892186,892235,50,0.17
ptg002384l,3310965,3311247,282,RepeatMasker,LTR,3310909,3311424,282,1.00
ptg002385l,1820841,1821146,305,RepeatMasker,LTR,1820450,1821097,256,0.84
ptg002387l,2116189,2116488,299,RepeatMasker,LTR,2116109,2116540,299,1.00
ptg002387l,2213313,2213609,296,RepeatMasker,LTR,2212483,2213394,81,0.27
ptg002392l,2413879,2414160,281,RepeatMasker,LTR,2413571,2414192,281,1.00
ptg002393l,800641,800920,279,RepeatMasker,LTR,800283,800940,279,1.00
ptg002396l,484975,485261,286,RepeatMasker,LTR,478807,488309,286,1.00
ptg002397l,2111327,2111617,290,RepeatMasker,LTR,2110844,2111434,107,0.37
ptg002397l,2249267,2249553,286,RepeatMasker,LTR,2248896,2249929,286,1.00
ptg002399l,750779,751088,309,RepeatMasker,LTR,750120,751057,278,0.90
ptg002415l,198203,198486,283,RepeatMasker,LTR,195470,199088,283,1.00
ptg002415l,1401089,1401402,313,RepeatMasker,LTR,1401280,1401957,123,0.39
ptg002416l,1054839,1055138,299,RepeatMasker,LTR,1054661,1055190,299,1.00
ptg002421l,1402815,1403114,299,RepeatMasker,LTR,1402795,1403148,299,1.00
ptg002421l,2426022,2426349,327,RepeatMasker,LTR,2425902,2426643,327,1.00
ptg002425l,1552851,1553132,281,RepeatMasker,LTR,1551896,1553771,281,1.00
ptg002431l,2664143,2664429,286,RepeatMasker,LTR,2659955,2665289,286,1.00
ptg002435l,1184872,1185158,286,RepeatMasker,LTR,1184996,1192062,163,0.57
ptg002436l,751856,752136,280,RepeatMasker,LTR,751841,752166,280,1.00
ptg002438l,3088869,3089167,298,RepeatMasker,LTR,3087623,3088879,10,0.03
ptg002444l,1353980,1354257,277,RepeatMasker,LTR,1350553,1354247,267,0.96
ptg002444l,1353980,1354257,277,RepeatMasker,LTR,1353931,1354385,277,1.00
ptg002446l,1216445,1216738,293,RepeatMasker,LTR,1215706,1217995,293,1.00
ptg002446l,1216445,1216744,299,RepeatMasker,LTR,1215706,1217995,299,1.00
ptg002449l,295484,295764,280,RepeatMasker,LTR,295088,296398,280,1.00
ptg002449l,3128103,3128409,306,RepeatMasker,LTR,3121485,3130968,306,1.00
ptg002452l,3596900,3597179,279,RepeatMasker,LTR,3596628,3597962,279,1.00
ptg002452l,3608658,3608938,280,RepeatMasker,LTR,3608606,3608968,280,1.00
ptg002454l,3201896,3202194,298,RepeatMasker,LTR,3201718,3202246,298,1.00
ptg002457l,224070,224381,311,RepeatMasker,LTR,224112,224427,270,0.87
ptg002468l,568786,569067,281,RepeatMasker,LTR,569017,569231,51,0.18
ptg002468l,2222530,2222823,293,RepeatMasker,LTR,2222776,2222846,48,0.16
ptg002468l,2222530,2222823,293,RepeatMasker,LTR,2222786,2225901,38,0.13
ptg002469l,980837,981156,319,RepeatMasker,LTR,980856,981302,301,0.94
ptg002473l,2075152,2075451,299,RepeatMasker,LTR,2074987,2075503,299,1.00
ptg002473l,2193313,2193612,299,RepeatMasker,LTR,2193135,2193662,299,1.00
ptg002473l,4366667,4366953,286,RepeatMasker,LTR,4361942,4367809,286,1.00
ptg002473l,4467756,4468047,291,RepeatMasker,LTR,4465501,4467795,39,0.13
ptg002474l,1782369,1782644,275,RepeatMasker,LTR,1781991,1785171,275,1.00
ptg002476l,3640867,3641195,328,RepeatMasker,LTR,3637886,3643783,328,1.00
ptg002488l,2165106,2165397,291,RepeatMasker,LTR,2164722,2165437,291,1.00
ptg002489l,1327985,1328279,294,RepeatMasker,LTR,1327777,1328331,294,1.00
ptg002489l,1387699,1387995,296,RepeatMasker,LTR,1387619,1388047,296,1.00
ptg002489l,1863769,1864065,296,RepeatMasker,LTR,1863561,1864117,296,1.00
ptg002493l,1386054,1386334,280,RepeatMasker,LTR,1385664,1386968,280,1.00
ptg002494l,1956099,1956419,320,RepeatMasker,LTR,1955986,1956100,1,0.00
ptg002497l,2447066,2447390,324,RepeatMasker,LTR,2447227,2448494,164,0.51
ptg002499l,2200461,2200746,285,RepeatMasker,LTR,2197383,2200575,114,0.40
ptg002499l,2200461,2200746,285,RepeatMasker,LTR,2200572,2200655,84,0.29
ptg002499l,4424682,4424981,299,RepeatMasker,LTR,4424517,4425033,299,1.00
ptg002503l,1393293,1393602,309,RepeatMasker,LTR,1393417,1393872,186,0.60
ptg002508l,690535,690816,281,RepeatMasker,LTR,690153,691623,281,1.00
ptg002509l,79677,79991,314,RepeatMasker,LTR,79682,79735,54,0.17
ptg002510l,4283884,4284170,286,RepeatMasker,LTR,4281110,4288078,286,1.00
ptg002518l,221692,222000,308,RepeatMasker,LTR,221229,225153,308,1.00
ptg002520l,839833,840133,300,RepeatMasker,LTR,839624,840186,300,1.00
ptg002527l,5274311,5274587,276,RepeatMasker,LTR,5274472,5274530,59,0.21
ptg002534l,549994,550322,328,RepeatMasker,LTR,550115,550555,208,0.63
ptg002534l,2729085,2729384,299,RepeatMasker,LTR,2728917,2729436,299,1.00
ptg002537l,1128426,1128710,284,RepeatMasker,LTR,1128690,1129675,21,0.07
ptg002548l,3212389,3212688,299,RepeatMasker,LTR,3212369,3212740,299,1.00
ptg002553l,110917,111232,315,RepeatMasker,LTR,109120,113024,315,1.00
ptg002558l,178403,178702,299,RepeatMasker,LTR,178362,178734,299,1.00
ptg002564l,207072,207360,288,RepeatMasker,LTR,207253,207819,108,0.38
ptg002564l,238497,238793,296,RepeatMasker,LTR,237118,239949,296,1.00
ptg002564l,3635481,3635765,284,RepeatMasker,LTR,3633748,3636929,284,1.00
ptg002570l,6374988,6375297,309,RepeatMasker,LTR,6372873,6376575,309,1.00
ptg002573l,6949197,6949494,297,RepeatMasker,LTR,6948956,6949257,60,0.20
ptg002573l,9332365,9332663,298,RepeatMasker,LTR,9332159,9332715,298,1.00
ptg002573l,10233214,10233521,307,RepeatMasker,LTR,10233369,10233683,153,0.50
ptg002575l,1179434,1179736,302,RepeatMasker,LTR,1179066,1180527,302,1.00
ptg002575l,3866711,3867007,296,RepeatMasker,LTR,3866717,3866761,45,0.15
ptg002577l,1473902,1474177,275,RepeatMasker,LTR,1472783,1474157,255,0.93
ptg002578l,179364,179677,313,RepeatMasker,LTR,178777,179670,306,0.98
ptg002578l,516022,516301,279,RepeatMasker,LTR,515711,516329,279,1.00
ptg002583l,3920707,3921027,320,RepeatMasker,LTR,3920977,3923492,51,0.16
ptg002583l,6946806,6947086,280,RepeatMasker,LTR,6945658,6947099,280,1.00
ptg002583l,7261534,7261814,280,RepeatMasker,LTR,7261297,7262461,280,1.00
ptg002586l,3282528,3282865,337,RepeatMasker,LTR,3281587,3284318,337,1.00
ptg002586l,4008114,4008397,283,RepeatMasker,LTR,4008093,4008137,23,0.08
ptg002588l,774477,774787,310,RepeatMasker,LTR,771095,775878,310,1.00
ptg002594l,4770149,4770449,300,RepeatMasker,LTR,4770200,4770378,179,0.60
ptg002594l,4770149,4770449,300,RepeatMasker,LTR,4770382,4770417,36,0.12
ptg002597l,78925,79244,319,RepeatMasker,LTR,77812,79076,151,0.47
ptg002597l,78925,79244,319,RepeatMasker,LTR,79082,86129,163,0.51
ptg002600l,1050211,1050515,304,RepeatMasker,LTR,1049984,1050839,304,1.00
ptg002601l,1293453,1293753,300,RepeatMasker,LTR,1293316,1293494,41,0.14
ptg002605l,2715856,2716177,321,RepeatMasker,LTR,2715390,2715920,64,0.20
ptg002606l,3023255,3023540,285,RepeatMasker,LTR,3023073,3023307,52,0.18
ptg002608l,1585618,1585918,300,RepeatMasker,LTR,1585410,1585970,300,1.00
ptg002609l,2716073,2716372,299,RepeatMasker,LTR,2715993,2716419,299,1.00
ptg002609l,5145411,5145701,290,RepeatMasker,LTR,5145236,5145753,290,1.00
ptg002609l,5324066,5324365,299,RepeatMasker,LTR,5323986,5324417,299,1.00
ptg002611l,4668603,4668934,331,RepeatMasker,LTR,4668805,4670167,130,0.39
ptg002611l,4668603,4668934,331,RepeatMasker,LTR,4668808,4670353,127,0.38
ptg002618l,539578,539859,281,RepeatMasker,LTR,539183,539892,281,1.00
ptg002618l,919445,919726,281,RepeatMasker,LTR,918400,920529,281,1.00
ptg002622l,2569130,2569438,308,RepeatMasker,LTR,2568739,2570241,308,1.00
ptg002622l,4118552,4118833,281,RepeatMasker,LTR,4118173,4119478,281,1.00
ptg002623l,965068,965383,315,RepeatMasker,LTR,964601,965156,88,0.28
ptg002623l,965068,965383,315,RepeatMasker,LTR,965355,968979,29,0.09
ptg002623l,2709740,2710049,309,RepeatMasker,LTR,2709263,2709763,23,0.07
ptg002624l,1768417,1768710,293,RepeatMasker,LTR,1768210,1768762,293,1.00
ptg002626l,1419754,1420034,280,RepeatMasker,LTR,1418599,1420678,280,1.00
ptg002637l,567289,567579,290,RepeatMasker,LTR,567047,567488,199,0.69
ptg002649l,47519,47804,285,RepeatMasker,LTR,42910,48666,285,1.00
ptg002650l,573180,573479,299,RepeatMasker,LTR,573002,573531,299,1.00
ptg002650l,1456736,1457056,320,RepeatMasker,LTR,1457006,1459538,51,0.16
ptg002650l,1862331,1862627,296,RepeatMasker,LTR,1862221,1862503,172,0.58
ptg002651l,854001,854281,280,RepeatMasker,LTR,852947,854309,280,1.00
ptg002659l,3768054,3768365,311,RepeatMasker,LTR,3767928,3768153,99,0.32
ptg002659l,5764209,5764500,291,RepeatMasker,LTR,5763748,5764432,223,0.77
ptg002659l,5764209,5764500,291,RepeatMasker,LTR,5764426,5765043,75,0.26
ptg002660l,1797604,1797916,312,RepeatMasker,LTR,1797312,1798777,312,1.00
ptg002663l,554735,555037,302,RepeatMasker,LTR,554168,555018,283,0.94
ptg002664l,240895,241176,281,RepeatMasker,LTR,240496,241817,281,1.00
ptg002665l,554686,554967,281,RepeatMasker,LTR,553600,555760,281,1.00
ptg002665l,1471231,1471510,279,RepeatMasker,LTR,1470817,1472309,279,1.00
ptg002666l,359091,359393,302,RepeatMasker,LTR,359164,359544,230,0.76
ptg002666l,2064582,2064872,290,RepeatMasker,LTR,2064204,2065507,290,1.00
ptg002668l,852921,853233,312,RepeatMasker,LTR,852643,853115,194,0.62
ptg002668l,1530596,1530886,290,RepeatMasker,LTR,1529005,1531818,290,1.00
ptg002668l,1820550,1820857,307,RepeatMasker,LTR,1819947,1820660,110,0.36
ptg002668l,1820550,1820857,307,RepeatMasker,LTR,1820808,1821512,50,0.16
ptg002670l,943330,943621,291,RepeatMasker,LTR,942431,946054,291,1.00
ptg002677l,3410697,3411021,324,RepeatMasker,LTR,3410897,3410991,95,0.29
ptg002677l,4579775,4580079,304,RepeatMasker,LTR,4579744,4580657,304,1.00
ptg002678l,1249480,1249777,297,RepeatMasker,LTR,1249300,1249829,297,1.00
ptg002680l,213209,213517,308,RepeatMasker,LTR,213383,216247,135,0.44
ptg002686l,1164132,1164418,286,RepeatMasker,LTR,1162580,1165260,286,1.00
ptg002690l,398392,398673,281,RepeatMasker,LTR,397333,399309,281,1.00
ptg002690l,4547331,4547613,282,RepeatMasker,LTR,4547209,4548728,282,1.00
ptg002692l,440049,440330,281,RepeatMasker,LTR,439863,440390,281,1.00
ptg002698l,79828,80125,297,RepeatMasker,LTR,80105,82490,21,0.07
ptg002701l,159526,159774,248,RepeatMasker,LTR,155366,161468,248,1.00
ptg002701l,159526,159774,248,RepeatMasker,LTR,159469,164827,248,1.00
ptg002703l,1524452,1524751,299,RepeatMasker,LTR,1524255,1524803,299,1.00
ptg002708l,2307838,2308157,319,RepeatMasker,LTR,2307299,2310600,319,1.00
ptg002718l,1119574,1119855,281,RepeatMasker,LTR,1119180,1119888,281,1.00
ptg002722l,2104208,2104488,280,RepeatMasker,LTR,2103123,2105263,280,1.00
ptg002722l,2111388,2111668,280,RepeatMasker,LTR,2110183,2112304,280,1.00
ptg002723l,126916,127209,293,RepeatMasker,LTR,126738,127261,293,1.00
ptg002723l,389349,389648,299,RepeatMasker,LTR,389171,389700,299,1.00
ptg002723l,440233,440537,304,RepeatMasker,LTR,440273,441231,265,0.87
ptg002723l,1090996,1091291,295,RepeatMasker,LTR,1090818,1091343,295,1.00
ptg002723l,1496524,1496820,296,RepeatMasker,LTR,1496346,1496872,296,1.00
ptg002725l,979580,979875,295,RepeatMasker,LTR,979388,979927,295,1.00
ptg002725l,1255832,1256131,299,RepeatMasker,LTR,1255752,1256183,299,1.00
ptg002730l,198576,198848,272,RepeatMasker,LTR,198686,205428,163,0.60
ptg002731l,1311663,1311966,303,RepeatMasker,LTR,1311687,1312111,280,0.92
ptg002732l,2088200,2088489,289,RepeatMasker,LTR,2087933,2088242,42,0.15
ptg002732l,2094498,2094787,289,RepeatMasker,LTR,2092716,2094540,42,0.15
ptg002734l,380903,381192,289,RepeatMasker,LTR,381024,381145,122,0.42
ptg002734l,380903,381192,289,RepeatMasker,LTR,381137,381677,56,0.19
ptg002736l,696766,697057,291,RepeatMasker,LTR,696424,699891,291,1.00
ptg002741l,971245,971546,301,RepeatMasker,LTR,971496,977755,51,0.17
ptg002746l,1772868,1773166,298,RepeatMasker,LTR,1772848,1772891,23,0.08
ptg002746l,3832578,3832878,300,RepeatMasker,LTR,3832269,3832823,245,0.82
ptg002746l,3832578,3832878,300,RepeatMasker,LTR,3832671,3832851,181,0.60
ptg002747l,2577810,2578095,285,RepeatMasker,LTR,2577789,2577833,23,0.08
ptg002747l,4747713,4747996,283,RepeatMasker,LTR,4746093,4748614,283,1.00
ptg002749l,1973346,1973642,296,RepeatMasker,LTR,1973554,1973956,89,0.30
ptg002749l,1973346,1973642,296,RepeatMasker,LTR,1973555,1973769,88,0.30
ptg002749l,2206693,2206990,297,RepeatMasker,LTR,2206515,2207042,297,1.00
ptg002749l,2385438,2385728,290,RepeatMasker,LTR,2384527,2388159,290,1.00
ptg002752l,896482,896769,287,RepeatMasker,LTR,894403,897606,287,1.00
ptg002753l,1002800,1003120,320,RepeatMasker,LTR,1003070,1003945,51,0.16
ptg002753l,1057831,1058111,280,RepeatMasker,LTR,1057356,1058171,280,1.00
ptg002754l,1727849,1728135,286,RepeatMasker,LTR,1726968,1727895,46,0.16
ptg002754l,1727849,1728135,286,RepeatMasker,LTR,1727865,1727931,67,0.23
ptg002754l,1727849,1728135,286,RepeatMasker,LTR,1727878,1728785,258,0.90
ptg002766l,926026,926317,291,RepeatMasker,LTR,925647,926061,35,0.12
ptg002766l,926026,926317,291,RepeatMasker,LTR,926062,926231,170,0.58
ptg002766l,926026,926317,291,RepeatMasker,LTR,926233,927244,85,0.29
ptg002772l,1661383,1661706,323,RepeatMasker,LTR,1661134,1661482,99,0.31
ptg002773l,4394913,4395219,306,RepeatMasker,LTR,4394391,4395902,306,1.00
ptg002786l,2235081,2235374,293,RepeatMasker,LTR,2235072,2235819,293,1.00
ptg002787l,164025,164344,319,RepeatMasker,LTR,162925,164119,94,0.29
ptg002801l,101189,101489,300,RepeatMasker,LTR,101438,101588,52,0.17
ptg002801l,101189,101489,300,RepeatMasker,LTR,99977,101205,16,0.05
ptg002801l,2963796,2964089,293,RepeatMasker,LTR,2963433,2964183,293,1.00
ptg002801l,2963796,2964089,293,RepeatMasker,LTR,2964087,2964313,3,0.01
ptg002804l,966789,967076,287,RepeatMasker,LTR,962077,967938,287,1.00
ptg002806l,1133423,1133713,290,RepeatMasker,LTR,1132946,1133528,105,0.36
ptg002810l,250567,250855,288,RepeatMasker,LTR,250262,252587,288,1.00
ptg002810l,258956,259237,281,RepeatMasker,LTR,258579,260038,281,1.00
ptg002810l,408299,408595,296,RepeatMasker,LTR,407934,409396,296,1.00
ptg002814l,747575,747880,305,RepeatMasker,LTR,747095,747670,95,0.31
ptg002814l,1577148,1577448,300,RepeatMasker,LTR,1577267,1577555,182,0.61
ptg002814l,1577148,1577448,300,RepeatMasker,LTR,1577305,1577555,144,0.48
ptg002818l,1364762,1365054,292,RepeatMasker,LTR,1364339,1366679,292,1.00
ptg002818l,2743423,2743712,289,RepeatMasker,LTR,2743505,2743565,61,0.21
ptg002819l,2137979,2138302,323,RepeatMasker,LTR,2138081,2138222,142,0.44
ptg002823l,575522,575799,277,RepeatMasker,LTR,573732,575789,267,0.96
ptg002823l,575522,575799,277,RepeatMasker,LTR,575461,575919,277,1.00
ptg002829l,1716069,1716389,320,RepeatMasker,LTR,1716339,1722549,51,0.16
ptg002834l,819172,819472,300,RepeatMasker,LTR,819001,819524,300,1.00
ptg002837l,247859,248180,321,RepeatMasker,LTR,243185,249056,321,1.00
ptg002837l,269512,269798,286,RepeatMasker,LTR,268758,270645,286,1.00
ptg002838l,342584,342898,314,RepeatMasker,LTR,341625,347621,314,1.00
ptg002840l,9040,9320,280,RepeatMasker,LTR,8658,10122,280,1.00
ptg002841l,885590,885888,298,RepeatMasker,LTR,885404,886681,298,1.00
ptg002841l,916035,916316,281,RepeatMasker,LTR,915145,916953,281,1.00
ptg002851l,549711,550001,290,RepeatMasker,LTR,549363,551775,290,1.00
ptg002852l,97602,97926,324,RepeatMasker,LTR,97878,101209,49,0.15
ptg002858l,4048658,4048968,310,RepeatMasker,LTR,4048599,4049675,310,1.00
ptg002859l,52774,53049,275,RepeatMasker,LTR,52968,53187,82,0.30
ptg002859l,2040741,2041028,287,RepeatMasker,LTR,2036026,2041868,287,1.00
ptg002862l,1870642,1870943,301,RepeatMasker,LTR,1870707,1871834,237,0.79
ptg002867l,3486060,3486362,302,RepeatMasker,LTR,3486064,3486507,299,0.99
ptg002870l,445185,445466,281,RepeatMasker,LTR,444771,446267,281,1.00
ptg002870l,452710,452991,281,RepeatMasker,LTR,452329,453633,281,1.00
ptg002876l,103450,103766,316,RepeatMasker,LTR,103104,103800,316,1.00
ptg002877l,2360954,2361271,317,RepeatMasker,LTR,2360470,2361417,317,1.00
ptg002882l,1698438,1698718,280,RepeatMasker,LTR,1697759,1698731,280,1.00
ptg002882l,2346502,2346789,287,RepeatMasker,LTR,2346623,2346840,167,0.58
ptg002882l,2346502,2346789,287,RepeatMasker,LTR,2346683,2346928,107,0.37
ptg002886l,2495431,2495735,304,RepeatMasker,LTR,2495609,2498100,127,0.42
ptg002887l,446814,447121,307,RepeatMasker,LTR,445781,447135,307,1.00
ptg002890l,2103802,2104089,287,RepeatMasker,LTR,2100651,2104085,283,0.99
ptg002890l,2103802,2104089,287,RepeatMasker,LTR,2104083,2104310,7,0.02
ptg002894l,1737364,1737692,328,RepeatMasker,LTR,1737089,1738039,328,1.00
ptg002898l,130834,131143,309,RepeatMasker,LTR,131113,133731,31,0.10
ptg002902l,582473,582759,286,RepeatMasker,LTR,581236,583301,286,1.00
ptg002902l,649996,650317,321,RepeatMasker,LTR,649875,651232,321,1.00
ptg002902l,999693,999979,286,RepeatMasker,LTR,999295,1005514,286,1.00
ptg002903l,11535920,11536219,299,RepeatMasker,LTR,11535727,11536271,299,1.00
ptg002908l,3910587,3910917,330,RepeatMasker,LTR,3910856,3911644,62,0.19
ptg002914l,2007698,2007977,279,RepeatMasker,LTR,2007382,2009495,279,1.00
ptg002920l,973389,973691,302,RepeatMasker,LTR,973520,980560,172,0.57
ptg002920l,2276559,2276849,290,RepeatMasker,LTR,2276460,2278318,290,1.00
ptg002920l,6782072,6782362,290,RepeatMasker,LTR,6781162,6784796,290,1.00
ptg002922l,90207,90488,281,RepeatMasker,LTR,90193,91135,281,1.00
ptg002926l,2512298,2512571,273,RepeatMasker,LTR,2511952,2513223,273,1.00
ptg002930l,849674,849976,302,RepeatMasker,LTR,849521,849701,27,0.09
ptg002938l,1088600,1088880,280,RepeatMasker,LTR,1088218,1088913,280,1.00
ptg002939l,1436497,1436778,281,RepeatMasker,LTR,1435580,1437578,281,1.00
ptg002939l,1443671,1443952,281,RepeatMasker,LTR,1442538,1443985,281,1.00
ptg002948l,1527721,1528030,309,RepeatMasker,LTR,1527339,1528683,309,1.00
ptg002949l,4138667,4138963,296,RepeatMasker,LTR,4138938,4139793,26,0.09
ptg002951l,425267,425566,299,RepeatMasker,LTR,425117,425618,299,1.00
ptg002955l,348319,348600,281,RepeatMasker,LTR,347937,348634,281,1.00
ptg002957l,2159001,2159297,296,RepeatMasker,LTR,2155177,2159005,4,0.01
ptg002957l,2159001,2159297,296,RepeatMasker,LTR,2155377,2159912,296,1.00
ptg002961l,404018,404299,281,RepeatMasker,LTR,403707,405098,281,1.00
ptg002961l,411532,411813,281,RepeatMasker,LTR,411150,412457,281,1.00
ptg002965l,6167410,6167728,318,RepeatMasker,LTR,6166941,6168713,318,1.00
ptg002974l,316663,316988,325,RepeatMasker,LTR,316830,317031,159,0.49
ptg002976l,1960693,1961010,317,RepeatMasker,LTR,1959731,1961211,317,1.00
ptg002981l,4350473,4350793,320,RepeatMasker,LTR,4348903,4351651,320,1.00
ptg002988l,225796,226095,299,RepeatMasker,LTR,225618,226147,299,1.00
ptg002989l,589715,590025,310,RepeatMasker,LTR,588273,589916,201,0.65
ptg002991l,971401,971717,316,RepeatMasker,LTR,971457,971524,68,0.22
ptg002993l,641702,642002,300,RepeatMasker,LTR,640949,641763,61,0.20
ptg002993l,1654506,1654793,287,RepeatMasker,LTR,1654581,1654733,153,0.53
ptg002994l,1192053,1192326,273,RepeatMasker,LTR,1191558,1192182,129,0.47
ptg002994l,1192053,1192326,273,RepeatMasker,LTR,1191784,1192325,272,1.00
ptg002996l,1718298,1718638,340,RepeatMasker,LTR,1717834,1720290,340,1.00
ptg003003l,80189,80489,300,RepeatMasker,LTR,79970,80541,300,1.00
ptg003008l,465832,466113,281,RepeatMasker,LTR,464772,466897,281,1.00
ptg003009l,415606,415884,278,RepeatMasker,LTR,415309,418127,278,1.00
ptg003012l,1724159,1724440,281,RepeatMasker,LTR,1723772,1725242,281,1.00
ptg003017l,143750,144047,297,RepeatMasker,LTR,143709,144093,297,1.00
ptg003022l,2710837,2711124,287,RepeatMasker,LTR,2710442,2711759,287,1.00
ptg003026l,1348878,1349175,297,RepeatMasker,LTR,1349125,1349494,51,0.17
ptg003028l,455907,456188,281,RepeatMasker,LTR,454876,456978,281,1.00
ptg003029l,2978289,2978572,283,RepeatMasker,LTR,2978235,2979400,283,1.00
ptg003031l,3059611,3059875,264,RepeatMasker,LTR,3058352,3060311,264,1.00
ptg003032l,280822,281138,316,RepeatMasker,LTR,280911,285012,228,0.72
ptg003034l,149654,149940,286,RepeatMasker,LTR,149322,149725,71,0.25
ptg003034l,149654,149940,286,RepeatMasker,LTR,149767,149800,34,0.12
ptg003034l,215246,215523,277,RepeatMasker,LTR,215514,215645,10,0.04
ptg003034l,215246,215523,277,RepeatMasker,LTR,211817,215513,267,0.96
ptg003034l,869232,869519,287,RepeatMasker,LTR,864581,870376,287,1.00
ptg003036l,840435,840715,280,RepeatMasker,LTR,838381,840764,280,1.00
ptg003039l,638053,638351,298,RepeatMasker,LTR,637857,638403,298,1.00
ptg003047l,611689,611980,291,RepeatMasker,LTR,611769,611822,54,0.19
ptg003047l,5641710,5642009,299,RepeatMasker,LTR,5641534,5642061,299,1.00
ptg003049l,332138,332442,304,RepeatMasker,LTR,331895,332988,304,1.00
ptg003049l,1832347,1832669,322,RepeatMasker,LTR,1831767,1832450,103,0.32
ptg003050l,2197410,2197717,307,RepeatMasker,LTR,2197321,2197608,198,0.64
ptg003051l,2365391,2365674,283,RepeatMasker,LTR,2364386,2366013,283,1.00
ptg003061l,4194635,4194932,297,RepeatMasker,LTR,4193513,4195567,297,1.00
ptg003069l,626295,626605,310,RepeatMasker,LTR,625403,626388,93,0.30
ptg003069l,626295,626605,310,RepeatMasker,LTR,626387,628794,219,0.71
ptg003074l,626004,626293,289,RepeatMasker,LTR,624768,626465,289,1.00
ptg003074l,2061683,2061960,277,RepeatMasker,LTR,2060705,2061837,154,0.56
ptg003074l,2061683,2061960,277,RepeatMasker,LTR,2061843,2062768,118,0.43
ptg003078l,1355450,1355770,320,RepeatMasker,LTR,1355722,1361919,49,0.15
ptg003078l,1556031,1556327,296,RepeatMasker,LTR,1555000,1557110,296,1.00
ptg003084l,702728,703007,279,RepeatMasker,LTR,702347,703040,279,1.00
ptg003084l,1535257,1535579,322,RepeatMasker,LTR,1535417,1535916,163,0.51
ptg003084l,1662061,1662362,301,RepeatMasker,LTR,1661700,1662402,301,1.00
ptg003088l,1674776,1675065,289,RepeatMasker,LTR,1674796,1674878,83,0.29
ptg003088l,1674776,1675065,289,RepeatMasker,LTR,1674816,1674965,150,0.52
ptg003088l,1674776,1675065,289,RepeatMasker,LTR,1674850,1675068,216,0.75
ptg003094l,495282,495588,306,RepeatMasker,LTR,493462,496543,306,1.00
ptg003094l,701137,701435,298,RepeatMasker,LTR,700910,701487,298,1.00
ptg003094l,727722,728021,299,RepeatMasker,LTR,727642,728073,299,1.00
ptg003094l,791028,791327,299,RepeatMasker,LTR,790987,791373,299,1.00
ptg003094l,806879,807174,295,RepeatMasker,LTR,804013,806927,48,0.16
ptg003094l,806879,807174,295,RepeatMasker,LTR,806205,807347,295,1.00
ptg003094l,806879,807174,295,RepeatMasker,LTR,806990,807896,185,0.63
ptg003094l,842647,842945,298,RepeatMasker,LTR,842447,842996,298,1.00
ptg003098l,175199,175498,299,RepeatMasker,LTR,175021,175550,299,1.00
ptg003098l,1460445,1460722,277,RepeatMasker,LTR,1460237,1460712,267,0.96
ptg003098l,1460445,1460722,277,RepeatMasker,LTR,1460384,1460845,277,1.00
ptg003101l,704558,704857,299,RepeatMasker,LTR,704538,704909,299,1.00
ptg003101l,840709,841027,318,RepeatMasker,LTR,840797,840943,147,0.46
ptg003105l,96374,96673,299,RepeatMasker,LTR,96294,96725,299,1.00
ptg003109l,34357,34637,280,RepeatMasker,LTR,33327,36233,280,1.00
ptg003112l,770240,770535,295,RepeatMasker,LTR,770046,770587,295,1.00
ptg003112l,787269,787564,295,RepeatMasker,LTR,787228,787616,295,1.00
ptg003118l,4330260,4330570,310,RepeatMasker,LTR,4328945,4330834,310,1.00
ptg003118l,4330260,4330570,310,RepeatMasker,LTR,4330104,4331083,310,1.00
ptg003121l,181514,181795,281,RepeatMasker,LTR,181132,182440,281,1.00
ptg003122l,943334,943614,280,RepeatMasker,LTR,942289,944254,280,1.00
ptg003124l,5797439,5797720,281,RepeatMasker,LTR,5797402,5798325,281,1.00
ptg003125l,2997022,2997294,272,RepeatMasker,LTR,2996633,2997931,272,1.00
ptg003127l,272059,272364,305,RepeatMasker,LTR,271973,272497,305,1.00
ptg003134l,945752,946059,307,RepeatMasker,LTR,946000,947526,60,0.20
ptg003134l,3005734,3006054,320,RepeatMasker,LTR,3006004,3007401,51,0.16
ptg003134l,7843889,7844172,283,RepeatMasker,LTR,7843510,7844818,283,1.00
ptg003136l,3183706,3184001,295,RepeatMasker,LTR,3183528,3184053,295,1.00
ptg003137l,1080468,1080760,292,RepeatMasker,LTR,1080631,1080974,130,0.45
ptg003143l,5302286,5302585,299,RepeatMasker,LTR,5302108,5302637,299,1.00
ptg003144l,1006597,1006883,286,RepeatMasker,LTR,1006042,1007726,286,1.00
ptg003145l,942858,943172,314,RepeatMasker,LTR,940925,943372,314,1.00
ptg003147l,1708187,1708485,298,RepeatMasker,LTR,1707549,1708287,100,0.34
ptg003154l,591973,592298,325,RepeatMasker,LTR,591713,592124,151,0.46
ptg003158l,26824,27117,293,RepeatMasker,LTR,25071,26866,42,0.14
ptg003158l,26824,27117,293,RepeatMasker,LTR,25902,26866,42,0.14
ptg003160l,1030328,1030623,295,RepeatMasker,LTR,1030097,1030698,295,1.00
ptg003162l,355877,356193,316,RepeatMasker,LTR,354907,357338,316,1.00
ptg003162l,730167,730480,313,RepeatMasker,LTR,730318,730818,163,0.52
ptg003169l,1303169,1303460,291,RepeatMasker,LTR,1302861,1303449,280,0.96
ptg003169l,1303169,1303460,291,RepeatMasker,LTR,1302982,1303214,45,0.15
ptg003176l,73792,74068,276,RepeatMasker,LTR,73877,74143,192,0.70
ptg003176l,2691677,2691976,299,RepeatMasker,LTR,2691469,2692028,299,1.00
ptg003176l,2718713,2719012,299,RepeatMasker,LTR,2718715,2719064,298,1.00
ptg003176l,2793809,2794108,299,RepeatMasker,LTR,2793789,2794142,299,1.00
ptg003177l,1676704,1677001,297,RepeatMasker,LTR,1676624,1677053,297,1.00
ptg003181l,1321541,1321854,313,RepeatMasker,LTR,1321848,1322064,7,0.02
ptg003186l,1769143,1769442,299,RepeatMasker,LTR,1768965,1769476,299,1.00
ptg003186l,2605006,2605302,296,RepeatMasker,LTR,2604813,2605349,296,1.00
ptg003187l,1490670,1490990,320,RepeatMasker,LTR,1490940,1495709,51,0.16
ptg003187l,2617984,2618301,317,RepeatMasker,LTR,2617657,2618035,51,0.16
ptg003187l,2617984,2618301,317,RepeatMasker,LTR,2618031,2618073,43,0.14
ptg003187l,4283267,4283562,295,RepeatMasker,LTR,4283070,4283614,295,1.00
ptg003196l,842302,842601,299,RepeatMasker,LTR,842092,842653,299,1.00
ptg003201l,287156,287442,286,RepeatMasker,LTR,287135,287179,23,0.08
ptg003201l,558250,558548,298,RepeatMasker,LTR,557723,558293,43,0.14
ptg003202l,377345,377625,280,RepeatMasker,LTR,376963,378259,280,1.00
ptg003202l,1346731,1347068,337,RepeatMasker,LTR,1345594,1346741,10,0.03
ptg003202l,1346731,1347068,337,RepeatMasker,LTR,1346769,1347704,300,0.89
ptg003204l,130806,131106,300,RepeatMasker,LTR,129809,131889,300,1.00
ptg003204l,950886,951203,317,RepeatMasker,LTR,950856,950994,108,0.34
ptg003204l,950886,951203,317,RepeatMasker,LTR,950927,951009,83,0.26
ptg003209l,2066659,2066968,309,RepeatMasker,LTR,2065418,2067815,309,1.00
ptg003211l,976973,977295,322,RepeatMasker,LTR,976416,977259,286,0.89
ptg003214l,543644,543954,310,RepeatMasker,LTR,543261,543843,199,0.64
ptg003214l,543644,543954,310,RepeatMasker,LTR,543844,544556,111,0.36
ptg003216l,500106,500414,308,RepeatMasker,LTR,500098,500154,48,0.16
ptg003217l,3911823,3912081,258,RepeatMasker,LTR,3911926,3913198,156,0.60
ptg003217l,5385525,5385791,266,RepeatMasker,LTR,5381342,5388764,266,1.00
ptg003221l,1513546,1513863,317,RepeatMasker,LTR,1513734,1514164,130,0.41
ptg003224l,99458,99786,328,RepeatMasker,LTR,99623,100123,164,0.50
ptg003227l,1290597,1290886,289,RepeatMasker,LTR,1286546,1290752,155,0.54
ptg003227l,4701411,4701704,293,RepeatMasker,LTR,4701495,4701746,210,0.72
ptg003232l,6097756,6098056,300,RepeatMasker,LTR,6097117,6097774,18,0.06
ptg003235l,839198,839493,295,RepeatMasker,LTR,838830,839506,295,1.00
ptg003236l,792857,793127,270,RepeatMasker,LTR,792475,793160,270,1.00
ptg003236l,812776,813057,281,RepeatMasker,LTR,812376,813090,281,1.00
ptg003240l,184975,185271,296,RepeatMasker,LTR,184640,185037,62,0.21
ptg003245l,1488663,1488976,313,RepeatMasker,LTR,1488703,1491430,274,0.88
ptg003246l,112647,112957,310,RepeatMasker,LTR,112415,114354,310,1.00
ptg003247l,146830,147122,292,RepeatMasker,LTR,146465,149952,292,1.00
ptg003257l,1294438,1294741,303,RepeatMasker,LTR,1294515,1294561,47,0.16
ptg003265l,2175983,2176272,289,RepeatMasker,LTR,2175224,2176241,258,0.89
ptg003265l,3279474,3279761,287,RepeatMasker,LTR,3278867,3279664,190,0.66
ptg003265l,3279474,3279761,287,RepeatMasker,LTR,3279538,3279765,224,0.78
ptg003267l,631684,631966,282,RepeatMasker,LTR,631302,632611,282,1.00
ptg003268l,3065150,3065442,292,RepeatMasker,LTR,3065260,3065329,70,0.24
ptg003268l,5574755,5575056,301,RepeatMasker,LTR,5574522,5575129,301,1.00
ptg003271l,1689510,1689820,310,RepeatMasker,LTR,1688995,1689548,38,0.12
ptg003276l,2604423,2604703,280,RepeatMasker,LTR,2604041,2605349,280,1.00
ptg003280l,649015,649331,316,RepeatMasker,LTR,649184,649628,148,0.47
ptg003280l,1031932,1032243,311,RepeatMasker,LTR,1032068,1039152,176,0.57
ptg003284l,835199,835481,282,RepeatMasker,LTR,835319,835819,163,0.58
ptg003290l,1852928,1853240,312,RepeatMasker,LTR,1851783,1853147,219,0.70
ptg003302l,405251,405559,308,RepeatMasker,LTR,405512,405800,48,0.16
ptg003302l,684284,684616,332,RepeatMasker,LTR,683951,684676,332,1.00
ptg003302l,684284,684616,332,RepeatMasker,LTR,684432,684781,185,0.56
ptg003302l,1843493,1843797,304,RepeatMasker,LTR,1842819,1846025,304,1.00
ptg003311l,713655,713961,306,RepeatMasker,LTR,713770,713820,51,0.17
ptg003311l,1154034,1154342,308,RepeatMasker,LTR,1153602,1157618,308,1.00
ptg003311l,2970076,2970373,297,RepeatMasker,LTR,2970352,2970666,22,0.07
ptg003312l,5244401,5244668,267,RepeatMasker,LTR,5237379,5244402,1,0.00
ptg003312l,9332023,9332321,298,RepeatMasker,LTR,9331848,9332373,298,1.00
ptg003314l,2387237,2387522,285,RepeatMasker,LTR,2387216,2387260,23,0.08
ptg003315l,1561603,1561911,308,RepeatMasker,LTR,1561261,1562180,308,1.00
ptg003315l,2328968,2329259,291,RepeatMasker,LTR,2328825,2329188,220,0.76
ptg003318l,415173,415450,277,RepeatMasker,LTR,415366,417467,85,0.31
ptg003319l,171025,171311,286,RepeatMasker,LTR,170654,173048,286,1.00
ptg003321l,2741486,2741807,321,RepeatMasker,LTR,2741785,2741824,23,0.07
ptg003323l,1971876,1972173,297,RepeatMasker,LTR,1970531,1972511,297,1.00
ptg003331l,379982,380283,301,RepeatMasker,LTR,379585,380120,138,0.46
ptg003331l,379982,380283,301,RepeatMasker,LTR,380121,381377,163,0.54
ptg003333l,20079,20378,299,RepeatMasker,LTR,20352,26577,27,0.09
ptg003333l,28155,28453,298,RepeatMasker,LTR,28427,34663,27,0.09
ptg003337l,382556,382841,285,RepeatMasker,LTR,382535,382579,23,0.08
ptg003339l,3963159,3963456,297,RepeatMasker,LTR,3962951,3963508,297,1.00
ptg003341l,419276,419557,281,RepeatMasker,LTR,418230,420192,281,1.00
ptg003347l,1160442,1160723,281,RepeatMasker,LTR,1159385,1161516,281,1.00
ptg003347l,1174801,1175078,277,RepeatMasker,LTR,1173679,1175714,277,1.00
ptg003347l,1387021,1387301,280,RepeatMasker,LTR,1386630,1387313,280,1.00
ptg003348l,85662,85993,331,RepeatMasker,LTR,85595,85963,301,0.91
ptg003348l,569265,569530,265,RepeatMasker,LTR,567602,569299,34,0.13
ptg003350l,2417790,2418071,281,RepeatMasker,LTR,2417410,2418716,281,1.00
ptg003354l,899729,900013,284,RepeatMasker,LTR,898630,902725,284,1.00
ptg003358l,699075,699374,299,RepeatMasker,LTR,698910,699426,299,1.00
ptg003367l,668944,669238,294,RepeatMasker,LTR,668903,669290,294,1.00
ptg003376l,544627,544951,324,RepeatMasker,LTR,544705,544750,46,0.14
ptg003392l,609404,609686,282,RepeatMasker,LTR,609084,609698,282,1.00
ptg003392l,905365,905657,292,RepeatMasker,LTR,905023,908489,292,1.00
ptg003398l,5339925,5340217,292,RepeatMasker,LTR,5339596,5343050,292,1.00
ptg003399l,153227,153526,299,RepeatMasker,LTR,153186,153578,299,1.00
ptg003399l,540528,540826,298,RepeatMasker,LTR,540362,540878,298,1.00
ptg003399l,906442,906740,298,RepeatMasker,LTR,906236,906792,298,1.00
ptg003399l,1708399,1708698,299,RepeatMasker,LTR,1708319,1708750,299,1.00
ptg003405l,90245,90526,281,RepeatMasker,LTR,89843,90539,281,1.00
ptg003405l,2809464,2809763,299,RepeatMasker,LTR,2808930,2814736,299,1.00
ptg003405l,4629190,4629487,297,RepeatMasker,LTR,4629461,4634499,27,0.09
ptg003405l,4944859,4945126,267,RepeatMasker,LTR,4944944,4944984,41,0.15
ptg003408l,3401788,3402080,292,RepeatMasker,LTR,3401580,3402132,292,1.00
ptg003409l,224418,224705,287,RepeatMasker,LTR,223843,225558,287,1.00
ptg003411l,266345,266600,255,RepeatMasker,LTR,266411,266534,124,0.49
ptg003411l,266345,266600,255,RepeatMasker,LTR,266478,266560,83,0.33
ptg003411l,492815,493115,300,RepeatMasker,LTR,491980,493197,300,1.00
ptg003411l,1194531,1194821,290,RepeatMasker,LTR,1194323,1194873,290,1.00
ptg003412l,3058885,3059182,297,RepeatMasker,LTR,3058828,3059584,297,1.00
ptg003412l,6551582,6551896,314,RepeatMasker,LTR,6550200,6553393,314,1.00
ptg003413l,1035241,1035525,284,RepeatMasker,LTR,1035517,1035549,9,0.03
ptg003413l,1035241,1035525,284,RepeatMasker,LTR,1035519,1035556,7,0.02
ptg003414l,1980979,1981278,299,RepeatMasker,LTR,1980801,1981330,299,1.00
ptg003414l,3285864,3286169,305,RepeatMasker,LTR,3284357,3287930,305,1.00
ptg003414l,3285864,3286169,305,RepeatMasker,LTR,3284361,3286131,267,0.88
ptg003414l,3285864,3286169,305,RepeatMasker,LTR,3286123,3288987,47,0.15
ptg003414l,4301231,4301539,308,RepeatMasker,LTR,4301189,4301857,308,1.00
ptg003420l,1970598,1970890,292,RepeatMasker,LTR,1967282,1972015,292,1.00
ptg003421l,418183,418513,330,RepeatMasker,LTR,417739,420977,330,1.00
ptg003429l,1841781,1842081,300,RepeatMasker,LTR,1840561,1841804,23,0.08
ptg003429l,1841781,1842081,300,RepeatMasker,LTR,1842003,1842180,79,0.26
ptg003431l,398724,399014,290,RepeatMasker,LTR,398790,398927,138,0.48
ptg003444l,223657,223937,280,RepeatMasker,LTR,223245,224730,280,1.00
ptg003444l,231486,231792,306,RepeatMasker,LTR,231349,231805,306,1.00
ptg003456l,1577374,1577673,299,RepeatMasker,LTR,1577294,1577725,299,1.00
ptg003457l,2159959,2160282,323,RepeatMasker,LTR,2160070,2161292,213,0.66
ptg003457l,4844762,4845054,292,RepeatMasker,LTR,4844682,4845106,292,1.00
ptg003470l,974673,974998,325,RepeatMasker,LTR,974499,975050,325,1.00
ptg003470l,1953728,1954026,298,RepeatMasker,LTR,1953521,1954078,298,1.00
ptg003470l,1999348,1999643,295,RepeatMasker,LTR,1999171,1999695,295,1.00
ptg003470l,2400623,2400908,285,RepeatMasker,LTR,2400522,2400735,112,0.39
ptg003470l,2400623,2400908,285,RepeatMasker,LTR,2400790,2400924,119,0.42
ptg003470l,2400623,2400908,285,RepeatMasker,LTR,2400885,2401200,24,0.08
ptg003471l,2347516,2347825,309,RepeatMasker,LTR,2346461,2348029,309,1.00
ptg003471l,2347516,2347825,309,RepeatMasker,LTR,2346720,2348008,309,1.00
ptg003471l,2347516,2347825,309,RepeatMasker,LTR,2347724,2348076,102,0.33
ptg003471l,2805192,2805472,280,RepeatMasker,LTR,2804816,2806274,280,1.00
ptg003471l,3720715,3720995,280,RepeatMasker,LTR,3719656,3721008,280,1.00
ptg003473l,105670,105959,289,RepeatMasker,LTR,105305,105992,289,1.00
ptg003473l,3613088,3613400,312,RepeatMasker,LTR,3612501,3613393,305,0.98
ptg003477l,57517,57814,297,RepeatMasker,LTR,57508,57634,117,0.39
ptg003477l,524506,524805,299,RepeatMasker,LTR,524298,524857,299,1.00
ptg003478l,4046168,4046479,311,RepeatMasker,LTR,4045972,4046203,35,0.11
ptg003478l,4046168,4046479,311,RepeatMasker,LTR,4046412,4046457,46,0.15
ptg003478l,6012916,6013206,290,RepeatMasker,LTR,6010358,6013294,290,1.00
ptg003478l,8456712,8457021,309,RepeatMasker,LTR,8455788,8457305,309,1.00
ptg003478l,8456712,8457021,309,RepeatMasker,LTR,8455963,8457296,309,1.00
ptg003480l,755437,755727,290,RepeatMasker,LTR,755707,755746,21,0.07
ptg003480l,1611830,1612146,316,RepeatMasker,LTR,1612110,1617153,37,0.12
ptg003482l,1386424,1386722,298,RepeatMasker,LTR,1386555,1386675,121,0.41
ptg003482l,1386424,1386722,298,RepeatMasker,LTR,1386570,1386688,119,0.40
ptg003489l,661872,662162,290,RepeatMasker,LTR,661792,662214,290,1.00
ptg003489l,937877,938172,295,RepeatMasker,LTR,937699,938224,295,1.00
ptg003491l,223798,224088,290,RepeatMasker,LTR,223428,224100,290,1.00
ptg003491l,697043,697323,280,RepeatMasker,LTR,695840,697967,280,1.00
ptg003495l,184085,184380,295,RepeatMasker,LTR,182893,186329,295,1.00
ptg003502l,2763912,2764220,308,RepeatMasker,LTR,2764058,2771133,163,0.53
ptg003516l,286967,287263,296,RepeatMasker,LTR,287245,287550,19,0.06
ptg003518l,353821,354097,276,RepeatMasker,LTR,353456,353886,65,0.24
ptg003530l,590361,590648,287,RepeatMasker,LTR,588135,591484,287,1.00
ptg003534l,11122099,11122396,297,RepeatMasker,LTR,11121921,11122448,297,1.00
ptg003537l,2173830,2174111,281,RepeatMasker,LTR,2172783,2174888,281,1.00
ptg003537l,2181017,2181298,281,RepeatMasker,LTR,2179890,2181933,281,1.00
ptg003537l,2269807,2270100,293,RepeatMasker,LTR,2269484,2272684,293,1.00
ptg003539l,349693,349989,296,RepeatMasker,LTR,349557,349866,173,0.58
ptg003539l,541757,542056,299,RepeatMasker,LTR,541677,542108,299,1.00
ptg003544l,2761869,2762168,299,RepeatMasker,LTR,2761828,2762220,299,1.00
ptg003545l,582486,582792,306,RepeatMasker,LTR,580824,582984,306,1.00
ptg003546l,623046,623326,280,RepeatMasker,LTR,622664,623960,280,1.00
ptg003546l,707665,707946,281,RepeatMasker,LTR,707283,708591,281,1.00
ptg003549l,960799,961083,284,RepeatMasker,LTR,961083,961248,1,0.00
ptg003551l,1259239,1259519,280,RepeatMasker,LTR,1258204,1260303,280,1.00
ptg003556l,845580,845887,307,RepeatMasker,LTR,845586,845765,180,0.59
ptg003556l,845580,845887,307,RepeatMasker,LTR,845848,846047,40,0.13
ptg003563l,3750991,3751276,285,RepeatMasker,LTR,3750546,3751423,285,1.00
ptg003563l,3827067,3827367,300,RepeatMasker,LTR,3826685,3828013,300,1.00
ptg003573l,223160,223440,280,RepeatMasker,LTR,222769,223476,280,1.00
ptg003574l,448803,449102,299,RepeatMasker,LTR,448595,449154,299,1.00
ptg003576l,364854,365178,324,RepeatMasker,LTR,361753,366972,324,1.00
ptg003579l,769233,769508,275,RepeatMasker,LTR,769471,769873,38,0.14
ptg003587l,2495341,2495640,299,RepeatMasker,LTR,2495477,2496756,164,0.55
ptg003588l,1454028,1454324,296,RepeatMasker,LTR,1453816,1454376,296,1.00
ptg003588l,1699932,1700217,285,RepeatMasker,LTR,1699991,1700060,70,0.25
ptg003598l,579495,579803,308,RepeatMasker,LTR,579765,584544,39,0.13
ptg003601l,2802070,2802367,297,RepeatMasker,LTR,2802113,2802521,255,0.86
ptg003601l,2802070,2802367,297,RepeatMasker,LTR,2801244,2802159,89,0.30
ptg003603l,219042,219359,317,RepeatMasker,LTR,217766,221128,317,1.00
ptg003605l,282154,282462,308,RepeatMasker,LTR,281114,284105,308,1.00
ptg003605l,282154,282462,308,RepeatMasker,LTR,282107,287192,308,1.00
ptg003615l,2395636,2395920,284,RepeatMasker,LTR,2395840,2396575,81,0.29
ptg003619l,1721713,1721997,284,RepeatMasker,LTR,1721378,1722798,284,1.00
ptg003620l,830704,831023,319,RepeatMasker,LTR,830824,831274,200,0.63
ptg003620l,2737596,2737895,299,RepeatMasker,LTR,2737555,2737947,299,1.00
ptg003620l,3139422,3139721,299,RepeatMasker,LTR,3139228,3139773,299,1.00
ptg003620l,3226233,3226530,297,RepeatMasker,LTR,3226153,3226582,297,1.00
ptg003621l,142386,142666,280,RepeatMasker,LTR,141328,143460,280,1.00
ptg003622l,365201,365484,283,RepeatMasker,LTR,364174,366133,283,1.00
ptg003622l,512802,513083,281,RepeatMasker,LTR,511656,513722,281,1.00
ptg003630l,521146,521446,300,RepeatMasker,LTR,520518,521199,53,0.18
ptg003630l,521146,521446,300,RepeatMasker,LTR,521248,521524,199,0.66
ptg003632l,2584644,2584923,279,RepeatMasker,LTR,2583580,2585704,279,1.00
ptg003634l,23878,24175,297,RepeatMasker,LTR,23700,24227,297,1.00
ptg003634l,6833287,6833595,308,RepeatMasker,LTR,6832809,6833374,87,0.28
ptg003634l,6833287,6833595,308,RepeatMasker,LTR,6833567,6837148,29,0.09
ptg003637l,161723,162019,296,RepeatMasker,LTR,161545,162071,296,1.00
ptg003641l,3151833,3152155,322,RepeatMasker,LTR,3151745,3153262,322,1.00
ptg003642l,228440,228733,293,RepeatMasker,LTR,228233,229170,293,1.00
ptg003643l,295473,295763,290,RepeatMasker,LTR,292656,295851,290,1.00
ptg003651l,479545,479834,289,RepeatMasker,LTR,479792,479887,43,0.15
ptg003652l,1557145,1557457,312,RepeatMasker,LTR,1557016,1557274,129,0.41
ptg003658l,589034,589345,311,RepeatMasker,LTR,586919,589288,254,0.82
ptg003658l,589034,589345,311,RepeatMasker,LTR,589289,590778,57,0.18
ptg003661l,151045,151316,271,RepeatMasker,LTR,149909,151954,271,1.00
ptg003665l,5045278,5045574,296,RepeatMasker,LTR,5045070,5045616,296,1.00
ptg003668l,249070,249355,285,RepeatMasker,LTR,249040,249093,23,0.08
ptg003670l,511963,512261,298,RepeatMasker,LTR,512072,513749,190,0.64
ptg003670l,894157,894452,295,RepeatMasker,LTR,893979,894504,295,1.00
ptg003670l,1009992,1010291,299,RepeatMasker,LTR,1009797,1010343,299,1.00
ptg003675l,1293609,1293896,287,RepeatMasker,LTR,1292324,1294744,287,1.00
ptg003675l,1676668,1676995,327,RepeatMasker,LTR,1673430,1679031,327,1.00
ptg003677l,1649086,1649367,281,RepeatMasker,LTR,1647308,1652157,281,1.00
ptg003681l,198796,199118,322,RepeatMasker,LTR,198223,198899,103,0.32
ptg003681l,2639215,2639515,300,RepeatMasker,LTR,2639006,2639567,300,1.00
ptg003681l,2884424,2884723,299,RepeatMasker,LTR,2884344,2884775,299,1.00
ptg003681l,3132898,3133198,300,RepeatMasker,LTR,3132679,3133250,300,1.00
ptg003687l,613276,613557,281,RepeatMasker,LTR,613411,613895,147,0.52
ptg003699l,2635017,2635298,281,RepeatMasker,LTR,2633969,2635941,281,1.00
ptg003699l,4083667,4083975,308,RepeatMasker,LTR,4083480,4083774,107,0.35
ptg003702l,653797,654096,299,RepeatMasker,LTR,653646,654415,299,1.00
ptg003708l,360750,361030,280,RepeatMasker,LTR,360744,361647,280,1.00
ptg003711l,1148584,1148879,295,RepeatMasker,LTR,1148391,1148931,295,1.00
ptg003715l,271339,271636,297,RepeatMasker,LTR,271281,274277,297,1.00
ptg003720l,135628,135923,295,RepeatMasker,LTR,135450,135975,295,1.00
ptg003721l,708076,708389,313,RepeatMasker,LTR,708113,709111,277,0.88
ptg003721l,4489391,4489704,313,RepeatMasker,LTR,4487568,4490502,313,1.00
ptg003721l,4491775,4492088,313,RepeatMasker,LTR,4490891,4492922,313,1.00
ptg003723l,2626994,2627314,320,RepeatMasker,LTR,2626949,2628142,320,1.00
ptg003723l,2626994,2627314,320,RepeatMasker,LTR,2627188,2628178,127,0.40
ptg003725l,1188300,1188592,292,RepeatMasker,LTR,1188029,1189056,292,1.00
ptg003728l,1985962,1986261,299,RepeatMasker,LTR,1986096,1988385,166,0.56
ptg003734l,1487516,1487797,281,RepeatMasker,LTR,1487130,1488388,281,1.00
ptg003737l,5863962,5864288,326,RepeatMasker,LTR,5864248,5865406,41,0.13
ptg003739l,342557,342805,248,RepeatMasker,LTR,338355,346564,248,1.00
ptg003739l,590064,590383,319,RepeatMasker,LTR,590333,592929,51,0.16
ptg003740l,401800,402078,278,RepeatMasker,LTR,401504,401866,66,0.24
ptg003747l,1075764,1076064,300,RepeatMasker,LTR,1074596,1075881,117,0.39
ptg003747l,1219146,1219437,291,RepeatMasker,LTR,1219388,1219451,50,0.17
ptg003748l,1486106,1486434,328,RepeatMasker,LTR,1486360,1486426,67,0.20
ptg003750l,302493,302788,295,RepeatMasker,LTR,302452,302834,295,1.00
ptg003750l,781167,781471,304,RepeatMasker,LTR,781063,781416,249,0.82
ptg003753l,1714787,1715035,248,RepeatMasker,LTR,1710587,1720093,248,1.00
ptg003766l,194967,195286,319,RepeatMasker,LTR,195130,195303,157,0.49
ptg003769l,226759,227048,289,RepeatMasker,LTR,220597,230093,289,1.00
ptg003770l,1202137,1202420,283,RepeatMasker,LTR,1201091,1203056,283,1.00
ptg003770l,1834152,1834446,294,RepeatMasker,LTR,1834426,1835411,21,0.07
ptg003778l,1751442,1751746,304,RepeatMasker,LTR,1751143,1752479,304,1.00
ptg003778l,2652956,2653255,299,RepeatMasker,LTR,2652791,2653305,299,1.00
ptg003782l,1440190,1440481,291,RepeatMasker,LTR,1439790,1440793,291,1.00
ptg003783l,2662460,2662763,303,RepeatMasker,LTR,2662688,2662734,47,0.16
ptg003785l,1480238,1480556,318,RepeatMasker,LTR,1480313,1482160,244,0.77
ptg003786l,32703,32983,280,RepeatMasker,LTR,32318,33788,280,1.00
ptg003791l,5032,5313,281,RepeatMasker,LTR,4621,5957,281,1.00
ptg003804l,1035430,1035729,299,RepeatMasker,LTR,1035255,1035781,299,1.00
ptg003804l,1633650,1633948,298,RepeatMasker,LTR,1633442,1634000,298,1.00
ptg003807l,658538,658830,292,RepeatMasker,LTR,658767,659289,64,0.22
ptg003808l,55816,56115,299,RepeatMasker,LTR,55736,56167,299,1.00
ptg003808l,737186,737464,278,RepeatMasker,LTR,736733,738068,278,1.00
ptg003812l,1816266,1816574,308,RepeatMasker,LTR,1816198,1816267,1,0.00
ptg003812l,1816266,1816574,308,RepeatMasker,LTR,1816535,1822444,40,0.13
ptg003817l,493739,494037,298,RepeatMasker,LTR,493659,494089,298,1.00
ptg003817l,829441,829740,299,RepeatMasker,LTR,829361,829792,299,1.00
ptg003817l,972519,972816,297,RepeatMasker,LTR,972439,972868,297,1.00
ptg003817l,1260620,1260919,299,RepeatMasker,LTR,1260579,1260965,299,1.00
ptg003829l,1226794,1227074,280,RepeatMasker,LTR,1225652,1227710,280,1.00
ptg003831l,1162779,1163060,281,RepeatMasker,LTR,1161735,1163853,281,1.00
ptg003831l,2538016,2538322,306,RepeatMasker,LTR,2538026,2538348,297,0.97
ptg003836l,1400747,1401034,287,RepeatMasker,LTR,1396175,1401869,287,1.00
ptg003838l,574357,574655,298,RepeatMasker,LTR,574519,576039,137,0.46
ptg003839l,1775888,1776205,317,RepeatMasker,LTR,1775812,1775951,63,0.20
ptg003839l,3113024,3113322,298,RepeatMasker,LTR,3113274,3113355,49,0.16
ptg003839l,9444483,9444782,299,RepeatMasker,LTR,9444289,9444834,299,1.00
ptg003841l,1231369,1231658,289,RepeatMasker,LTR,1231281,1231793,289,1.00
ptg003841l,1516196,1516491,295,RepeatMasker,LTR,1516341,1516527,151,0.51
ptg003841l,1835243,1835578,335,RepeatMasker,LTR,1835352,1835397,46,0.14
ptg003843l,1294450,1294749,299,RepeatMasker,LTR,1294370,1294801,299,1.00
ptg003843l,1465609,1465897,288,RepeatMasker,LTR,1464754,1465633,24,0.08
ptg003846l,805970,806233,263,RepeatMasker,LTR,805674,806374,263,1.00
ptg003846l,1651610,1651890,280,RepeatMasker,LTR,1651195,1652534,280,1.00
ptg003846l,1993421,1993718,297,RepeatMasker,LTR,1993263,1993517,96,0.32
ptg003850l,1373672,1373971,299,RepeatMasker,LTR,1373819,1374746,153,0.51
ptg003852l,518538,518854,316,RepeatMasker,LTR,518498,518543,5,0.02
ptg003872l,855292,855606,314,RepeatMasker,LTR,854713,859584,314,1.00
ptg003873l,20268,20593,325,RepeatMasker,LTR,20544,20617,50,0.15
ptg003873l,20268,20593,325,RepeatMasker,LTR,20555,26492,39,0.12
ptg003873l,1291120,1291422,302,RepeatMasker,LTR,1291415,1296649,8,0.03
ptg003873l,3325282,3325554,272,RepeatMasker,LTR,3325268,3325993,272,1.00
ptg003883l,667803,668102,299,RepeatMasker,LTR,667609,668154,299,1.00
ptg003884l,751875,752178,303,RepeatMasker,LTR,751627,752171,296,0.98
ptg003887l,2272133,2272428,295,RepeatMasker,LTR,2271953,2272480,295,1.00
ptg003891l,233857,234152,295,RepeatMasker,LTR,233785,233942,85,0.29
ptg003892l,1200459,1200740,281,RepeatMasker,LTR,1200077,1200753,281,1.00
ptg003895l,613129,613408,279,RepeatMasker,LTR,612788,613214,85,0.30
ptg003897l,2965139,2965461,322,RepeatMasker,LTR,2965365,2965398,34,0.11
ptg003916l,2153033,2153338,305,RepeatMasker,LTR,2153267,2153403,72,0.24
ptg003917l,803172,803494,322,RepeatMasker,LTR,803443,806080,52,0.16
ptg003917l,1842839,1843127,288,RepeatMasker,LTR,1841843,1843521,288,1.00
ptg003917l,2207186,2207507,321,RepeatMasker,LTR,2206703,2207278,92,0.29
ptg003921l,89759,90055,296,RepeatMasker,LTR,89645,89860,101,0.34
ptg003921l,89759,90055,296,RepeatMasker,LTR,89908,90773,148,0.50
ptg003921l,1656675,1656975,300,RepeatMasker,LTR,1656924,1657012,52,0.17
ptg003921l,1656675,1656975,300,RepeatMasker,LTR,1656947,1661522,29,0.10
ptg003921l,1907560,1907859,299,RepeatMasker,LTR,1907395,1907911,299,1.00
ptg003921l,2569667,2569966,299,RepeatMasker,LTR,2569489,2570018,299,1.00
ptg003923l,1131691,1132004,313,RepeatMasker,LTR,1127691,1131878,187,0.60
ptg003923l,2906586,2906889,303,RepeatMasker,LTR,2906599,2906643,45,0.15
ptg003923l,3606029,3606320,291,RepeatMasker,LTR,3606265,3606331,56,0.19
ptg003923l,3606029,3606320,291,RepeatMasker,LTR,3606296,3606347,25,0.09
ptg003925l,14856,15153,297,RepeatMasker,LTR,14815,15199,297,1.00
ptg003925l,485549,485846,297,RepeatMasker,LTR,485355,485898,297,1.00
ptg003934l,1678571,1678852,281,RepeatMasker,LTR,1678189,1679277,281,1.00
ptg003936l,825187,825487,300,RepeatMasker,LTR,824986,825539,300,1.00
ptg003938l,2015656,2015970,314,RepeatMasker,LTR,2015663,2015707,45,0.14
ptg003939l,281835,282105,270,RepeatMasker,LTR,282098,282329,8,0.03
ptg003950l,5595438,5595737,299,RepeatMasker,LTR,5595397,5595789,299,1.00
ptg003951l,592835,593142,307,RepeatMasker,LTR,593136,593209,7,0.02
ptg003957l,1530723,1531013,290,RepeatMasker,LTR,1530313,1531020,290,1.00
ptg003957l,1530723,1531013,290,RepeatMasker,LTR,1530718,1531657,290,1.00
ptg003959l,353985,354267,282,RepeatMasker,LTR,352952,355068,282,1.00
ptg003964l,1419996,1420280,284,RepeatMasker,LTR,1420047,1421264,234,0.82
ptg003964l,2683463,2683749,286,RepeatMasker,LTR,2683266,2683614,151,0.53
ptg003964l,2683463,2683749,286,RepeatMasker,LTR,2683727,2683776,23,0.08
ptg003964l,3362022,3362314,292,RepeatMasker,LTR,3362264,3363055,51,0.17
ptg003964l,6350855,6351164,309,RepeatMasker,LTR,6351053,6351096,44,0.14
ptg003965l,199159,199458,299,RepeatMasker,LTR,198952,199510,299,1.00
ptg003968l,4149767,4150087,320,RepeatMasker,LTR,4149974,4150861,114,0.36
ptg003968l,4694667,4694976,309,RepeatMasker,LTR,4693522,4694730,63,0.20
ptg003968l,4694667,4694976,309,RepeatMasker,LTR,4694872,4696803,105,0.34
ptg003968l,5030181,5030480,299,RepeatMasker,LTR,5030005,5030532,299,1.00
ptg003969l,3049,3341,292,RepeatMasker,LTR,2880,3393,292,1.00
ptg003983l,636457,636791,334,RepeatMasker,LTR,635722,637702,334,1.00
ptg003985l,121738,122030,292,RepeatMasker,LTR,121396,122730,292,1.00
ptg003987l,1165282,1165585,303,RepeatMasker,LTR,1165177,1165315,33,0.11
ptg003994l,1102585,1102870,285,RepeatMasker,LTR,1102831,1104065,40,0.14
ptg003994l,3691286,3691578,292,RepeatMasker,LTR,3690921,3694407,292,1.00
ptg003995l,2315250,2315539,289,RepeatMasker,LTR,2315254,2316643,286,0.99
ptg003998l,1679708,1680010,302,RepeatMasker,LTR,1679348,1680804,302,1.00
ptg003998l,3433265,3433589,324,RepeatMasker,LTR,3433491,3434534,99,0.31
ptg004007l,394896,395191,295,RepeatMasker,LTR,394881,395003,107,0.36
ptg004008l,3831333,3831612,279,RepeatMasker,LTR,3831219,3831755,279,1.00
ptg004008l,7981529,7981867,338,RepeatMasker,LTR,7980953,7981594,65,0.19
ptg004010l,1354672,1354953,281,RepeatMasker,LTR,1353479,1355594,281,1.00
ptg004012l,157142,157441,299,RepeatMasker,LTR,153772,157791,299,1.00
ptg004012l,4156555,4156868,313,RepeatMasker,LTR,4156357,4157811,313,1.00
ptg004014l,4486809,4487108,299,RepeatMasker,LTR,4486601,4487161,299,1.00
ptg004016l,2170795,2171086,291,RepeatMasker,LTR,2170602,2174727,291,1.00
ptg004020l,156984,157313,329,RepeatMasker,LTR,157055,157165,111,0.34
ptg004021l,1051484,1051772,288,RepeatMasker,LTR,1051606,1058686,167,0.58
ptg004021l,4520613,4520925,312,RepeatMasker,LTR,4520893,4521642,33,0.11
ptg004023l,3730536,3730816,280,RepeatMasker,LTR,3728151,3730589,53,0.19
ptg004029l,239285,239578,293,RepeatMasker,LTR,239107,239630,293,1.00
ptg004029l,405127,405424,297,RepeatMasker,LTR,404919,405476,297,1.00
ptg004030l,536865,537192,327,RepeatMasker,LTR,536557,537332,327,1.00
ptg004030l,536865,537192,327,RepeatMasker,LTR,536845,537594,327,1.00
ptg004033l,11050262,11050596,334,RepeatMasker,LTR,11050464,11050752,133,0.40
ptg004037l,558315,558627,312,RepeatMasker,LTR,558212,559253,312,1.00
ptg004048l,64823,65130,307,RepeatMasker,LTR,64134,65175,307,1.00
ptg004048l,64823,65130,307,RepeatMasker,LTR,64175,65671,307,1.00
ptg004049l,1890683,1890978,295,RepeatMasker,LTR,1887800,1891139,295,1.00
ptg004052l,41074,41354,280,RepeatMasker,LTR,40682,42134,280,1.00
ptg004058l,211688,211987,299,RepeatMasker,LTR,211510,212039,299,1.00
ptg004060l,119062,119379,317,RepeatMasker,LTR,119340,124234,40,0.13
ptg004068l,2839714,2839993,279,RepeatMasker,LTR,2839384,2840765,279,1.00
ptg004070l,74909,75221,312,RepeatMasker,LTR,75115,79667,107,0.34
ptg004073l,1307723,1308025,302,RepeatMasker,LTR,1307336,1308670,302,1.00
ptg004082l,2632413,2632725,312,RepeatMasker,LTR,2629087,2632458,45,0.14
ptg004082l,2632413,2632725,312,RepeatMasker,LTR,2632457,2632759,269,0.86
ptg004082l,4672786,4673097,311,RepeatMasker,LTR,4672945,4672988,44,0.14
ptg004087l,700329,700640,311,RepeatMasker,LTR,699303,701055,311,1.00
ptg004088l,496415,496730,315,RepeatMasker,LTR,496319,496479,64,0.20
ptg004090l,85131,85422,291,RepeatMasker,LTR,84971,85474,291,1.00
ptg004090l,145416,145713,297,RepeatMasker,LTR,145396,145765,297,1.00
ptg004092l,625493,625802,309,RepeatMasker,LTR,624712,626053,309,1.00
ptg004092l,625493,625802,309,RepeatMasker,LTR,624879,626001,309,1.00
ptg004092l,915610,915902,292,RepeatMasker,LTR,915246,916173,292,1.00
ptg004093l,364918,365222,304,RepeatMasker,LTR,364223,365872,304,1.00
ptg004093l,823671,823951,280,RepeatMasker,LTR,823313,824732,280,1.00
ptg004093l,831603,831883,280,RepeatMasker,LTR,831286,832519,280,1.00
ptg004096l,38171,38448,277,RepeatMasker,LTR,37961,38506,277,1.00
ptg004096l,750673,750986,313,RepeatMasker,LTR,750639,750769,96,0.31
ptg004096l,750673,750986,313,RepeatMasker,LTR,750707,750782,76,0.24
ptg004097l,1433895,1434190,295,RepeatMasker,LTR,1433660,1433960,65,0.22
ptg004104l,339523,339805,282,RepeatMasker,LTR,338693,340896,282,1.00
ptg004107l,539460,539764,304,RepeatMasker,LTR,538889,539463,3,0.01
ptg004117l,156075,156386,311,RepeatMasker,LTR,156220,163216,167,0.54
ptg004123l,1811567,1811840,273,RepeatMasker,LTR,1810522,1812640,273,1.00
ptg004123l,1818742,1819023,281,RepeatMasker,LTR,1817607,1819056,281,1.00
ptg004126l,478817,479122,305,RepeatMasker,LTR,478788,479011,194,0.64
ptg004129l,130327,130610,283,RepeatMasker,LTR,127789,131227,283,1.00
ptg004133l,1683456,1683748,292,RepeatMasker,LTR,1683114,1684446,292,1.00
ptg004135l,2795050,2795349,299,RepeatMasker,LTR,2794872,2795401,299,1.00
ptg004135l,3151989,3152289,300,RepeatMasker,LTR,3151988,3152137,148,0.49
ptg004135l,3151989,3152289,300,RepeatMasker,LTR,3151998,3152209,212,0.71
ptg004136l,1902077,1902374,297,RepeatMasker,LTR,1901901,1902426,297,1.00
ptg004136l,3533454,3533749,295,RepeatMasker,LTR,3533276,3533801,295,1.00
ptg004136l,3915525,3915824,299,RepeatMasker,LTR,3915360,3915876,299,1.00
ptg004139l,1227092,1227387,295,RepeatMasker,LTR,1226909,1227439,295,1.00
ptg004141l,266518,266802,284,RepeatMasker,LTR,266493,266541,23,0.08
ptg004143l,97694,97974,280,RepeatMasker,LTR,96637,97987,280,1.00
ptg004145l,1235717,1236030,313,RepeatMasker,LTR,1235976,1236041,55,0.18
ptg004145l,1235717,1236030,313,RepeatMasker,LTR,1236001,1236063,30,0.10
ptg004145l,3652725,3653005,280,RepeatMasker,LTR,3651578,3653646,280,1.00
ptg004147l,484291,484577,286,RepeatMasker,LTR,482722,485431,286,1.00
ptg004147l,1012308,1012617,309,RepeatMasker,LTR,1012455,1013708,163,0.53
ptg004148l,1269442,1269744,302,RepeatMasker,LTR,1269663,1270665,82,0.27
ptg004157l,150219,150509,290,RepeatMasker,LTR,149085,151148,290,1.00
ptg004162l,118243,118514,271,RepeatMasker,LTR,118312,118510,199,0.73
ptg004162l,2113134,2113440,306,RepeatMasker,LTR,2113085,2113226,92,0.30
ptg004164l,256165,256470,305,RepeatMasker,LTR,255661,256186,21,0.07
ptg004167l,2752260,2752553,293,RepeatMasker,LTR,2751792,2752299,39,0.13
ptg004168l,130865,131167,302,RepeatMasker,LTR,131143,131757,25,0.08
ptg004168l,3221355,3221643,288,RepeatMasker,LTR,3221548,3222781,96,0.33
ptg004172l,306536,306819,283,RepeatMasker,LTR,306681,307045,139,0.49
ptg004173l,2190771,2191052,281,RepeatMasker,LTR,2190389,2191847,281,1.00
ptg004179l,2486552,2486839,287,RepeatMasker,LTR,2486332,2487009,287,1.00
ptg004180l,1866407,1866737,330,RepeatMasker,LTR,1866416,1866482,67,0.20
ptg004189l,2025458,2025751,293,RepeatMasker,LTR,2025701,2027905,51,0.17
ptg004192l,50357,50645,288,RepeatMasker,LTR,50617,51943,29,0.10
ptg004192l,4245761,4246058,297,RepeatMasker,LTR,4245681,4246110,297,1.00
ptg004199l,1045099,1045381,282,RepeatMasker,LTR,1042322,1045387,282,1.00
ptg004199l,2145005,2145334,329,RepeatMasker,LTR,2145308,2145359,27,0.08
ptg004199l,2890774,2891057,283,RepeatMasker,LTR,2890753,2890797,23,0.08
ptg004199l,5479255,5479561,306,RepeatMasker,LTR,5478814,5480987,306,1.00
ptg004199l,5479255,5479561,306,RepeatMasker,LTR,5479031,5484307,306,1.00
ptg004208l,6648587,6648867,280,RepeatMasker,LTR,6648197,6649665,280,1.00
ptg004213l,917365,917692,327,RepeatMasker,LTR,917607,917808,86,0.26
ptg004221l,612729,613008,279,RepeatMasker,LTR,612164,613802,279,1.00
ptg004222l,915975,916270,295,RepeatMasker,LTR,915765,916322,295,1.00
ptg004222l,1555487,1555786,299,RepeatMasker,LTR,1555311,1555838,299,1.00
ptg004233l,4436259,4436601,342,RepeatMasker,LTR,4436168,4436501,242,0.71
ptg004233l,4436259,4436601,342,RepeatMasker,LTR,4436500,4436782,102,0.30
ptg004239l,744839,745119,280,RepeatMasker,LTR,742226,746506,280,1.00
ptg004239l,2186456,2186768,312,RepeatMasker,LTR,2186182,2188198,312,1.00
ptg004242l,423541,423845,304,RepeatMasker,LTR,423832,424320,14,0.05
ptg004242l,1092484,1092776,292,RepeatMasker,LTR,1092557,1093634,220,0.75
ptg004245l,803413,803726,313,RepeatMasker,LTR,803720,803948,7,0.02
ptg004245l,3021760,3022038,278,RepeatMasker,LTR,3021888,3022009,122,0.44
ptg004247l,403678,403966,288,RepeatMasker,LTR,403777,403819,43,0.15
ptg004248l,2525589,2525883,294,RepeatMasker,LTR,2525712,2532747,172,0.59
ptg004257l,634587,634886,299,RepeatMasker,LTR,634391,634938,299,1.00
ptg004257l,1004359,1004658,299,RepeatMasker,LTR,1004148,1004710,299,1.00
ptg004264l,118779,119075,296,RepeatMasker,LTR,119069,119282,7,0.02
ptg004267l,2043446,2043729,283,RepeatMasker,LTR,2042445,2043532,86,0.30
ptg004268l,360309,360618,309,RepeatMasker,LTR,360326,361418,293,0.95
ptg004277l,2426269,2426553,284,RepeatMasker,LTR,2425887,2426568,284,1.00
ptg004279l,145545,145826,281,RepeatMasker,LTR,144532,145852,281,1.00
ptg004284l,264929,265234,305,RepeatMasker,LTR,264824,265123,194,0.64
ptg004287l,144521,144801,280,RepeatMasker,LTR,144137,144814,280,1.00
ptg004288l,642218,642530,312,RepeatMasker,LTR,642424,646975,107,0.34
ptg004291l,3437980,3438277,297,RepeatMasker,LTR,3438070,3438551,208,0.70
ptg004295l,130925,131205,280,RepeatMasker,LTR,129810,131218,280,1.00
ptg004295l,197545,197851,306,RepeatMasker,LTR,196768,199689,306,1.00
ptg004300l,1248717,1249027,310,RepeatMasker,LTR,1248940,1249072,88,0.28
ptg004302l,580443,580744,301,RepeatMasker,LTR,580487,580887,258,0.86
ptg004302l,1049904,1050220,316,RepeatMasker,LTR,1050170,1052306,51,0.16
ptg004309l,204422,204705,283,RepeatMasker,LTR,204314,204522,100,0.35
ptg004309l,204422,204705,283,RepeatMasker,LTR,204482,204550,69,0.24
ptg004313l,304564,304875,311,RepeatMasker,LTR,304672,306641,204,0.66
ptg004314l,1125128,1125427,299,RepeatMasker,LTR,1125108,1125461,299,1.00
ptg004315l,357686,357987,301,RepeatMasker,LTR,357179,358312,301,1.00
ptg004321l,572923,573225,302,RepeatMasker,LTR,571223,573078,155,0.51
ptg004321l,3517302,3517579,277,RepeatMasker,LTR,3517281,3517325,23,0.08
ptg004323l,3259376,3259671,295,RepeatMasker,LTR,3259009,3259683,295,1.00
ptg004327l,552520,552840,320,RepeatMasker,LTR,552796,552984,45,0.14
ptg004327l,3830093,3830389,296,RepeatMasker,LTR,3829915,3830441,296,1.00
ptg004327l,4019804,4020129,325,RepeatMasker,LTR,4019569,4019985,181,0.56
ptg004330l,2489019,2489318,299,RepeatMasker,LTR,2488939,2489370,299,1.00
ptg004332l,93643,93948,305,RepeatMasker,LTR,93920,96482,29,0.10
ptg004337l,964972,965273,301,RepeatMasker,LTR,964723,965302,301,1.00
ptg004345l,742918,743205,287,RepeatMasker,LTR,742159,743682,287,1.00
ptg004345l,2182900,2183181,281,RepeatMasker,LTR,2182517,2183828,281,1.00
ptg004349l,1789366,1789643,277,RepeatMasker,LTR,1788313,1789596,230,0.83
ptg004349l,1789366,1789643,277,RepeatMasker,LTR,1789609,1789967,35,0.13
ptg004349l,2126780,2127077,297,RepeatMasker,LTR,2126623,2127129,297,1.00
ptg004351l,1391329,1391610,281,RepeatMasker,LTR,1390412,1391638,281,1.00
ptg004354l,288264,288571,307,RepeatMasker,LTR,288408,291990,164,0.53
ptg004356l,612070,612384,314,RepeatMasker,LTR,612204,613720,181,0.58
ptg004362l,5136083,5136369,286,RepeatMasker,LTR,5133310,5140282,286,1.00
ptg004364l,1909004,1909292,288,RepeatMasker,LTR,1909291,1909479,2,0.01
ptg004368l,298713,298986,273,RepeatMasker,LTR,298746,298985,240,0.88
ptg004368l,304700,304978,278,RepeatMasker,LTR,304738,305030,241,0.87
ptg004371l,842377,842658,281,RepeatMasker,LTR,841334,842677,281,1.00
ptg004372l,610264,610545,281,RepeatMasker,LTR,609875,610578,281,1.00
ptg004373l,347063,347358,295,RepeatMasker,LTR,345969,347391,295,1.00
ptg004374l,793152,793467,315,RepeatMasker,LTR,792803,793454,302,0.96
ptg004380l,901012,901334,322,RepeatMasker,LTR,901226,902363,109,0.34
ptg004383l,717883,718163,280,RepeatMasker,LTR,717501,718958,280,1.00
ptg004383l,808928,809206,278,RepeatMasker,LTR,808546,810008,278,1.00
ptg004384l,282662,282970,308,RepeatMasker,LTR,282224,283290,308,1.00
ptg004384l,600003,600284,281,RepeatMasker,LTR,598875,600929,281,1.00
ptg004386l,2102417,2102716,299,RepeatMasker,LTR,2102628,2106620,89,0.30
ptg004399l,355615,355896,281,RepeatMasker,LTR,354070,355956,281,1.00
ptg004404l,947979,948266,287,RepeatMasker,LTR,947335,951103,287,1.00
ptg004404l,2554833,2555120,287,RepeatMasker,LTR,2551145,2555982,287,1.00
ptg004406l,1688984,1689267,283,RepeatMasker,LTR,1687436,1690125,283,1.00
ptg004408l,135288,135570,282,RepeatMasker,LTR,134237,135583,282,1.00
ptg004408l,142462,142741,279,RepeatMasker,LTR,141328,142754,279,1.00
ptg004410l,719086,719420,334,RepeatMasker,LTR,719401,719448,20,0.06
ptg004411l,1281292,1281571,279,RepeatMasker,LTR,1276770,1284137,279,1.00
ptg004411l,2650891,2651195,304,RepeatMasker,LTR,2649162,2653587,304,1.00
ptg004414l,941306,941603,297,RepeatMasker,LTR,941226,941655,297,1.00
ptg004417l,2377410,2377736,326,RepeatMasker,LTR,2377203,2378614,326,1.00
ptg004420l,1412760,1413057,297,RepeatMasker,LTR,1413031,1413325,27,0.09
ptg004422l,2016048,2016347,299,RepeatMasker,LTR,2015840,2016399,299,1.00
ptg004422l,3642685,3642985,300,RepeatMasker,LTR,3638327,3644131,300,1.00
ptg004423l,1776204,1776525,321,RepeatMasker,LTR,1776428,1776740,98,0.31
ptg004434l,173136,173420,284,RepeatMasker,LTR,171914,173252,116,0.41
ptg004443l,445279,445563,284,RepeatMasker,LTR,443504,447003,284,1.00
ptg004443l,1403145,1403425,280,RepeatMasker,LTR,1402985,1403420,275,0.98
ptg004452l,2405381,2405661,280,RepeatMasker,LTR,2404333,2406440,280,1.00
ptg004453l,479309,479602,293,RepeatMasker,LTR,479596,479823,7,0.02
ptg004455l,322196,322483,287,RepeatMasker,LTR,317958,323342,287,1.00
ptg004456l,949266,949594,328,RepeatMasker,LTR,948579,949853,328,1.00
ptg004456l,2930437,2930736,299,RepeatMasker,LTR,2930357,2930788,299,1.00
ptg004457l,362200,362500,300,RepeatMasker,LTR,361988,362552,300,1.00
ptg004460l,1261213,1261505,292,RepeatMasker,LTR,1260871,1264341,292,1.00
ptg004468l,2457733,2458032,299,RepeatMasker,LTR,2457549,2458084,299,1.00
ptg004477l,531238,531551,313,RepeatMasker,LTR,528553,532222,313,1.00
ptg004479l,3238547,3238846,299,RepeatMasker,LTR,3238556,3238898,291,0.97
ptg004489l,2019716,2019997,281,RepeatMasker,LTR,2019710,2020034,281,1.00
ptg004491l,145279,145584,305,RepeatMasker,LTR,145281,145636,304,1.00
ptg004491l,1278722,1279016,294,RepeatMasker,LTR,1278858,1279382,159,0.54
ptg004491l,2317704,2318015,311,RepeatMasker,LTR,2317077,2318129,311,1.00
ptg004492l,2185987,2186286,299,RepeatMasker,LTR,2185907,2186338,299,1.00
ptg004493l,1703261,1703546,285,RepeatMasker,LTR,1703383,1706831,164,0.58
ptg004503l,626039,626320,281,RepeatMasker,LTR,624990,627104,281,1.00
ptg004510l,839912,840211,299,RepeatMasker,LTR,839705,840263,299,1.00
ptg004510l,2874108,2874412,304,RepeatMasker,LTR,2873507,2874949,304,1.00
ptg004512l,3413760,3414046,286,RepeatMasker,LTR,3411238,3414634,286,1.00
ptg004513l,1209496,1209781,285,RepeatMasker,LTR,1209533,1209598,66,0.23
ptg004513l,2073894,2074189,295,RepeatMasker,LTR,2073689,2074241,295,1.00
ptg004515l,440793,441092,299,RepeatMasker,LTR,440586,441144,299,1.00
ptg004521l,1506310,1506612,302,RepeatMasker,LTR,1505581,1507865,302,1.00
ptg004521l,1506316,1506618,302,RepeatMasker,LTR,1505581,1507865,302,1.00
ptg004521l,2504070,2504338,268,RepeatMasker,LTR,2504106,2504150,45,0.17
ptg004523l,3546630,3546922,292,RepeatMasker,LTR,3546485,3546856,226,0.77
ptg004523l,5478454,5478744,290,RepeatMasker,LTR,5478085,5479338,290,1.00
ptg004528l,635067,635371,304,RepeatMasker,LTR,633861,635395,304,1.00
ptg004528l,1061524,1061857,333,RepeatMasker,LTR,1061775,1061904,83,0.25
ptg004530l,4753213,4753490,277,RepeatMasker,LTR,4753132,4754989,277,1.00
ptg004530l,5428297,5428592,295,RepeatMasker,LTR,5428119,5428644,295,1.00
ptg004535l,1260866,1261142,276,RepeatMasker,LTR,1261044,1261290,99,0.36
ptg004535l,1988968,1989277,309,RepeatMasker,LTR,1989247,1990811,31,0.10
ptg004538l,1917631,1917912,281,RepeatMasker,LTR,1916487,1917945,281,1.00
ptg004540l,43431,43718,287,RepeatMasker,LTR,43298,43444,13,0.05
ptg004541l,1753627,1753949,322,RepeatMasker,LTR,1752340,1756410,322,1.00
ptg004541l,2092811,2093108,297,RepeatMasker,LTR,2092770,2093160,297,1.00
ptg004541l,2246726,2247021,295,RepeatMasker,LTR,2246646,2247073,295,1.00
ptg004544l,4076764,4077039,275,RepeatMasker,LTR,4076911,4077426,129,0.47
ptg004549l,41766,42047,281,RepeatMasker,LTR,41389,42848,281,1.00
ptg004549l,815533,815831,298,RepeatMasker,LTR,814774,816870,298,1.00
ptg004552l,105399,105695,296,RepeatMasker,LTR,105190,105747,296,1.00
ptg004553l,304928,305226,298,RepeatMasker,LTR,305203,305592,24,0.08
ptg004555l,2650916,2651196,280,RepeatMasker,LTR,2650403,2651978,280,1.00
ptg004556l,2850683,2850973,290,RepeatMasker,LTR,2847810,2851061,290,1.00
ptg004556l,2945505,2945793,288,RepeatMasker,LTR,2945687,2945849,107,0.37
ptg004558l,1235707,1236005,298,RepeatMasker,LTR,1235709,1236649,297,1.00
ptg004561l,674507,674814,307,RepeatMasker,LTR,672784,678766,307,1.00
ptg004563l,3796536,3796825,289,RepeatMasker,LTR,3795467,3797469,289,1.00
ptg004573l,70269,70583,314,RepeatMasker,LTR,70351,70395,45,0.14
ptg004578l,146309,146640,331,RepeatMasker,LTR,146410,146626,217,0.66
ptg004578l,1224338,1224615,277,RepeatMasker,LTR,1221283,1227202,277,1.00
ptg004578l,1297507,1297804,297,RepeatMasker,LTR,1297427,1297856,297,1.00
ptg004584l,815428,815725,297,RepeatMasker,LTR,815659,820325,67,0.23
ptg004585l,161221,161544,323,RepeatMasker,LTR,160764,161260,39,0.12
ptg004591l,658257,658534,277,RepeatMasker,LTR,658394,659057,141,0.51
ptg004594l,619316,619628,312,RepeatMasker,LTR,616885,620219,312,1.00
ptg004610l,1602540,1602852,312,RepeatMasker,LTR,1601912,1602922,312,1.00
ptg004618l,2380772,2381084,312,RepeatMasker,LTR,2380457,2381724,312,1.00
ptg004619l,2687610,2687890,280,RepeatMasker,LTR,2687236,2688693,280,1.00
ptg004620l,1704691,1705023,332,RepeatMasker,LTR,1704831,1705373,193,0.58
ptg004620l,2479862,2480188,326,RepeatMasker,LTR,2479841,2480988,326,1.00
ptg004620l,2559572,2559874,302,RepeatMasker,LTR,2559645,2560747,230,0.76
ptg004621l,674506,674805,299,RepeatMasker,LTR,674298,674857,299,1.00
ptg004637l,1512737,1513067,330,RepeatMasker,LTR,1511278,1513876,330,1.00
ptg004639l,2353254,2353583,329,RepeatMasker,LTR,2353242,2354350,329,1.00
ptg004639l,2717104,2717392,288,RepeatMasker,LTR,2712183,2719159,288,1.00
ptg004639l,4115587,4115886,299,RepeatMasker,LTR,4115615,4115920,272,0.91
ptg004639l,4411054,4411350,296,RepeatMasker,LTR,4410876,4411402,296,1.00
ptg004639l,4810202,4810499,297,RepeatMasker,LTR,4809994,4810551,297,1.00
ptg004642l,1996175,1996456,281,RepeatMasker,LTR,1995782,1997264,281,1.00
ptg004642l,2003335,2003616,281,RepeatMasker,LTR,2002945,2004268,281,1.00
ptg004648l,1482735,1483023,288,RepeatMasker,LTR,1482856,1489916,168,0.58
ptg004648l,1615221,1615514,293,RepeatMasker,LTR,1615497,1616347,18,0.06
ptg004658l,2249567,2249836,269,RepeatMasker,LTR,2249777,2249843,60,0.22
ptg004658l,2249567,2249836,269,RepeatMasker,LTR,2249785,2249843,52,0.19
ptg004674l,2637939,2638242,303,RepeatMasker,LTR,2638064,2638166,103,0.34
ptg004674l,2637939,2638242,303,RepeatMasker,LTR,2638149,2638713,94,0.31
ptg004676l,60182,60517,335,RepeatMasker,LTR,60321,60431,111,0.33
ptg004677l,2993338,2993665,327,RepeatMasker,LTR,2993599,2993941,67,0.20
ptg004677l,2993338,2993665,327,RepeatMasker,LTR,2993635,2994052,31,0.09
ptg004677l,3435546,3435845,299,RepeatMasker,LTR,3435466,3435897,299,1.00
ptg004677l,3520941,3521257,316,RepeatMasker,LTR,3520259,3521254,313,0.99
ptg004677l,3520941,3521257,316,RepeatMasker,LTR,3521251,3521477,7,0.02
ptg004678l,186846,187126,280,RepeatMasker,LTR,186519,187897,280,1.00
ptg004679l,1704408,1704670,262,RepeatMasker,LTR,1703156,1706375,262,1.00
ptg004680l,889800,890120,320,RepeatMasker,LTR,889903,890352,218,0.68
ptg004682l,3393815,3394095,280,RepeatMasker,LTR,3393514,3394123,280,1.00
ptg004685l,753216,753549,333,RepeatMasker,LTR,751948,753349,133,0.40
ptg004685l,753216,753549,333,RepeatMasker,LTR,753425,756231,125,0.38
ptg004688l,100658,100939,281,RepeatMasker,LTR,100282,101737,281,1.00
ptg004693l,1162280,1162600,320,RepeatMasker,LTR,1162550,1168797,51,0.16
ptg004699l,1302834,1303142,308,RepeatMasker,LTR,1302352,1302921,87,0.28
ptg004699l,1302834,1303142,308,RepeatMasker,LTR,1303114,1303184,29,0.09
ptg004699l,1849802,1850103,301,RepeatMasker,LTR,1850097,1850132,7,0.02
ptg004705l,260802,261129,327,RepeatMasker,LTR,260782,261530,327,1.00
ptg004705l,260802,261129,327,RepeatMasker,LTR,260782,261928,327,1.00
ptg004717l,658272,658565,293,RepeatMasker,LTR,658096,658617,293,1.00
ptg004717l,683615,683897,282,RepeatMasker,LTR,681261,684809,282,1.00
ptg004719l,56534,56829,295,RepeatMasker,LTR,56355,56881,295,1.00
ptg004720l,1534095,1534375,280,RepeatMasker,LTR,1533336,1535008,280,1.00
ptg004724l,1511736,1512025,289,RepeatMasker,LTR,1509675,1512882,289,1.00
ptg004728l,1153357,1153637,280,RepeatMasker,LTR,1148898,1154259,280,1.00
ptg004728l,1196430,1196710,280,RepeatMasker,LTR,1196030,1196723,280,1.00
ptg004728l,1203565,1203855,290,RepeatMasker,LTR,1203198,1203882,290,1.00
ptg004728l,1203565,1203855,290,RepeatMasker,LTR,1203269,1203868,290,1.00
ptg004728l,3199238,3199534,296,RepeatMasker,LTR,3199029,3199586,296,1.00
ptg004730l,1466452,1466761,309,RepeatMasker,LTR,1466731,1469468,31,0.10
ptg004730l,3552718,3553001,283,RepeatMasker,LTR,3552325,3553020,283,1.00
ptg004730l,3571045,3571325,280,RepeatMasker,LTR,3570734,3571970,280,1.00
ptg004734l,52424,52723,299,RepeatMasker,LTR,52246,52775,299,1.00
ptg004734l,188544,188843,299,RepeatMasker,LTR,188350,188877,299,1.00
ptg004734l,4688824,4689151,327,RepeatMasker,LTR,4689101,4692228,51,0.16
ptg004735l,375569,375867,298,RepeatMasker,LTR,375725,380339,143,0.48
ptg004742l,1861799,1862080,281,RepeatMasker,LTR,1860933,1862861,281,1.00
ptg004742l,2836603,2836882,279,RepeatMasker,LTR,2836225,2838363,279,1.00
ptg004749l,479441,479740,299,RepeatMasker,LTR,475874,479955,299,1.00
ptg004758l,731574,731867,293,RepeatMasker,LTR,731725,731900,143,0.49
ptg004758l,1024252,1024551,299,RepeatMasker,LTR,1024074,1024603,299,1.00
ptg004758l,1468767,1469057,290,RepeatMasker,LTR,1468178,1471492,290,1.00
ptg004768l,43799,44092,293,RepeatMasker,LTR,43978,44050,73,0.25
ptg004774l,66745,67073,328,RepeatMasker,LTR,67067,67271,7,0.02
ptg004774l,69350,69661,311,RepeatMasker,LTR,68094,69477,127,0.41
ptg004774l,69350,69661,311,RepeatMasker,LTR,69542,73072,120,0.39
ptg004775l,1455523,1455811,288,RepeatMasker,LTR,1453124,1455729,206,0.72
ptg004777l,568912,569218,306,RepeatMasker,LTR,566978,569519,306,1.00
ptg004777l,623982,624277,295,RepeatMasker,LTR,623902,624329,295,1.00
ptg004782l,59905,60197,292,RepeatMasker,LTR,59976,63157,222,0.76
ptg004785l,669975,670223,248,RepeatMasker,LTR,665756,673088,248,1.00
ptg004788l,697947,698236,289,RepeatMasker,LTR,697138,699235,289,1.00
ptg004790l,348957,349259,302,RepeatMasker,LTR,348047,349001,44,0.15
ptg004795l,39560,39879,319,RepeatMasker,LTR,39308,40191,319,1.00
ptg004795l,2078422,2078716,294,RepeatMasker,LTR,2074268,2083767,294,1.00
ptg004816l,4887970,4888257,287,RepeatMasker,LTR,4883312,4889137,287,1.00
ptg004839l,842990,843276,286,RepeatMasker,LTR,842367,844131,286,1.00
ptg004840l,1075449,1075742,293,RepeatMasker,LTR,1075692,1075982,51,0.17
ptg004840l,1126383,1126672,289,RepeatMasker,LTR,1126293,1127315,289,1.00
ptg004841l,3979538,3979840,302,RepeatMasker,LTR,3977512,3980387,302,1.00
ptg004849l,1267678,1267958,280,RepeatMasker,LTR,1267599,1267984,280,1.00
ptg004850l,2717871,2718192,321,RepeatMasker,LTR,2718142,2722830,51,0.16
ptg004852l,7116,7418,302,RepeatMasker,LTR,7397,11267,22,0.07
ptg004852l,868371,868670,299,RepeatMasker,LTR,868399,868724,272,0.91
ptg004857l,324667,324960,293,RepeatMasker,LTR,324472,325012,293,1.00
ptg004857l,994462,994759,297,RepeatMasker,LTR,994256,994811,297,1.00
ptg004864l,1053892,1054205,313,RepeatMasker,LTR,1053998,1054070,73,0.23
ptg004870l,446234,446533,299,RepeatMasker,LTR,446054,446585,299,1.00
ptg004870l,827111,827410,299,RepeatMasker,LTR,826903,827462,299,1.00
ptg004871l,2759254,2759547,293,RepeatMasker,LTR,2759491,2759648,57,0.19
ptg004871l,3528665,3528945,280,RepeatMasker,LTR,3527531,3529592,280,1.00
ptg004872l,1162743,1163023,280,RepeatMasker,LTR,1162351,1163805,280,1.00
ptg004883l,389966,390277,311,RepeatMasker,LTR,390096,391791,182,0.59
ptg004883l,4322804,4323091,287,RepeatMasker,LTR,4318177,4323947,287,1.00
ptg004883l,4506804,4507133,329,RepeatMasker,LTR,4506753,4506973,169,0.51
ptg004883l,4506804,4507133,329,RepeatMasker,LTR,4506964,4507288,170,0.52
ptg004885l,1882837,1883123,286,RepeatMasker,LTR,1881083,1883675,286,1.00
ptg004890l,293752,294033,281,RepeatMasker,LTR,292695,294068,281,1.00
ptg004891l,291545,291826,281,RepeatMasker,LTR,290490,292626,281,1.00
ptg004894l,705508,705788,280,RepeatMasker,LTR,705111,706583,280,1.00
ptg004896l,484532,484813,281,RepeatMasker,LTR,484161,485458,281,1.00
ptg004900l,677612,677911,299,RepeatMasker,LTR,677404,677963,299,1.00
ptg004900l,3339344,3339662,318,RepeatMasker,LTR,3338477,3342042,318,1.00
ptg004901l,854662,854960,298,RepeatMasker,LTR,854782,854822,41,0.14
ptg004901l,1847477,1847777,300,RepeatMasker,LTR,1846440,1847535,58,0.19
ptg004901l,1847477,1847777,300,RepeatMasker,LTR,1847535,1848302,243,0.81
ptg004902l,239679,239958,279,RepeatMasker,LTR,238650,240592,279,1.00
ptg004903l,2858943,2859224,281,RepeatMasker,LTR,2858543,2860026,281,1.00
ptg004905l,2835822,2836113,291,RepeatMasker,LTR,2835598,2836165,291,1.00
ptg004918l,1862178,1862502,324,RepeatMasker,LTR,1862397,1863267,106,0.33
ptg004918l,2102998,2103330,332,RepeatMasker,LTR,2103243,2103376,88,0.27
ptg004927l,1635999,1636299,300,RepeatMasker,LTR,1636126,1636215,90,0.30
ptg004937l,1356957,1357271,314,RepeatMasker,LTR,1357069,1357113,45,0.14
ptg004948l,2491651,2491919,268,RepeatMasker,LTR,2491445,2491662,11,0.04
ptg004950l,266882,267179,297,RepeatMasker,LTR,266862,267226,297,1.00
ptg004958l,26088,26373,285,RepeatMasker,LTR,20999,27221,285,1.00
ptg004960l,1678829,1679088,259,RepeatMasker,LTR,1677147,1679290,259,1.00
ptg004984l,7478448,7478759,311,RepeatMasker,LTR,7478747,7481247,13,0.04
ptg004986l,1487365,1487657,292,RepeatMasker,LTR,1486503,1487617,252,0.86
ptg004988l,242905,243215,310,RepeatMasker,LTR,241051,243428,310,1.00
ptg004988l,242905,243215,310,RepeatMasker,LTR,243062,243514,154,0.50
ptg004990l,653100,653403,303,RepeatMasker,LTR,652162,655703,303,1.00
ptg004991l,732044,732356,312,RepeatMasker,LTR,732099,732245,147,0.47
ptg004991l,3430463,3430759,296,RepeatMasker,LTR,3430401,3430862,296,1.00
ptg004993l,392248,392548,300,RepeatMasker,LTR,392039,392600,300,1.00
ptg004995l,611418,611715,297,RepeatMasker,LTR,611495,611659,165,0.56
ptg004999l,1149439,1149752,313,RepeatMasker,LTR,1149332,1150168,313,1.00
ptg005001l,57480,57762,282,RepeatMasker,LTR,57098,58407,282,1.00
ptg005006l,374094,374411,317,RepeatMasker,LTR,373704,374850,317,1.00
ptg005006l,374094,374411,317,RepeatMasker,LTR,373881,374850,317,1.00
ptg005006l,1149086,1149354,268,RepeatMasker,LTR,1149183,1149259,77,0.29
ptg005011l,2363834,2364133,299,RepeatMasker,LTR,2363810,2364185,299,1.00
ptg005013l,634488,634786,298,RepeatMasker,LTR,633468,634705,217,0.73
ptg005019l,919111,919432,321,RepeatMasker,LTR,919203,919357,155,0.48
ptg005026l,5142855,5143139,284,RepeatMasker,LTR,5142549,5145192,284,1.00
ptg005032l,561477,561797,320,RepeatMasker,LTR,560999,561576,99,0.31
ptg005032l,561477,561797,320,RepeatMasker,LTR,561571,562461,227,0.71
ptg005035l,932983,933281,298,RepeatMasker,LTR,932761,933333,298,1.00
ptg005037l,1651814,1652094,280,RepeatMasker,LTR,1651425,1652106,280,1.00
ptg005040l,3149543,3149842,299,RepeatMasker,LTR,3149365,3149894,299,1.00
ptg005042l,1186249,1186551,302,RepeatMasker,LTR,1186115,1186403,154,0.51
ptg005044l,1011977,1012279,302,RepeatMasker,LTR,1011223,1013837,302,1.00
ptg005047l,224680,224955,275,RepeatMasker,LTR,224872,224950,79,0.29
ptg005050l,404294,404573,279,RepeatMasker,LTR,403912,404585,279,1.00
ptg005055l,1030509,1030813,304,RepeatMasker,LTR,1028537,1030511,2,0.01
ptg005056l,736398,736696,298,RepeatMasker,LTR,736233,736748,298,1.00
ptg005056l,1045056,1045353,297,RepeatMasker,LTR,1045036,1045405,297,1.00
ptg005058l,565181,565478,297,RepeatMasker,LTR,565003,565530,297,1.00
ptg005058l,1390686,1390972,286,RepeatMasker,LTR,1390234,1390873,187,0.65
ptg005058l,1390686,1390972,286,RepeatMasker,LTR,1390768,1390976,205,0.72
ptg005061l,1966009,1966288,279,RepeatMasker,LTR,1966134,1966234,101,0.36
ptg005061l,2356104,2356410,306,RepeatMasker,LTR,2349488,2358971,306,1.00
ptg005065l,1786788,1787084,296,RepeatMasker,LTR,1786606,1787136,296,1.00
ptg005068l,1191396,1191676,280,RepeatMasker,LTR,1190996,1192321,280,1.00
ptg005069l,869824,870101,277,RepeatMasker,LTR,869763,870223,277,1.00
ptg005069l,869824,870101,277,RepeatMasker,LTR,866393,870091,267,0.96
ptg005069l,4134159,4134441,282,RepeatMasker,LTR,4133647,4134554,282,1.00
ptg005080l,1533045,1533365,320,RepeatMasker,LTR,1533315,1533828,51,0.16
ptg005083l,1865242,1865549,307,RepeatMasker,LTR,1864699,1867277,307,1.00
ptg005084l,761411,761707,296,RepeatMasker,LTR,761246,761759,296,1.00
ptg005084l,830394,830693,299,RepeatMasker,LTR,830374,830727,299,1.00
ptg005084l,876596,876895,299,RepeatMasker,LTR,876418,876947,299,1.00
ptg005084l,972246,972545,299,RepeatMasker,LTR,972051,972597,299,1.00
ptg005086l,5576796,5577095,299,RepeatMasker,LTR,5576716,5577147,299,1.00
ptg005090l,340053,340333,280,RepeatMasker,LTR,338923,340346,280,1.00
ptg005090l,340053,340333,280,RepeatMasker,LTR,339623,340968,280,1.00
ptg005090l,1653106,1653401,295,RepeatMasker,LTR,1652898,1653453,295,1.00
ptg005092l,1664231,1664530,299,RepeatMasker,LTR,1662854,1664731,299,1.00
ptg005095l,1935050,1935349,299,RepeatMasker,LTR,1935003,1935798,299,1.00
ptg005095l,1935050,1935349,299,RepeatMasker,LTR,1933083,1935683,299,1.00
ptg005101l,701582,701886,304,RepeatMasker,LTR,701509,702176,304,1.00
ptg005107l,731118,731417,299,RepeatMasker,LTR,730940,731469,299,1.00
ptg005107l,1212213,1212508,295,RepeatMasker,LTR,1212133,1212560,295,1.00
ptg005107l,3547827,3548139,312,RepeatMasker,LTR,3547948,3549264,192,0.62
ptg005115l,190497,190807,310,RepeatMasker,LTR,187727,197260,310,1.00
ptg005121l,2422908,2423188,280,RepeatMasker,LTR,2422526,2423990,280,1.00
ptg005121l,3649536,3649826,290,RepeatMasker,LTR,3649072,3649601,65,0.22
ptg005130l,675047,675374,327,RepeatMasker,LTR,674475,675881,327,1.00
ptg005138l,485222,485503,281,RepeatMasker,LTR,485137,485277,55,0.20
ptg005145l,463536,463821,285,RepeatMasker,LTR,463606,467733,216,0.76
ptg005158l,47431,47716,285,RepeatMasker,LTR,44348,48567,285,1.00
ptg005159l,873167,873448,281,RepeatMasker,LTR,872778,874095,281,1.00
ptg005161l,1783771,1784052,281,RepeatMasker,LTR,1782633,1784687,281,1.00
ptg005161l,3816301,3816616,315,RepeatMasker,LTR,3816090,3816668,315,1.00
ptg005164l,859784,860083,299,RepeatMasker,LTR,859606,860135,299,1.00
ptg005165l,1438177,1438489,312,RepeatMasker,LTR,1437494,1439709,312,1.00
ptg005180l,1662871,1663194,323,RepeatMasker,LTR,1662953,1663930,242,0.75
ptg005180l,3654165,3654490,325,RepeatMasker,LTR,3654412,3658955,79,0.24
ptg005187l,1039668,1039967,299,RepeatMasker,LTR,1039725,1039937,213,0.71
ptg005189l,44527,44826,299,RepeatMasker,LTR,44486,44878,299,1.00
ptg005189l,220295,220601,306,RepeatMasker,LTR,219975,222201,306,1.00
ptg005193l,2667468,2667740,272,RepeatMasker,LTR,2667597,2667695,99,0.36
ptg005198l,1278030,1278317,287,RepeatMasker,LTR,1277803,1279134,287,1.00
ptg005205l,237944,238246,302,RepeatMasker,LTR,236836,238030,86,0.28
ptg005208l,97728,98027,299,RepeatMasker,LTR,97059,98400,299,1.00
ptg005208l,2208171,2208464,293,RepeatMasker,LTR,2207214,2208497,293,1.00
ptg005211l,3505363,3505670,307,RepeatMasker,LTR,3505521,3505799,150,0.49
ptg005231l,1074710,1075015,305,RepeatMasker,LTR,1074442,1074761,51,0.17
ptg005231l,1074710,1075015,305,RepeatMasker,LTR,1074970,1075595,46,0.15
ptg005236l,400118,400414,296,RepeatMasker,LTR,400390,405425,25,0.08
ptg005237l,2597330,2597610,280,RepeatMasker,LTR,2596276,2598250,280,1.00
ptg005245l,2767365,2767661,296,RepeatMasker,LTR,2767465,2768419,197,0.67
ptg005251l,2021085,2021381,296,RepeatMasker,LTR,2021329,2021516,53,0.18
ptg005252l,277773,278063,290,RepeatMasker,LTR,276746,278846,290,1.00
ptg005253l,10012,10297,285,RepeatMasker,LTR,8442,11132,285,1.00
ptg005254l,189975,190274,299,RepeatMasker,LTR,189810,190326,299,1.00
ptg005259l,1701936,1702216,280,RepeatMasker,LTR,1702180,1706570,37,0.13
ptg005260l,673105,673386,281,RepeatMasker,LTR,672758,674023,281,1.00
ptg005260l,673105,673386,281,RepeatMasker,LTR,673091,674023,281,1.00
ptg005260l,2987874,2988171,297,RepeatMasker,LTR,2987666,2988223,297,1.00
ptg005272l,230748,231063,315,RepeatMasker,LTR,230727,231391,315,1.00
ptg005274l,2998762,2999084,322,RepeatMasker,LTR,2998872,3001136,213,0.66
ptg005281l,2127664,2127963,299,RepeatMasker,LTR,2127456,2128015,299,1.00
ptg005295l,291573,291854,281,RepeatMasker,LTR,290521,292637,281,1.00
ptg005296l,208050,208364,314,RepeatMasker,LTR,208090,209241,275,0.88
ptg005296l,2029032,2029313,281,RepeatMasker,LTR,2028642,2029345,281,1.00
ptg005299l,3801820,3802118,298,RepeatMasker,LTR,3801785,3802170,298,1.00
ptg005299l,4043557,4043856,299,RepeatMasker,LTR,4043379,4043908,299,1.00
ptg005299l,4505601,4505892,291,RepeatMasker,LTR,4505521,4505939,291,1.00
ptg005300l,2198064,2198367,303,RepeatMasker,LTR,2198220,2198664,148,0.49
ptg005302l,3267334,3267629,295,RepeatMasker,LTR,3266956,3267642,295,1.00
ptg005303l,124995,125275,280,RepeatMasker,LTR,124613,125921,280,1.00
ptg005314l,1143370,1143653,283,RepeatMasker,LTR,1143048,1146761,283,1.00
ptg005314l,2619518,2619839,321,RepeatMasker,LTR,2619759,2619830,72,0.22
ptg005314l,3982935,3983260,325,RepeatMasker,LTR,3983098,3984366,163,0.50
ptg005314l,3982935,3983260,325,RepeatMasker,LTR,3983098,3984803,163,0.50
ptg005316l,2424299,2424583,284,RepeatMasker,LTR,2423161,2425403,284,1.00
ptg005329l,584027,584282,255,RepeatMasker,LTR,584130,585068,153,0.60
ptg005334l,1098136,1098413,277,RepeatMasker,LTR,1097751,1099200,277,1.00
ptg005335l,1094585,1094861,276,RepeatMasker,LTR,1094659,1100285,203,0.74
ptg005335l,1768371,1768647,276,RepeatMasker,LTR,1768139,1768782,276,1.00
ptg005342l,497199,497479,280,RepeatMasker,LTR,496162,498261,280,1.00
ptg005342l,2200427,2200704,277,RepeatMasker,LTR,2197004,2200694,267,0.96
ptg005342l,2200427,2200704,277,RepeatMasker,LTR,2200366,2200826,277,1.00
ptg005345l,2010230,2010511,281,RepeatMasker,LTR,2009831,2010544,281,1.00
ptg005348l,360462,360782,320,RepeatMasker,LTR,360732,367002,51,0.16
ptg005355l,1833192,1833492,300,RepeatMasker,LTR,1832983,1833544,300,1.00
ptg005355l,5130594,5130894,300,RepeatMasker,LTR,5128000,5132092,300,1.00
ptg005356l,2671832,2672106,274,RepeatMasker,LTR,2671653,2671864,32,0.12
ptg005356l,3764309,3764614,305,RepeatMasker,LTR,3764476,3766226,139,0.46
ptg005358l,441383,441670,287,RepeatMasker,LTR,441362,441406,23,0.08
ptg005358l,2231185,2231481,296,RepeatMasker,LTR,2230975,2231533,296,1.00
ptg005366l,784021,784301,280,RepeatMasker,LTR,783627,784335,280,1.00
ptg005369l,374137,374423,286,RepeatMasker,LTR,372562,375282,286,1.00
ptg005370l,313895,314199,304,RepeatMasker,LTR,313530,314992,304,1.00
ptg005371l,2006149,2006430,281,RepeatMasker,LTR,2005101,2007223,281,1.00
ptg005371l,3007688,3007970,282,RepeatMasker,LTR,3007020,3009850,282,1.00
ptg005372l,1688177,1688475,298,RepeatMasker,LTR,1688097,1688527,298,1.00
ptg005375l,222252,222551,299,RepeatMasker,LTR,222211,222597,299,1.00
ptg005376l,188476,188765,289,RepeatMasker,LTR,188439,188499,23,0.08
ptg005381l,744073,744353,280,RepeatMasker,LTR,743680,744384,280,1.00
ptg005381l,751207,751504,297,RepeatMasker,LTR,750842,752155,297,1.00
ptg005385l,3748046,3748331,285,RepeatMasker,LTR,3748076,3748115,40,0.14
ptg005386l,961524,961844,320,RepeatMasker,LTR,960453,962275,320,1.00
ptg005386l,1228490,1228810,320,RepeatMasker,LTR,1227420,1229241,320,1.00
ptg005393l,1415973,1416262,289,RepeatMasker,LTR,1416212,1417166,51,0.18
ptg005393l,1962737,1963041,304,RepeatMasker,LTR,1963019,1963066,23,0.08
ptg005394l,122260,122540,280,RepeatMasker,LTR,122210,123911,280,1.00
ptg005394l,1189333,1189664,331,RepeatMasker,LTR,1187363,1190599,331,1.00
ptg005403l,2710755,2711044,289,RepeatMasker,LTR,2710739,2712787,289,1.00
ptg005403l,2727790,2728074,284,RepeatMasker,LTR,2727828,2727977,150,0.53
ptg005408l,167609,167904,295,RepeatMasker,LTR,167568,167956,295,1.00
ptg005413l,2752519,2752818,299,RepeatMasker,LTR,2752439,2752870,299,1.00
ptg005417l,413887,414193,306,RepeatMasker,LTR,413902,414838,292,0.95
ptg005418l,1075165,1075464,299,RepeatMasker,LTR,1075124,1075516,299,1.00
ptg005421l,2776797,2777102,305,RepeatMasker,LTR,2776769,2776844,47,0.15
ptg005421l,3868843,3869131,288,RepeatMasker,LTR,3868343,3869034,191,0.66
ptg005421l,3868843,3869131,288,RepeatMasker,LTR,3868908,3869134,224,0.78
ptg005422l,1385293,1385592,299,RepeatMasker,LTR,1385099,1385644,299,1.00
ptg005422l,3430318,3430617,299,RepeatMasker,LTR,3430238,3430669,299,1.00
ptg005422l,4641009,4641306,297,RepeatMasker,LTR,4641144,4648207,163,0.55
ptg005435l,168135,168455,320,RepeatMasker,LTR,167806,168154,19,0.06
ptg005438l,601803,602101,298,RepeatMasker,LTR,598536,602893,298,1.00
ptg005439l,1150134,1150457,323,RepeatMasker,LTR,1149747,1153862,323,1.00
ptg005441l,2775198,2775484,286,RepeatMasker,LTR,2775306,2782389,179,0.63
ptg005442l,787526,787803,277,RepeatMasker,LTR,782652,787610,84,0.30
ptg005442l,836648,836943,295,RepeatMasker,LTR,836750,836826,77,0.26
ptg005446l,2179361,2179648,287,RepeatMasker,LTR,2177199,2179995,287,1.00
ptg005452l,70509,70828,319,RepeatMasker,LTR,69431,70645,136,0.43
ptg005452l,70509,70828,319,RepeatMasker,LTR,69755,74186,319,1.00
ptg005458l,575017,575303,286,RepeatMasker,LTR,575141,582191,163,0.57
ptg005459l,1673752,1674058,306,RepeatMasker,LTR,1673207,1674822,306,1.00
ptg005462l,6633637,6633917,280,RepeatMasker,LTR,6632736,6633930,280,1.00
ptg005466l,952084,952379,295,RepeatMasker,LTR,951903,952431,295,1.00
ptg005466l,1430182,1430481,299,RepeatMasker,LTR,1429974,1430533,299,1.00
ptg005466l,1798293,1798591,298,RepeatMasker,LTR,1798125,1798643,298,1.00
ptg005466l,2622023,2622319,296,RepeatMasker,LTR,2622260,2622330,60,0.20
ptg005466l,2622023,2622319,296,RepeatMasker,LTR,2622294,2622344,26,0.09
ptg005466l,2622023,2622319,296,RepeatMasker,LTR,2621023,2622263,240,0.81
ptg005470l,217146,217448,302,RepeatMasker,LTR,217170,217592,279,0.92
ptg005471l,693027,693306,279,RepeatMasker,LTR,692581,693384,279,1.00
ptg005476l,2589978,2590268,290,RepeatMasker,LTR,2589753,2590016,38,0.13
ptg005478l,5042794,5043074,280,RepeatMasker,LTR,5042404,5043086,280,1.00
ptg005483l,760441,760738,297,RepeatMasker,LTR,760418,760790,297,1.00
ptg005486l,890995,891276,281,RepeatMasker,LTR,889955,892076,281,1.00
ptg005486l,898177,898458,281,RepeatMasker,LTR,897041,899088,281,1.00
ptg005486l,1284354,1284653,299,RepeatMasker,LTR,1284313,1284687,299,1.00
ptg005492l,1409185,1409504,319,RepeatMasker,LTR,1409454,1412477,51,0.16
ptg005492l,2328366,2328670,304,RepeatMasker,LTR,2328345,2328389,23,0.08
ptg005493l,1103442,1103775,333,RepeatMasker,LTR,1103724,1108711,52,0.16
ptg005493l,1786289,1786596,307,RepeatMasker,LTR,1785804,1786328,39,0.13
ptg005502l,1248679,1248983,304,RepeatMasker,LTR,1248093,1248876,197,0.65
ptg005510l,1125846,1126141,295,RepeatMasker,LTR,1125276,1126510,295,1.00
ptg005510l,2485676,2485958,282,RepeatMasker,LTR,2485858,2485928,71,0.25
ptg005510l,2485676,2485958,282,RepeatMasker,LTR,2485866,2485915,50,0.18
ptg005510l,2485676,2485958,282,RepeatMasker,LTR,2485868,2485933,66,0.23
ptg005510l,2485676,2485958,282,RepeatMasker,LTR,2485872,2485924,53,0.19
ptg005510l,2485676,2485958,282,RepeatMasker,LTR,2485883,2485933,51,0.18
ptg005512l,40901,41199,298,RepeatMasker,LTR,40723,41251,298,1.00
ptg005512l,148299,148598,299,RepeatMasker,LTR,148121,148650,299,1.00
ptg005513l,458621,458941,320,RepeatMasker,LTR,458829,463757,113,0.35
ptg005527l,60459,60775,316,RepeatMasker,LTR,59969,62356,316,1.00
ptg005528l,250489,250775,286,RepeatMasker,LTR,250090,256906,286,1.00
ptg005529l,5879663,5879949,286,RepeatMasker,LTR,5878673,5880810,286,1.00
ptg005529l,5884917,5885203,286,RepeatMasker,LTR,5883350,5885969,286,1.00
ptg005529l,6389899,6390199,300,RepeatMasker,LTR,6389690,6390233,300,1.00
ptg005530l,2104646,2104925,279,RepeatMasker,LTR,2104740,2104894,155,0.56
ptg005540l,377686,378000,314,RepeatMasker,LTR,376419,379251,314,1.00
ptg005542l,970803,971110,307,RepeatMasker,LTR,971059,971253,52,0.17
ptg005542l,1650071,1650370,299,RepeatMasker,LTR,1649877,1650422,299,1.00
ptg005542l,2732236,2732520,284,RepeatMasker,LTR,2732353,2732855,168,0.59
ptg005542l,2732236,2732520,284,RepeatMasker,LTR,2732359,2732733,162,0.57
ptg005542l,2914726,2915034,308,RepeatMasker,LTR,2914851,2917443,184,0.60
ptg005545l,2893163,2893454,291,RepeatMasker,LTR,2892640,2894217,291,1.00
ptg005548l,994870,995197,327,RepeatMasker,LTR,994878,994967,90,0.28
ptg005554l,8142615,8142905,290,RepeatMasker,LTR,8142889,8143783,17,0.06
ptg005554l,9736595,9736909,314,RepeatMasker,LTR,9736110,9736682,87,0.28
ptg005554l,9736595,9736909,314,RepeatMasker,LTR,9736881,9740503,29,0.09
ptg005556l,54107,54404,297,RepeatMasker,LTR,53736,55204,297,1.00
ptg005556l,61243,61540,297,RepeatMasker,LTR,60878,62186,297,1.00
ptg005558l,1016979,1017283,304,RepeatMasker,LTR,1017241,1017281,41,0.13
ptg005561l,803792,804079,287,RepeatMasker,LTR,799141,804938,287,1.00
ptg005562l,4542304,4542590,286,RepeatMasker,LTR,4541804,4542493,189,0.66
ptg005562l,4542304,4542590,286,RepeatMasker,LTR,4542369,4542608,222,0.78
ptg005562l,4542304,4542590,286,RepeatMasker,LTR,4542551,4542630,40,0.14
ptg005562l,4542304,4542590,286,RepeatMasker,LTR,4542562,4542642,29,0.10
ptg005564l,634570,634899,329,RepeatMasker,LTR,634863,635374,37,0.11
ptg005564l,1135451,1135737,286,RepeatMasker,LTR,1131868,1136112,286,1.00
ptg005573l,566902,567197,295,RepeatMasker,LTR,566822,567249,295,1.00
ptg005578l,340362,340661,299,RepeatMasker,LTR,340167,340713,299,1.00
ptg005578l,390835,391134,299,RepeatMasker,LTR,390657,391186,299,1.00
ptg005578l,694284,694584,300,RepeatMasker,LTR,694090,694636,300,1.00
ptg005582l,219103,219394,291,RepeatMasker,LTR,219101,220189,291,1.00
ptg005584l,424326,424608,282,RepeatMasker,LTR,423682,425048,282,1.00
ptg005588l,899375,899670,295,RepeatMasker,LTR,899007,900314,295,1.00
ptg005588l,2868654,2868979,325,RepeatMasker,LTR,2868528,2868671,17,0.05
ptg005588l,2868654,2868979,325,RepeatMasker,LTR,2868609,2868869,215,0.66
ptg005588l,2868654,2868979,325,RepeatMasker,LTR,2868872,2871391,108,0.33
ptg005588l,4291665,4291965,300,RepeatMasker,LTR,4291468,4292017,300,1.00
ptg005591l,2238340,2238620,280,RepeatMasker,LTR,2237944,2239268,280,1.00
ptg005591l,2358839,2359162,323,RepeatMasker,LTR,2359000,2361263,163,0.50
ptg005593l,914175,914498,323,RepeatMasker,LTR,914336,916893,163,0.50
ptg005601l,7447,7778,331,RepeatMasker,LTR,7325,7561,114,0.34
ptg005602l,3557518,3557799,281,RepeatMasker,LTR,3557122,3558603,281,1.00
ptg005604l,35422,35738,316,RepeatMasker,LTR,35660,36336,79,0.25
ptg005606l,404650,404950,300,RepeatMasker,LTR,404275,404885,235,0.78
ptg005607l,848518,848817,299,RepeatMasker,LTR,846538,848763,245,0.82
ptg005615l,7080161,7080469,308,RepeatMasker,LTR,7080266,7080754,204,0.66
ptg005615l,7536744,7537037,293,RepeatMasker,LTR,7536591,7537089,293,1.00
ptg005615l,10592956,10593282,326,RepeatMasker,LTR,10591914,10593759,326,1.00
ptg005617l,350517,350809,292,RepeatMasker,LTR,350332,351706,292,1.00
ptg005618l,1836541,1836821,280,RepeatMasker,LTR,1835794,1836834,280,1.00
ptg005618l,1844307,1844621,314,RepeatMasker,LTR,1844335,1844634,287,0.91
ptg005623l,1052745,1053035,290,RepeatMasker,LTR,1051703,1053048,290,1.00
ptg005632l,2050711,2051031,320,RepeatMasker,LTR,2050981,2057237,51,0.16
ptg005632l,2060393,2060693,300,RepeatMasker,LTR,2059858,2060792,300,1.00
ptg005632l,2060393,2060693,300,RepeatMasker,LTR,2060573,2060821,121,0.40
ptg005636l,1093211,1093509,298,RepeatMasker,LTR,1092820,1094299,298,1.00
ptg005639l,26743,27066,323,RepeatMasker,LTR,26449,27079,323,1.00
ptg005650l,1198158,1198438,280,RepeatMasker,LTR,1197776,1198451,280,1.00
ptg005665l,2008868,2009162,294,RepeatMasker,LTR,2008488,2009812,294,1.00
ptg005665l,2420191,2420472,281,RepeatMasker,LTR,2419880,2421122,281,1.00
ptg005667l,1153382,1153675,293,RepeatMasker,LTR,1153174,1153727,293,1.00
ptg005671l,2959790,2960085,295,RepeatMasker,LTR,2959769,2959813,23,0.08
ptg005682l,413170,413451,281,RepeatMasker,LTR,412788,414255,281,1.00
ptg005685l,3362381,3362687,306,RepeatMasker,LTR,3360372,3363221,306,1.00
ptg005686l,1184185,1184494,309,RepeatMasker,LTR,1183796,1185057,309,1.00
ptg005693l,96379,96674,295,RepeatMasker,LTR,96201,96726,295,1.00
ptg005697l,19236,19531,295,RepeatMasker,LTR,19505,21711,27,0.09
ptg005699l,963135,963443,308,RepeatMasker,LTR,963281,970304,163,0.53
ptg005699l,1093871,1094163,292,RepeatMasker,LTR,1093529,1096996,292,1.00
ptg005704l,81109,81389,280,RepeatMasker,LTR,80776,82192,280,1.00
ptg005707l,3359,3638,279,RepeatMasker,LTR,3353,3650,279,1.00
ptg005708l,548365,548669,304,RepeatMasker,LTR,548331,548432,67,0.22
ptg005709l,1339689,1339988,299,RepeatMasker,LTR,1339982,1340210,7,0.02
ptg005709l,3213969,3214260,291,RepeatMasker,LTR,3214103,3214557,158,0.54
ptg005722l,3551956,3552253,297,RepeatMasker,LTR,3551963,3552398,291,0.98
ptg005723l,28791,29090,299,RepeatMasker,LTR,28581,29124,299,1.00
ptg005727l,769803,770112,309,RepeatMasker,LTR,770082,772758,31,0.10
ptg005728l,56602,56879,277,RepeatMasker,LTR,53172,56869,267,0.96
ptg005728l,56602,56879,277,RepeatMasker,LTR,56870,57001,10,0.04
ptg005728l,110183,110494,311,RepeatMasker,LTR,109806,111936,311,1.00
ptg005728l,110183,110494,311,RepeatMasker,LTR,109938,116624,311,1.00
ptg005728l,388559,388883,324,RepeatMasker,LTR,388684,388783,100,0.31
ptg005728l,552624,552934,310,RepeatMasker,LTR,552906,553158,29,0.09
ptg005731l,1653487,1653793,306,RepeatMasker,LTR,1653267,1653771,284,0.93
ptg005738l,2174988,2175271,283,RepeatMasker,LTR,2173588,2178085,283,1.00
ptg005739l,478555,478835,280,RepeatMasker,LTR,478175,479626,280,1.00
ptg005742l,4375868,4376181,313,RepeatMasker,LTR,4376033,4376335,149,0.48
ptg005746l,1097290,1097587,297,RepeatMasker,LTR,1097112,1097639,297,1.00
ptg005746l,1275308,1275606,298,RepeatMasker,LTR,1275115,1275658,298,1.00
ptg005746l,1666919,1667238,319,RepeatMasker,LTR,1666745,1667287,319,1.00
ptg005751l,347529,347835,306,RepeatMasker,LTR,347810,347981,26,0.08
ptg005761l,602917,603209,292,RepeatMasker,LTR,602668,603497,292,1.00
ptg005761l,1742839,1743118,279,RepeatMasker,LTR,1742819,1742862,23,0.08
ptg005761l,4009711,4010031,320,RepeatMasker,LTR,4009982,4016221,50,0.16
ptg005770l,192868,193187,319,RepeatMasker,LTR,192853,193505,319,1.00
ptg005770l,969395,969680,285,RepeatMasker,LTR,969374,969418,23,0.08
ptg005772l,1722841,1723128,287,RepeatMasker,LTR,1722811,1722893,52,0.18
ptg005779l,921858,922155,297,RepeatMasker,LTR,921993,924536,163,0.55
ptg005780l,638237,638540,303,RepeatMasker,LTR,638313,638360,48,0.16
ptg005794l,809370,809673,303,RepeatMasker,LTR,809447,809835,227,0.75
ptg005796l,1794828,1795160,332,RepeatMasker,LTR,1794948,1797511,213,0.64
ptg005797l,160396,160701,305,RepeatMasker,LTR,160675,161467,27,0.09
ptg005800l,717416,717691,275,RepeatMasker,LTR,716266,717422,6,0.02
ptg005803l,146756,147050,294,RepeatMasker,LTR,146676,147102,294,1.00
ptg005803l,1960543,1960870,327,RepeatMasker,LTR,1955919,1961704,327,1.00
ptg005806l,379176,379478,302,RepeatMasker,LTR,377397,380452,302,1.00
ptg005807l,951893,952210,317,RepeatMasker,LTR,951183,953678,317,1.00
ptg005809l,1537621,1537920,299,RepeatMasker,LTR,1537877,1538519,44,0.15
ptg005816l,1276246,1276542,296,RepeatMasker,LTR,1275510,1276567,296,1.00
ptg005816l,1276246,1276548,302,RepeatMasker,LTR,1275510,1276567,302,1.00
ptg005820l,921273,921581,308,RepeatMasker,LTR,920906,921360,87,0.28
ptg005820l,921273,921581,308,RepeatMasker,LTR,921553,922760,29,0.09
ptg005828l,1790792,1791071,279,RepeatMasker,LTR,1790319,1790885,93,0.33
ptg005833l,744549,744797,248,RepeatMasker,LTR,740345,750451,248,1.00
ptg005834l,692928,693215,287,RepeatMasker,LTR,691353,694074,287,1.00
ptg005834l,790402,790717,315,RepeatMasker,LTR,789299,790551,149,0.47
ptg005834l,2164610,2164895,285,RepeatMasker,LTR,2164126,2165035,285,1.00
ptg005834l,3386022,3386302,280,RepeatMasker,LTR,3386008,3386335,280,1.00
ptg005837l,17882,18163,281,RepeatMasker,LTR,17500,18964,281,1.00
ptg005838l,697543,697839,296,RepeatMasker,LTR,697623,699964,217,0.73
ptg005843l,364937,365219,282,RepeatMasker,LTR,364934,365830,282,1.00
ptg005850l,1208945,1209242,297,RepeatMasker,LTR,1208904,1209294,297,1.00
ptg005857l,1346464,1346783,319,RepeatMasker,LTR,1346734,1347425,50,0.16
ptg005865l,587053,587361,308,RepeatMasker,LTR,583500,587377,308,1.00
ptg005865l,1227440,1227734,294,RepeatMasker,LTR,1227064,1227771,294,1.00
ptg005870l,1184964,1185245,281,RepeatMasker,LTR,1184567,1185280,281,1.00
ptg005875l,716633,716941,308,RepeatMasker,LTR,716154,716720,87,0.28
ptg005875l,716633,716941,308,RepeatMasker,LTR,716913,717131,29,0.09
ptg005876l,1584946,1585226,280,RepeatMasker,LTR,1584940,1585871,280,1.00
ptg005876l,2370389,2370716,327,RepeatMasker,LTR,2369955,2370630,241,0.74
ptg005878l,725741,726047,306,RepeatMasker,LTR,725882,728684,166,0.54
ptg005883l,215242,215554,312,RepeatMasker,LTR,215113,215371,129,0.41
ptg005884l,686618,686920,302,RepeatMasker,LTR,686160,687526,302,1.00
ptg005890l,1624507,1624796,289,RepeatMasker,LTR,1622937,1625655,289,1.00
ptg005905l,657205,657500,295,RepeatMasker,LTR,657142,657600,295,1.00
ptg005913l,1513903,1514213,310,RepeatMasker,LTR,1512520,1514805,310,1.00
ptg005913l,2311432,2311732,300,RepeatMasker,LTR,2311221,2311784,300,1.00
ptg005914l,928998,929299,301,RepeatMasker,LTR,928528,929059,61,0.20
ptg005916l,34783,35064,281,RepeatMasker,LTR,34401,35096,281,1.00
ptg005917l,431191,431515,324,RepeatMasker,LTR,430319,431286,95,0.29
ptg005917l,431191,431515,324,RepeatMasker,LTR,431509,431736,7,0.02
ptg005917l,1117380,1117679,299,RepeatMasker,LTR,1117202,1117726,299,1.00
ptg005920l,219650,219952,302,RepeatMasker,LTR,218721,219679,29,0.10
ptg005920l,219650,219952,302,RepeatMasker,LTR,218890,220162,302,1.00
ptg005926l,231167,231448,281,RepeatMasker,LTR,231151,231481,281,1.00
ptg005926l,519328,519631,303,RepeatMasker,LTR,518968,520421,303,1.00
ptg005935l,634163,634447,284,RepeatMasker,LTR,634297,634968,151,0.53
ptg005941l,120163,120468,305,RepeatMasker,LTR,119895,121178,305,1.00
ptg005941l,1183475,1183804,329,RepeatMasker,LTR,1183532,1184057,273,0.83
ptg005944l,399054,399331,277,RepeatMasker,LTR,397707,399317,263,0.95
ptg005944l,399054,399331,277,RepeatMasker,LTR,398993,399453,277,1.00
ptg005944l,4332070,4332356,286,RepeatMasker,LTR,4327392,4333197,286,1.00
ptg005951l,369822,370099,277,RepeatMasker,LTR,369430,370734,277,1.00
ptg005954l,1046521,1046832,311,RepeatMasker,LTR,1045944,1047133,311,1.00
ptg005960l,3273041,3273325,284,RepeatMasker,LTR,3273234,3273348,92,0.32
ptg005960l,3273041,3273325,284,RepeatMasker,LTR,3273269,3273360,57,0.20
ptg005960l,3273041,3273325,284,RepeatMasker,LTR,3273291,3274524,35,0.12
ptg005964l,2071822,2072124,302,RepeatMasker,LTR,2071730,2073810,302,1.00
ptg005965l,348260,348566,306,RepeatMasker,LTR,347248,348299,39,0.13
ptg005965l,348260,348566,306,RepeatMasker,LTR,347472,348872,306,1.00
ptg005966l,8444905,8445199,294,RepeatMasker,LTR,8444602,8445211,294,1.00
ptg005968l,933651,933942,291,RepeatMasker,LTR,933563,933686,35,0.12
ptg005968l,933651,933942,291,RepeatMasker,LTR,933788,933838,51,0.18
ptg005977l,456829,457111,282,RepeatMasker,LTR,456903,457470,209,0.74
ptg005981l,537375,537674,299,RepeatMasker,LTR,537073,538309,299,1.00
ptg005981l,664695,664976,281,RepeatMasker,LTR,664308,664989,281,1.00
ptg005985l,3148570,3148890,320,RepeatMasker,LTR,3147925,3149560,320,1.00
ptg005988l,71646,71944,298,RepeatMasker,LTR,71437,71996,298,1.00
ptg005992l,180944,181256,312,RepeatMasker,LTR,180322,182213,312,1.00
ptg006000l,417437,417749,312,RepeatMasker,LTR,417710,423628,40,0.13
ptg006007l,76277,76578,301,RepeatMasker,LTR,76281,76694,298,0.99
ptg006013l,1508141,1508431,290,RepeatMasker,LTR,1507959,1509576,290,1.00
ptg006013l,1508141,1508431,290,RepeatMasker,LTR,1508229,1510557,203,0.70
ptg006015l,2532103,2532423,320,RepeatMasker,LTR,2532216,2532253,38,0.12
ptg006015l,2703414,2703720,306,RepeatMasker,LTR,2702868,2705448,306,1.00
ptg006017l,702196,702476,280,RepeatMasker,LTR,701807,702506,280,1.00
ptg006020l,640467,640793,326,RepeatMasker,LTR,640643,641124,151,0.46
ptg006040l,137203,137503,300,RepeatMasker,LTR,137123,137555,300,1.00
ptg006047l,2300650,2300930,280,RepeatMasker,LTR,2300307,2300941,280,1.00
ptg006047l,2307774,2308054,280,RepeatMasker,LTR,2307393,2308067,280,1.00
ptg006047l,3012513,3012815,302,RepeatMasker,LTR,3012683,3014064,133,0.44
ptg006047l,3012513,3012815,302,RepeatMasker,LTR,3012724,3014383,92,0.30
ptg006048l,366787,367068,281,RepeatMasker,LTR,366405,367870,281,1.00
ptg006048l,1413662,1413954,292,RepeatMasker,LTR,1413296,1416791,292,1.00
ptg006051l,901048,901372,324,RepeatMasker,LTR,900846,901164,116,0.36
ptg006051l,2404992,2405300,308,RepeatMasker,LTR,2404610,2405095,103,0.33
ptg006052l,883306,883612,306,RepeatMasker,LTR,879995,883724,306,1.00
ptg006058l,2306853,2307148,295,RepeatMasker,LTR,2306675,2307200,295,1.00
ptg006063l,626752,627042,290,RepeatMasker,LTR,625581,628665,290,1.00
ptg006063l,626752,627042,290,RepeatMasker,LTR,626425,629430,290,1.00
ptg006064l,547375,547700,325,RepeatMasker,LTR,546374,548888,325,1.00
ptg006077l,1105257,1105540,283,RepeatMasker,LTR,1104878,1106182,283,1.00
ptg006078l,4645562,4645894,332,RepeatMasker,LTR,4645732,4646231,163,0.49
ptg006083l,268675,268974,299,RepeatMasker,LTR,268510,269026,299,1.00
ptg006083l,414674,414927,253,RepeatMasker,LTR,414761,414855,95,0.38
ptg006083l,414674,414927,253,RepeatMasker,LTR,414847,414975,81,0.32
ptg006083l,430755,431054,299,RepeatMasker,LTR,430562,431106,299,1.00
ptg006089l,41072,41372,300,RepeatMasker,LTR,40873,41424,300,1.00
ptg006090l,370451,370729,278,RepeatMasker,LTR,370430,370474,23,0.08
ptg006090l,2034853,2035158,305,RepeatMasker,LTR,2034671,2035157,304,1.00
ptg006094l,286266,286565,299,RepeatMasker,LTR,286087,286617,299,1.00
ptg006094l,541978,542277,299,RepeatMasker,LTR,541958,542311,299,1.00
ptg006094l,2746326,2746623,297,RepeatMasker,LTR,2746562,2746646,62,0.21
ptg006094l,2746326,2746623,297,RepeatMasker,LTR,2746590,2746960,34,0.11
ptg006100l,1097349,1097678,329,RepeatMasker,LTR,1097516,1102366,163,0.50
ptg006104l,2658157,2658457,300,RepeatMasker,LTR,2658364,2658468,94,0.31
ptg006108l,718940,719252,312,RepeatMasker,LTR,713640,723148,312,1.00
ptg006115l,2480835,2481115,280,RepeatMasker,LTR,2480814,2480858,23,0.08
ptg006116l,1578545,1578853,308,RepeatMasker,LTR,1578736,1579448,118,0.38
ptg006126l,402055,402370,315,RepeatMasker,LTR,400623,402092,37,0.12
ptg006126l,1381022,1381321,299,RepeatMasker,LTR,1380942,1381373,299,1.00
ptg006135l,430654,430979,325,RepeatMasker,LTR,430572,430841,187,0.58
ptg006140l,1242146,1242445,299,RepeatMasker,LTR,1241384,1242786,299,1.00
ptg006158l,314163,314444,281,RepeatMasker,LTR,313092,315087,281,1.00
ptg006160l,154453,154752,299,RepeatMasker,LTR,154258,154804,299,1.00
ptg006171l,1999850,2000140,290,RepeatMasker,LTR,1999233,2000041,191,0.66
ptg006171l,1999850,2000140,290,RepeatMasker,LTR,1999915,2000146,226,0.78
ptg006172l,368760,369041,281,RepeatMasker,LTR,368451,369682,281,1.00
ptg006174l,515224,515478,254,RepeatMasker,LTR,511020,515999,254,1.00
ptg006174l,515224,515478,254,RepeatMasker,LTR,514000,518160,254,1.00
ptg006177l,744018,744317,299,RepeatMasker,LTR,743840,744369,299,1.00
ptg006183l,3526532,3526804,272,RepeatMasker,LTR,3526773,3527250,32,0.12
ptg006191l,218285,218565,280,RepeatMasker,LTR,217903,219199,280,1.00
ptg006191l,448297,448545,248,RepeatMasker,LTR,444090,453600,248,1.00
ptg006191l,558368,558649,281,RepeatMasker,LTR,557986,558682,281,1.00
ptg006191l,1098343,1098642,299,RepeatMasker,LTR,1097318,1099425,299,1.00
ptg006193l,2217955,2218250,295,RepeatMasker,LTR,2217777,2218302,295,1.00
ptg006198l,310405,310711,306,RepeatMasker,LTR,309853,311204,306,1.00
ptg006200l,1542889,1543188,299,RepeatMasker,LTR,1542681,1543240,299,1.00
ptg006200l,1732615,1732914,299,RepeatMasker,LTR,1732595,1732966,299,1.00
ptg006200l,1817131,1817423,292,RepeatMasker,LTR,1816967,1817475,292,1.00
ptg006200l,2022639,2022945,306,RepeatMasker,LTR,2021450,2022653,14,0.05
ptg006200l,2022639,2022945,306,RepeatMasker,LTR,2022889,2023045,57,0.19
ptg006201l,553494,553775,281,RepeatMasker,LTR,553643,553670,28,0.10
ptg006210l,1513565,1513880,315,RepeatMasker,LTR,1513832,1518188,49,0.16
ptg006212l,211783,212091,308,RepeatMasker,LTR,211401,212103,308,1.00
ptg006217l,668680,668969,289,RepeatMasker,LTR,668915,668978,55,0.19
ptg006218l,678879,679160,281,RepeatMasker,LTR,678486,679962,281,1.00
ptg006218l,876906,877202,296,RepeatMasker,LTR,876524,877214,296,1.00
ptg006222l,2989639,2989919,280,RepeatMasker,LTR,2989691,2989885,195,0.70
ptg006224l,5031612,5031917,305,RepeatMasker,LTR,5031380,5031671,59,0.19
ptg006224l,5031612,5031917,305,RepeatMasker,LTR,5031889,5035473,29,0.10
ptg006224l,5979741,5980031,290,RepeatMasker,LTR,5978814,5980194,290,1.00
ptg006227l,594211,594515,304,RepeatMasker,LTR,594353,594853,163,0.54
ptg006235l,814394,814710,316,RepeatMasker,LTR,814680,814720,31,0.10
ptg006235l,814394,814710,316,RepeatMasker,LTR,814688,814737,23,0.07
ptg006244l,1393518,1393804,286,RepeatMasker,LTR,1388860,1394133,286,1.00
ptg006249l,1676867,1677148,281,RepeatMasker,LTR,1676476,1677794,281,1.00
ptg006252l,80204,80503,299,RepeatMasker,LTR,80026,80555,299,1.00
ptg006252l,326995,327294,299,RepeatMasker,LTR,326801,327346,299,1.00
ptg006255l,3282394,3282687,293,RepeatMasker,LTR,3282505,3282774,183,0.62
ptg006261l,683444,683775,331,RepeatMasker,LTR,683448,683823,328,0.99
ptg006261l,983401,983698,297,RepeatMasker,LTR,983403,983745,296,1.00
ptg006280l,1211181,1211483,302,RepeatMasker,LTR,1210427,1212917,302,1.00
ptg006286l,378869,379149,280,RepeatMasker,LTR,377731,379162,280,1.00
ptg006289l,3548031,3548338,307,RepeatMasker,LTR,3548048,3549249,291,0.95
ptg006289l,3776945,3777240,295,RepeatMasker,LTR,3774096,3777060,115,0.39
ptg006289l,3776945,3777240,295,RepeatMasker,LTR,3777076,3784490,165,0.56
ptg006292l,233069,233349,280,RepeatMasker,LTR,232687,233360,280,1.00
ptg006292l,233069,233349,280,RepeatMasker,LTR,232758,233361,280,1.00
ptg006296l,2488594,2488909,315,RepeatMasker,LTR,2488875,2494779,35,0.11
ptg006298l,3348489,3348781,292,RepeatMasker,LTR,3348147,3349502,292,1.00
ptg006298l,4733073,4733355,282,RepeatMasker,LTR,4733267,4733350,84,0.30
ptg006298l,6664730,6665036,306,RepeatMasker,LTR,6664939,6665059,98,0.32
ptg006301l,491416,491721,305,RepeatMasker,LTR,491332,491530,114,0.37
ptg006304l,562079,562360,281,RepeatMasker,LTR,561695,563006,281,1.00
ptg006305l,62965,63264,299,RepeatMasker,LTR,62757,63316,299,1.00
ptg006308l,1084465,1084767,302,RepeatMasker,LTR,1084489,1084912,279,0.92
ptg006310l,74168,74497,329,RepeatMasker,LTR,74435,74483,49,0.15
ptg006310l,1679868,1680160,292,RepeatMasker,LTR,1679790,1680312,292,1.00
ptg006314l,11849909,11850200,291,RepeatMasker,LTR,11849324,11850014,105,0.36
ptg006316l,200984,201299,315,RepeatMasker,LTR,200641,202373,315,1.00
ptg006316l,986343,986642,299,RepeatMasker,LTR,986302,986688,299,1.00
ptg006317l,679581,679860,279,RepeatMasker,LTR,679187,680505,279,1.00
ptg006325l,583352,583650,298,RepeatMasker,LTR,583294,587109,298,1.00
ptg006327l,1407004,1407315,311,RepeatMasker,LTR,1406967,1407015,11,0.04
ptg006327l,1407004,1407315,311,RepeatMasker,LTR,1407118,1407527,198,0.64
ptg006327l,2207267,2207550,283,RepeatMasker,LTR,2207051,2208207,283,1.00
ptg006328l,75192,75492,300,RepeatMasker,LTR,75291,75651,202,0.67
ptg006328l,1320926,1321221,295,RepeatMasker,LTR,1320906,1321273,295,1.00
ptg006328l,1405463,1405763,300,RepeatMasker,LTR,1405237,1405815,300,1.00
ptg006335l,1171755,1172054,299,RepeatMasker,LTR,1171590,1172106,299,1.00
ptg006339l,433825,434152,327,RepeatMasker,LTR,433347,433940,115,0.35
ptg006349l,435243,435541,298,RepeatMasker,LTR,435172,435588,298,1.00
ptg006364l,576135,576426,291,RepeatMasker,LTR,575763,576460,291,1.00
ptg006364l,1268246,1268574,328,RepeatMasker,LTR,1268277,1269909,298,0.91
ptg006365l,602254,602536,282,RepeatMasker,LTR,601613,604409,282,1.00
ptg006368l,1409551,1409878,327,RepeatMasker,LTR,1409591,1410055,288,0.88
ptg006369l,1323380,1323675,295,RepeatMasker,LTR,1323172,1323727,295,1.00
ptg006373l,884483,884775,292,RepeatMasker,LTR,884339,884707,224,0.77
ptg006380l,7747728,7748013,285,RepeatMasker,LTR,7747851,7754221,163,0.57
ptg006380l,10000896,10001180,284,RepeatMasker,LTR,10000929,10001635,252,0.89
ptg006383l,2432463,2432755,292,RepeatMasker,LTR,2432097,2433771,292,1.00
ptg006384l,3672533,3672816,283,RepeatMasker,LTR,3671104,3676145,283,1.00
ptg006389l,997974,998246,272,RepeatMasker,LTR,998080,1005114,167,0.61
ptg006393l,812896,813176,280,RepeatMasker,LTR,811867,813818,280,1.00
ptg006397l,579716,579997,281,RepeatMasker,LTR,578670,580790,281,1.00
ptg006409l,265750,266045,295,RepeatMasker,LTR,265670,266097,295,1.00
ptg006413l,3136917,3137213,296,RepeatMasker,LTR,3136739,3137265,296,1.00
ptg006420l,281230,281523,293,RepeatMasker,LTR,281150,281575,293,1.00
ptg006420l,801606,801884,278,RepeatMasker,LTR,801864,802013,21,0.08
ptg006421l,447860,448139,279,RepeatMasker,LTR,446814,448923,279,1.00
ptg006423l,1767444,1767766,322,RepeatMasker,LTR,1767395,1767558,114,0.35
ptg006426l,2931170,2931465,295,RepeatMasker,LTR,2930992,2931517,295,1.00
ptg006426l,3336145,3336422,277,RepeatMasker,LTR,3335746,3339882,277,1.00
ptg006426l,4884221,4884521,300,RepeatMasker,LTR,4884013,4884555,300,1.00
ptg006427l,594244,594568,324,RepeatMasker,LTR,594268,596010,301,0.93
ptg006427l,2924522,2924809,287,RepeatMasker,LTR,2924256,2924564,42,0.15
ptg006436l,258381,258680,299,RepeatMasker,LTR,258203,258732,299,1.00
ptg006436l,695121,695435,314,RepeatMasker,LTR,695387,695458,49,0.16
ptg006436l,695121,695435,314,RepeatMasker,LTR,695396,700231,40,0.13
ptg006442l,74741,75021,280,RepeatMasker,LTR,74359,75666,280,1.00
ptg006443l,2376271,2376555,284,RepeatMasker,LTR,2376186,2376967,284,1.00
ptg006453l,1023163,1023462,299,RepeatMasker,LTR,1023143,1023496,299,1.00
ptg006454l,6413113,6413422,309,RepeatMasker,LTR,6413219,6413742,204,0.66
ptg006455l,2009263,2009572,309,RepeatMasker,LTR,2007844,2010269,309,1.00
ptg006466l,608840,609127,287,RepeatMasker,LTR,604144,609994,287,1.00
ptg006466l,1845004,1845296,292,RepeatMasker,LTR,1844752,1845930,292,1.00
ptg006472l,457283,457596,313,RepeatMasker,LTR,456523,459359,313,1.00
ptg006473l,318025,318314,289,RepeatMasker,LTR,317645,318356,289,1.00
ptg006479l,821174,821454,280,RepeatMasker,LTR,820039,822087,280,1.00
ptg006480l,743444,743733,289,RepeatMasker,LTR,743478,743555,78,0.27
ptg006481l,1717702,1718005,303,RepeatMasker,LTR,1714681,1718485,303,1.00
ptg006482l,1648979,1649278,299,RepeatMasker,LTR,1648814,1649330,299,1.00
ptg006482l,2202260,2202573,313,RepeatMasker,LTR,2202567,2202784,7,0.02
ptg006488l,1033587,1033866,279,RepeatMasker,LTR,1032474,1037320,279,1.00
ptg006496l,1926447,1926760,313,RepeatMasker,LTR,1926379,1926537,90,0.29
ptg006504l,541609,541927,318,RepeatMasker,LTR,540366,545291,318,1.00
ptg006513l,1068303,1068601,298,RepeatMasker,LTR,1067182,1068619,298,1.00
ptg006513l,1121359,1121636,277,RepeatMasker,LTR,1117941,1121626,267,0.96
ptg006513l,1121359,1121636,277,RepeatMasker,LTR,1121298,1121759,277,1.00
ptg006513l,1132090,1132621,531,RepeatMasker,LTR,1131503,1132238,148,0.28
ptg006516l,316105,316386,281,RepeatMasker,LTR,316366,317347,21,0.07
ptg006518l,1006439,1006719,280,RepeatMasker,LTR,1005827,1007399,280,1.00
ptg006521l,885205,885518,313,RepeatMasker,LTR,884377,885222,17,0.05
ptg006522l,6052933,6053228,295,RepeatMasker,LTR,6052755,6053280,295,1.00
ptg006524l,4627457,4627756,299,RepeatMasker,LTR,4627250,4627808,299,1.00
ptg006524l,5006348,5006675,327,RepeatMasker,LTR,5006051,5007996,327,1.00
ptg006524l,5396908,5397212,304,RepeatMasker,LTR,5397121,5397751,92,0.30
ptg006530l,1035499,1035812,313,RepeatMasker,LTR,1033982,1035748,249,0.80
ptg006534l,1212321,1212619,298,RepeatMasker,LTR,1212241,1212666,298,1.00
ptg006535l,804940,805255,315,RepeatMasker,LTR,804876,805667,315,1.00
ptg006537l,613834,614114,280,RepeatMasker,LTR,612795,614127,280,1.00
ptg006537l,7200944,7201226,282,RepeatMasker,LTR,7200509,7202078,282,1.00
ptg006542l,1418963,1419252,289,RepeatMasker,LTR,1418003,1420937,289,1.00
ptg006542l,1418963,1419252,289,RepeatMasker,LTR,1419140,1421402,113,0.39
ptg006551l,1070403,1070702,299,RepeatMasker,LTR,1070184,1070754,299,1.00
ptg006562l,71464,71760,296,RepeatMasker,LTR,71594,71769,167,0.56
ptg006562l,71464,71760,296,RepeatMasker,LTR,71724,71826,37,0.13
ptg006564l,870848,871128,280,RepeatMasker,LTR,870468,871155,280,1.00
ptg006564l,2124685,2125001,316,RepeatMasker,LTR,2124544,2125004,316,1.00
ptg006569l,1975125,1975417,292,RepeatMasker,LTR,1974213,1977091,292,1.00
ptg006570l,2431705,2432017,312,RepeatMasker,LTR,2430794,2433956,312,1.00
ptg006579l,524203,524509,306,RepeatMasker,LTR,523930,524468,265,0.87
ptg006582l,2203649,2203921,272,RepeatMasker,LTR,2203753,2210784,169,0.62
ptg006588l,2572568,2572867,299,RepeatMasker,LTR,2572745,2572889,123,0.41
ptg006589l,350603,350868,265,RepeatMasker,LTR,349486,350881,265,1.00
ptg006597l,142221,142520,299,RepeatMasker,LTR,142014,142572,299,1.00
ptg006602l,320312,320593,281,RepeatMasker,LTR,319881,321227,281,1.00
ptg006615l,993321,993627,306,RepeatMasker,LTR,993261,993528,207,0.68
ptg006620l,295300,295604,304,RepeatMasker,LTR,295439,295941,166,0.55
ptg006620l,3693145,3693458,313,RepeatMasker,LTR,3691987,3693674,313,1.00
ptg006624l,1504249,1504530,281,RepeatMasker,LTR,1503854,1505336,281,1.00
ptg006632l,72933,73236,303,RepeatMasker,LTR,73030,73111,82,0.27
ptg006632l,492943,493243,300,RepeatMasker,LTR,492742,493295,300,1.00
ptg006638l,2509659,2509932,273,RepeatMasker,LTR,2508891,2509823,164,0.60
ptg006639l,1917081,1917381,300,RepeatMasker,LTR,1917314,1917484,68,0.23
ptg006640l,81347,81652,305,RepeatMasker,LTR,80982,82454,305,1.00
ptg006654l,746565,746855,290,RepeatMasker,LTR,746354,746907,290,1.00
ptg006660l,1541251,1541541,290,RepeatMasker,LTR,1540852,1542340,290,1.00
ptg006665l,64159,64458,299,RepeatMasker,LTR,64320,65639,139,0.46
ptg006665l,1496694,1496989,295,RepeatMasker,LTR,1496911,1497149,79,0.27
ptg006666l,214557,214848,291,RepeatMasker,LTR,214392,214900,291,1.00
ptg006667l,362727,363008,281,RepeatMasker,LTR,361677,363792,281,1.00
ptg006672l,1440472,1440774,302,RepeatMasker,LTR,1440547,1440919,228,0.75
ptg006672l,1461947,1462247,300,RepeatMasker,LTR,1461971,1462392,277,0.92
ptg006673l,984573,984872,299,RepeatMasker,LTR,984366,984924,299,1.00
ptg006674l,1459741,1460039,298,RepeatMasker,LTR,1459381,1460680,298,1.00
ptg006679l,236091,236390,299,RepeatMasker,LTR,235885,236442,299,1.00
ptg006682l,459432,459726,294,RepeatMasker,LTR,458374,459739,294,1.00
ptg006682l,466556,466836,280,RepeatMasker,LTR,465370,466850,280,1.00
ptg006704l,176069,176377,308,RepeatMasker,LTR,176347,179032,31,0.10
ptg006706l,315097,315394,297,RepeatMasker,LTR,315017,315446,297,1.00
ptg006707l,1172960,1173261,301,RepeatMasker,LTR,1173182,1174389,80,0.27
ptg006708l,217746,218030,284,RepeatMasker,LTR,215926,220207,284,1.00
ptg006710l,664254,664547,293,RepeatMasker,LTR,664510,670440,38,0.13
ptg006711l,1354505,1354845,340,RepeatMasker,LTR,1352275,1354506,1,0.00
ptg006711l,3174476,3174757,281,RepeatMasker,LTR,3174082,3174770,281,1.00
ptg006711l,3181600,3181893,293,RepeatMasker,LTR,3181231,3182530,293,1.00
ptg006712l,4575136,4575433,297,RepeatMasker,LTR,4574488,4575223,87,0.29
ptg006712l,4575136,4575433,297,RepeatMasker,LTR,4575232,4576663,202,0.68
ptg006716l,4163102,4163349,247,RepeatMasker,LTR,4158898,4165211,247,1.00
ptg006732l,285149,285430,281,RepeatMasker,LTR,284094,285443,281,1.00
ptg006734l,148266,148575,309,RepeatMasker,LTR,148348,148503,156,0.50
ptg006737l,5530258,5530547,289,RepeatMasker,LTR,5530365,5531970,183,0.63
ptg006738l,74948,75260,312,RepeatMasker,LTR,74681,75863,312,1.00
ptg006738l,592544,592853,309,RepeatMasker,LTR,590226,593704,309,1.00
ptg006742l,4163284,4163565,281,RepeatMasker,LTR,4162973,4163602,281,1.00
ptg006746l,95210,95501,291,RepeatMasker,LTR,95240,98664,262,0.90
ptg006747l,1332323,1332604,281,RepeatMasker,LTR,1331944,1333405,281,1.00
ptg006751l,110131,110430,299,RepeatMasker,LTR,109953,110482,299,1.00
ptg006758l,347988,348284,296,RepeatMasker,LTR,348251,348309,34,0.11
ptg006760l,1155700,1156025,325,RepeatMasker,LTR,1155453,1155801,101,0.31
ptg006760l,1155700,1156025,325,RepeatMasker,LTR,1156000,1157492,26,0.08
ptg006773l,563282,563581,299,RepeatMasker,LTR,563073,563633,299,1.00
ptg006776l,845987,846279,292,RepeatMasker,LTR,845811,846331,292,1.00
ptg006780l,2621292,2621565,273,RepeatMasker,LTR,2620587,2622051,273,1.00
ptg006788l,3021675,3021977,302,RepeatMasker,LTR,3021923,3022279,55,0.18
ptg006788l,5547357,5547657,300,RepeatMasker,LTR,5547599,5547668,59,0.20
ptg006788l,5547357,5547657,300,RepeatMasker,LTR,5547633,5547682,25,0.08
ptg006791l,828651,828963,312,RepeatMasker,LTR,828774,828849,76,0.24
ptg006791l,2565506,2565811,305,RepeatMasker,LTR,2565630,2566147,182,0.60
ptg006796l,308729,309012,283,RepeatMasker,LTR,305944,309614,283,1.00
ptg006797l,101097,101389,292,RepeatMasker,LTR,100755,104219,292,1.00
ptg006802l,2635132,2635417,285,RepeatMasker,LTR,2633739,2636280,285,1.00
ptg006805l,828161,828442,281,RepeatMasker,LTR,828383,828543,60,0.21
ptg006811l,1428698,1428997,299,RepeatMasker,LTR,1428492,1429049,299,1.00
ptg006823l,331612,331909,297,RepeatMasker,LTR,331246,331942,297,1.00
ptg006823l,561326,561635,309,RepeatMasker,LTR,560865,561889,309,1.00
ptg006825l,3892900,3893185,285,RepeatMasker,LTR,3888181,3894013,285,1.00
ptg006825l,4967133,4967429,296,RepeatMasker,LTR,4966403,4968675,296,1.00
ptg006825l,4967133,4967435,302,RepeatMasker,LTR,4966403,4968675,302,1.00
ptg006827l,900430,900744,314,RepeatMasker,LTR,899956,900517,87,0.28
ptg006827l,900430,900744,314,RepeatMasker,LTR,900716,902610,29,0.09
ptg006843l,1673306,1673605,299,RepeatMasker,LTR,1673128,1673657,299,1.00
ptg006850l,417077,417357,280,RepeatMasker,LTR,417047,418137,280,1.00
ptg006850l,1125843,1126123,280,RepeatMasker,LTR,1125461,1126920,280,1.00
ptg006850l,1369879,1370185,306,RepeatMasker,LTR,1370023,1370522,163,0.53
ptg006861l,19852,20175,323,RepeatMasker,LTR,20008,20511,168,0.52
ptg006869l,714884,715180,296,RepeatMasker,LTR,715016,716297,165,0.56
ptg006870l,732450,732765,315,RepeatMasker,LTR,732504,732680,177,0.56
ptg006870l,732450,732765,315,RepeatMasker,LTR,732688,732757,70,0.22
ptg006873l,808767,809076,309,RepeatMasker,LTR,809044,809661,33,0.11
ptg006873l,849942,850261,319,RepeatMasker,LTR,850113,850690,149,0.47
ptg006873l,5691492,5691774,282,RepeatMasker,LTR,5690815,5691719,227,0.80
ptg006888l,1020640,1020936,296,RepeatMasker,LTR,1019357,1021403,296,1.00
ptg006890l,617159,617476,317,RepeatMasker,LTR,617140,617191,32,0.10
ptg006892l,350849,351143,294,RepeatMasker,LTR,350810,351189,294,1.00
ptg006893l,678267,678548,281,RepeatMasker,LTR,677885,678582,281,1.00
ptg006900l,9005755,9006076,321,RepeatMasker,LTR,9005776,9006400,301,0.94
ptg006900l,16005919,16006213,294,RepeatMasker,LTR,16006108,16006313,106,0.36
ptg006902l,76647,76967,320,RepeatMasker,LTR,75701,76651,4,0.01
ptg006912l,460842,461133,291,RepeatMasker,LTR,460638,461185,291,1.00
ptg006912l,589509,589809,300,RepeatMasker,LTR,589316,589861,300,1.00
ptg006915l,129880,130167,287,RepeatMasker,LTR,125191,131029,287,1.00
ptg006917l,486016,486294,278,RepeatMasker,LTR,485632,486940,278,1.00
ptg006921l,104838,105146,308,RepeatMasker,LTR,104029,105364,308,1.00
ptg006922l,3482999,3483277,278,RepeatMasker,LTR,3482602,3483358,278,1.00
ptg006922l,3885564,3885849,285,RepeatMasker,LTR,3885543,3885587,23,0.08
ptg006923l,611810,612109,299,RepeatMasker,LTR,611632,612161,299,1.00
ptg006928l,1674855,1675154,299,RepeatMasker,LTR,1674677,1675206,299,1.00
ptg006933l,3660489,3660776,287,RepeatMasker,LTR,3660769,3661559,8,0.03
ptg006935l,2079493,2079795,302,RepeatMasker,LTR,2079476,2079829,302,1.00
ptg006935l,3046865,3047145,280,RepeatMasker,LTR,3046036,3047012,147,0.53
ptg006936l,567769,568069,300,RepeatMasker,LTR,567560,568121,300,1.00
ptg006943l,547659,547958,299,RepeatMasker,LTR,547618,548009,299,1.00
ptg006944l,715672,715951,279,RepeatMasker,LTR,714573,716675,279,1.00
ptg006944l,1194164,1194492,328,RepeatMasker,LTR,1193485,1194165,1,0.00
ptg006944l,3974636,3974940,304,RepeatMasker,LTR,3972577,3977362,304,1.00
ptg006945l,3469108,3469407,299,RepeatMasker,LTR,3469028,3469459,299,1.00
ptg006949l,1803157,1803448,291,RepeatMasker,LTR,1802786,1803460,291,1.00
ptg006949l,1854075,1854353,278,RepeatMasker,LTR,1850442,1856769,278,1.00
ptg006954l,13025,13305,280,RepeatMasker,LTR,12688,14108,280,1.00
ptg006959l,625866,626172,306,RepeatMasker,LTR,625315,628621,306,1.00
ptg006962l,431039,431320,281,RepeatMasker,LTR,430644,431353,281,1.00
ptg006964l,111226,111512,286,RepeatMasker,LTR,110826,112551,286,1.00
ptg006964l,334064,334375,311,RepeatMasker,LTR,334032,334087,23,0.07
ptg006965l,2162142,2162478,336,RepeatMasker,LTR,2160237,2162623,336,1.00
ptg006967l,1227513,1227801,288,RepeatMasker,LTR,1226865,1229094,288,1.00
ptg006967l,1227513,1227801,288,RepeatMasker,LTR,1227097,1230848,288,1.00
ptg006968l,772,1053,281,RepeatMasker,LTR,455,1087,281,1.00
ptg006974l,1003370,1003689,319,RepeatMasker,LTR,1003293,1003668,298,0.93
ptg006979l,892228,892525,297,RepeatMasker,LTR,892050,892577,297,1.00
ptg006980l,77206,77486,280,RepeatMasker,LTR,76824,77498,280,1.00
ptg006980l,84339,84633,294,RepeatMasker,LTR,83974,84645,294,1.00
ptg006984l,51744,52041,297,RepeatMasker,LTR,51551,52093,297,1.00
ptg006984l,404335,404635,300,RepeatMasker,LTR,404135,404687,300,1.00
ptg006984l,480083,480384,301,RepeatMasker,LTR,479883,480436,301,1.00
ptg006984l,516061,516357,296,RepeatMasker,LTR,515854,516409,296,1.00
ptg006994l,2428179,2428499,320,RepeatMasker,LTR,2428351,2429050,149,0.47
ptg006994l,2469915,2470221,306,RepeatMasker,LTR,2470161,2470350,61,0.20
ptg006998l,2702921,2703235,314,RepeatMasker,LTR,2702547,2703248,314,1.00
ptg007001l,38961,39243,282,RepeatMasker,LTR,37919,40033,282,1.00
ptg007005l,2097055,2097324,269,RepeatMasker,LTR,2096161,2097079,24,0.09
ptg007005l,2617810,2618105,295,RepeatMasker,LTR,2617425,2617868,58,0.20
ptg007005l,3920894,3921174,280,RepeatMasker,LTR,3920510,3921814,280,1.00
ptg007006l,419829,420143,314,RepeatMasker,LTR,419955,422367,189,0.60
ptg007007l,422307,422585,278,RepeatMasker,LTR,421772,423222,278,1.00
ptg007009l,791068,791338,270,RepeatMasker,LTR,790960,791136,68,0.25
ptg007010l,2146668,2146951,283,RepeatMasker,LTR,2146366,2146984,283,1.00
ptg007010l,2146668,2146951,283,RepeatMasker,LTR,2146288,2146984,283,1.00
ptg007012l,1383032,1383363,331,RepeatMasker,LTR,1382184,1384682,331,1.00
ptg007017l,1980814,1981096,282,RepeatMasker,LTR,1980793,1980837,23,0.08
ptg007018l,412251,412537,286,RepeatMasker,LTR,412074,413450,286,1.00
ptg007020l,3486021,3486300,279,RepeatMasker,LTR,3481312,3487159,279,1.00
ptg007021l,2818561,2818870,309,RepeatMasker,LTR,2817325,2818609,48,0.16
ptg007021l,5322205,5322512,307,RepeatMasker,LTR,5321986,5322490,285,0.93
ptg007028l,79438,79734,296,RepeatMasker,LTR,79069,79747,296,1.00
ptg007030l,144568,144860,292,RepeatMasker,LTR,144333,145987,292,1.00
ptg007031l,485670,485949,279,RepeatMasker,LTR,484621,485962,279,1.00
ptg007031l,497104,497383,279,RepeatMasker,LTR,495956,497417,279,1.00
ptg007031l,836323,836648,325,RepeatMasker,LTR,835377,837658,325,1.00
ptg007037l,475744,476074,330,RepeatMasker,LTR,474881,475849,105,0.32
ptg007040l,165148,165426,278,RepeatMasker,LTR,165087,165194,46,0.17
ptg007049l,514907,515204,297,RepeatMasker,LTR,514827,515256,297,1.00
ptg007053l,2249776,2250105,329,RepeatMasker,LTR,2249793,2250674,313,0.95
ptg007053l,2764397,2764715,318,RepeatMasker,LTR,2762157,2764505,108,0.34
ptg007057l,107226,107498,272,RepeatMasker,LTR,107359,108275,140,0.51
ptg007057l,246941,247249,308,RepeatMasker,LTR,245894,247262,308,1.00
ptg007060l,2449090,2449389,299,RepeatMasker,LTR,2449010,2449441,299,1.00
ptg007064l,602466,602775,309,RepeatMasker,LTR,602745,605493,31,0.10
ptg007072l,72411,72732,321,RepeatMasker,LTR,72462,72640,179,0.56
ptg007072l,72411,72732,321,RepeatMasker,LTR,72644,72679,36,0.11
ptg007078l,464843,465140,297,RepeatMasker,LTR,464649,465192,297,1.00
ptg007087l,111410,111721,311,RepeatMasker,LTR,111634,111768,88,0.28
ptg007088l,1119086,1119367,281,RepeatMasker,LTR,1117931,1120004,281,1.00
ptg007088l,1153118,1153429,311,RepeatMasker,LTR,1153238,1153372,135,0.43
ptg007097l,2245452,2245733,281,RepeatMasker,LTR,2244388,2245766,281,1.00
ptg007101l,1770836,1771137,301,RepeatMasker,LTR,1770813,1771189,301,1.00
ptg007102l,479477,479768,291,RepeatMasker,LTR,479304,479576,99,0.34
ptg007112l,776823,777121,298,RepeatMasker,LTR,776615,777173,298,1.00
ptg007131l,2098900,2099179,279,RepeatMasker,LTR,2097854,2099192,279,1.00
ptg007131l,2106078,2106358,280,RepeatMasker,LTR,2104931,2106371,280,1.00
ptg007138l,1348442,1348736,294,RepeatMasker,LTR,1348071,1349381,294,1.00
ptg007148l,1898645,1898960,315,RepeatMasker,LTR,1898751,1899047,210,0.67
ptg007148l,3287915,3288202,287,RepeatMasker,LTR,3287507,3289061,287,1.00
ptg007162l,1110551,1110846,295,RepeatMasker,LTR,1110531,1110880,295,1.00
ptg007163l,153024,153333,309,RepeatMasker,LTR,152375,153170,146,0.47
ptg007163l,153024,153333,309,RepeatMasker,LTR,152475,153359,309,1.00
ptg007168l,285436,285730,294,RepeatMasker,LTR,285242,285782,294,1.00
ptg007171l,1810922,1811218,296,RepeatMasker,LTR,1810555,1811250,296,1.00
ptg007171l,1818081,1818362,281,RepeatMasker,LTR,1817699,1819006,281,1.00
ptg007174l,1035740,1036021,281,RepeatMasker,LTR,1035332,1036819,281,1.00
ptg007175l,1322934,1323218,284,RepeatMasker,LTR,1321868,1324012,284,1.00
ptg007178l,1161102,1161389,287,RepeatMasker,LTR,1157061,1162250,287,1.00
ptg007186l,1978527,1978840,313,RepeatMasker,LTR,1978383,1980193,313,1.00
ptg007188l,3032456,3032758,302,RepeatMasker,LTR,3032669,3032729,61,0.20
ptg007197l,658422,658711,289,RepeatMasker,LTR,658018,659513,289,1.00
ptg007205l,198902,199215,313,RepeatMasker,LTR,198877,198955,53,0.17
ptg007207l,584152,584447,295,RepeatMasker,LTR,580920,585379,295,1.00
ptg007219l,1353289,1353588,299,RepeatMasker,LTR,1353317,1353634,272,0.91
ptg007222l,39843,40136,293,RepeatMasker,LTR,39650,40188,293,1.00
ptg007228l,3436356,3436655,299,RepeatMasker,LTR,3436158,3436707,299,1.00
ptg007237l,151523,151832,309,RepeatMasker,LTR,151674,152503,159,0.51
ptg007241l,1122083,1122370,287,RepeatMasker,LTR,1122308,1122631,63,0.22
ptg007243l,1478876,1479176,300,RepeatMasker,LTR,1478835,1479228,300,1.00
ptg007243l,1543864,1544164,300,RepeatMasker,LTR,1543660,1544216,300,1.00
ptg007243l,1586339,1586638,299,RepeatMasker,LTR,1586131,1586690,299,1.00
ptg007243l,1597130,1597426,296,RepeatMasker,LTR,1596929,1597478,296,1.00
ptg007250l,1228469,1228780,311,RepeatMasker,LTR,1227899,1233492,311,1.00
ptg007260l,1386426,1386727,301,RepeatMasker,LTR,1386052,1386796,301,1.00
ptg007261l,656231,656520,289,RepeatMasker,LTR,655583,657859,289,1.00
ptg007264l,362733,363044,311,RepeatMasker,LTR,362722,363097,311,1.00
ptg007264l,362733,363044,311,RepeatMasker,LTR,362756,363004,249,0.80
ptg007267l,897729,898021,292,RepeatMasker,LTR,897962,897993,32,0.11
ptg007269l,270948,271246,298,RepeatMasker,LTR,271004,271183,180,0.60
ptg007270l,2257891,2258197,306,RepeatMasker,LTR,2255428,2260083,306,1.00
ptg007271l,742062,742387,325,RepeatMasker,LTR,741900,743157,325,1.00
ptg007274l,215527,215826,299,RepeatMasker,LTR,215771,216495,56,0.19
ptg007277l,1432751,1433042,291,RepeatMasker,LTR,1432541,1433094,291,1.00
ptg007279l,365512,365821,309,RepeatMasker,LTR,365759,366052,63,0.20
ptg007282l,103837,104171,334,RepeatMasker,LTR,104096,104458,76,0.23
ptg007285l,2094377,2094679,302,RepeatMasker,LTR,2094450,2094711,230,0.76
ptg007287l,2321181,2321467,286,RepeatMasker,LTR,2316572,2322304,286,1.00
ptg007289l,3911460,3911760,300,RepeatMasker,LTR,3910572,3911512,52,0.17
ptg007295l,812529,812824,295,RepeatMasker,LTR,812362,812876,295,1.00
ptg007300l,1301101,1301403,302,RepeatMasker,LTR,1300741,1302046,302,1.00
ptg007300l,1867631,1867911,280,RepeatMasker,LTR,1867249,1868704,280,1.00
ptg007301l,2585579,2585874,295,RepeatMasker,LTR,2585377,2585926,295,1.00
ptg007301l,3685352,3685646,294,RepeatMasker,LTR,3685507,3685567,61,0.21
ptg007310l,1375433,1375767,334,RepeatMasker,LTR,1375076,1377793,334,1.00
ptg007312l,99522,99841,319,RepeatMasker,LTR,99791,101917,51,0.16
ptg007316l,2766698,2766986,288,RepeatMasker,LTR,2766430,2767380,288,1.00
ptg007319l,345188,345473,285,RepeatMasker,LTR,340548,345566,285,1.00
ptg007319l,345188,345473,285,RepeatMasker,LTR,343567,346327,285,1.00
ptg007334l,1005351,1005634,283,RepeatMasker,LTR,1002585,1006259,283,1.00
ptg007349l,1550727,1551052,325,RepeatMasker,LTR,1550835,1550877,43,0.13
ptg007349l,2618703,2619026,323,RepeatMasker,LTR,2618308,2621260,323,1.00
ptg007349l,3120939,3121226,287,RepeatMasker,LTR,3119369,3122086,287,1.00
ptg007356l,551730,551992,262,RepeatMasker,LTR,551840,552305,153,0.58
ptg007356l,3133196,3133495,299,RepeatMasker,LTR,3133198,3133547,298,1.00
ptg007357l,368864,369159,295,RepeatMasker,LTR,368657,369211,295,1.00
ptg007362l,2526481,2526778,297,RepeatMasker,LTR,2526313,2526830,297,1.00
ptg007370l,530502,530779,277,RepeatMasker,LTR,530485,531118,277,1.00
ptg007370l,805984,806279,295,RepeatMasker,LTR,805789,806331,295,1.00
ptg007373l,659942,660259,317,RepeatMasker,LTR,660083,661949,177,0.56
ptg007375l,1293513,1293794,281,RepeatMasker,LTR,1293123,1293827,281,1.00
ptg007375l,1354998,1355279,281,RepeatMasker,LTR,1354607,1355312,281,1.00
ptg007377l,643182,643476,294,RepeatMasker,LTR,642966,643528,294,1.00
ptg007379l,151217,151510,293,RepeatMasker,LTR,151039,151562,293,1.00
ptg007380l,462603,462904,301,RepeatMasker,LTR,462798,467355,107,0.36
ptg007380l,574630,574929,299,RepeatMasker,LTR,574266,575574,299,1.00
ptg007385l,1638296,1638576,280,RepeatMasker,LTR,1637904,1638955,280,1.00
ptg007386l,1311120,1311426,306,RepeatMasker,LTR,1310600,1313700,306,1.00
ptg007395l,1360970,1361287,317,RepeatMasker,LTR,1360423,1361745,317,1.00
ptg007396l,1202917,1203233,316,RepeatMasker,LTR,1203205,1203257,29,0.09
ptg007396l,1795841,1796137,296,RepeatMasker,LTR,1795591,1796189,296,1.00
ptg007397l,907811,908081,270,RepeatMasker,LTR,907569,908484,270,1.00
ptg007397l,907811,908081,270,RepeatMasker,LTR,907592,908337,270,1.00
ptg007397l,907811,908081,270,RepeatMasker,LTR,907908,908313,174,0.64
ptg007397l,2848060,2848343,283,RepeatMasker,LTR,2848039,2848083,23,0.08
ptg007400l,771605,771885,280,RepeatMasker,LTR,771223,771896,280,1.00
ptg007400l,771605,771885,280,RepeatMasker,LTR,771294,772677,280,1.00
ptg007400l,788251,788536,285,RepeatMasker,LTR,787874,788571,285,1.00
ptg007400l,788251,788536,285,RepeatMasker,LTR,787953,789327,285,1.00
ptg007412l,625623,625903,280,RepeatMasker,LTR,625312,625915,280,1.00
ptg007435l,137101,137429,328,RepeatMasker,LTR,136472,137811,328,1.00
ptg007436l,1281681,1281977,296,RepeatMasker,LTR,1281396,1281942,261,0.88
ptg007436l,1281681,1281977,296,RepeatMasker,LTR,1281937,1287587,41,0.14
ptg007437l,497711,498010,299,RepeatMasker,LTR,497543,498062,299,1.00
ptg007437l,852753,853052,299,RepeatMasker,LTR,852733,853104,299,1.00
ptg007439l,8043135,8043449,314,RepeatMasker,LTR,8042674,8043222,87,0.28
ptg007439l,8043135,8043449,314,RepeatMasker,LTR,8043421,8044830,29,0.09
ptg007439l,10069359,10069677,318,RepeatMasker,LTR,10069153,10071271,318,1.00
ptg007442l,3138251,3138551,300,RepeatMasker,LTR,3138026,3138603,300,1.00
ptg007446l,144075,144358,283,RepeatMasker,LTR,143695,144391,283,1.00
ptg007452l,984404,984691,287,RepeatMasker,LTR,982835,985590,287,1.00
ptg007458l,150576,150863,287,RepeatMasker,LTR,149112,150844,268,0.93
ptg007472l,641863,642152,289,RepeatMasker,LTR,641969,642166,184,0.64
ptg007472l,3620323,3620616,293,RepeatMasker,LTR,3620500,3626601,117,0.40
ptg007472l,5163513,5163820,307,RepeatMasker,LTR,5163723,5164051,98,0.32
ptg007473l,1298248,1298553,305,RepeatMasker,LTR,1297787,1298332,84,0.28
ptg007473l,1298248,1298553,305,RepeatMasker,LTR,1298525,1300518,29,0.10
ptg007479l,572987,573296,309,RepeatMasker,LTR,572580,576118,309,1.00
ptg007479l,650863,651173,310,RepeatMasker,LTR,649606,650879,16,0.05
ptg007479l,650863,651173,310,RepeatMasker,LTR,651037,651090,54,0.17
ptg007485l,282419,282699,280,RepeatMasker,LTR,282121,282737,280,1.00
ptg007488l,1488219,1488553,334,RepeatMasker,LTR,1486508,1488403,184,0.55
ptg007488l,2912383,2912672,289,RepeatMasker,LTR,2912250,2912478,95,0.33
ptg007488l,2912383,2912672,289,RepeatMasker,LTR,2912626,2918560,47,0.16
ptg007489l,7664,7957,293,RepeatMasker,LTR,7600,8601,293,1.00
ptg007490l,797639,797920,281,RepeatMasker,LTR,797320,797954,281,1.00
ptg007493l,1002490,1002789,299,RepeatMasker,LTR,1002562,1002807,228,0.76
ptg007497l,986424,986736,312,RepeatMasker,LTR,984669,987571,312,1.00
ptg007497l,1362580,1362879,299,RepeatMasker,LTR,1362372,1362931,299,1.00
ptg007497l,2188575,2188874,299,RepeatMasker,LTR,2188495,2188926,299,1.00
ptg007501l,1109222,1109521,299,RepeatMasker,LTR,1109014,1109573,299,1.00
ptg007501l,1257266,1257565,299,RepeatMasker,LTR,1257246,1257599,299,1.00
ptg007502l,1847503,1847817,314,RepeatMasker,LTR,1847012,1848719,314,1.00
ptg007504l,2048392,2048691,299,RepeatMasker,LTR,2048183,2048748,299,1.00
ptg007509l,639964,640245,281,RepeatMasker,LTR,636944,640589,281,1.00
ptg007509l,700836,701152,316,RepeatMasker,LTR,700588,701603,316,1.00
ptg007521l,294397,294687,290,RepeatMasker,LTR,294173,294739,290,1.00
ptg007521l,507761,508072,311,RepeatMasker,LTR,507581,508124,311,1.00
ptg007528l,1018138,1018423,285,RepeatMasker,LTR,1017318,1018183,45,0.16
ptg007529l,346314,346603,289,RepeatMasker,LTR,346293,346337,23,0.08
ptg007529l,2171194,2171494,300,RepeatMasker,LTR,2170986,2171546,300,1.00
ptg007529l,2445293,2445589,296,RepeatMasker,LTR,2445138,2445641,296,1.00
ptg007530l,568437,568718,281,RepeatMasker,LTR,563792,569551,281,1.00
ptg007556l,136668,136949,281,RepeatMasker,LTR,136274,136962,281,1.00
ptg007561l,483455,483759,304,RepeatMasker,LTR,483390,483615,160,0.53
ptg007565l,696005,696325,320,RepeatMasker,LTR,692946,696509,320,1.00
ptg007565l,696005,696325,320,RepeatMasker,LTR,694513,698878,320,1.00
ptg007569l,505786,506068,282,RepeatMasker,LTR,505618,505966,180,0.64
ptg007576l,741715,742017,302,RepeatMasker,LTR,740770,742173,302,1.00
ptg007576l,1212326,1212645,319,RepeatMasker,LTR,1212158,1213703,319,1.00
ptg007576l,2737286,2737583,297,RepeatMasker,LTR,2737452,2737746,132,0.44
ptg007598l,288700,288981,281,RepeatMasker,LTR,288318,289779,281,1.00
ptg007598l,315813,316111,298,RepeatMasker,LTR,315448,316571,298,1.00
ptg007598l,1304529,1304828,299,RepeatMasker,LTR,1304509,1304862,299,1.00
ptg007598l,1419379,1419685,306,RepeatMasker,LTR,1419653,1419720,33,0.11
ptg007598l,1419379,1419685,306,RepeatMasker,LTR,1419679,1419907,7,0.02
ptg007617l,450779,451063,284,RepeatMasker,LTR,450075,451680,284,1.00
ptg007624l,598348,598665,317,RepeatMasker,LTR,598659,598885,7,0.02
ptg007624l,1508246,1508543,297,RepeatMasker,LTR,1508166,1508568,297,1.00
ptg007624l,1862676,1862975,299,RepeatMasker,LTR,1862498,1863027,299,1.00
ptg007626l,62839,63147,308,RepeatMasker,LTR,62895,62964,70,0.23
ptg007630l,629129,629409,280,RepeatMasker,LTR,627996,629438,280,1.00
ptg007635l,2042090,2042420,330,RepeatMasker,LTR,2042359,2042835,62,0.19
ptg007640l,386716,386997,281,RepeatMasker,LTR,385578,387636,281,1.00
ptg007640l,1804757,1805037,280,RepeatMasker,LTR,1804410,1805073,280,1.00
ptg007643l,100732,101034,302,RepeatMasker,LTR,100300,100966,234,0.77
ptg007644l,462090,462382,292,RepeatMasker,LTR,461883,462273,183,0.63
ptg007649l,148243,148552,309,RepeatMasker,LTR,148522,151068,31,0.10
ptg007654l,1953167,1953484,317,RepeatMasker,LTR,1952837,1954275,317,1.00
ptg007661l,17654,17962,308,RepeatMasker,LTR,17263,18764,308,1.00
ptg007661l,34477,34756,279,RepeatMasker,LTR,34431,35404,279,1.00
ptg007661l,1204471,1204751,280,RepeatMasker,LTR,1203411,1204764,280,1.00
ptg007661l,1454203,1454483,280,RepeatMasker,LTR,1453804,1455122,280,1.00
ptg007664l,1445857,1446144,287,RepeatMasker,LTR,1441274,1446438,287,1.00
ptg007664l,2158174,2158461,287,RepeatMasker,LTR,2157867,2159291,287,1.00
ptg007664l,3122954,3123234,280,RepeatMasker,LTR,3122572,3123881,280,1.00
ptg007666l,112581,112864,283,RepeatMasker,LTR,111480,114881,283,1.00
ptg007668l,461247,461552,305,RepeatMasker,LTR,461049,461400,153,0.50
ptg007668l,3023182,3023456,274,RepeatMasker,LTR,3023160,3023205,23,0.08
ptg007668l,3565001,3565305,304,RepeatMasker,LTR,3564525,3565071,70,0.23
ptg007668l,3565001,3565305,304,RepeatMasker,LTR,3565277,3565332,29,0.10
ptg007670l,115263,115555,292,RepeatMasker,LTR,115505,117846,51,0.17
ptg007673l,599344,599650,306,RepeatMasker,LTR,599508,604854,143,0.47
ptg007674l,1303967,1304275,308,RepeatMasker,LTR,1304078,1304179,102,0.33
ptg007674l,1535976,1536274,298,RepeatMasker,LTR,1536051,1536419,224,0.75
ptg007675l,1918587,1918872,285,RepeatMasker,LTR,1918407,1918683,96,0.34
ptg007675l,1918587,1918872,285,RepeatMasker,LTR,1918671,1919116,202,0.71
ptg007680l,246239,246518,279,RepeatMasker,LTR,245237,247159,279,1.00
ptg007687l,2249295,2249613,318,RepeatMasker,LTR,2249227,2251126,318,1.00
ptg007691l,1464139,1464420,281,RepeatMasker,LTR,1463757,1464433,281,1.00
ptg007692l,290818,291118,300,RepeatMasker,LTR,290604,291170,300,1.00
ptg007696l,2137958,2138256,298,RepeatMasker,LTR,2137792,2138308,298,1.00
ptg007698l,754903,755179,276,RepeatMasker,LTR,753393,755849,276,1.00
ptg007706l,1352992,1353274,282,RepeatMasker,LTR,1352884,1353403,282,1.00
ptg007712l,290819,291105,286,RepeatMasker,LTR,290324,293504,286,1.00
ptg007713l,168664,168966,302,RepeatMasker,LTR,168834,170217,133,0.44
ptg007713l,1572933,1573213,280,RepeatMasker,LTR,1572551,1573225,280,1.00
ptg007714l,549408,549693,285,RepeatMasker,LTR,548038,550134,285,1.00
ptg007714l,559147,559432,285,RepeatMasker,LTR,558090,559873,285,1.00
ptg007718l,643008,643323,315,RepeatMasker,LTR,642520,643288,280,0.89
ptg007718l,643008,643323,315,RepeatMasker,LTR,643287,643608,37,0.12
ptg007718l,1777801,1778090,289,RepeatMasker,LTR,1777602,1778142,289,1.00
ptg007718l,2941533,2941842,309,RepeatMasker,LTR,2941822,2942022,21,0.07
ptg007719l,924445,924740,295,RepeatMasker,LTR,924267,924792,295,1.00
ptg007721l,270079,270356,277,RepeatMasker,LTR,267247,270346,267,0.96
ptg007721l,270079,270356,277,RepeatMasker,LTR,270018,270478,277,1.00
ptg007723l,194900,195219,319,RepeatMasker,LTR,190750,196586,319,1.00
ptg007725l,943466,943753,287,RepeatMasker,LTR,941896,944633,287,1.00
ptg007726l,35632,35923,291,RepeatMasker,LTR,35119,37105,291,1.00
ptg007729l,2638259,2638567,308,RepeatMasker,LTR,2637877,2639212,308,1.00
ptg007735l,485337,485641,304,RepeatMasker,LTR,481218,485384,47,0.15
ptg007739l,2599227,2599547,320,RepeatMasker,LTR,2599497,2601897,51,0.16
ptg007740l,1637450,1637762,312,RepeatMasker,LTR,1636942,1638513,312,1.00
ptg007740l,2565853,2566173,320,RepeatMasker,LTR,2566123,2567860,51,0.16
ptg007754l,577163,577444,281,RepeatMasker,LTR,576768,578094,281,1.00
ptg007754l,613574,613855,281,RepeatMasker,LTR,613163,614497,281,1.00
ptg007763l,2816758,2817057,299,RepeatMasker,LTR,2816678,2817109,299,1.00
ptg007768l,1407931,1408233,302,RepeatMasker,LTR,1408070,1413776,164,0.54
ptg007770l,2335091,2335355,264,RepeatMasker,LTR,2335139,2335178,40,0.15
ptg007777l,365706,365987,281,RepeatMasker,LTR,364567,366623,281,1.00
ptg007786l,146718,147006,288,RepeatMasker,LTR,146790,147103,217,0.75
ptg007787l,50963,51240,277,RepeatMasker,LTR,51231,51362,10,0.04
ptg007787l,50963,51240,277,RepeatMasker,LTR,47538,51230,267,0.96
ptg007787l,172706,173025,319,RepeatMasker,LTR,172226,173371,319,1.00
ptg007791l,361508,361822,314,RepeatMasker,LTR,360649,364172,314,1.00
ptg007792l,2806152,2806454,302,RepeatMasker,LTR,2806411,2812384,44,0.15
ptg007816l,524543,524825,282,RepeatMasker,LTR,523955,527531,282,1.00
ptg007817l,966984,967287,303,RepeatMasker,LTR,963151,972543,303,1.00
ptg007824l,1234521,1234828,307,RepeatMasker,LTR,1230166,1235890,307,1.00
ptg007824l,2892825,2893105,280,RepeatMasker,LTR,2891776,2893889,280,1.00
ptg007830l,156962,157255,293,RepeatMasker,LTR,157038,157224,187,0.64
ptg007832l,1525367,1525666,299,RepeatMasker,LTR,1525287,1525698,299,1.00
ptg007834l,184952,185279,327,RepeatMasker,LTR,185198,185285,82,0.25
ptg007834l,1116053,1116349,296,RepeatMasker,LTR,1115910,1116360,296,1.00
ptg007834l,1116053,1116349,296,RepeatMasker,LTR,1115990,1116994,296,1.00
ptg007842l,4160875,4161193,318,RepeatMasker,LTR,4161151,4164577,43,0.14
ptg007846l,97476,97767,291,RepeatMasker,LTR,97725,97765,41,0.14
ptg007850l,834236,834517,281,RepeatMasker,LTR,833855,835160,281,1.00
ptg007850l,3722834,3723143,309,RepeatMasker,LTR,3722951,3722980,30,0.10
ptg007854l,999946,1000225,279,RepeatMasker,LTR,999564,1000857,279,1.00
ptg007858l,143424,143725,301,RepeatMasker,LTR,143593,144972,133,0.44
ptg007859l,769868,770145,277,RepeatMasker,LTR,769663,772232,277,1.00
ptg007861l,699810,700103,293,RepeatMasker,LTR,699616,700155,293,1.00
ptg007867l,761823,762127,304,RepeatMasker,LTR,762104,765577,24,0.08
ptg007869l,1536216,1536535,319,RepeatMasker,LTR,1534611,1536292,76,0.24
ptg007882l,557810,558070,260,RepeatMasker,LTR,556458,558362,260,1.00
ptg007883l,69141,69441,300,RepeatMasker,LTR,68929,69493,300,1.00
ptg007883l,434467,434783,316,RepeatMasker,LTR,434444,434496,29,0.09
ptg007883l,434467,434783,316,RepeatMasker,LTR,434620,435625,164,0.52
ptg007883l,2623778,2624098,320,RepeatMasker,LTR,2623194,2623883,105,0.33
ptg007883l,2623778,2624098,320,RepeatMasker,LTR,2623850,2625125,249,0.78
ptg007884l,561955,562250,295,RepeatMasker,LTR,561587,562283,295,1.00
ptg007890l,309483,309809,326,RepeatMasker,LTR,309600,309795,196,0.60
ptg007895l,608177,608479,302,RepeatMasker,LTR,607423,609732,302,1.00
ptg007895l,608177,608479,302,RepeatMasker,LTR,608347,609712,133,0.44
ptg007898l,3963302,3963623,321,RepeatMasker,LTR,3963595,3963726,29,0.09
ptg007898l,3963302,3963623,321,RepeatMasker,LTR,3963597,3963708,27,0.08
ptg007900l,97115,97384,269,RepeatMasker,LTR,97318,97395,67,0.25
ptg007900l,97115,97384,269,RepeatMasker,LTR,97318,97411,67,0.25
ptg007902l,89044,89336,292,RepeatMasker,LTR,88678,92168,292,1.00
ptg007906l,1653854,1654154,300,RepeatMasker,LTR,1653699,1654206,300,1.00
ptg007907l,51747,52029,282,RepeatMasker,LTR,51347,52041,282,1.00
ptg007908l,188365,188671,306,RepeatMasker,LTR,188315,189568,306,1.00
ptg007924l,104769,105069,300,RepeatMasker,LTR,105044,105404,26,0.09
ptg007924l,518699,519003,304,RepeatMasker,LTR,515151,519022,304,1.00
ptg007930l,1332178,1332484,306,RepeatMasker,LTR,1331633,1333167,306,1.00
ptg007936l,892222,892524,302,RepeatMasker,LTR,890947,895289,302,1.00
ptg007942l,265645,265936,291,RepeatMasker,LTR,264727,266041,291,1.00
ptg007944l,585412,585714,302,RepeatMasker,LTR,580665,587606,302,1.00
ptg007948l,2331706,2331986,280,RepeatMasker,LTR,2331692,2332018,280,1.00
ptg007948l,2336296,2336576,280,RepeatMasker,LTR,2335963,2337212,280,1.00
ptg007949l,924345,924676,331,RepeatMasker,LTR,924562,924675,114,0.34
ptg007958l,736422,736704,282,RepeatMasker,LTR,736033,737346,282,1.00
ptg007958l,1479738,1480060,322,RepeatMasker,LTR,1479008,1482044,322,1.00
ptg007969l,2538876,2539156,280,RepeatMasker,LTR,2538508,2539169,280,1.00
ptg007979l,1377698,1377987,289,RepeatMasker,LTR,1376468,1377760,62,0.21
ptg007982l,44043,44336,293,RepeatMasker,LTR,43965,44388,293,1.00
ptg007983l,1240603,1240889,286,RepeatMasker,LTR,1236176,1241193,286,1.00
ptg007983l,1680557,1680840,283,RepeatMasker,LTR,1680231,1683822,283,1.00
ptg007984l,259092,259379,287,RepeatMasker,LTR,257541,260285,287,1.00
ptg007984l,997931,998196,265,RepeatMasker,LTR,997936,998433,261,0.98
ptg007986l,821354,821654,300,RepeatMasker,LTR,821092,821829,300,1.00
ptg007986l,821354,821654,300,RepeatMasker,LTR,818898,821593,239,0.80
ptg007988l,497676,497957,281,RepeatMasker,LTR,497284,497995,281,1.00
ptg007988l,504680,504961,281,RepeatMasker,LTR,504302,504993,281,1.00
ptg007989l,1513250,1513545,295,RepeatMasker,LTR,1513528,1513899,18,0.06
ptg007989l,3245040,3245366,326,RepeatMasker,LTR,3245073,3245961,294,0.90
ptg007996l,78638,78942,304,RepeatMasker,LTR,78816,79067,127,0.42
ptg008016l,2158451,2158742,291,RepeatMasker,LTR,2158639,2158689,51,0.18
ptg008026l,919712,920005,293,RepeatMasker,LTR,919922,920518,84,0.29
ptg008030l,480593,480888,295,RepeatMasker,LTR,480415,480940,295,1.00
ptg008031l,1942056,1942370,314,RepeatMasker,LTR,1941580,1942143,87,0.28
ptg008031l,1942056,1942370,314,RepeatMasker,LTR,1942342,1945959,29,0.09
ptg008037l,238076,238368,292,RepeatMasker,LTR,237734,241202,292,1.00
ptg008039l,1221391,1221690,299,RepeatMasker,LTR,1221183,1221742,299,1.00
ptg008043l,470243,470563,320,RepeatMasker,LTR,470513,473916,51,0.16
ptg008044l,991558,991850,292,RepeatMasker,LTR,991556,993007,292,1.00
ptg008048l,2263599,2263879,280,RepeatMasker,LTR,2262489,2264515,280,1.00
ptg008056l,2000331,2000611,280,RepeatMasker,LTR,1999949,2001413,280,1.00
ptg008060l,1957547,1957835,288,RepeatMasker,LTR,1957548,1958707,288,1.00
ptg008062l,186882,187206,324,RepeatMasker,LTR,187003,188058,204,0.63
ptg008062l,689187,689476,289,RepeatMasker,LTR,684474,690190,289,1.00
ptg008062l,2204553,2204817,264,RepeatMasker,LTR,2204495,2209488,264,1.00
ptg008069l,86340,86621,281,RepeatMasker,LTR,86586,87913,36,0.13
ptg008080l,19983,20292,309,RepeatMasker,LTR,19189,20491,309,1.00
ptg008084l,699562,699861,299,RepeatMasker,LTR,699112,699671,109,0.36
ptg008085l,287996,288276,280,RepeatMasker,LTR,286840,288916,280,1.00
ptg008090l,3877215,3877511,296,RepeatMasker,LTR,3877033,3877563,296,1.00
ptg008090l,4027222,4027521,299,RepeatMasker,LTR,4027142,4027568,299,1.00
ptg008094l,936261,936554,293,RepeatMasker,LTR,935613,936319,58,0.20
ptg008101l,2346501,2346818,317,RepeatMasker,LTR,2346671,2346789,119,0.38
ptg008103l,2290606,2290905,299,RepeatMasker,LTR,2290565,2290951,299,1.00
ptg008105l,840508,840801,293,RepeatMasker,LTR,839787,840656,148,0.51
ptg008105l,840508,840801,293,RepeatMasker,LTR,839883,840737,229,0.78
ptg008106l,1988217,1988511,294,RepeatMasker,LTR,1988274,1988301,28,0.10
ptg008106l,1988217,1988511,294,RepeatMasker,LTR,1988424,1988452,29,0.10
ptg008107l,1621238,1621545,307,RepeatMasker,LTR,1620272,1621985,307,1.00
ptg008109l,250724,251007,283,RepeatMasker,LTR,250634,251119,283,1.00
ptg008112l,2673038,2673356,318,RepeatMasker,LTR,2672345,2673087,49,0.15
ptg008112l,3393153,3393432,279,RepeatMasker,LTR,3393107,3393225,72,0.26
ptg008112l,4919314,4919594,280,RepeatMasker,LTR,4918907,4919606,280,1.00
ptg008115l,789716,790005,289,RepeatMasker,LTR,789701,789756,40,0.14
ptg008115l,789716,790005,289,RepeatMasker,LTR,789856,789927,72,0.25
ptg008115l,1058381,1058673,292,RepeatMasker,LTR,1058015,1061523,292,1.00
ptg008116l,335763,336044,281,RepeatMasker,LTR,335374,336077,281,1.00
ptg008116l,362069,362350,281,RepeatMasker,LTR,361769,362383,281,1.00
ptg008116l,550503,550829,326,RepeatMasker,LTR,550138,551474,326,1.00
ptg008124l,386822,387109,287,RepeatMasker,LTR,382127,387963,287,1.00
ptg008124l,681660,681995,335,RepeatMasker,LTR,681735,681919,185,0.55
ptg008124l,1056929,1057216,287,RepeatMasker,LTR,1052279,1058070,287,1.00
ptg008127l,1510224,1510552,328,RepeatMasker,LTR,1509867,1516658,328,1.00
ptg008131l,100401,100681,280,RepeatMasker,LTR,100019,101321,280,1.00
ptg008134l,118922,119208,286,RepeatMasker,LTR,117506,123125,286,1.00
ptg008138l,99788,100079,291,RepeatMasker,LTR,98696,99862,74,0.25
ptg008138l,99788,100079,291,RepeatMasker,LTR,99862,100040,179,0.62
ptg008142l,1352627,1352919,292,RepeatMasker,LTR,1352196,1352690,63,0.22
ptg008144l,445244,445540,296,RepeatMasker,LTR,445458,445571,83,0.28
ptg008146l,1065617,1065934,317,RepeatMasker,LTR,1065786,1066208,149,0.47
ptg008154l,1864618,1864900,282,RepeatMasker,LTR,1864597,1864641,23,0.08
ptg008159l,737080,737377,297,RepeatMasker,LTR,736682,739750,297,1.00
ptg008191l,349580,349891,311,RepeatMasker,LTR,349665,349763,99,0.32
ptg008196l,1125368,1125655,287,RepeatMasker,LTR,1125192,1125689,287,1.00
ptg008196l,1149788,1150119,331,RepeatMasker,LTR,1149639,1150166,331,1.00
ptg008196l,1290170,1290456,286,RepeatMasker,LTR,1289998,1290490,286,1.00
ptg008196l,1407643,1407939,296,RepeatMasker,LTR,1407482,1407991,296,1.00
ptg008203l,104422,104737,315,RepeatMasker,LTR,104604,106271,134,0.43
ptg008203l,227756,228056,300,RepeatMasker,LTR,227535,228108,300,1.00
ptg008203l,2617872,2618171,299,RepeatMasker,LTR,2617695,2618223,299,1.00
ptg008203l,2775259,2775552,293,RepeatMasker,LTR,2775267,2775586,286,0.98
ptg008203l,3325109,3325406,297,RepeatMasker,LTR,3325029,3325458,297,1.00
ptg008203l,3488395,3488692,297,RepeatMasker,LTR,3488098,3492064,297,1.00
ptg008204l,3383953,3384234,281,RepeatMasker,LTR,3382820,3385016,281,1.00
ptg008205l,747874,748198,324,RepeatMasker,LTR,745796,749016,324,1.00
ptg008211l,659456,659771,315,RepeatMasker,LTR,659122,659632,176,0.56
ptg008211l,659456,659771,315,RepeatMasker,LTR,659545,659708,164,0.52
ptg008221l,2227561,2227884,323,RepeatMasker,LTR,2227387,2227936,323,1.00
ptg008227l,188322,188607,285,RepeatMasker,LTR,188503,188678,105,0.37
ptg008253l,163630,163940,310,RepeatMasker,LTR,163767,165043,174,0.56
ptg008268l,103670,103951,281,RepeatMasker,LTR,103288,103964,281,1.00
ptg008273l,726761,727057,296,RepeatMasker,LTR,726583,727109,296,1.00
ptg008273l,2241325,2241624,299,RepeatMasker,LTR,2240667,2242019,299,1.00
ptg008281l,830522,830803,281,RepeatMasker,LTR,830211,831449,281,1.00
ptg008295l,1568117,1568397,280,RepeatMasker,LTR,1567079,1569181,280,1.00
ptg008295l,1573825,1574104,279,RepeatMasker,LTR,1572690,1574736,279,1.00
ptg008299l,35252,35532,280,RepeatMasker,LTR,34870,35544,280,1.00
ptg008300l,801709,802020,311,RepeatMasker,LTR,798210,801759,50,0.16
ptg008305l,4121858,4122171,313,RepeatMasker,LTR,4121307,4124227,313,1.00
ptg008305l,5605052,5605333,281,RepeatMasker,LTR,5604420,5605970,281,1.00
ptg008308l,1321415,1321703,288,RepeatMasker,LTR,1319630,1321458,43,0.15
ptg008315l,112468,112764,296,RepeatMasker,LTR,112290,112816,296,1.00
ptg008317l,189955,190236,281,RepeatMasker,LTR,189565,191038,281,1.00
ptg008324l,192171,192467,296,RepeatMasker,LTR,192294,193556,174,0.59
ptg008335l,4227266,4227555,289,RepeatMasker,LTR,4227169,4227802,289,1.00
ptg008335l,4620241,4620559,318,RepeatMasker,LTR,4620386,4620462,77,0.24
ptg008337l,1382386,1382673,287,RepeatMasker,LTR,1381896,1383508,287,1.00
ptg008339l,491997,492286,289,RepeatMasker,LTR,491795,492338,289,1.00
ptg008339l,1416437,1416736,299,RepeatMasker,LTR,1416230,1416788,299,1.00
ptg008339l,1882080,1882376,296,RepeatMasker,LTR,1882076,1883792,296,1.00
ptg008339l,2007407,2007702,295,RepeatMasker,LTR,2007435,2007500,66,0.22
ptg008339l,2563761,2564036,275,RepeatMasker,LTR,2563539,2563855,94,0.34
ptg008339l,3056118,3056415,297,RepeatMasker,LTR,3055940,3056467,297,1.00
ptg008339l,3077015,3077312,297,RepeatMasker,LTR,3076935,3077359,297,1.00
ptg008339l,3197676,3197971,295,RepeatMasker,LTR,3197495,3198023,295,1.00
ptg008343l,2156200,2156482,282,RepeatMasker,LTR,2155818,2157123,282,1.00
ptg008345l,682029,682324,295,RepeatMasker,LTR,681835,682376,295,1.00
ptg008347l,8243,8542,299,RepeatMasker,LTR,7664,10498,299,1.00
ptg008347l,121124,121416,292,RepeatMasker,LTR,115589,121526,292,1.00
ptg008354l,855846,856132,286,RepeatMasker,LTR,854809,856768,286,1.00
ptg008356l,789951,790265,314,RepeatMasker,LTR,789469,790038,87,0.28
ptg008356l,789951,790265,314,RepeatMasker,LTR,790237,792542,29,0.09
ptg008358l,2373028,2373337,309,RepeatMasker,LTR,2372675,2373972,309,1.00
ptg008366l,1628788,1629106,318,RepeatMasker,LTR,1628071,1630275,318,1.00
ptg008372l,83619,83900,281,RepeatMasker,LTR,83324,84543,281,1.00
ptg008372l,186777,187102,325,RepeatMasker,LTR,183892,188343,325,1.00
ptg008383l,1354157,1354458,301,RepeatMasker,LTR,1353431,1354180,23,0.08
ptg008383l,1354157,1354458,301,RepeatMasker,LTR,1354402,1354478,57,0.19
ptg008386l,1495789,1496092,303,RepeatMasker,LTR,1493604,1496118,303,1.00
ptg008389l,132233,132556,323,RepeatMasker,LTR,132447,133791,110,0.34
ptg008389l,1659309,1659617,308,RepeatMasker,LTR,1658891,1660586,308,1.00
ptg008392l,910392,910690,298,RepeatMasker,LTR,909407,911320,298,1.00
ptg008393l,3779155,3779462,307,RepeatMasker,LTR,3779367,3780216,96,0.31
ptg008396l,252560,252865,305,RepeatMasker,LTR,252158,252626,66,0.22
ptg008400l,2399670,2399959,289,RepeatMasker,LTR,2399674,2400211,286,0.99
ptg008400l,2399670,2399959,289,RepeatMasker,LTR,2399827,2400277,133,0.46
ptg008408l,130058,130356,298,RepeatMasker,LTR,130194,131451,163,0.55
ptg008413l,4376909,4377203,294,RepeatMasker,LTR,4375996,4378578,294,1.00
ptg008413l,5271417,5271732,315,RepeatMasker,LTR,5270818,5271469,52,0.17
ptg008413l,5271417,5271732,315,RepeatMasker,LTR,5271496,5271587,92,0.29
ptg008413l,5271417,5271732,315,RepeatMasker,LTR,5271653,5271698,46,0.15
ptg008415l,1200834,1201115,281,RepeatMasker,LTR,1200442,1201128,281,1.00
ptg008416l,1777862,1778186,324,RepeatMasker,LTR,1778043,1778956,144,0.44
ptg008422l,218211,218524,313,RepeatMasker,LTR,218180,218234,23,0.07
ptg008422l,983291,983571,280,RepeatMasker,LTR,982910,984375,280,1.00
ptg008425l,160892,161178,286,RepeatMasker,LTR,156281,161907,286,1.00
ptg008432l,1056445,1056762,317,RepeatMasker,LTR,1056268,1058681,317,1.00
ptg008432l,1154906,1155200,294,RepeatMasker,LTR,1154532,1160251,294,1.00
ptg008433l,285004,285294,290,RepeatMasker,LTR,285259,285311,36,0.12
ptg008439l,909218,909506,288,RepeatMasker,LTR,909184,909241,23,0.08
ptg008440l,4085461,4085731,270,RepeatMasker,LTR,4085262,4085516,55,0.20
ptg008440l,4085461,4085731,270,RepeatMasker,LTR,4085528,4085697,170,0.63
ptg008440l,4085461,4085731,270,RepeatMasker,LTR,4085701,4091523,31,0.11
ptg008441l,362355,362649,294,RepeatMasker,LTR,362157,363232,294,1.00
ptg008442l,302657,302947,290,RepeatMasker,LTR,302812,303047,136,0.47
ptg008443l,392565,392846,281,RepeatMasker,LTR,392183,393490,281,1.00
ptg008446l,1078198,1078497,299,RepeatMasker,LTR,1078023,1078549,299,1.00
ptg008447l,71688,72014,326,RepeatMasker,LTR,71850,76604,165,0.51
ptg008449l,753979,754309,330,RepeatMasker,LTR,754147,761549,163,0.49
ptg008460l,426864,427145,281,RepeatMasker,LTR,425817,427953,281,1.00
ptg008464l,600225,600553,328,RepeatMasker,LTR,600287,600840,267,0.81
ptg008475l,394523,394821,298,RepeatMasker,LTR,394502,394873,298,1.00
ptg008475l,1080812,1081108,296,RepeatMasker,LTR,1080634,1081160,296,1.00
ptg008479l,954610,954891,281,RepeatMasker,LTR,953561,954924,281,1.00
ptg008492l,3121673,3121979,306,RepeatMasker,LTR,3121288,3122619,306,1.00
ptg008500l,336916,337222,306,RepeatMasker,LTR,336459,337027,111,0.36
ptg008507l,3459785,3460072,287,RepeatMasker,LTR,3459710,3460538,287,1.00
ptg008508l,1565639,1565921,282,RepeatMasker,LTR,1563932,1566389,282,1.00
ptg008508l,1626515,1626815,300,RepeatMasker,LTR,1626200,1626735,220,0.73
ptg008509l,115408,115694,286,RepeatMasker,LTR,115460,115592,133,0.47
ptg008509l,535432,535692,260,RepeatMasker,LTR,534778,535530,98,0.38
ptg008515l,400336,400633,297,RepeatMasker,LTR,400316,400667,297,1.00
ptg008516l,34195,34475,280,RepeatMasker,LTR,33813,34488,280,1.00
ptg008519l,1341369,1341678,309,RepeatMasker,LTR,1340753,1342179,309,1.00
ptg008528l,574818,575098,280,RepeatMasker,LTR,574436,575877,280,1.00
ptg008530l,2007345,2007593,248,RepeatMasker,LTR,2003136,2009315,248,1.00
ptg008531l,77955,78289,334,RepeatMasker,LTR,78122,78153,32,0.10
ptg008539l,1250650,1250937,287,RepeatMasker,LTR,1250800,1250854,55,0.19
ptg008547l,2547461,2547760,299,RepeatMasker,LTR,2547282,2547708,247,0.83
ptg008549l,14601,14893,292,RepeatMasker,LTR,14231,15657,292,1.00
ptg008551l,1013683,1013980,297,RepeatMasker,LTR,1012695,1014639,297,1.00
ptg008552l,1139714,1140026,312,RepeatMasker,LTR,1139941,1140005,65,0.21
ptg008554l,2042691,2042974,283,RepeatMasker,LTR,2042670,2042713,22,0.08
ptg008554l,2401405,2401702,297,RepeatMasker,LTR,2400743,2402095,297,1.00
ptg008554l,2408578,2408877,299,RepeatMasker,LTR,2407821,2408927,299,1.00
ptg008556l,466665,466969,304,RepeatMasker,LTR,466305,467771,304,1.00
ptg008557l,1189691,1190014,323,RepeatMasker,LTR,1189694,1189792,99,0.31
ptg008559l,409376,409674,298,RepeatMasker,LTR,409010,409706,298,1.00
ptg008560l,194340,194635,295,RepeatMasker,LTR,194470,195728,166,0.56
ptg008563l,253912,254210,298,RepeatMasker,LTR,253467,256894,298,1.00
ptg008569l,420639,420964,325,RepeatMasker,LTR,420399,421504,325,1.00
ptg008570l,527430,527721,291,RepeatMasker,LTR,527586,527631,46,0.16
ptg008579l,1020973,1021268,295,RepeatMasker,LTR,1020795,1021320,295,1.00
ptg008579l,2863650,2863978,328,RepeatMasker,LTR,2863530,2865181,328,1.00
ptg008581l,405531,405836,305,RepeatMasker,LTR,405667,405789,123,0.40
ptg008610l,3220892,3221174,282,RepeatMasker,LTR,3219757,3221207,282,1.00
ptg008611l,565621,565902,281,RepeatMasker,LTR,565228,566224,281,1.00
ptg008611l,847920,848200,280,RepeatMasker,LTR,847538,848212,280,1.00
ptg008615l,202361,202667,306,RepeatMasker,LTR,201804,204776,306,1.00
ptg008623l,847719,847995,276,RepeatMasker,LTR,846688,848016,276,1.00
ptg008623l,856053,856343,290,RepeatMasker,LTR,856031,856994,290,1.00
ptg008630l,724458,724757,299,RepeatMasker,LTR,724438,724790,299,1.00
ptg008632l,1231587,1231876,289,RepeatMasker,LTR,1231412,1232618,289,1.00
ptg008633l,522392,522673,281,RepeatMasker,LTR,521254,523320,281,1.00
ptg008634l,367431,367753,322,RepeatMasker,LTR,364905,367926,322,1.00
ptg008641l,1397539,1397865,326,RepeatMasker,LTR,1395420,1399007,326,1.00
ptg008649l,1808218,1808498,280,RepeatMasker,LTR,1807833,1808531,280,1.00
ptg008651l,2949771,2950092,321,RepeatMasker,LTR,2949593,2950113,321,1.00
ptg008651l,4820205,4820505,300,RepeatMasker,LTR,4820335,4821373,171,0.57
ptg008658l,1621719,1622018,299,RepeatMasker,LTR,1621524,1622052,299,1.00
ptg008669l,1392989,1393303,314,RepeatMasker,LTR,1391791,1397973,314,1.00
ptg008679l,2717940,2718236,296,RepeatMasker,LTR,2716602,2718262,296,1.00
ptg008700l,774382,774630,248,RepeatMasker,LTR,770182,779684,248,1.00
ptg008700l,4539332,4539614,282,RepeatMasker,LTR,4539233,4539459,127,0.45
ptg008701l,1044174,1044508,334,RepeatMasker,LTR,1044425,1044898,84,0.25
ptg008707l,1305323,1305613,290,RepeatMasker,LTR,1303225,1307402,290,1.00
ptg008712l,926852,927145,293,RepeatMasker,LTR,926838,927000,148,0.51
ptg008712l,926852,927145,293,RepeatMasker,LTR,927006,927281,140,0.48
ptg008712l,926852,927145,293,RepeatMasker,LTR,927006,927512,140,0.48
ptg008716l,636714,637018,304,RepeatMasker,LTR,636801,637156,218,0.72
ptg008723l,778172,778498,326,RepeatMasker,LTR,778211,778259,49,0.15
ptg008724l,91271,91552,281,RepeatMasker,LTR,90889,91585,281,1.00
ptg008724l,129233,129514,281,RepeatMasker,LTR,128166,129527,281,1.00
ptg008727l,4208371,4208672,301,RepeatMasker,LTR,4208017,4208486,115,0.38
ptg008734l,180480,180784,304,RepeatMasker,LTR,180193,181586,304,1.00
ptg008745l,531945,532243,298,RepeatMasker,LTR,531814,532896,298,1.00
ptg008749l,322926,323238,312,RepeatMasker,LTR,319392,323817,312,1.00
ptg008749l,2281632,2281937,305,RepeatMasker,LTR,2280121,2283042,305,1.00
ptg008755l,407703,408000,297,RepeatMasker,LTR,407731,408046,270,0.91
ptg008759l,1382926,1383191,265,RepeatMasker,LTR,1383078,1383120,43,0.16
ptg008759l,1382926,1383191,265,RepeatMasker,LTR,1383121,1389703,71,0.27
ptg008760l,1718246,1718528,282,RepeatMasker,LTR,1718194,1719149,282,1.00
ptg008765l,1540649,1540932,283,RepeatMasker,LTR,1540246,1545221,283,1.00
ptg008775l,2925168,2925449,281,RepeatMasker,LTR,2923963,2926085,281,1.00
ptg008776l,126328,126647,319,RepeatMasker,LTR,126303,126482,154,0.48
ptg008777l,2052897,2053212,315,RepeatMasker,LTR,2052611,2053147,250,0.79
ptg008789l,3431222,3431552,330,RepeatMasker,LTR,3430359,3431816,330,1.00
ptg008790l,3308525,3308837,312,RepeatMasker,LTR,3308295,3309215,312,1.00
ptg008807l,66436,66749,313,RepeatMasker,LTR,66713,67570,37,0.12
ptg008807l,804511,804804,293,RepeatMasker,LTR,804470,804856,293,1.00
ptg008818l,285588,285876,288,RepeatMasker,LTR,285567,285611,23,0.08
ptg008818l,1362805,1363086,281,RepeatMasker,LTR,1362403,1363122,281,1.00
ptg008818l,1967490,1967795,305,RepeatMasker,LTR,1967665,1967758,94,0.31
ptg008826l,649151,649464,313,RepeatMasker,LTR,649059,649170,19,0.06
ptg008827l,1089878,1090183,305,RepeatMasker,LTR,1090018,1090068,51,0.17
ptg008830l,1447726,1448043,317,RepeatMasker,LTR,1448042,1448085,2,0.01
ptg008831l,2099862,2100142,280,RepeatMasker,LTR,2099538,2100776,280,1.00
ptg008832l,489733,490028,295,RepeatMasker,LTR,489692,490074,295,1.00
ptg008835l,1363377,1363664,287,RepeatMasker,LTR,1358709,1364565,287,1.00
ptg008836l,1875752,1876051,299,RepeatMasker,LTR,1875574,1876098,299,1.00
ptg008838l,272853,273133,280,RepeatMasker,LTR,272471,273770,280,1.00
ptg008838l,3080535,3080815,280,RepeatMasker,LTR,3080165,3080827,280,1.00
ptg008840l,432244,432544,300,RepeatMasker,LTR,432021,432597,300,1.00
ptg008840l,497035,497335,300,RepeatMasker,LTR,497000,497388,300,1.00
ptg008841l,41483,41770,287,RepeatMasker,LTR,39114,42604,287,1.00
ptg008845l,2178075,2178363,288,RepeatMasker,LTR,2178054,2178098,23,0.08
ptg008881l,279865,280166,301,RepeatMasker,LTR,278886,279910,45,0.15
ptg008883l,636722,637021,299,RepeatMasker,LTR,636916,637052,106,0.35
ptg008886l,317124,317413,289,RepeatMasker,LTR,317231,317591,183,0.63
ptg008911l,206688,206966,278,RepeatMasker,LTR,206527,206722,34,0.12
ptg008917l,1777232,1777529,297,RepeatMasker,LTR,1777212,1777563,297,1.00
ptg008927l,161829,162128,299,RepeatMasker,LTR,161648,162180,299,1.00
ptg008928l,1282384,1282703,319,RepeatMasker,LTR,1282327,1282483,99,0.31
ptg008928l,1282384,1282703,319,RepeatMasker,LTR,1282368,1282534,150,0.47
ptg008931l,723436,723757,321,RepeatMasker,LTR,722077,725068,321,1.00
ptg008944l,24371,24651,280,RepeatMasker,LTR,24300,24436,65,0.23
ptg008944l,599228,599547,319,RepeatMasker,LTR,599054,599599,319,1.00
ptg008945l,749827,750112,285,RepeatMasker,LTR,749521,750124,285,1.00
ptg008967l,494286,494585,299,RepeatMasker,LTR,494108,494637,299,1.00
ptg008976l,938152,938482,330,RepeatMasker,LTR,935929,945400,330,1.00
ptg008990l,1882608,1882908,300,RepeatMasker,LTR,1882394,1882960,300,1.00
ptg008990l,2525815,2526108,293,RepeatMasker,LTR,2525650,2526160,293,1.00
ptg008995l,498521,498812,291,RepeatMasker,LTR,498343,498864,291,1.00
ptg009000l,53477,53786,309,RepeatMasker,LTR,53441,53694,217,0.70
ptg009002l,555914,556236,322,RepeatMasker,LTR,555939,556269,298,0.93
ptg009002l,909180,909481,301,RepeatMasker,LTR,908791,910279,301,1.00
ptg009006l,178761,179064,303,RepeatMasker,LTR,178846,181744,219,0.72
ptg009013l,139183,139482,299,RepeatMasker,LTR,138975,139534,299,1.00
ptg009013l,279559,279858,299,RepeatMasker,LTR,279366,279910,299,1.00
ptg009013l,297205,297504,299,RepeatMasker,LTR,297064,297556,299,1.00
ptg009018l,1156691,1157018,327,RepeatMasker,LTR,1155835,1160671,327,1.00
ptg009020l,1945122,1945402,280,RepeatMasker,LTR,1943990,1946033,280,1.00
ptg009023l,1092633,1092923,290,RepeatMasker,LTR,1091573,1093699,290,1.00
ptg009026l,332342,332665,323,RepeatMasker,LTR,332176,333652,323,1.00
ptg009028l,1826800,1827114,314,RepeatMasker,LTR,1826621,1826918,118,0.38
ptg009035l,1098727,1099010,283,RepeatMasker,LTR,1095934,1099623,283,1.00
ptg009048l,2632693,2632973,280,RepeatMasker,LTR,2632303,2633613,280,1.00
ptg009054l,634557,634864,307,RepeatMasker,LTR,634175,634876,307,1.00
ptg009057l,224798,225123,325,RepeatMasker,LTR,222954,227815,325,1.00
ptg009064l,680033,680335,302,RepeatMasker,LTR,678633,680667,302,1.00
ptg009083l,42162,42491,329,RepeatMasker,LTR,42307,42409,103,0.31
ptg009107l,1617815,1618129,314,RepeatMasker,LTR,1616638,1617942,127,0.40
ptg009107l,1617815,1618129,314,RepeatMasker,LTR,1618093,1618197,37,0.12
ptg009107l,1833049,1833381,332,RepeatMasker,LTR,1832913,1833433,332,1.00
ptg009113l,243249,243539,290,RepeatMasker,LTR,243329,243724,211,0.73
ptg009116l,269932,270231,299,RepeatMasker,LTR,269732,270283,299,1.00
ptg009120l,38561,38843,282,RepeatMasker,LTR,38410,38721,160,0.57
ptg009120l,651075,651380,305,RepeatMasker,LTR,651374,651552,7,0.02
ptg009121l,277441,277727,286,RepeatMasker,LTR,272851,278634,286,1.00
ptg009124l,1407646,1407946,300,RepeatMasker,LTR,1407718,1407978,229,0.76
ptg009130l,505322,505598,276,RepeatMasker,LTR,505568,505604,31,0.11
ptg009133l,1238349,1238635,286,RepeatMasker,LTR,1233653,1239491,286,1.00
ptg009140l,157209,157505,296,RepeatMasker,LTR,157013,157557,296,1.00
ptg009142l,229425,229705,280,RepeatMasker,LTR,229107,230485,280,1.00
ptg009147l,1123738,1124018,280,RepeatMasker,LTR,1123356,1124820,280,1.00
ptg009151l,2756096,2756387,291,RepeatMasker,LTR,2755605,2756658,291,1.00
ptg009152l,1643000,1643308,308,RepeatMasker,LTR,1643140,1644197,169,0.55
ptg009177l,238380,238680,300,RepeatMasker,LTR,237000,239246,300,1.00
ptg009179l,994927,995216,289,RepeatMasker,LTR,994504,995118,191,0.66
ptg009179l,994927,995216,289,RepeatMasker,LTR,995002,995219,215,0.74
ptg009179l,1124130,1124438,308,RepeatMasker,LTR,1124025,1124842,308,1.00
ptg009187l,785248,785570,322,RepeatMasker,LTR,785555,785777,16,0.05
ptg009219l,1566266,1566577,311,RepeatMasker,LTR,1564855,1566517,251,0.81
ptg009224l,2032246,2032522,276,RepeatMasker,LTR,2032185,2032644,276,1.00
ptg009224l,2032246,2032522,276,RepeatMasker,LTR,2028819,2032512,266,0.96
ptg009224l,2122624,2122926,302,RepeatMasker,LTR,2122446,2122978,302,1.00
ptg009224l,3730248,3730541,293,RepeatMasker,LTR,3730170,3730593,293,1.00
ptg009227l,175165,175477,312,RepeatMasker,LTR,174771,175628,312,1.00
ptg009227l,1286058,1286361,303,RepeatMasker,LTR,1286334,1288883,28,0.09
ptg009229l,36660,36980,320,RepeatMasker,LTR,36548,36674,14,0.04
ptg009229l,36660,36980,320,RepeatMasker,LTR,36730,36842,113,0.35
ptg009238l,1473644,1473923,279,RepeatMasker,LTR,1473262,1474572,279,1.00
ptg009244l,818287,818567,280,RepeatMasker,LTR,817138,818580,280,1.00
ptg009255l,182820,183100,280,RepeatMasker,LTR,181819,183895,280,1.00
ptg009255l,214531,214812,281,RepeatMasker,LTR,213407,214825,281,1.00
ptg009255l,3271661,3271980,319,RepeatMasker,LTR,3271645,3271768,107,0.34
ptg009257l,1122542,1122842,300,RepeatMasker,LTR,1122520,1122565,23,0.08
ptg009262l,94887,95181,294,RepeatMasker,LTR,94747,95233,294,1.00
ptg009262l,1629517,1629798,281,RepeatMasker,LTR,1628174,1629716,199,0.71
ptg009267l,1114781,1115061,280,RepeatMasker,LTR,1114387,1115705,280,1.00
ptg009271l,926432,926747,315,RepeatMasker,LTR,926205,926438,6,0.02
ptg009274l,775026,775313,287,RepeatMasker,LTR,775150,782248,164,0.57
ptg009277l,262330,262629,299,RepeatMasker,LTR,262289,262675,299,1.00
ptg009278l,457309,457601,292,RepeatMasker,LTR,456967,460434,292,1.00
ptg009278l,787638,787937,299,RepeatMasker,LTR,787558,787989,299,1.00
ptg009278l,1179004,1179304,300,RepeatMasker,LTR,1178826,1179356,300,1.00
ptg009281l,905966,906247,281,RepeatMasker,LTR,904920,906883,281,1.00
ptg009285l,3383244,3383543,299,RepeatMasker,LTR,3383035,3383595,299,1.00
ptg009285l,3396911,3397206,295,RepeatMasker,LTR,3396733,3397258,295,1.00
ptg009286l,3742762,3743075,313,RepeatMasker,LTR,3742739,3744556,313,1.00
ptg009291l,49870,50183,313,RepeatMasker,LTR,49890,50828,294,0.94
ptg009300l,2158898,2159179,281,RepeatMasker,LTR,2158720,2159231,281,1.00
ptg009307l,488379,488686,307,RepeatMasker,LTR,486581,488997,307,1.00
ptg009307l,488379,488686,307,RepeatMasker,LTR,487826,489143,307,1.00
ptg009307l,643149,643476,327,RepeatMasker,LTR,643316,643473,158,0.48
ptg009308l,75387,75667,280,RepeatMasker,LTR,74259,76303,280,1.00
ptg009308l,103841,104120,279,RepeatMasker,LTR,102697,104133,279,1.00
ptg009318l,1250462,1250768,306,RepeatMasker,LTR,1248159,1251033,306,1.00
ptg009318l,1895861,1896172,311,RepeatMasker,LTR,1895666,1896224,311,1.00
ptg009323l,1971458,1971748,290,RepeatMasker,LTR,1971378,1971800,290,1.00
ptg009328l,2672603,2672905,302,RepeatMasker,LTR,2672773,2674156,133,0.44
ptg009332l,26159,26508,349,RepeatMasker,LTR,25479,26216,57,0.16
ptg009336l,1443317,1443607,290,RepeatMasker,LTR,1443548,1443661,60,0.21
ptg009339l,1347223,1347504,281,RepeatMasker,LTR,1346829,1348150,281,1.00
ptg009342l,306132,306419,287,RepeatMasker,LTR,301485,307273,287,1.00
ptg009343l,1183975,1184276,301,RepeatMasker,LTR,1184074,1185689,203,0.67
ptg009346l,29708,30014,306,RepeatMasker,LTR,23095,30156,306,1.00
ptg009348l,580951,581232,281,RepeatMasker,LTR,578165,581846,281,1.00
ptg009355l,551838,552118,280,RepeatMasker,LTR,551456,552920,280,1.00
ptg009357l,1550465,1550741,276,RepeatMasker,LTR,1547709,1550797,276,1.00
ptg009362l,1449704,1449990,286,RepeatMasker,LTR,1446593,1449716,12,0.04
ptg009370l,1427283,1427582,299,RepeatMasker,LTR,1427263,1427634,299,1.00
ptg009370l,2661722,2662020,298,RepeatMasker,LTR,2661506,2662072,298,1.00
ptg009370l,5524121,5524440,319,RepeatMasker,LTR,5523418,5526753,319,1.00
ptg009373l,3465201,3465481,280,RepeatMasker,LTR,3465043,3465492,280,1.00
ptg009373l,3465201,3465481,280,RepeatMasker,LTR,3465123,3466274,280,1.00
ptg009376l,397436,397729,293,RepeatMasker,LTR,397599,397848,131,0.45
ptg009376l,515329,515632,303,RepeatMasker,LTR,514974,516421,303,1.00
ptg009376l,515329,515632,303,RepeatMasker,LTR,515017,516312,303,1.00
ptg009405l,1507351,1507650,299,RepeatMasker,LTR,1507237,1507454,103,0.34
ptg009409l,750144,750446,302,RepeatMasker,LTR,750168,750594,279,0.92
ptg009412l,1573360,1573638,278,RepeatMasker,LTR,1568915,1575276,278,1.00
ptg009423l,11665,11964,299,RepeatMasker,LTR,11674,11998,291,0.97
ptg009426l,232313,232593,280,RepeatMasker,LTR,231928,232604,280,1.00
ptg009428l,386968,387270,302,RepeatMasker,LTR,386748,387322,302,1.00
ptg009434l,271774,272025,251,RepeatMasker,LTR,271730,271797,23,0.09
ptg009434l,271774,272025,251,RepeatMasker,LTR,271891,271993,103,0.41
ptg009434l,271774,272025,251,RepeatMasker,LTR,272024,272064,2,0.01
ptg009441l,789757,790075,318,RepeatMasker,LTR,789234,789816,59,0.19
ptg009441l,789757,790075,318,RepeatMasker,LTR,789774,789898,125,0.39
ptg009451l,1460106,1460408,302,RepeatMasker,LTR,1460072,1460146,40,0.13
ptg009452l,2625502,2625783,281,RepeatMasker,LTR,2625120,2625816,281,1.00
ptg009459l,458071,458370,299,RepeatMasker,LTR,457903,458422,299,1.00
ptg009465l,335129,335429,300,RepeatMasker,LTR,334932,335481,300,1.00
ptg009465l,1074695,1074977,282,RepeatMasker,LTR,1074960,1075195,18,0.06
ptg009465l,3301873,3302160,287,RepeatMasker,LTR,3297178,3302995,287,1.00
ptg009471l,1547332,1547647,315,RepeatMasker,LTR,1547484,1547642,159,0.50
ptg009476l,713288,713574,286,RepeatMasker,LTR,706417,713414,126,0.44
ptg009476l,713288,713574,286,RepeatMasker,LTR,713386,714688,189,0.66
ptg009478l,1678941,1679255,314,RepeatMasker,LTR,1678459,1679028,87,0.28
ptg009478l,1678941,1679255,314,RepeatMasker,LTR,1679227,1680178,29,0.09
ptg009482l,1332141,1332421,280,RepeatMasker,LTR,1331759,1333199,280,1.00
ptg009492l,894630,894964,334,RepeatMasker,LTR,894954,895131,11,0.03
ptg009499l,1998661,1998981,320,RepeatMasker,LTR,1997638,1998751,90,0.28
ptg009499l,1998661,1998981,320,RepeatMasker,LTR,1998366,1999011,320,1.00
ptg009499l,2086587,2086887,300,RepeatMasker,LTR,2086837,2086924,51,0.17
ptg009499l,2086587,2086887,300,RepeatMasker,LTR,2086859,2087435,29,0.10
ptg009508l,134110,134440,330,RepeatMasker,LTR,134276,135545,165,0.50
ptg009509l,142296,142576,280,RepeatMasker,LTR,141914,142609,280,1.00
ptg009509l,616164,616490,326,RepeatMasker,LTR,616252,616345,94,0.29
ptg009510l,299384,299689,305,RepeatMasker,LTR,298450,299646,262,0.86
ptg009514l,766241,766547,306,RepeatMasker,LTR,765716,767313,306,1.00
ptg009516l,83982,84266,284,RepeatMasker,LTR,80021,85117,284,1.00
ptg009518l,1671184,1671474,290,RepeatMasker,LTR,1671184,1671274,90,0.31
ptg009527l,805354,805640,286,RepeatMasker,LTR,803089,806495,286,1.00
ptg009542l,1526829,1527126,297,RepeatMasker,LTR,1526448,1527775,297,1.00
ptg009543l,93035,93316,281,RepeatMasker,LTR,92655,94118,281,1.00
ptg009546l,3390868,3391179,311,RepeatMasker,LTR,3389967,3390915,47,0.15
ptg009551l,1062990,1063285,295,RepeatMasker,LTR,1062970,1063319,295,1.00
ptg009552l,499721,500016,295,RepeatMasker,LTR,499520,499740,19,0.06
ptg009553l,1122461,1122737,276,RepeatMasker,LTR,1122492,1122565,74,0.27
ptg009554l,259351,259632,281,RepeatMasker,LTR,258950,259665,281,1.00
ptg009555l,1225306,1225585,279,RepeatMasker,LTR,1224913,1226364,279,1.00
ptg009559l,819302,819610,308,RepeatMasker,LTR,819582,823196,29,0.09
ptg009559l,819302,819610,308,RepeatMasker,LTR,818844,819372,70,0.23
ptg009564l,550099,550385,286,RepeatMasker,LTR,550022,550179,80,0.28
ptg009568l,1062789,1063109,320,RepeatMasker,LTR,1062641,1063120,320,1.00
ptg009569l,508616,508909,293,RepeatMasker,LTR,508593,508943,293,1.00
ptg009579l,143491,143790,299,RepeatMasker,LTR,143313,143837,299,1.00
ptg009592l,1877951,1878250,299,RepeatMasker,LTR,1877871,1878302,299,1.00
ptg009595l,160600,160918,318,RepeatMasker,LTR,160397,161206,318,1.00
ptg009600l,2002301,2002620,319,RepeatMasker,LTR,2001411,2002335,34,0.11
ptg009614l,469562,469874,312,RepeatMasker,LTR,468284,470959,312,1.00
ptg009615l,18359,18656,297,RepeatMasker,LTR,16061,18446,87,0.29
ptg009615l,19984,20259,275,RepeatMasker,LTR,20088,21114,172,0.63
ptg009621l,815442,815722,280,RepeatMasker,LTR,812175,818348,280,1.00
ptg009627l,267631,267945,314,RepeatMasker,LTR,267586,268312,314,1.00
ptg009629l,222422,222719,297,RepeatMasker,LTR,222217,222771,297,1.00
ptg009629l,1734589,1734896,307,RepeatMasker,LTR,1734709,1734879,171,0.56
ptg009638l,1140426,1140713,287,RepeatMasker,LTR,1139948,1140530,104,0.36
ptg009641l,1063179,1063427,248,RepeatMasker,LTR,1058972,1068481,248,1.00
ptg009643l,398999,399317,318,RepeatMasker,LTR,399286,401615,32,0.10
ptg009643l,928926,929219,293,RepeatMasker,LTR,928972,934795,248,0.85
ptg009643l,2937834,2938153,319,RepeatMasker,LTR,2937720,2937921,87,0.27
ptg009646l,4557825,4558124,299,RepeatMasker,LTR,4557784,4558176,299,1.00
ptg009647l,467043,467343,300,RepeatMasker,LTR,466865,467395,300,1.00
ptg009648l,222826,223127,301,RepeatMasker,LTR,223104,223350,24,0.08
ptg009649l,2599520,2599806,286,RepeatMasker,LTR,2599171,2600706,286,1.00
ptg009664l,3180569,3180868,299,RepeatMasker,LTR,3180361,3180901,299,1.00
ptg009665l,736777,737081,304,RepeatMasker,LTR,736830,737322,252,0.83
ptg009671l,770226,770537,311,RepeatMasker,LTR,770032,770584,311,1.00
ptg009674l,672916,673282,366,RepeatMasker,LTR,673081,674439,202,0.55
ptg009686l,484737,485059,322,RepeatMasker,LTR,484897,489389,163,0.51
ptg009691l,281288,281574,286,RepeatMasker,LTR,279718,282435,286,1.00
ptg009692l,326063,326373,310,RepeatMasker,LTR,326049,326074,11,0.04
ptg009692l,913834,914109,275,RepeatMasker,LTR,914109,914182,1,0.00
ptg009693l,230891,231188,297,RepeatMasker,LTR,230714,231240,297,1.00
ptg009701l,1336092,1336383,291,RepeatMasker,LTR,1336002,1336202,110,0.38
ptg009711l,3201077,3201371,294,RepeatMasker,LTR,3199416,3204654,294,1.00
ptg009712l,35412,35709,297,RepeatMasker,LTR,35650,35720,60,0.20
ptg009712l,35412,35709,297,RepeatMasker,LTR,35684,35734,26,0.09
ptg009714l,333179,333502,323,RepeatMasker,LTR,333454,334678,49,0.15
ptg009714l,1462086,1462388,302,RepeatMasker,LTR,1462163,1465645,226,0.75
ptg009718l,335033,335329,296,RepeatMasker,LTR,335103,335383,227,0.77
ptg009718l,2359234,2359544,310,RepeatMasker,LTR,2359388,2362639,157,0.51
ptg009718l,2359234,2359544,310,RepeatMasker,LTR,2358873,2362068,310,1.00
ptg009718l,3786168,3786498,330,RepeatMasker,LTR,3786319,3786363,45,0.14
ptg009722l,318564,318852,288,RepeatMasker,LTR,318190,319634,288,1.00
ptg009728l,1297810,1298111,301,RepeatMasker,LTR,1297964,1298408,148,0.49
ptg009731l,1183409,1183683,274,RepeatMasker,LTR,1183520,1184777,164,0.60
ptg009733l,827758,828074,316,RepeatMasker,LTR,827450,831131,316,1.00
ptg009736l,227303,227597,294,RepeatMasker,LTR,227223,227649,294,1.00
ptg009736l,561255,561551,296,RepeatMasker,LTR,561175,561603,296,1.00
ptg009736l,1055493,1055792,299,RepeatMasker,LTR,1055289,1055844,299,1.00
ptg009736l,1075023,1075322,299,RepeatMasker,LTR,1074845,1075356,299,1.00
ptg009736l,1102746,1103045,299,RepeatMasker,LTR,1102564,1103097,299,1.00
ptg009736l,1220286,1220581,295,RepeatMasker,LTR,1220206,1220628,295,1.00
ptg009736l,1677386,1677681,295,RepeatMasker,LTR,1677191,1677733,295,1.00
ptg009736l,1999103,1999400,297,RepeatMasker,LTR,1998907,1999452,297,1.00
ptg009749l,813056,813362,306,RepeatMasker,LTR,813284,815260,79,0.26
ptg009758l,1821342,1821622,280,RepeatMasker,LTR,1821327,1822404,280,1.00
ptg009758l,1828542,1828823,281,RepeatMasker,LTR,1827387,1829458,281,1.00
ptg009758l,4677806,4678105,299,RepeatMasker,LTR,4677627,4678157,299,1.00
ptg009762l,518042,518339,297,RepeatMasker,LTR,518203,519096,137,0.46
ptg009762l,781126,781423,297,RepeatMasker,LTR,780951,781475,297,1.00
ptg009762l,1949342,1949639,297,RepeatMasker,LTR,1949262,1949691,297,1.00
ptg009763l,1584662,1584984,322,RepeatMasker,LTR,1583379,1587327,322,1.00
ptg009766l,1211672,1211950,278,RepeatMasker,LTR,1211850,1211964,101,0.36
ptg009771l,2153562,2153844,282,RepeatMasker,LTR,2151244,2156666,282,1.00
ptg009771l,2678283,2678566,283,RepeatMasker,LTR,2677127,2679198,283,1.00
ptg009774l,1187542,1187859,317,RepeatMasker,LTR,1185535,1187695,153,0.48
ptg009774l,1187542,1187859,317,RepeatMasker,LTR,1186087,1188737,317,1.00
ptg009778l,218976,219302,326,RepeatMasker,LTR,218961,219016,40,0.12
ptg009778l,218976,219302,326,RepeatMasker,LTR,219089,219172,84,0.26
ptg009796l,771710,772002,292,RepeatMasker,LTR,771986,773054,17,0.06
ptg009797l,2900260,2900577,317,RepeatMasker,LTR,2897301,2900291,31,0.10
ptg009813l,1394670,1394951,281,RepeatMasker,LTR,1393623,1395704,281,1.00
ptg009814l,418872,419150,278,RepeatMasker,LTR,418005,418909,37,0.13
ptg009820l,1528505,1528783,278,RepeatMasker,LTR,1528123,1529582,278,1.00
ptg009821l,260236,260541,305,RepeatMasker,LTR,260455,260627,87,0.29
ptg009831l,1032656,1032964,308,RepeatMasker,LTR,1032177,1032777,121,0.39
ptg009835l,34865,35146,281,RepeatMasker,LTR,34476,35948,281,1.00
ptg009839l,645325,645614,289,RepeatMasker,LTR,645117,645666,289,1.00
ptg009842l,372966,373269,303,RepeatMasker,LTR,371930,376626,303,1.00
ptg009847l,285059,285390,331,RepeatMasker,LTR,285236,285297,62,0.19
ptg009847l,682591,682885,294,RepeatMasker,LTR,682729,683030,157,0.53
ptg009847l,823256,823563,307,RepeatMasker,LTR,823373,823779,191,0.62
ptg009852l,408666,408962,296,RepeatMasker,LTR,408646,408996,296,1.00
ptg009854l,340126,340430,304,RepeatMasker,LTR,340228,340363,136,0.45
ptg009857l,473829,474122,293,RepeatMasker,LTR,473841,474168,282,0.96
ptg009860l,508447,508739,292,RepeatMasker,LTR,508578,511241,162,0.55
ptg009863l,108150,108450,300,RepeatMasker,LTR,108109,108520,300,1.00
ptg009863l,108150,108450,300,RepeatMasker,LTR,108163,108524,288,0.96
ptg009865l,777514,777836,322,RepeatMasker,LTR,777641,778206,196,0.61
ptg009865l,804439,804742,303,RepeatMasker,LTR,804717,806508,26,0.09
ptg009866l,160746,161052,306,RepeatMasker,LTR,161023,162365,30,0.10
ptg009872l,1573070,1573383,313,RepeatMasker,LTR,1573260,1573457,124,0.40
ptg009879l,88263,88544,281,RepeatMasker,LTR,87126,88557,281,1.00
ptg009880l,437580,437873,293,RepeatMasker,LTR,435648,438090,293,1.00
ptg009882l,1017654,1017953,299,RepeatMasker,LTR,1017478,1018005,299,1.00
ptg009882l,1444238,1444537,299,RepeatMasker,LTR,1444059,1444589,299,1.00
ptg009883l,265216,265497,281,RepeatMasker,LTR,264828,265531,281,1.00
ptg009883l,614149,614444,295,RepeatMasker,LTR,613399,619377,295,1.00
ptg009883l,929090,929402,312,RepeatMasker,LTR,928701,929436,312,1.00
ptg009884l,1295705,1295985,280,RepeatMasker,LTR,1295312,1296629,280,1.00
ptg009889l,320842,321141,299,RepeatMasker,LTR,320292,321606,299,1.00
ptg009892l,243399,243676,277,RepeatMasker,LTR,242655,246109,277,1.00
ptg009898l,2258619,2258923,304,RepeatMasker,LTR,2258515,2258869,250,0.82
ptg009913l,955590,955876,286,RepeatMasker,LTR,953530,957290,286,1.00
ptg009924l,249244,249525,281,RepeatMasker,LTR,248854,249558,281,1.00
ptg009928l,850526,850839,313,RepeatMasker,LTR,850412,850629,103,0.33
ptg009928l,941674,941951,277,RepeatMasker,LTR,941653,941697,23,0.08
ptg009934l,827215,827495,280,RepeatMasker,LTR,826802,827528,280,1.00
ptg009934l,827215,827495,280,RepeatMasker,LTR,827181,828298,280,1.00
ptg009940l,205030,205329,299,RepeatMasker,LTR,204641,205342,299,1.00
ptg009941l,43428,43708,280,RepeatMasker,LTR,43015,44488,280,1.00
ptg009941l,173750,174030,280,RepeatMasker,LTR,173734,174049,280,1.00
ptg009948l,864206,864482,276,RepeatMasker,LTR,861744,866010,276,1.00
ptg009951l,1117572,1117868,296,RepeatMasker,LTR,1117630,1117682,53,0.18
ptg009951l,1117572,1117868,296,RepeatMasker,LTR,1117651,1118006,218,0.74
ptg009958l,1092540,1092829,289,RepeatMasker,LTR,1092088,1092730,190,0.66
ptg009958l,1092540,1092829,289,RepeatMasker,LTR,1092604,1092839,226,0.78
ptg009961l,1072758,1073057,299,RepeatMasker,LTR,1072678,1073109,299,1.00
ptg009963l,135458,135738,280,RepeatMasker,LTR,134282,136866,280,1.00
ptg009970l,339100,339399,299,RepeatMasker,LTR,338894,339451,299,1.00
ptg009976l,776030,776353,323,RepeatMasker,LTR,776207,776666,147,0.46
ptg009979l,361710,361980,270,RepeatMasker,LTR,361943,365017,38,0.14
ptg009979l,2106742,2107047,305,RepeatMasker,LTR,2106885,2112417,163,0.53
ptg009986l,1132459,1132740,281,RepeatMasker,LTR,1131429,1133535,281,1.00
ptg009986l,1139632,1139914,282,RepeatMasker,LTR,1138490,1140548,282,1.00
ptg009995l,1335238,1335541,303,RepeatMasker,LTR,1334485,1335883,303,1.00
ptg009995l,1335238,1335541,303,RepeatMasker,LTR,1335409,1336793,133,0.44
ptg010010l,469356,469653,297,RepeatMasker,LTR,469147,469776,297,1.00
ptg010010l,469356,469653,297,RepeatMasker,LTR,469341,469776,297,1.00
ptg010010l,2992665,2992964,299,RepeatMasker,LTR,2992500,2993016,299,1.00
ptg010028l,1112166,1112470,304,RepeatMasker,LTR,1112307,1113564,164,0.54
ptg010028l,1411816,1412115,299,RepeatMasker,LTR,1411638,1412167,299,1.00
ptg010036l,1611508,1611825,317,RepeatMasker,LTR,1607114,1611923,317,1.00
ptg010042l,1047527,1047827,300,RepeatMasker,LTR,1047310,1047861,300,1.00
ptg010043l,163869,164164,295,RepeatMasker,LTR,163285,166954,295,1.00
ptg010046l,341721,341999,278,RepeatMasker,LTR,341339,342012,278,1.00
ptg010052l,747516,747790,274,RepeatMasker,LTR,747480,747679,163,0.59
ptg010052l,747516,747790,274,RepeatMasker,LTR,747690,748579,101,0.37
ptg010054l,804029,804319,290,RepeatMasker,LTR,803449,804818,290,1.00
ptg010057l,193377,193664,287,RepeatMasker,LTR,189315,194523,287,1.00
ptg010060l,1264900,1265192,292,RepeatMasker,LTR,1265142,1266460,51,0.17
ptg010061l,570764,571044,280,RepeatMasker,LTR,570376,571846,280,1.00
ptg010065l,418540,418822,282,RepeatMasker,LTR,418158,419479,282,1.00
ptg010072l,265001,265287,286,RepeatMasker,LTR,264601,271411,286,1.00
ptg010081l,104656,104964,308,RepeatMasker,LTR,104641,106474,308,1.00
ptg010091l,2368765,2369058,293,RepeatMasker,LTR,2368385,2369697,293,1.00
ptg010091l,3075215,3075496,281,RepeatMasker,LTR,3075180,3075529,281,1.00
ptg010091l,3079037,3079332,295,RepeatMasker,LTR,3078668,3079365,295,1.00
ptg010094l,751424,751719,295,RepeatMasker,LTR,751217,751771,295,1.00
ptg010095l,240452,240732,280,RepeatMasker,LTR,240695,240759,38,0.14
ptg010106l,700679,701018,339,RepeatMasker,LTR,700721,701811,298,0.88
ptg010107l,76079,76374,295,RepeatMasker,LTR,76210,79791,165,0.56
ptg010114l,690127,690408,281,RepeatMasker,LTR,689739,691053,281,1.00
ptg010123l,767944,768225,281,RepeatMasker,LTR,767938,768846,281,1.00
ptg010124l,109084,109371,287,RepeatMasker,LTR,109063,109168,84,0.29
ptg010129l,571714,572006,292,RepeatMasker,LTR,570693,571818,104,0.36
ptg010129l,571714,572006,292,RepeatMasker,LTR,571796,571971,176,0.60
ptg010129l,571714,572006,292,RepeatMasker,LTR,571976,577594,31,0.11
ptg010137l,2679419,2679714,295,RepeatMasker,LTR,2678343,2679613,194,0.66
ptg010141l,587003,587284,281,RepeatMasker,LTR,585882,587317,281,1.00
ptg010141l,2965317,2965628,311,RepeatMasker,LTR,2965345,2965429,85,0.27
ptg010141l,2965317,2965628,311,RepeatMasker,LTR,2965576,2966167,53,0.17
ptg010143l,209186,209467,281,RepeatMasker,LTR,208803,209479,281,1.00
ptg010143l,471726,472007,281,RepeatMasker,LTR,471319,472797,281,1.00
ptg010143l,893491,893800,309,RepeatMasker,LTR,893101,893832,309,1.00
ptg010143l,1076361,1076691,330,RepeatMasker,LTR,1075440,1077239,330,1.00
ptg010145l,900375,900684,309,RepeatMasker,LTR,899818,901083,309,1.00
ptg010152l,220615,220903,288,RepeatMasker,LTR,220734,220824,91,0.32
ptg010154l,543838,544152,314,RepeatMasker,LTR,543994,544938,159,0.51
ptg010154l,561168,561459,291,RepeatMasker,LTR,561165,561289,121,0.42
ptg010165l,353053,353360,307,RepeatMasker,LTR,353187,354468,174,0.57
ptg010165l,677383,677682,299,RepeatMasker,LTR,677205,677734,299,1.00
ptg010165l,715042,715342,300,RepeatMasker,LTR,714811,715394,300,1.00
ptg010167l,538482,538758,276,RepeatMasker,LTR,538263,539030,276,1.00
ptg010171l,612767,613074,307,RepeatMasker,LTR,611514,612812,45,0.15
ptg010171l,612767,613074,307,RepeatMasker,LTR,612807,613315,268,0.87
ptg010171l,612767,613074,307,RepeatMasker,LTR,613072,613365,3,0.01
ptg010174l,655208,655507,299,RepeatMasker,LTR,655188,655541,299,1.00
ptg010174l,723715,724014,299,RepeatMasker,LTR,723635,724066,299,1.00
ptg010175l,202174,202460,286,RepeatMasker,LTR,201726,202365,191,0.67
ptg010175l,202174,202460,286,RepeatMasker,LTR,202239,202464,222,0.78
ptg010175l,202174,202460,286,RepeatMasker,LTR,202421,202479,40,0.14
ptg010175l,461106,461386,280,RepeatMasker,LTR,460058,462027,280,1.00
ptg010184l,284306,284593,287,RepeatMasker,LTR,284308,284640,286,1.00
ptg010185l,1318674,1318954,280,RepeatMasker,LTR,1318363,1318987,280,1.00
ptg010189l,251244,251524,280,RepeatMasker,LTR,250274,251556,280,1.00
ptg010201l,914872,915176,304,RepeatMasker,LTR,913918,915916,304,1.00
ptg010202l,491022,491330,308,RepeatMasker,LTR,488367,491945,308,1.00
ptg010204l,1102225,1102545,320,RepeatMasker,LTR,1102495,1107763,51,0.16
ptg010210l,710820,711118,298,RepeatMasker,LTR,710740,711170,298,1.00
ptg010210l,1304647,1304946,299,RepeatMasker,LTR,1304439,1304998,299,1.00
ptg010214l,90330,90630,300,RepeatMasker,LTR,90596,91647,35,0.12
ptg010214l,156690,156989,299,RepeatMasker,LTR,156980,158210,10,0.03
ptg010220l,1730236,1730515,279,RepeatMasker,LTR,1729843,1731291,279,1.00
ptg010227l,1388348,1388628,280,RepeatMasker,LTR,1387967,1388641,280,1.00
ptg010228l,222343,222625,282,RepeatMasker,LTR,221020,222800,282,1.00
ptg010231l,466018,466342,324,RepeatMasker,LTR,465480,467086,324,1.00
ptg010231l,466018,466342,324,RepeatMasker,LTR,466207,467577,136,0.42
ptg010231l,1638894,1639175,281,RepeatMasker,LTR,1638505,1639798,281,1.00
ptg010240l,1927309,1927589,280,RepeatMasker,LTR,1926919,1927624,280,1.00
ptg010242l,1841180,1841480,300,RepeatMasker,LTR,1840686,1843149,300,1.00
ptg010247l,934415,934671,256,RepeatMasker,LTR,930214,936745,256,1.00
ptg010247l,1711325,1711619,294,RepeatMasker,LTR,1711021,1711651,294,1.00
ptg010247l,1718502,1718783,281,RepeatMasker,LTR,1718083,1719428,281,1.00
ptg010251l,5206646,5206950,304,RepeatMasker,LTR,5206159,5206997,304,1.00
ptg010252l,666759,667058,299,RepeatMasker,LTR,666809,666870,62,0.21
ptg010264l,1714275,1714572,297,RepeatMasker,LTR,1714067,1714624,297,1.00
ptg010271l,139858,140155,297,RepeatMasker,LTR,139338,139896,38,0.13
ptg010276l,1529897,1530219,322,RepeatMasker,LTR,1529956,1530731,264,0.82
ptg010279l,272144,272431,287,RepeatMasker,LTR,269561,273284,287,1.00
ptg010284l,533167,533464,297,RepeatMasker,LTR,532989,533516,297,1.00
ptg010284l,811689,811986,297,RepeatMasker,LTR,811511,812038,297,1.00
ptg010284l,897718,898003,285,RepeatMasker,LTR,897510,898055,285,1.00
ptg010288l,599793,600095,302,RepeatMasker,LTR,599039,601651,302,1.00
ptg010293l,366595,366908,313,RepeatMasker,LTR,365717,366629,34,0.11
ptg010293l,366595,366908,313,RepeatMasker,LTR,366640,366714,75,0.24
ptg010293l,366595,366908,313,RepeatMasker,LTR,366663,371184,246,0.79
ptg010297l,1788973,1789260,287,RepeatMasker,LTR,1786076,1789695,287,1.00
ptg010297l,1788973,1789260,287,RepeatMasker,LTR,1787740,1795433,287,1.00
ptg010311l,2860923,2861203,280,RepeatMasker,LTR,2860529,2861865,280,1.00
ptg010318l,1045317,1045602,285,RepeatMasker,LTR,1045465,1045557,93,0.33
ptg010324l,364890,365207,317,RepeatMasker,LTR,365087,365144,58,0.18
ptg010335l,830974,831275,301,RepeatMasker,LTR,830910,831386,301,1.00
ptg010354l,974386,974685,299,RepeatMasker,LTR,974306,974737,299,1.00
ptg010363l,150966,151246,280,RepeatMasker,LTR,149819,151259,280,1.00
ptg010370l,400429,400709,280,RepeatMasker,LTR,400046,400741,280,1.00
ptg010380l,1119499,1119780,281,RepeatMasker,LTR,1119102,1120428,281,1.00
ptg010384l,13676,14001,325,RepeatMasker,LTR,13709,14594,293,0.90
ptg010384l,637056,637362,306,RepeatMasker,LTR,636842,637091,35,0.11
ptg010395l,145921,146209,288,RepeatMasker,LTR,142028,147236,288,1.00
ptg010398l,1638411,1638707,296,RepeatMasker,LTR,1638043,1638739,296,1.00
ptg010408l,106257,106537,280,RepeatMasker,LTR,105844,106550,280,1.00
ptg010408l,414607,414893,286,RepeatMasker,LTR,414303,415748,286,1.00
ptg010410l,453578,453863,285,RepeatMasker,LTR,448877,454476,285,1.00
ptg010410l,601812,602121,309,RepeatMasker,LTR,600105,606253,309,1.00
ptg010410l,845639,845929,290,RepeatMasker,LTR,844730,848361,290,1.00
ptg010410l,923133,923426,293,RepeatMasker,LTR,923110,923478,293,1.00
ptg010416l,951224,951526,302,RepeatMasker,LTR,951471,952226,56,0.19
ptg010443l,830136,830434,298,RepeatMasker,LTR,826885,833052,298,1.00
ptg010449l,168305,168622,317,RepeatMasker,LTR,168219,168628,317,1.00
ptg010451l,436614,436893,279,RepeatMasker,LTR,436232,437694,279,1.00
ptg010460l,1698532,1698851,319,RepeatMasker,LTR,1696756,1698870,319,1.00
ptg010461l,963192,963484,292,RepeatMasker,LTR,962716,963297,105,0.36
ptg010472l,1151621,1151928,307,RepeatMasker,LTR,1151381,1151643,22,0.07
ptg010479l,103050,103366,316,RepeatMasker,LTR,103195,103526,172,0.54
ptg010495l,896920,897225,305,RepeatMasker,LTR,896712,897277,305,1.00
ptg010505l,378261,378545,284,RepeatMasker,LTR,373591,379426,284,1.00
ptg010505l,959782,960068,286,RepeatMasker,LTR,956025,960929,286,1.00
ptg010505l,1093173,1093476,303,RepeatMasker,LTR,1093315,1094311,162,0.53
ptg010506l,1008052,1008350,298,RepeatMasker,LTR,1007810,1008402,298,1.00
ptg010508l,98508,98805,297,RepeatMasker,LTR,98333,98857,297,1.00
ptg010508l,369502,369801,299,RepeatMasker,LTR,369422,369853,299,1.00
ptg010510l,2241407,2241712,305,RepeatMasker,LTR,2241043,2242356,305,1.00
ptg010512l,471433,471725,292,RepeatMasker,LTR,471153,471950,292,1.00
ptg010515l,1295170,1295451,281,RepeatMasker,LTR,1294848,1295484,281,1.00
ptg010515l,1302314,1302595,281,RepeatMasker,LTR,1301917,1302628,281,1.00
ptg010517l,1597921,1598220,299,RepeatMasker,LTR,1597716,1598272,299,1.00
ptg010518l,1815703,1815993,290,RepeatMasker,LTR,1815682,1815726,23,0.08
ptg010519l,269647,269947,300,RepeatMasker,LTR,269785,271036,163,0.54
ptg010524l,197994,198313,319,RepeatMasker,LTR,197978,198106,112,0.35
ptg010528l,3002339,3002635,296,RepeatMasker,LTR,3002116,3002687,296,1.00
ptg010545l,1284202,1284489,287,RepeatMasker,LTR,1283476,1285342,287,1.00
ptg010552l,2269481,2269777,296,RepeatMasker,LTR,2269751,2269871,27,0.09
ptg010560l,277534,277818,284,RepeatMasker,LTR,277577,277949,242,0.85
ptg010565l,1531878,1532158,280,RepeatMasker,LTR,1531375,1532956,280,1.00
ptg010573l,373497,373783,286,RepeatMasker,LTR,372632,373567,70,0.24
ptg010573l,2499326,2499625,299,RepeatMasker,LTR,2499148,2499677,299,1.00
ptg010573l,2710758,2711050,292,RepeatMasker,LTR,2710509,2710842,84,0.29
ptg010574l,2290490,2290767,277,RepeatMasker,LTR,2289919,2290730,240,0.87
ptg010594l,504118,504400,282,RepeatMasker,LTR,503728,504413,282,1.00
ptg010595l,17160,17441,281,RepeatMasker,LTR,16751,18086,281,1.00
ptg010598l,2908,3236,328,RepeatMasker,LTR,2,3133,225,0.69
ptg010598l,2908,3236,328,RepeatMasker,LTR,3134,3224,91,0.28
ptg010598l,2908,3236,328,RepeatMasker,LTR,3221,8294,16,0.05
ptg010613l,3912604,3912941,337,RepeatMasker,LTR,3912312,3912800,196,0.58
ptg010615l,1239708,1240014,306,RepeatMasker,LTR,1239523,1240048,306,1.00
ptg010617l,668286,668566,280,RepeatMasker,LTR,667904,669211,280,1.00
ptg010624l,267460,267770,310,RepeatMasker,LTR,267740,270427,31,0.10
ptg010624l,415380,415661,281,RepeatMasker,LTR,414329,416461,281,1.00
ptg010624l,422193,422492,299,RepeatMasker,LTR,421436,423508,299,1.00
ptg010624l,422584,422865,281,RepeatMasker,LTR,421436,423508,281,1.00
ptg010624l,1143677,1143960,283,RepeatMasker,LTR,1142626,1144761,283,1.00
ptg010647l,1037490,1037769,279,RepeatMasker,LTR,1037504,1040346,266,0.95
ptg010647l,1123001,1123310,309,RepeatMasker,LTR,1122089,1123736,309,1.00
ptg010651l,526179,526461,282,RepeatMasker,LTR,524921,527012,282,1.00
ptg010655l,499606,499910,304,RepeatMasker,LTR,499742,500248,169,0.56
ptg010658l,289351,289643,292,RepeatMasker,LTR,289011,292474,292,1.00
ptg010659l,405888,406188,300,RepeatMasker,LTR,406022,406092,71,0.24
ptg010659l,405888,406188,300,RepeatMasker,LTR,406040,406452,149,0.50
ptg010664l,386774,387053,279,RepeatMasker,LTR,385676,388004,279,1.00
ptg010665l,1349195,1349524,329,RepeatMasker,LTR,1349246,1349296,51,0.16
ptg010676l,1254236,1254519,283,RepeatMasker,LTR,1252137,1257870,283,1.00
ptg010678l,2529497,2529783,286,RepeatMasker,LTR,2526880,2529668,171,0.60
ptg010678l,2529497,2529783,286,RepeatMasker,LTR,2527669,2530638,286,1.00
ptg010692l,174657,174938,281,RepeatMasker,LTR,174260,175599,281,1.00
ptg010698l,3454528,3454855,327,RepeatMasker,LTR,3454781,3455073,75,0.23
ptg010706l,529493,529795,302,RepeatMasker,LTR,529664,529819,132,0.44
ptg010711l,646101,646413,312,RepeatMasker,LTR,645580,648929,312,1.00
ptg010711l,646101,646413,312,RepeatMasker,LTR,646235,649757,179,0.57
ptg010716l,91987,92300,313,RepeatMasker,LTR,91829,92823,313,1.00
ptg010727l,1399656,1399964,308,RepeatMasker,LTR,1399270,1399759,103,0.33
ptg010741l,2550564,2550866,302,RepeatMasker,LTR,2549841,2550650,86,0.28
ptg010741l,2550564,2550866,302,RepeatMasker,LTR,2550812,2550888,55,0.18
ptg010748l,384523,384817,294,RepeatMasker,LTR,384316,384869,294,1.00
ptg010749l,74434,74762,328,RepeatMasker,LTR,74600,75098,163,0.50
ptg010749l,99506,99806,300,RepeatMasker,LTR,99284,99840,300,1.00
ptg010752l,572192,572510,318,RepeatMasker,LTR,571608,572503,311,0.98
ptg010753l,533384,533703,319,RepeatMasker,LTR,533483,534768,221,0.69
ptg010757l,572342,572627,285,RepeatMasker,LTR,572315,572365,23,0.08
ptg010758l,707683,707950,267,RepeatMasker,LTR,706032,708290,267,1.00
ptg010761l,1157601,1157890,289,RepeatMasker,LTR,1157314,1158272,289,1.00
ptg010762l,200232,200527,295,RepeatMasker,LTR,199858,201321,295,1.00
ptg010768l,89610,89919,309,RepeatMasker,LTR,89849,93898,71,0.23
ptg010773l,744867,745145,278,RepeatMasker,LTR,744383,745376,278,1.00
ptg010780l,67735,67983,248,RepeatMasker,LTR,63531,73029,248,1.00
ptg010785l,615432,615701,269,RepeatMasker,LTR,611229,620756,269,1.00
ptg010787l,735123,735428,305,RepeatMasker,LTR,733980,736064,305,1.00
ptg010787l,1435563,1435862,299,RepeatMasker,LTR,1435379,1435914,299,1.00
ptg010794l,47379,47671,292,RepeatMasker,LTR,47654,48504,18,0.06
ptg010808l,1344568,1344855,287,RepeatMasker,LTR,1340727,1345685,287,1.00
ptg010817l,323112,323430,318,RepeatMasker,LTR,323261,323586,170,0.53
ptg010821l,494573,494869,296,RepeatMasker,LTR,494532,494915,296,1.00
ptg010826l,837437,837735,298,RepeatMasker,LTR,837712,840101,24,0.08
ptg010829l,9856,10147,291,RepeatMasker,LTR,10097,10394,51,0.18
ptg010830l,506556,506882,326,RepeatMasker,LTR,506263,507667,326,1.00
ptg010831l,449784,450062,278,RepeatMasker,LTR,450012,450352,51,0.18
ptg010834l,470745,471053,308,RepeatMasker,LTR,470353,471085,308,1.00
ptg010834l,470745,471053,308,RepeatMasker,LTR,470762,471851,292,0.95
ptg010834l,482187,482468,281,RepeatMasker,LTR,481869,482499,281,1.00
ptg010842l,679879,680187,308,RepeatMasker,LTR,678548,679882,3,0.01
ptg010842l,679879,680187,308,RepeatMasker,LTR,680056,680335,132,0.43
ptg010843l,1364475,1364794,319,RepeatMasker,LTR,1364149,1364789,314,0.98
ptg010849l,1785178,1785508,330,RepeatMasker,LTR,1785353,1786375,156,0.47
ptg010862l,576172,576490,318,RepeatMasker,LTR,574922,576187,15,0.05
ptg010869l,903537,903857,320,RepeatMasker,LTR,903554,903598,45,0.14
ptg010876l,1378931,1379213,282,RepeatMasker,LTR,1376177,1379385,282,1.00
ptg010883l,328593,328892,299,RepeatMasker,LTR,328425,328944,299,1.00
ptg010883l,409025,409323,298,RepeatMasker,LTR,408945,409375,298,1.00
ptg010905l,1300933,1301229,296,RepeatMasker,LTR,1300910,1301281,296,1.00
ptg010910l,278181,278462,281,RepeatMasker,LTR,277822,279106,281,1.00
ptg010917l,1224069,1224355,286,RepeatMasker,LTR,1219423,1225210,286,1.00
ptg010920l,995276,995557,281,RepeatMasker,LTR,995303,995595,255,0.91
ptg010920l,1271470,1271757,287,RepeatMasker,LTR,1271189,1272596,287,1.00
ptg010925l,268846,269145,299,RepeatMasker,LTR,268668,269197,299,1.00
ptg010938l,3808191,3808493,302,RepeatMasker,LTR,3807469,3808214,23,0.08
ptg010944l,695992,696292,300,RepeatMasker,LTR,696016,696437,277,0.92
ptg010945l,489318,489618,300,RepeatMasker,LTR,489103,489670,300,1.00
ptg010945l,548606,548915,309,RepeatMasker,LTR,547560,549708,309,1.00
ptg010945l,555832,556115,283,RepeatMasker,LTR,554653,556751,283,1.00
ptg010945l,629813,630112,299,RepeatMasker,LTR,629635,630164,299,1.00
ptg010945l,822233,822532,299,RepeatMasker,LTR,822055,822584,299,1.00
ptg010952l,1290843,1291138,295,RepeatMasker,LTR,1291104,1291167,35,0.12
ptg010955l,418814,419113,299,RepeatMasker,LTR,418636,419165,299,1.00
ptg010959l,381269,381564,295,RepeatMasker,LTR,381505,381554,50,0.17
ptg010962l,807904,808202,298,RepeatMasker,LTR,807824,808254,298,1.00
ptg010965l,184296,184581,285,RepeatMasker,LTR,183902,185385,285,1.00
ptg010966l,1358015,1358314,299,RepeatMasker,LTR,1357828,1358471,299,1.00
ptg010968l,104062,104382,320,RepeatMasker,LTR,104111,104279,169,0.53
ptg010968l,104062,104382,320,RepeatMasker,LTR,104318,104556,65,0.20
ptg010969l,880492,880803,311,RepeatMasker,LTR,879396,880816,311,1.00
ptg010973l,376061,376361,300,RepeatMasker,LTR,375091,376710,300,1.00
ptg010976l,233759,234046,287,RepeatMasker,LTR,233158,234424,287,1.00
ptg010980l,404963,405246,283,RepeatMasker,LTR,403918,406028,283,1.00
ptg010984l,250685,250998,313,RepeatMasker,LTR,249946,250788,103,0.33
ptg011001l,36569,36886,317,RepeatMasker,LTR,35768,39210,317,1.00
ptg011001l,1475882,1476172,290,RepeatMasker,LTR,1475019,1477472,290,1.00
ptg011010l,915216,915518,302,RepeatMasker,LTR,915218,916164,301,1.00
ptg011011l,2488466,2488779,313,RepeatMasker,LTR,2488736,2488849,44,0.14
ptg011012l,114031,114339,308,RepeatMasker,LTR,113648,115141,308,1.00
ptg011015l,2479822,2480103,281,RepeatMasker,LTR,2479663,2480130,281,1.00
ptg011015l,2479822,2480103,281,RepeatMasker,LTR,2479743,2480136,281,1.00
ptg011020l,266024,266304,280,RepeatMasker,LTR,264978,266317,280,1.00
ptg011022l,484813,485141,328,RepeatMasker,LTR,484364,485524,328,1.00
ptg011029l,364387,364687,300,RepeatMasker,LTR,364170,364739,300,1.00
ptg011036l,886917,887216,299,RepeatMasker,LTR,886722,887268,299,1.00
ptg011039l,70779,71079,300,RepeatMasker,LTR,70738,71131,300,1.00
ptg011039l,901266,901572,306,RepeatMasker,LTR,900413,901959,306,1.00
ptg011040l,1568651,1568947,296,RepeatMasker,LTR,1568601,1568702,51,0.17
ptg011043l,1185065,1185337,272,RepeatMasker,LTR,1185331,1185557,7,0.03
ptg011050l,469852,470170,318,RepeatMasker,LTR,469457,469872,20,0.06
ptg011050l,469852,470170,318,RepeatMasker,LTR,469535,469872,20,0.06
ptg011050l,469852,470170,318,RepeatMasker,LTR,469875,470804,296,0.93
ptg011052l,139944,140238,294,RepeatMasker,LTR,139107,144150,294,1.00
ptg011053l,1076549,1076830,281,RepeatMasker,LTR,1076796,1077673,35,0.12
ptg011063l,963924,964210,286,RepeatMasker,LTR,964204,964418,7,0.02
ptg011068l,2353235,2353511,276,RepeatMasker,LTR,2353132,2356698,276,1.00
ptg011082l,975091,975370,279,RepeatMasker,LTR,974336,978161,279,1.00
ptg011092l,2223565,2223864,299,RepeatMasker,LTR,2223485,2223898,299,1.00
ptg011092l,2601408,2601717,309,RepeatMasker,LTR,2598770,2601928,309,1.00
ptg011092l,2601408,2601717,309,RepeatMasker,LTR,2601252,2602010,309,1.00
ptg011092l,2872188,2872469,281,RepeatMasker,LTR,2870761,2875774,281,1.00
ptg011092l,3061737,3062042,305,RepeatMasker,LTR,3062011,3062087,32,0.10
ptg011092l,3918271,3918561,290,RepeatMasker,LTR,3918093,3918613,290,1.00
ptg011097l,864477,864788,311,RepeatMasker,LTR,863931,864643,166,0.53
ptg011097l,864477,864788,311,RepeatMasker,LTR,864090,865043,311,1.00
ptg011106l,311633,311952,319,RepeatMasker,LTR,311902,316068,51,0.16
ptg011118l,151357,151656,299,RepeatMasker,LTR,150624,152908,299,1.00
ptg011118l,151357,151656,299,RepeatMasker,LTR,150629,153217,299,1.00
ptg011120l,257188,257474,286,RepeatMasker,LTR,255613,257995,286,1.00
ptg011122l,811056,811337,281,RepeatMasker,LTR,810674,812139,281,1.00
ptg011123l,517875,518174,299,RepeatMasker,LTR,517697,518226,299,1.00
ptg011125l,1149294,1149591,297,RepeatMasker,LTR,1148918,1150227,297,1.00
ptg011127l,739945,740256,311,RepeatMasker,LTR,739904,740373,311,1.00
ptg011132l,1947375,1947688,313,RepeatMasker,LTR,1947480,1949575,209,0.67
ptg011145l,427720,428000,280,RepeatMasker,LTR,427350,428802,280,1.00
ptg011151l,1912714,1913011,297,RepeatMasker,LTR,1912673,1913063,297,1.00
ptg011151l,2187283,2187564,281,RepeatMasker,LTR,2184223,2190147,281,1.00
ptg011152l,1674,1973,299,RepeatMasker,LTR,1702,2025,272,0.91
ptg011152l,683132,683427,295,RepeatMasker,LTR,682955,683479,295,1.00
ptg011152l,759027,759307,280,RepeatMasker,LTR,757984,760085,280,1.00
ptg011152l,799316,799615,299,RepeatMasker,LTR,799107,799667,299,1.00
ptg011152l,1180481,1180778,297,RepeatMasker,LTR,1180287,1180812,297,1.00
ptg011154l,562189,562489,300,RepeatMasker,LTR,561886,562273,84,0.28
ptg011195l,341726,342024,298,RepeatMasker,LTR,341518,342076,298,1.00
ptg011200l,1063168,1063460,292,RepeatMasker,LTR,1062428,1063575,292,1.00
ptg011207l,1314640,1314920,280,RepeatMasker,LTR,1314262,1315555,280,1.00
ptg011216l,791365,791685,320,RepeatMasker,LTR,791635,797450,51,0.16
ptg011220l,520270,520554,284,RepeatMasker,LTR,519888,520586,284,1.00
ptg011221l,772927,773208,281,RepeatMasker,LTR,772551,774011,281,1.00
ptg011221l,807102,807383,281,RepeatMasker,LTR,806712,808029,281,1.00
ptg011224l,385371,385652,281,RepeatMasker,LTR,385490,386750,163,0.58
ptg011225l,56912,57204,292,RepeatMasker,LTR,56581,57903,292,1.00
ptg011225l,56912,57204,292,RepeatMasker,LTR,56641,57903,292,1.00
ptg011235l,656298,656630,332,RepeatMasker,LTR,655817,656392,94,0.28
ptg011238l,1863507,1863816,309,RepeatMasker,LTR,1863654,1866319,163,0.53
ptg011246l,1575993,1576365,372,RepeatMasker,LTR,1576203,1577444,163,0.44
ptg011252l,1048097,1048385,288,RepeatMasker,LTR,1047202,1048202,105,0.36
ptg011254l,1142959,1143240,281,RepeatMasker,LTR,1142953,1143253,281,1.00
ptg011262l,1314880,1315183,303,RepeatMasker,LTR,1314520,1315829,303,1.00
ptg011265l,491874,492161,287,RepeatMasker,LTR,490932,493018,287,1.00
ptg011272l,1529061,1529356,295,RepeatMasker,LTR,1528518,1531417,295,1.00
ptg011284l,559769,560077,308,RepeatMasker,LTR,559187,559865,96,0.31
ptg011284l,559769,560077,308,RepeatMasker,LTR,559853,560830,225,0.73
ptg011298l,55604,55895,291,RepeatMasker,LTR,54687,55646,42,0.14
ptg011299l,1097334,1097633,299,RepeatMasker,LTR,1097152,1097685,299,1.00
ptg011305l,825643,825958,315,RepeatMasker,LTR,823169,825906,263,0.83
ptg011307l,917927,918218,291,RepeatMasker,LTR,914293,918368,291,1.00
ptg011307l,917927,918218,291,RepeatMasker,LTR,916369,918677,291,1.00
ptg011323l,234225,234501,276,RepeatMasker,LTR,233748,234334,109,0.39
ptg011323l,234225,234501,276,RepeatMasker,LTR,234300,234531,202,0.73
ptg011325l,163487,163767,280,RepeatMasker,LTR,163121,163798,280,1.00
ptg011338l,139332,139666,334,RepeatMasker,LTR,138686,139386,54,0.16
ptg011338l,139332,139666,334,RepeatMasker,LTR,139512,139603,92,0.28
ptg011345l,1613438,1613721,283,RepeatMasker,LTR,1611950,1614621,283,1.00
ptg011350l,1171039,1171327,288,RepeatMasker,LTR,1170822,1171183,144,0.50
ptg011350l,1171039,1171327,288,RepeatMasker,LTR,1171216,1171336,112,0.39
ptg011350l,1171039,1171327,288,RepeatMasker,LTR,1171321,1171895,7,0.02
ptg011351l,951791,952076,285,RepeatMasker,LTR,951894,953198,183,0.64
ptg011363l,821210,821493,283,RepeatMasker,LTR,821325,821473,149,0.53
ptg011375l,806232,806549,317,RepeatMasker,LTR,806142,806428,196,0.62
ptg011375l,806232,806549,317,RepeatMasker,LTR,806442,806669,108,0.34
ptg011379l,2355104,2355383,279,RepeatMasker,LTR,2355070,2355127,23,0.08
ptg011382l,1609905,1610226,321,RepeatMasker,LTR,1609858,1610564,321,1.00
ptg011391l,811924,812251,327,RepeatMasker,LTR,812166,812839,86,0.26
ptg011394l,541145,541435,290,RepeatMasker,LTR,540483,543867,290,1.00
ptg011394l,1454926,1455248,322,RepeatMasker,LTR,1454126,1454972,46,0.14
ptg011397l,667869,668194,325,RepeatMasker,LTR,666646,668166,297,0.91
ptg011397l,667869,668194,325,RepeatMasker,LTR,666811,668217,325,1.00
ptg011404l,13436,13735,299,RepeatMasker,LTR,13572,20602,164,0.55
ptg011409l,1455685,1455992,307,RepeatMasker,LTR,1455720,1455754,35,0.11
ptg011411l,869320,869600,280,RepeatMasker,LTR,868259,869613,280,1.00
ptg011418l,1204133,1204433,300,RepeatMasker,LTR,1203907,1204485,300,1.00
ptg011431l,252789,253106,317,RepeatMasker,LTR,252537,256432,317,1.00
ptg011431l,3479896,3480176,280,RepeatMasker,LTR,3479718,3480228,280,1.00
ptg011433l,224099,224413,314,RepeatMasker,LTR,222647,225238,314,1.00
ptg011434l,104498,104763,265,RepeatMasker,LTR,103364,104776,265,1.00
ptg011434l,240793,241062,269,RepeatMasker,LTR,241026,246932,37,0.14
ptg011436l,24039,24309,270,RepeatMasker,LTR,24230,24334,80,0.30
ptg011436l,24039,24309,270,RepeatMasker,LTR,24248,24320,62,0.23
ptg011436l,24039,24309,270,RepeatMasker,LTR,24257,24320,53,0.20
ptg011444l,303544,303824,280,RepeatMasker,LTR,299457,307972,280,1.00
ptg011444l,820888,821169,281,RepeatMasker,LTR,820506,821180,281,1.00
ptg011444l,820888,821169,281,RepeatMasker,LTR,820577,821973,281,1.00
ptg011444l,828039,828320,281,RepeatMasker,LTR,827606,828331,281,1.00
ptg011444l,828039,828320,281,RepeatMasker,LTR,827728,828965,281,1.00
ptg011457l,1601839,1602140,301,RepeatMasker,LTR,1601759,1602192,301,1.00
ptg011458l,917015,917296,281,RepeatMasker,LTR,916617,917330,281,1.00
ptg011460l,829758,830038,280,RepeatMasker,LTR,829447,830072,280,1.00
ptg011465l,1085205,1085504,299,RepeatMasker,LTR,1085125,1085556,299,1.00
ptg011474l,1005543,1005873,330,RepeatMasker,LTR,1005547,1007496,327,0.99
ptg011474l,1005543,1005873,330,RepeatMasker,LTR,1005772,1011138,102,0.31
ptg011479l,2070275,2070587,312,RepeatMasker,LTR,2070459,2073656,129,0.41
ptg011482l,1008415,1008695,280,RepeatMasker,LTR,1007283,1008708,280,1.00
ptg011487l,196145,196432,287,RepeatMasker,LTR,193364,197332,287,1.00
ptg011489l,2047039,2047338,299,RepeatMasker,LTR,2046998,2047391,299,1.00
ptg011496l,247215,247501,286,RepeatMasker,LTR,246816,253773,286,1.00
ptg011508l,500242,500538,296,RepeatMasker,LTR,500061,500589,296,1.00
ptg011510l,1241428,1241744,316,RepeatMasker,LTR,1241429,1242539,316,1.00
ptg011513l,374188,374499,311,RepeatMasker,LTR,374166,375342,311,1.00
ptg011522l,8738,9018,280,RepeatMasker,LTR,8346,9663,280,1.00
ptg011531l,1126705,1127006,301,RepeatMasker,LTR,1125809,1129939,301,1.00
ptg011531l,3329086,3329375,289,RepeatMasker,LTR,3328960,3329191,105,0.36
ptg011531l,3329086,3329375,289,RepeatMasker,LTR,3329191,3329829,185,0.64
ptg011537l,519222,519502,280,RepeatMasker,LTR,518085,520140,280,1.00
ptg011542l,674708,675002,294,RepeatMasker,LTR,674512,677574,294,1.00
ptg011543l,2819852,2820132,280,RepeatMasker,LTR,2819469,2820934,280,1.00
ptg011543l,2868917,2869197,280,RepeatMasker,LTR,2868528,2869842,280,1.00
ptg011544l,32669,32950,281,RepeatMasker,LTR,32285,32963,281,1.00
ptg011546l,153756,154037,281,RepeatMasker,LTR,153715,154083,281,1.00
ptg011546l,705104,705401,297,RepeatMasker,LTR,704932,705454,297,1.00
ptg011546l,858095,858429,334,RepeatMasker,LTR,857878,858455,334,1.00
ptg011546l,1079604,1079923,319,RepeatMasker,LTR,1078335,1080692,319,1.00
ptg011546l,1146649,1146946,297,RepeatMasker,LTR,1146474,1146998,297,1.00
ptg011546l,1205300,1205593,293,RepeatMasker,LTR,1205092,1205645,293,1.00
ptg011546l,1462260,1462553,293,RepeatMasker,LTR,1462084,1462605,293,1.00
ptg011546l,1468363,1468684,321,RepeatMasker,LTR,1467081,1471032,321,1.00
ptg011546l,1584096,1584387,291,RepeatMasker,LTR,1584076,1584439,291,1.00
ptg011546l,1718280,1718606,326,RepeatMasker,LTR,1718123,1718658,326,1.00
ptg011546l,1920041,1920350,309,RepeatMasker,LTR,1920313,1921355,38,0.12
ptg011546l,1991614,1991907,293,RepeatMasker,LTR,1991407,1991959,293,1.00
ptg011546l,2008912,2009205,293,RepeatMasker,LTR,2008717,2009257,293,1.00
ptg011546l,2042993,2043283,290,RepeatMasker,LTR,2042790,2043335,290,1.00
ptg011546l,2131774,2132069,295,RepeatMasker,LTR,2131733,2132115,295,1.00
ptg011546l,2139531,2139825,294,RepeatMasker,LTR,2139451,2139877,294,1.00
ptg011546l,2584608,2584905,297,RepeatMasker,LTR,2584528,2584957,297,1.00
ptg011547l,255465,255756,291,RepeatMasker,LTR,254955,255508,43,0.15
ptg011549l,599742,600057,315,RepeatMasker,LTR,599518,600113,315,1.00
ptg011558l,1283817,1284116,299,RepeatMasker,LTR,1283642,1284168,299,1.00
ptg011559l,208232,208513,281,RepeatMasker,LTR,207844,209307,281,1.00
ptg011568l,2325278,2325587,309,RepeatMasker,LTR,2324896,2326225,309,1.00
ptg011568l,2831240,2831531,291,RepeatMasker,LTR,2831463,2831777,69,0.24
ptg011576l,990989,991269,280,RepeatMasker,LTR,990607,991915,280,1.00
ptg011583l,995228,995529,301,RepeatMasker,LTR,995429,995903,101,0.34
ptg011584l,121483,121778,295,RepeatMasker,LTR,121276,121830,295,1.00
ptg011600l,1946093,1946392,299,RepeatMasker,LTR,1945879,1946444,299,1.00
ptg011602l,3731712,3732010,298,RepeatMasker,LTR,3731503,3732062,298,1.00
ptg011602l,4030990,4031283,293,RepeatMasker,LTR,4030508,4031083,93,0.32
ptg011602l,4341702,4342021,319,RepeatMasker,LTR,4341107,4341751,49,0.15
ptg011608l,103726,104012,286,RepeatMasker,LTR,101455,104858,286,1.00
ptg011621l,1166467,1166748,281,RepeatMasker,LTR,1166074,1167393,281,1.00
ptg011621l,1508289,1508569,280,RepeatMasker,LTR,1507968,1508581,280,1.00
ptg011621l,1551260,1551541,281,RepeatMasker,LTR,1551225,1551574,281,1.00
ptg011621l,1557935,1558215,280,RepeatMasker,LTR,1557540,1558248,280,1.00
ptg011622l,1988620,1988936,316,RepeatMasker,LTR,1987934,1989139,316,1.00
ptg011637l,378782,379065,283,RepeatMasker,LTR,378281,379698,283,1.00
ptg011637l,378782,379065,283,RepeatMasker,LTR,378918,379834,148,0.52
ptg011641l,27503,27783,280,RepeatMasker,LTR,26439,28565,280,1.00
ptg011641l,356741,357021,280,RepeatMasker,LTR,354600,359808,280,1.00
ptg011641l,558804,559114,310,RepeatMasker,LTR,558496,558988,184,0.59
ptg011641l,1014796,1015076,280,RepeatMasker,LTR,1014780,1015710,280,1.00
ptg011644l,13112,13437,325,RepeatMasker,LTR,12112,13191,79,0.24
ptg011644l,13112,13437,325,RepeatMasker,LTR,13224,13304,81,0.25
ptg011644l,13112,13437,325,RepeatMasker,LTR,13376,14120,62,0.19
ptg011645l,1623614,1623892,278,RepeatMasker,LTR,1623676,1623734,59,0.21
ptg011659l,84470,84772,302,RepeatMasker,LTR,84452,84641,171,0.57
ptg011666l,976812,977111,299,RepeatMasker,LTR,976732,977163,299,1.00
ptg011687l,1464720,1465006,286,RepeatMasker,LTR,1464320,1466939,286,1.00
ptg011690l,342219,342503,284,RepeatMasker,LTR,342238,342460,223,0.79
ptg011690l,342219,342503,284,RepeatMasker,LTR,342473,344197,31,0.11
ptg011700l,212457,212738,281,RepeatMasker,LTR,212154,213537,281,1.00
ptg011706l,344951,345239,288,RepeatMasker,LTR,344585,346039,288,1.00
ptg011709l,902613,902918,305,RepeatMasker,LTR,902078,902989,305,1.00
ptg011709l,902613,902918,305,RepeatMasker,LTR,902794,903175,125,0.41
ptg011721l,1149004,1149299,295,RepeatMasker,LTR,1149204,1149812,96,0.33
ptg011729l,1053934,1054242,308,RepeatMasker,LTR,1054170,1054232,63,0.20
ptg011736l,1560505,1560821,316,RepeatMasker,LTR,1560158,1561614,316,1.00
ptg011740l,52665,52942,277,RepeatMasker,LTR,52276,53335,277,1.00
ptg011742l,794355,794654,299,RepeatMasker,LTR,794275,794706,299,1.00
ptg011744l,304953,305248,295,RepeatMasker,LTR,304746,305300,295,1.00
ptg011746l,213267,213548,281,RepeatMasker,LTR,212205,214342,281,1.00
ptg011751l,1385445,1385731,286,RepeatMasker,LTR,1384573,1386242,286,1.00
ptg011756l,201472,201787,315,RepeatMasker,LTR,201348,201483,11,0.03
ptg011757l,495419,495700,281,RepeatMasker,LTR,494374,496336,281,1.00
ptg011758l,424881,425161,280,RepeatMasker,LTR,424482,425592,280,1.00
ptg011790l,446477,446776,299,RepeatMasker,LTR,445808,447776,299,1.00
ptg011790l,446851,447145,294,RepeatMasker,LTR,445808,447776,294,1.00
ptg011794l,376815,377141,326,RepeatMasker,LTR,371699,377311,326,1.00
ptg011799l,338704,339003,299,RepeatMasker,LTR,338522,339055,299,1.00
ptg011803l,485743,486041,298,RepeatMasker,LTR,485663,486093,298,1.00
ptg011808l,1097862,1098142,280,RepeatMasker,LTR,1097029,1098922,280,1.00
ptg011811l,322892,323140,248,RepeatMasker,LTR,318689,328183,248,1.00
ptg011823l,2159096,2159365,269,RepeatMasker,LTR,2159203,2159702,163,0.61
ptg011828l,877487,877771,284,RepeatMasker,LTR,876936,877559,72,0.25
ptg011828l,877487,877771,284,RepeatMasker,LTR,877681,877812,91,0.32
ptg011847l,297135,297442,307,RepeatMasker,LTR,297244,297335,92,0.30
ptg011856l,555955,556256,301,RepeatMasker,LTR,553346,556277,301,1.00
ptg011856l,646944,647260,316,RepeatMasker,LTR,647072,651505,189,0.60
ptg011856l,1242732,1243019,287,RepeatMasker,LTR,1238435,1244695,287,1.00
ptg011858l,310060,310343,283,RepeatMasker,LTR,309765,310992,283,1.00
ptg011861l,178057,178354,297,RepeatMasker,LTR,178060,178137,78,0.26
ptg011866l,90465,90765,300,RepeatMasker,LTR,90240,90817,300,1.00
ptg011873l,233153,233439,286,RepeatMasker,LTR,228444,234274,286,1.00
ptg011885l,1069342,1069645,303,RepeatMasker,LTR,1069321,1069365,23,0.08
ptg011886l,443478,443800,322,RepeatMasker,LTR,443684,443753,70,0.22
ptg011888l,2930330,2930618,288,RepeatMasker,LTR,2929828,2930521,191,0.66
ptg011888l,2930330,2930618,288,RepeatMasker,LTR,2930395,2930621,224,0.78
ptg011889l,301141,301427,286,RepeatMasker,LTR,301008,305330,286,1.00
ptg011891l,239381,239709,328,RepeatMasker,LTR,238247,239580,199,0.61
ptg011892l,424383,424652,269,RepeatMasker,LTR,423864,426085,269,1.00
ptg011934l,1123681,1123961,280,RepeatMasker,LTR,1123276,1124601,280,1.00
ptg011955l,556823,557134,311,RepeatMasker,LTR,556263,559129,311,1.00
ptg011958l,1430962,1431249,287,RepeatMasker,LTR,1431099,1431474,151,0.53
ptg011959l,2442830,2443164,334,RepeatMasker,LTR,2443082,2443211,83,0.25
ptg011963l,263799,264085,286,RepeatMasker,LTR,264079,264294,7,0.02
ptg011969l,221137,221415,278,RepeatMasker,LTR,221175,221655,241,0.87
ptg011977l,4423487,4423798,311,RepeatMasker,LTR,4423754,4423806,45,0.14
ptg011977l,8263812,8264136,324,RepeatMasker,LTR,8264061,8264353,76,0.23
ptg011978l,7020807,7021081,274,RepeatMasker,LTR,7020993,7022047,89,0.32
ptg011982l,51496,51795,299,RepeatMasker,LTR,50825,52194,299,1.00
ptg011983l,908606,908886,280,RepeatMasker,LTR,907582,909515,280,1.00
ptg011983l,1449199,1449476,277,RepeatMasker,LTR,1449317,1449482,160,0.58
ptg011992l,465680,465985,305,RepeatMasker,LTR,465512,465706,26,0.09
ptg011992l,465680,465985,305,RepeatMasker,LTR,465540,466118,305,1.00
ptg011996l,532798,533097,299,RepeatMasker,LTR,531675,533137,299,1.00
ptg011996l,674495,674775,280,RepeatMasker,LTR,673352,674788,280,1.00
ptg011996l,1584917,1585198,281,RepeatMasker,LTR,1584670,1585841,281,1.00
ptg011997l,212895,213221,326,RepeatMasker,LTR,212634,214819,326,1.00
ptg011997l,212895,213221,326,RepeatMasker,LTR,212828,214859,326,1.00
ptg012002l,453542,453841,299,RepeatMasker,LTR,453501,453893,299,1.00
ptg012002l,892905,893204,299,RepeatMasker,LTR,892825,893256,299,1.00
ptg012018l,269304,269590,286,RepeatMasker,LTR,268897,272951,286,1.00
ptg012025l,241078,241359,281,RepeatMasker,LTR,239946,241995,281,1.00
ptg012034l,1945216,1945525,309,RepeatMasker,LTR,1944834,1946171,309,1.00
ptg012043l,223504,223783,279,RepeatMasker,LTR,221492,224192,279,1.00
ptg012048l,1415197,1415477,280,RepeatMasker,LTR,1414734,1415986,280,1.00
ptg012052l,1556419,1556734,315,RepeatMasker,LTR,1555466,1556766,315,1.00
ptg012055l,254546,254854,308,RepeatMasker,LTR,253217,254549,3,0.01
ptg012055l,254546,254854,308,RepeatMasker,LTR,254723,254808,86,0.28
ptg012058l,728033,728343,310,RepeatMasker,LTR,727455,728911,310,1.00
ptg012058l,872552,872859,307,RepeatMasker,LTR,869016,874583,307,1.00
ptg012058l,1521713,1522050,337,RepeatMasker,LTR,1522012,1522094,39,0.12
ptg012059l,255066,255375,309,RepeatMasker,LTR,254230,255332,266,0.86
ptg012065l,2267162,2267441,279,RepeatMasker,LTR,2266648,2267168,6,0.02
ptg012070l,3474604,3474887,283,RepeatMasker,LTR,3474386,3474880,276,0.98
ptg012073l,3479914,3480214,300,RepeatMasker,LTR,3479234,3480151,237,0.79
ptg012075l,341797,342084,287,RepeatMasker,LTR,340887,344498,287,1.00
ptg012076l,1234413,1234692,279,RepeatMasker,LTR,1233365,1234705,279,1.00
ptg012079l,650230,650518,288,RepeatMasker,LTR,649762,650814,288,1.00
ptg012086l,279319,279628,309,RepeatMasker,LTR,278529,279847,309,1.00
ptg012091l,1233373,1233668,295,RepeatMasker,LTR,1233618,1237815,51,0.17
ptg012091l,1694532,1694815,283,RepeatMasker,LTR,1694055,1694757,225,0.80
ptg012102l,170505,170795,290,RepeatMasker,LTR,170656,170706,51,0.18
ptg012106l,1654252,1655121,869,RepeatMasker,LTR,1655012,1662044,110,0.13
ptg012106l,1676286,1676566,280,RepeatMasker,LTR,1675904,1676595,280,1.00
ptg012113l,633978,634286,308,RepeatMasker,LTR,628264,634040,62,0.20
ptg012117l,2689941,2690240,299,RepeatMasker,LTR,2689763,2690292,299,1.00
ptg012129l,636131,636443,312,RepeatMasker,LTR,635251,636684,312,1.00
ptg012133l,352719,352999,280,RepeatMasker,LTR,352337,353635,280,1.00
ptg012144l,374687,375015,328,RepeatMasker,LTR,374845,379752,171,0.52
ptg012152l,770767,771048,281,RepeatMasker,LTR,769722,771841,281,1.00
ptg012171l,1416046,1416334,288,RepeatMasker,LTR,1416168,1423205,167,0.58
ptg012172l,236689,237005,316,RepeatMasker,LTR,233380,238129,316,1.00
ptg012179l,248327,248608,281,RepeatMasker,LTR,247947,248621,281,1.00
ptg012185l,211783,212063,280,RepeatMasker,LTR,211401,212882,280,1.00
ptg012190l,1970149,1970429,280,RepeatMasker,LTR,1969767,1971230,280,1.00
ptg012194l,457656,457956,300,RepeatMasker,LTR,457444,458008,300,1.00
ptg012194l,574769,575066,297,RepeatMasker,LTR,574689,575118,297,1.00
ptg012197l,3902392,3902677,285,RepeatMasker,LTR,3902513,3903795,165,0.58
ptg012198l,689040,689339,299,RepeatMasker,LTR,689068,689391,272,0.91
ptg012198l,851157,851456,299,RepeatMasker,LTR,851137,851490,299,1.00
ptg012198l,1061399,1061698,299,RepeatMasker,LTR,1061319,1061750,299,1.00
ptg012202l,261013,261319,306,RepeatMasker,LTR,261015,264923,305,1.00
ptg012205l,171757,172056,299,RepeatMasker,LTR,171737,172108,299,1.00
ptg012236l,475288,475616,328,RepeatMasker,LTR,475126,476160,328,1.00
ptg012239l,189805,190112,307,RepeatMasker,LTR,189950,196957,163,0.53
ptg012242l,877073,877393,320,RepeatMasker,LTR,877125,877161,37,0.12
ptg012242l,930936,931223,287,RepeatMasker,LTR,930934,930989,53,0.18
ptg012245l,1167206,1167505,299,RepeatMasker,LTR,1167051,1167557,299,1.00
ptg012246l,68099,68430,331,RepeatMasker,LTR,65387,68137,38,0.11
ptg012249l,148867,149157,290,RepeatMasker,LTR,148645,151790,290,1.00
ptg012255l,733449,733748,299,RepeatMasker,LTR,732688,734788,299,1.00
ptg012273l,151660,151957,297,RepeatMasker,LTR,151619,152009,297,1.00
ptg012273l,528945,529250,305,RepeatMasker,LTR,526845,532813,305,1.00
ptg012297l,383669,383949,280,RepeatMasker,LTR,383333,384750,280,1.00
ptg012300l,220794,221093,299,RepeatMasker,LTR,220613,221145,299,1.00
ptg012327l,73037,73324,287,RepeatMasker,LTR,68388,74157,287,1.00
ptg012338l,661283,661583,300,RepeatMasker,LTR,660835,664253,300,1.00
ptg012340l,568546,568832,286,RepeatMasker,LTR,565461,569727,286,1.00
ptg012356l,526352,526680,328,RepeatMasker,LTR,526646,527443,35,0.11
ptg012356l,1763459,1763739,280,RepeatMasker,LTR,1763443,1763752,280,1.00
ptg012359l,1230897,1231196,299,RepeatMasker,LTR,1230703,1231248,299,1.00
ptg012367l,591197,591513,316,RepeatMasker,LTR,591356,591423,68,0.22
ptg012367l,1212293,1212573,280,RepeatMasker,LTR,1211921,1213186,280,1.00
ptg012375l,2208954,2209286,332,RepeatMasker,LTR,2208111,2213097,332,1.00
ptg012376l,1244624,1244938,314,RepeatMasker,LTR,1244931,1245039,8,0.03
ptg012386l,6889,7172,283,RepeatMasker,LTR,6501,7204,283,1.00
ptg012386l,19630,19910,280,RepeatMasker,LTR,19250,20545,280,1.00
ptg012386l,1148356,1148664,308,RepeatMasker,LTR,1147634,1148727,308,1.00
ptg012390l,1611277,1611566,289,RepeatMasker,LTR,1610902,1611578,289,1.00
ptg012395l,145620,145950,330,RepeatMasker,LTR,143367,150113,330,1.00
ptg012403l,1975789,1976070,281,RepeatMasker,LTR,1975390,1976083,281,1.00
ptg012410l,145163,145454,291,RepeatMasker,LTR,144821,147854,291,1.00
ptg012410l,306128,306456,328,RepeatMasker,LTR,305083,306138,10,0.03
ptg012410l,306128,306456,328,RepeatMasker,LTR,306158,307239,299,0.91
ptg012410l,313276,313556,280,RepeatMasker,LTR,312451,314193,280,1.00
ptg012415l,386932,387218,286,RepeatMasker,LTR,387047,387597,172,0.60
ptg012422l,903467,903765,298,RepeatMasker,LTR,903549,904133,217,0.73
ptg012427l,1072900,1073194,294,RepeatMasker,LTR,1070826,1073545,294,1.00
ptg012430l,371296,371595,299,RepeatMasker,LTR,371329,372382,267,0.89
ptg012430l,371296,371595,299,RepeatMasker,LTR,371443,374641,153,0.51
ptg012443l,202922,203229,307,RepeatMasker,LTR,203113,204145,117,0.38
ptg012448l,2049135,2049393,258,RepeatMasker,LTR,2048355,2050353,258,1.00
ptg012448l,2170710,2170852,142,RepeatMasker,LTR,2170193,2171657,142,1.00
ptg012448l,2208376,2208656,280,RepeatMasker,LTR,2207965,2209300,280,1.00
ptg012449l,505820,506131,311,RepeatMasker,LTR,506083,506440,49,0.16
ptg012449l,505820,506131,311,RepeatMasker,LTR,506085,506252,47,0.15
ptg012449l,1013042,1013341,299,RepeatMasker,LTR,1011759,1015383,299,1.00
ptg012456l,2130700,2131000,300,RepeatMasker,LTR,2130485,2133910,300,1.00
ptg012457l,972083,972395,312,RepeatMasker,LTR,972372,975376,24,0.08
ptg012466l,1085790,1086107,317,RepeatMasker,LTR,1086052,1086080,29,0.09
ptg012470l,1292754,1293046,292,RepeatMasker,LTR,1292412,1295876,292,1.00
ptg012470l,1753230,1753529,299,RepeatMasker,LTR,1753150,1753581,299,1.00
ptg012472l,157964,158244,280,RepeatMasker,LTR,156916,158888,280,1.00
ptg012478l,623694,624021,327,RepeatMasker,LTR,623752,623847,96,0.29
ptg012479l,381622,381922,300,RepeatMasker,LTR,381827,383672,96,0.32
ptg012482l,57829,58133,304,RepeatMasker,LTR,56789,57839,10,0.03
ptg012482l,57829,58133,304,RepeatMasker,LTR,57840,58660,294,0.97
ptg012482l,461934,462226,292,RepeatMasker,LTR,461530,462862,292,1.00
ptg012482l,2288576,2288873,297,RepeatMasker,LTR,2288849,2290424,25,0.08
ptg012485l,64333,64621,288,RepeatMasker,LTR,63755,64571,238,0.83
ptg012487l,323246,323526,280,RepeatMasker,LTR,322864,323538,280,1.00
ptg012493l,1447170,1447482,312,RepeatMasker,LTR,1443627,1448636,312,1.00
ptg012510l,186238,186517,279,RepeatMasker,LTR,185198,186531,279,1.00
ptg012520l,229344,229629,285,RepeatMasker,LTR,228701,230070,285,1.00
ptg012520l,229344,229629,285,RepeatMasker,LTR,229010,231208,285,1.00
ptg012521l,652435,652730,295,RepeatMasker,LTR,652240,652782,295,1.00
ptg012523l,75396,75676,280,RepeatMasker,LTR,74214,76312,280,1.00
ptg012525l,1061205,1061485,280,RepeatMasker,LTR,1060808,1062119,280,1.00
ptg012529l,1337418,1337717,299,RepeatMasker,LTR,1337240,1337769,299,1.00
ptg012529l,1457465,1457759,294,RepeatMasker,LTR,1457288,1457793,294,1.00
ptg012536l,1096111,1096414,303,RepeatMasker,LTR,1096135,1096878,280,0.92
ptg012554l,500733,501028,295,RepeatMasker,LTR,500555,501080,295,1.00
ptg012555l,270657,270981,324,RepeatMasker,LTR,269782,270681,24,0.07
ptg012559l,1740978,1741305,327,RepeatMasker,LTR,1740589,1741381,327,1.00
ptg012573l,853145,853465,320,RepeatMasker,LTR,853415,857536,51,0.16
ptg012579l,1866726,1867001,275,RepeatMasker,LTR,1864521,1867867,275,1.00
ptg012580l,951962,952243,281,RepeatMasker,LTR,951892,952881,281,1.00
ptg012594l,602585,602885,300,RepeatMasker,LTR,601478,602641,56,0.19
ptg012598l,842624,842904,280,RepeatMasker,LTR,842235,842937,280,1.00
ptg012599l,416048,416334,286,RepeatMasker,LTR,416183,416232,50,0.17
ptg012601l,84262,84585,323,RepeatMasker,LTR,84442,85379,144,0.45
ptg012603l,1899676,1899989,313,RepeatMasker,LTR,1895854,1900019,313,1.00
ptg012606l,523742,524025,283,RepeatMasker,LTR,521057,524638,283,1.00
ptg012609l,131833,132120,287,RepeatMasker,LTR,127188,132983,287,1.00
ptg012609l,1039005,1039291,286,RepeatMasker,LTR,1038605,1041480,286,1.00
ptg012612l,1439698,1440026,328,RepeatMasker,LTR,1436177,1439850,152,0.46
ptg012616l,23058,23375,317,RepeatMasker,LTR,23339,25612,37,0.12
ptg012616l,859563,859871,308,RepeatMasker,LTR,859709,860207,163,0.53
ptg012617l,729417,729722,305,RepeatMasker,LTR,729035,729734,305,1.00
ptg012623l,797470,797769,299,RepeatMasker,LTR,797390,797821,299,1.00
ptg012625l,1200002,1200290,288,RepeatMasker,LTR,1200136,1200957,155,0.54
ptg012625l,2695875,2696188,313,RepeatMasker,LTR,2696168,2696207,21,0.07
ptg012634l,2213893,2214197,304,RepeatMasker,LTR,2213938,2214006,69,0.23
ptg012645l,1325185,1325465,280,RepeatMasker,LTR,1324804,1326258,280,1.00
ptg012646l,2916285,2916556,271,RepeatMasker,LTR,2916346,2917852,211,0.78
ptg012646l,3155321,3155623,302,RepeatMasker,LTR,3155491,3156874,133,0.44
ptg012646l,3155321,3155623,302,RepeatMasker,LTR,3155532,3157198,92,0.30
ptg012648l,112295,112588,293,RepeatMasker,LTR,112099,112640,293,1.00
ptg012648l,161084,161380,296,RepeatMasker,LTR,160876,161432,296,1.00
ptg012648l,191035,191334,299,RepeatMasker,LTR,190994,191388,299,1.00
ptg012648l,204228,204521,293,RepeatMasker,LTR,204033,204573,293,1.00
ptg012650l,669055,669335,280,RepeatMasker,LTR,668007,670109,280,1.00
ptg012653l,494599,494887,288,RepeatMasker,LTR,494882,495689,6,0.02
ptg012660l,409978,410258,280,RepeatMasker,LTR,409571,410270,280,1.00
ptg012661l,1069391,1069714,323,RepeatMasker,LTR,1069651,1069725,64,0.20
ptg012661l,1069391,1069714,323,RepeatMasker,LTR,1069688,1069742,27,0.08
ptg012662l,209072,209320,248,RepeatMasker,LTR,204864,214406,248,1.00
ptg012671l,482967,483254,287,RepeatMasker,LTR,482921,483211,244,0.85
ptg012672l,67687,67968,281,RepeatMasker,LTR,64647,68430,281,1.00
ptg012672l,524359,524645,286,RepeatMasker,LTR,523958,530766,286,1.00
ptg012692l,1146041,1146361,320,RepeatMasker,LTR,1146311,1152513,51,0.16
ptg012698l,792213,792517,304,RepeatMasker,LTR,792314,793909,204,0.67
ptg012698l,2528925,2529248,323,RepeatMasker,LTR,2528725,2529398,323,1.00
ptg012699l,120289,120584,295,RepeatMasker,LTR,120081,120636,295,1.00
ptg012699l,381518,381816,298,RepeatMasker,LTR,381336,381868,298,1.00
ptg012718l,153550,153853,303,RepeatMasker,LTR,153574,155013,280,0.92
ptg012736l,524467,524747,280,RepeatMasker,LTR,524086,525393,280,1.00
ptg012743l,150203,150487,284,RepeatMasker,LTR,150429,150584,59,0.21
ptg012756l,102476,102798,322,RepeatMasker,LTR,101601,102500,24,0.07
ptg012760l,365382,365661,279,RepeatMasker,LTR,365064,365673,279,1.00
ptg012764l,1138177,1138488,311,RepeatMasker,LTR,1138456,1139570,33,0.11
ptg012765l,31500,31807,307,RepeatMasker,LTR,31340,31540,40,0.13
ptg012765l,31500,31807,307,RepeatMasker,LTR,31798,31856,10,0.03
ptg012767l,627979,628267,288,RepeatMasker,LTR,625604,628926,288,1.00
ptg012783l,1315875,1316157,282,RepeatMasker,LTR,1315565,1316793,282,1.00
ptg012786l,303883,304195,312,RepeatMasker,LTR,301572,303956,73,0.23
ptg012786l,597245,597526,281,RepeatMasker,LTR,596864,598329,281,1.00
ptg012786l,597245,597526,281,RepeatMasker,LTR,596935,598329,281,1.00
ptg012786l,604396,604677,281,RepeatMasker,LTR,604008,605321,281,1.00
ptg012813l,220663,220982,319,RepeatMasker,LTR,219977,220907,244,0.76
ptg012813l,220663,220982,319,RepeatMasker,LTR,220175,220926,263,0.82
ptg012816l,277546,277826,280,RepeatMasker,LTR,276220,280618,280,1.00
ptg012818l,816567,816860,293,RepeatMasker,LTR,816365,816912,293,1.00
ptg012818l,868266,868561,295,RepeatMasker,LTR,868246,868595,295,1.00
ptg012826l,794119,794418,299,RepeatMasker,LTR,794039,794470,299,1.00
ptg012826l,1045219,1045518,299,RepeatMasker,LTR,1045011,1045570,299,1.00
ptg012826l,1293662,1293957,295,RepeatMasker,LTR,1293484,1294009,295,1.00
ptg012830l,259432,259711,279,RepeatMasker,LTR,259321,259773,279,1.00
ptg012835l,650122,650441,319,RepeatMasker,LTR,650047,650178,56,0.18
ptg012835l,650122,650441,319,RepeatMasker,LTR,650218,650301,84,0.26
ptg012843l,32127,32416,289,RepeatMasker,LTR,30304,32244,117,0.40
ptg012843l,501955,502263,308,RepeatMasker,LTR,500346,507119,308,1.00
ptg012843l,558624,558904,280,RepeatMasker,LTR,557547,559540,280,1.00
ptg012844l,291640,291946,306,RepeatMasker,LTR,290990,292943,306,1.00
ptg012852l,19368,19666,298,RepeatMasker,LTR,18891,19569,201,0.67
ptg012852l,19368,19666,298,RepeatMasker,LTR,19442,19671,225,0.76
ptg012854l,1150482,1150762,280,RepeatMasker,LTR,1150287,1150814,280,1.00
ptg012861l,1655434,1655730,296,RepeatMasker,LTR,1654876,1655995,296,1.00
ptg012870l,2036421,2036701,280,RepeatMasker,LTR,2033786,2036737,280,1.00
ptg012873l,669494,669794,300,RepeatMasker,LTR,669282,669846,300,1.00
ptg012882l,1027743,1028041,298,RepeatMasker,LTR,1027544,1028093,298,1.00
ptg012884l,294689,294965,276,RepeatMasker,LTR,294827,294924,98,0.36
ptg012884l,672292,672591,299,RepeatMasker,LTR,672114,672643,299,1.00
ptg012884l,960144,960438,294,RepeatMasker,LTR,959966,960490,294,1.00
ptg012884l,1134785,1135084,299,RepeatMasker,LTR,1134607,1135136,299,1.00
ptg012884l,1721529,1721829,300,RepeatMasker,LTR,1721351,1721881,300,1.00
ptg012884l,2017493,2017791,298,RepeatMasker,LTR,2017298,2017843,298,1.00
ptg012884l,2093868,2094166,298,RepeatMasker,LTR,2093870,2094218,297,1.00
ptg012884l,2126791,2127097,306,RepeatMasker,LTR,2126651,2127114,306,1.00
ptg012884l,2126791,2127097,306,RepeatMasker,LTR,2126667,2127375,306,1.00
ptg012884l,2768272,2768569,297,RepeatMasker,LTR,2768192,2768621,297,1.00
ptg012893l,628178,628473,295,RepeatMasker,LTR,624414,628195,17,0.06
ptg012893l,628178,628473,295,RepeatMasker,LTR,628193,628773,281,0.95
ptg012905l,877070,877380,310,RepeatMasker,LTR,876727,878182,310,1.00
ptg012906l,74999,75296,297,RepeatMasker,LTR,75289,75588,8,0.03
ptg012913l,825142,825453,311,RepeatMasker,LTR,824653,825217,75,0.24
ptg012913l,825142,825453,311,RepeatMasker,LTR,825425,827970,29,0.09
ptg012919l,257324,257629,305,RepeatMasker,LTR,257622,257849,8,0.03
ptg012935l,765050,765355,305,RepeatMasker,LTR,762586,765603,305,1.00
ptg012939l,445354,445641,287,RepeatMasker,LTR,444134,446491,287,1.00
ptg012947l,1518167,1518458,291,RepeatMasker,LTR,1517042,1518743,291,1.00
ptg012947l,2297453,2297763,310,RepeatMasker,LTR,2297308,2297602,149,0.48
ptg012951l,252767,253059,292,RepeatMasker,LTR,252895,254141,165,0.57
ptg012961l,524943,525230,287,RepeatMasker,LTR,522776,525162,219,0.76
ptg012968l,269111,269403,292,RepeatMasker,LTR,268769,272235,292,1.00
ptg012969l,1595683,1596010,327,RepeatMasker,LTR,1595386,1599058,327,1.00
ptg012969l,3364611,3364908,297,RepeatMasker,LTR,3364533,3364960,297,1.00
ptg012971l,756401,756691,290,RepeatMasker,LTR,756192,756797,290,1.00
ptg012972l,301500,301799,299,RepeatMasker,LTR,301645,302534,155,0.52
ptg012980l,937577,937887,310,RepeatMasker,LTR,937266,937920,310,1.00
ptg012981l,767378,767659,281,RepeatMasker,LTR,766997,768306,281,1.00
ptg012982l,1901462,1901742,280,RepeatMasker,LTR,1900416,1902520,280,1.00
ptg012988l,129805,130097,292,RepeatMasker,LTR,127054,129841,36,0.12
ptg012990l,1006337,1006636,299,RepeatMasker,LTR,1006134,1006688,299,1.00
ptg012993l,665825,666160,335,RepeatMasker,LTR,665820,666240,335,1.00
ptg012993l,665825,666160,335,RepeatMasker,LTR,666150,666256,11,0.03
ptg013006l,262728,263025,297,RepeatMasker,LTR,261613,263038,297,1.00
ptg013013l,210408,210740,332,RepeatMasker,LTR,210586,211232,155,0.47
ptg013026l,141365,141657,292,RepeatMasker,LTR,140241,142488,292,1.00
ptg013036l,6138,6441,303,RepeatMasker,LTR,6354,6488,88,0.29
ptg013039l,688948,689229,281,RepeatMasker,LTR,688570,690033,281,1.00
ptg013050l,298726,299006,280,RepeatMasker,LTR,298407,299018,280,1.00
ptg013051l,461168,461486,318,RepeatMasker,LTR,459721,461320,152,0.48
ptg013051l,461168,461486,318,RepeatMasker,LTR,461463,461948,24,0.08
ptg013054l,236244,236541,297,RepeatMasker,LTR,236457,236506,50,0.17
ptg013054l,236244,236541,297,RepeatMasker,LTR,236513,236560,29,0.10
ptg013055l,273887,274167,280,RepeatMasker,LTR,273488,274969,280,1.00
ptg013062l,721766,722049,283,RepeatMasker,LTR,721573,722101,283,1.00
ptg013062l,810542,810838,296,RepeatMasker,LTR,810498,810878,296,1.00
ptg013068l,1877093,1877404,311,RepeatMasker,LTR,1876650,1877198,105,0.34
ptg013071l,92450,92698,248,RepeatMasker,LTR,88213,94165,248,1.00
ptg013081l,80400,80698,298,RepeatMasker,LTR,80202,80750,298,1.00
ptg013085l,202349,202633,284,RepeatMasker,LTR,201839,202391,42,0.15
ptg013097l,1314478,1314758,280,RepeatMasker,LTR,1313432,1314771,280,1.00
ptg013097l,1329757,1330037,280,RepeatMasker,LTR,1329108,1330631,280,1.00
ptg013107l,350981,351262,281,RepeatMasker,LTR,350659,351901,281,1.00
ptg013112l,1222125,1222424,299,RepeatMasker,LTR,1222046,1222476,299,1.00
ptg013115l,121423,121704,281,RepeatMasker,LTR,121041,122349,281,1.00
ptg013117l,4120621,4120901,280,RepeatMasker,LTR,4120607,4121535,280,1.00
ptg013124l,375585,375882,297,RepeatMasker,LTR,375734,376927,149,0.50
ptg013134l,2245124,2245422,298,RepeatMasker,LTR,2244759,2245982,298,1.00
ptg013134l,2727444,2727725,281,RepeatMasker,LTR,2727035,2728526,281,1.00
ptg013134l,2734596,2734877,281,RepeatMasker,LTR,2734214,2735521,281,1.00
ptg013137l,156004,156285,281,RepeatMasker,LTR,155600,157087,281,1.00
ptg013137l,163131,163412,281,RepeatMasker,LTR,162743,164059,281,1.00
ptg013148l,462129,462430,301,RepeatMasker,LTR,461929,462482,301,1.00
ptg013148l,482931,483230,299,RepeatMasker,LTR,482733,483282,299,1.00
ptg013148l,499009,499304,295,RepeatMasker,LTR,498929,499356,295,1.00
ptg013148l,683288,683587,299,RepeatMasker,LTR,683080,683639,299,1.00
ptg013149l,907120,907419,299,RepeatMasker,LTR,907079,907471,299,1.00
ptg013155l,1213995,1214298,303,RepeatMasker,LTR,1213558,1214827,303,1.00
ptg013173l,53041,53366,325,RepeatMasker,LTR,53311,53377,56,0.17
ptg013173l,53041,53366,325,RepeatMasker,LTR,53341,53391,26,0.08
ptg013180l,512457,512733,276,RepeatMasker,LTR,512442,512670,213,0.77
ptg013199l,1068622,1068946,324,RepeatMasker,LTR,1068786,1069289,161,0.50
ptg013200l,2912768,2913079,311,RepeatMasker,LTR,2912792,2913595,288,0.93
ptg013219l,790876,791190,314,RepeatMasker,LTR,788609,790900,24,0.08
ptg013221l,163197,163492,295,RepeatMasker,LTR,163150,163526,295,1.00
ptg013221l,168074,168369,295,RepeatMasker,LTR,168054,168403,295,1.00
ptg013221l,790257,790550,293,RepeatMasker,LTR,790287,790584,264,0.90
ptg013221l,5927299,5927590,291,RepeatMasker,LTR,5926489,5927708,291,1.00
ptg013223l,134797,135127,330,RepeatMasker,LTR,133769,142051,330,1.00
ptg013226l,48083,48406,323,RepeatMasker,LTR,48303,48331,29,0.09
ptg013234l,265201,265500,299,RepeatMasker,LTR,265121,265552,299,1.00
ptg013236l,187937,188217,280,RepeatMasker,LTR,186890,188998,280,1.00
ptg013236l,745231,745546,315,RepeatMasker,LTR,744562,745373,142,0.45
ptg013236l,745231,745546,315,RepeatMasker,LTR,744704,745370,139,0.44
ptg013251l,877869,878168,299,RepeatMasker,LTR,877789,878220,299,1.00
ptg013262l,53352,53622,270,RepeatMasker,LTR,53615,53807,8,0.03
ptg013267l,328462,328761,299,RepeatMasker,LTR,328287,328813,299,1.00
ptg013267l,469007,469302,295,RepeatMasker,LTR,468812,469354,295,1.00
ptg013278l,214424,214719,295,RepeatMasker,LTR,214380,214426,2,0.01
ptg013281l,460290,460617,327,RepeatMasker,LTR,459657,461008,327,1.00
ptg013284l,2273304,2273616,312,RepeatMasker,LTR,2269767,2274730,312,1.00
ptg013288l,63528,63810,282,RepeatMasker,LTR,63517,63838,282,1.00
ptg013298l,601054,601361,307,RepeatMasker,LTR,601328,601757,34,0.11
ptg013312l,266456,266749,293,RepeatMasker,LTR,266115,267308,293,1.00
ptg013316l,155649,155935,286,RepeatMasker,LTR,155263,159410,286,1.00
ptg013328l,151683,151963,280,RepeatMasker,LTR,151301,152609,280,1.00
ptg013329l,917125,917449,324,RepeatMasker,LTR,917369,917421,53,0.16
ptg013335l,50884,51191,307,RepeatMasker,LTR,50804,51241,307,1.00
ptg013335l,71357,71650,293,RepeatMasker,LTR,71159,71702,293,1.00
ptg013345l,20081,20381,300,RepeatMasker,LTR,19887,20433,300,1.00
ptg013346l,318322,318608,286,RepeatMasker,LTR,317920,324320,286,1.00
ptg013365l,50589,50887,298,RepeatMasker,LTR,50846,56754,42,0.14
ptg013374l,1097385,1097679,294,RepeatMasker,LTR,1097525,1100732,155,0.53
ptg013375l,598419,598700,281,RepeatMasker,LTR,598031,599501,281,1.00
ptg013376l,46464,46752,288,RepeatMasker,LTR,46738,46974,15,0.05
ptg013382l,741119,741416,297,RepeatMasker,LTR,740925,741468,297,1.00
ptg013387l,2907336,2907584,248,RepeatMasker,LTR,2903130,2912640,248,1.00
ptg013389l,2753410,2753694,284,RepeatMasker,LTR,2751254,2753640,230,0.81
ptg013393l,638357,638656,299,RepeatMasker,LTR,638162,638708,299,1.00
ptg013393l,795709,796008,299,RepeatMasker,LTR,795531,796060,299,1.00
ptg013407l,299725,300033,308,RepeatMasker,LTR,299406,300815,308,1.00
ptg013414l,289068,289353,285,RepeatMasker,LTR,289037,289091,23,0.08
ptg013414l,1117862,1118165,303,RepeatMasker,LTR,1117939,1118101,163,0.54
ptg013419l,759059,759368,309,RepeatMasker,LTR,759106,759285,180,0.58
ptg013429l,295648,295933,285,RepeatMasker,LTR,294284,296374,285,1.00
ptg013447l,203559,203856,297,RepeatMasker,LTR,203382,203908,297,1.00
ptg013463l,755188,755469,281,RepeatMasker,LTR,754119,756105,281,1.00
ptg013463l,1573774,1574061,287,RepeatMasker,LTR,1569126,1574911,287,1.00
ptg013469l,578396,578690,294,RepeatMasker,LTR,578020,579334,294,1.00
ptg013476l,775071,775378,307,RepeatMasker,LTR,772293,776468,307,1.00
ptg013477l,242548,242860,312,RepeatMasker,LTR,242821,248740,40,0.13
ptg013483l,203440,203767,327,RepeatMasker,LTR,203027,204250,327,1.00
ptg013491l,535468,535796,328,RepeatMasker,LTR,535523,535867,274,0.84
ptg013498l,697006,697307,301,RepeatMasker,LTR,695980,697320,301,1.00
ptg013502l,4763345,4763623,278,RepeatMasker,LTR,4762726,4764260,278,1.00
ptg013520l,128251,128548,297,RepeatMasker,LTR,127839,129182,297,1.00
ptg013528l,67891,68185,294,RepeatMasker,LTR,68163,68218,23,0.08
ptg013528l,1541710,1541995,285,RepeatMasker,LTR,1541313,1545083,285,1.00
ptg013532l,131013,131312,299,RepeatMasker,LTR,130933,131364,299,1.00
ptg013532l,309888,310181,293,RepeatMasker,LTR,309713,310233,293,1.00
ptg013533l,1136869,1137150,281,RepeatMasker,LTR,1136466,1137951,281,1.00
ptg013539l,423909,424228,319,RepeatMasker,LTR,424178,424296,51,0.16
ptg013551l,610366,610662,296,RepeatMasker,LTR,609637,611918,296,1.00
ptg013551l,610366,610668,302,RepeatMasker,LTR,609637,611918,302,1.00
ptg013554l,152873,153200,327,RepeatMasker,LTR,152575,156424,327,1.00
ptg013565l,82889,83206,317,RepeatMasker,LTR,82400,83331,317,1.00
ptg013583l,2120189,2120471,282,RepeatMasker,LTR,2119913,2121087,282,1.00
ptg013586l,359340,359619,279,RepeatMasker,LTR,358927,360397,279,1.00
ptg013586l,403477,403757,280,RepeatMasker,LTR,403083,404396,280,1.00
ptg013589l,1407715,1408039,324,RepeatMasker,LTR,1406923,1408263,324,1.00
ptg013601l,2776350,2776653,303,RepeatMasker,LTR,2776623,2777599,31,0.10
ptg013607l,589534,589833,299,RepeatMasker,LTR,589339,589885,299,1.00
ptg013607l,1180818,1181116,298,RepeatMasker,LTR,1180596,1181168,298,1.00
ptg013613l,867866,868150,284,RepeatMasker,LTR,867826,867889,23,0.08
ptg013617l,295708,295992,284,RepeatMasker,LTR,295323,296026,284,1.00
ptg013621l,71250,71531,281,RepeatMasker,LTR,70892,71564,281,1.00
ptg013624l,82197,82477,280,RepeatMasker,LTR,81797,83267,280,1.00
ptg013626l,123356,123632,276,RepeatMasker,LTR,123470,123519,50,0.18
ptg013630l,337201,337487,286,RepeatMasker,LTR,332490,338341,286,1.00
ptg013639l,110916,111210,294,RepeatMasker,LTR,109869,111849,294,1.00
ptg013642l,406783,407080,297,RepeatMasker,LTR,406586,407132,297,1.00
ptg013644l,626891,627218,327,RepeatMasker,LTR,625996,627163,272,0.83
ptg013644l,626891,627218,327,RepeatMasker,LTR,626829,627519,327,1.00
ptg013648l,56579,56871,292,RepeatMasker,LTR,56508,56607,28,0.10
ptg013648l,56579,56871,292,RepeatMasker,LTR,56643,56990,229,0.78
ptg013659l,528364,528663,299,RepeatMasker,LTR,525891,528915,299,1.00
ptg013660l,494456,494782,326,RepeatMasker,LTR,494422,495344,326,1.00
ptg013670l,519139,519420,281,RepeatMasker,LTR,518106,519974,281,1.00
ptg013670l,554343,554624,281,RepeatMasker,LTR,554296,555253,281,1.00
ptg013678l,1538685,1538998,313,RepeatMasker,LTR,1538989,1539220,10,0.03
ptg013681l,131849,132141,292,RepeatMasker,LTR,132091,132418,51,0.17
ptg013697l,130645,130927,282,RepeatMasker,LTR,129590,131711,282,1.00
ptg013705l,249599,249901,302,RepeatMasker,LTR,248845,251471,302,1.00
ptg013708l,1175314,1175602,288,RepeatMasker,LTR,1175136,1175654,288,1.00
ptg013710l,870166,870484,318,RepeatMasker,LTR,868277,870514,318,1.00
ptg013728l,1478034,1478329,295,RepeatMasker,LTR,1477993,1478375,295,1.00
ptg013728l,2129190,2129507,317,RepeatMasker,LTR,2128798,2131633,317,1.00
ptg013734l,436514,436803,289,RepeatMasker,LTR,433257,437663,289,1.00
ptg013744l,3100596,3100894,298,RepeatMasker,LTR,3098154,3103301,298,1.00
ptg013753l,141197,141501,304,RepeatMasker,LTR,140142,142282,304,1.00
ptg013767l,515158,515455,297,RepeatMasker,LTR,515010,515177,19,0.06
ptg013767l,515158,515455,297,RepeatMasker,LTR,515062,515222,64,0.22
ptg013771l,2080621,2080924,303,RepeatMasker,LTR,2078401,2081170,303,1.00
ptg013776l,862571,862867,296,RepeatMasker,LTR,862389,862919,296,1.00
ptg013782l,699836,700135,299,RepeatMasker,LTR,699037,701279,299,1.00
ptg013783l,943041,943338,297,RepeatMasker,LTR,942833,943390,297,1.00
ptg013784l,255546,255853,307,RepeatMasker,LTR,255449,255661,115,0.37
ptg013784l,255546,255853,307,RepeatMasker,LTR,255573,255753,181,0.59
ptg013791l,793548,793847,299,RepeatMasker,LTR,793507,793881,299,1.00
ptg013793l,884576,884879,303,RepeatMasker,LTR,884758,885254,122,0.40
ptg013794l,81867,82146,279,RepeatMasker,LTR,81474,82949,279,1.00
ptg013817l,253574,253863,289,RepeatMasker,LTR,250723,253810,236,0.82
ptg013818l,677313,677599,286,RepeatMasker,LTR,675610,678454,286,1.00
ptg013820l,620774,621054,280,RepeatMasker,LTR,620431,621081,280,1.00
ptg013831l,84328,84615,287,RepeatMasker,LTR,82904,85472,287,1.00
ptg013831l,91416,91703,287,RepeatMasker,LTR,86705,92561,287,1.00
ptg013833l,437426,437714,288,RepeatMasker,LTR,434208,437672,246,0.85
ptg013848l,108946,109226,280,RepeatMasker,LTR,108553,109246,280,1.00
ptg013849l,494694,494984,290,RepeatMasker,LTR,493525,495618,290,1.00
ptg013852l,1064697,1064989,292,RepeatMasker,LTR,1064939,1066670,51,0.17
ptg013854l,318443,318691,248,RepeatMasker,LTR,314237,318730,248,1.00
ptg013855l,358443,358745,302,RepeatMasker,LTR,358015,358479,36,0.12
ptg013858l,60565,60845,280,RepeatMasker,LTR,59517,60868,280,1.00
ptg013858l,84113,84412,299,RepeatMasker,LTR,83364,84695,299,1.00
ptg013877l,948676,948958,282,RepeatMasker,LTR,947553,949029,282,1.00
ptg013895l,415852,416150,298,RepeatMasker,LTR,416037,416073,37,0.12
ptg013895l,472721,473018,297,RepeatMasker,LTR,472906,472942,37,0.12
ptg013905l,1378269,1378568,299,RepeatMasker,LTR,1378091,1378620,299,1.00
ptg013910l,482476,482756,280,RepeatMasker,LTR,482604,483274,153,0.55
ptg013914l,959733,960062,329,RepeatMasker,LTR,959861,960234,202,0.61
ptg013915l,109005,109291,286,RepeatMasker,LTR,104359,110138,286,1.00
ptg013915l,382194,382475,281,RepeatMasker,LTR,379140,385057,281,1.00
ptg013919l,695657,695937,280,RepeatMasker,LTR,695270,695949,280,1.00
ptg013930l,432918,433217,299,RepeatMasker,LTR,432838,433264,299,1.00
ptg013931l,176538,176848,310,RepeatMasker,LTR,176490,176983,310,1.00
ptg013934l,2693853,2694153,300,RepeatMasker,LTR,2693501,2693931,78,0.26
ptg013953l,509939,510232,293,RepeatMasker,LTR,509898,510284,293,1.00
ptg013954l,298228,298508,280,RepeatMasker,LTR,297089,299140,280,1.00
ptg013965l,161486,161775,289,RepeatMasker,LTR,161349,162707,289,1.00
ptg013965l,802887,803188,301,RepeatMasker,LTR,801318,803235,301,1.00
ptg013968l,1000668,1000968,300,RepeatMasker,LTR,1000450,1001020,300,1.00
ptg013981l,48736,49042,306,RepeatMasker,LTR,43190,50254,306,1.00
ptg013982l,1574796,1575104,308,RepeatMasker,LTR,1572501,1575934,308,1.00
ptg013990l,616489,616785,296,RepeatMasker,LTR,616324,616818,296,1.00
ptg013990l,616489,616785,296,RepeatMasker,LTR,616404,616818,296,1.00
ptg013993l,67032,67280,248,RepeatMasker,LTR,62824,72325,248,1.00
ptg013997l,1676883,1677199,316,RepeatMasker,LTR,1677037,1684095,163,0.52
ptg014007l,462396,462695,299,RepeatMasker,LTR,462231,462747,299,1.00
ptg014007l,771466,771762,296,RepeatMasker,LTR,771443,771796,296,1.00
ptg014020l,126409,126734,325,RepeatMasker,LTR,126447,127389,288,0.89
ptg014024l,463411,463690,279,RepeatMasker,LTR,458432,466424,279,1.00
ptg014038l,361672,361952,280,RepeatMasker,LTR,360505,362587,280,1.00
ptg014053l,1354405,1354705,300,RepeatMasker,LTR,1354191,1354757,300,1.00
ptg014090l,139108,139392,284,RepeatMasker,LTR,139237,139737,156,0.55
ptg014090l,139108,139392,284,RepeatMasker,LTR,139258,139689,135,0.48
ptg014093l,497172,497459,287,RepeatMasker,LTR,495547,498308,287,1.00
ptg014097l,502786,503067,281,RepeatMasker,LTR,502464,503868,281,1.00
ptg014102l,751932,752225,293,RepeatMasker,LTR,751852,752275,293,1.00
ptg014108l,788260,788573,313,RepeatMasker,LTR,787270,788307,47,0.15
ptg014108l,788260,788573,313,RepeatMasker,LTR,788306,790301,268,0.86
ptg014110l,1542424,1542709,285,RepeatMasker,LTR,1540854,1543589,285,1.00
ptg014112l,9013,9294,281,RepeatMasker,LTR,8627,9939,281,1.00
ptg014121l,355923,356209,286,RepeatMasker,LTR,351460,360359,286,1.00
ptg014122l,93049,93355,306,RepeatMasker,LTR,91080,94632,306,1.00
ptg014133l,2664568,2664879,311,RepeatMasker,LTR,2664477,2664766,198,0.64
ptg014165l,190665,190989,324,RepeatMasker,LTR,189106,190717,52,0.16
ptg014165l,190665,190989,324,RepeatMasker,LTR,190729,191097,261,0.81
ptg014171l,1058391,1058724,333,RepeatMasker,LTR,1058548,1059062,177,0.53
ptg014172l,1417430,1417729,299,RepeatMasker,LTR,1417252,1417763,299,1.00
ptg014172l,1612970,1613270,300,RepeatMasker,LTR,1612761,1613322,300,1.00
ptg014172l,1745050,1745349,299,RepeatMasker,LTR,1745009,1745401,299,1.00
ptg014174l,769637,769965,328,RepeatMasker,LTR,769201,770769,328,1.00
ptg014190l,2055749,2056017,268,RepeatMasker,LTR,2055941,2056136,77,0.29
ptg014201l,1347807,1348115,308,RepeatMasker,LTR,1347901,1351356,215,0.70
ptg014220l,87819,88099,280,RepeatMasker,LTR,87430,88132,280,1.00
ptg014228l,352069,352368,299,RepeatMasker,LTR,351904,352420,299,1.00
ptg014228l,467750,468045,295,RepeatMasker,LTR,467542,468097,295,1.00
ptg014228l,1058045,1058344,299,RepeatMasker,LTR,1058047,1058390,298,1.00
ptg014228l,1231410,1231709,299,RepeatMasker,LTR,1231209,1231761,299,1.00
ptg014228l,1354024,1354320,296,RepeatMasker,LTR,1350627,1354310,286,0.97
ptg014228l,1354024,1354320,296,RepeatMasker,LTR,1353982,1354442,296,1.00
ptg014238l,1271655,1271969,314,RepeatMasker,LTR,1269947,1273064,314,1.00
ptg014245l,317784,318057,273,RepeatMasker,LTR,315307,318002,218,0.80
ptg014251l,699010,699309,299,RepeatMasker,LTR,698833,699361,299,1.00
ptg014251l,1316040,1316338,298,RepeatMasker,LTR,1315832,1316390,298,1.00
ptg014251l,1394011,1394310,299,RepeatMasker,LTR,1393846,1394362,299,1.00
ptg014252l,467342,467667,325,RepeatMasker,LTR,466523,467605,263,0.81
ptg014252l,467342,467667,325,RepeatMasker,LTR,466523,468139,325,1.00
ptg014252l,467342,467667,325,RepeatMasker,LTR,466840,468139,325,1.00
ptg014264l,187745,188026,281,RepeatMasker,LTR,187363,188828,281,1.00
ptg014268l,762331,762621,290,RepeatMasker,LTR,762310,762359,28,0.10
ptg014275l,2304624,2304946,322,RepeatMasker,LTR,2304603,2305489,322,1.00
ptg014319l,45177,45488,311,RepeatMasker,LTR,45440,49046,49,0.16
ptg014338l,1058974,1059310,336,RepeatMasker,LTR,1059027,1059323,284,0.85
ptg014344l,51919,52218,299,RepeatMasker,LTR,51662,52151,232,0.78
ptg014345l,158404,158690,286,RepeatMasker,LTR,158259,158761,286,1.00
ptg014345l,158404,158690,286,RepeatMasker,LTR,158647,159591,44,0.15
ptg014346l,1277141,1277488,347,RepeatMasker,LTR,1275058,1277325,184,0.53
ptg014346l,1277141,1277488,347,RepeatMasker,LTR,1277326,1277824,163,0.47
ptg014354l,185783,186077,294,RepeatMasker,LTR,185915,186414,163,0.55
ptg014355l,1340241,1340552,311,RepeatMasker,LTR,1340420,1341810,133,0.43
ptg014355l,1340241,1340552,311,RepeatMasker,LTR,1340461,1341987,92,0.30
ptg014355l,2905992,2906300,308,RepeatMasker,LTR,2905906,2906080,88,0.29
ptg014355l,2905992,2906300,308,RepeatMasker,LTR,2906159,2906556,142,0.46
ptg014360l,39260,39581,321,RepeatMasker,LTR,39531,41285,51,0.16
ptg014363l,256200,256448,248,RepeatMasker,LTR,251998,261503,248,1.00
ptg014363l,396076,396356,280,RepeatMasker,LTR,395684,397158,280,1.00
ptg014368l,166688,167007,319,RepeatMasker,LTR,164586,166995,307,0.96
ptg014371l,14610,14900,290,RepeatMasker,LTR,14382,14952,290,1.00
ptg014371l,235705,236015,310,RepeatMasker,LTR,234566,235762,57,0.18
ptg014376l,479283,479619,336,RepeatMasker,LTR,479103,479399,116,0.35
ptg014380l,1854921,1855229,308,RepeatMasker,LTR,1854813,1855116,195,0.63
ptg014384l,939915,940242,327,RepeatMasker,LTR,939895,939941,26,0.08
ptg014384l,1898823,1899112,289,RepeatMasker,LTR,1897794,1899143,289,1.00
ptg014384l,1898823,1899112,289,RepeatMasker,LTR,1898821,1899746,289,1.00
ptg014384l,1983859,1984141,282,RepeatMasker,LTR,1983464,1984929,282,1.00
ptg014384l,1991009,1991300,291,RepeatMasker,LTR,1990631,1991944,291,1.00
ptg014396l,256738,257037,299,RepeatMasker,LTR,256559,257089,299,1.00
ptg014396l,456542,456839,297,RepeatMasker,LTR,456334,456891,297,1.00
ptg014406l,2892492,2892773,281,RepeatMasker,LTR,2891354,2894872,281,1.00
ptg014421l,99409,99689,280,RepeatMasker,LTR,99101,99720,280,1.00
ptg014428l,111965,112264,299,RepeatMasker,LTR,111562,112297,299,1.00
ptg014442l,1648705,1649012,307,RepeatMasker,LTR,1647819,1648751,46,0.15
ptg014452l,578811,579120,309,RepeatMasker,LTR,579090,581820,31,0.10
ptg014459l,18568,18895,327,RepeatMasker,LTR,16919,19289,327,1.00
ptg014459l,184008,184308,300,RepeatMasker,LTR,183780,184343,300,1.00
ptg014465l,452992,453272,280,RepeatMasker,LTR,452680,453917,280,1.00
ptg014468l,136336,136585,249,RepeatMasker,LTR,132148,142249,249,1.00
ptg014473l,754400,754682,282,RepeatMasker,LTR,754011,755327,282,1.00
ptg014476l,1889174,1889493,319,RepeatMasker,LTR,1889443,1889631,51,0.16
ptg014484l,195739,196047,308,RepeatMasker,LTR,195064,196005,266,0.86
ptg014507l,1323833,1324136,303,RepeatMasker,LTR,1323457,1325365,303,1.00
ptg014524l,95651,95955,304,RepeatMasker,LTR,95803,96325,153,0.50
ptg014538l,927763,928068,305,RepeatMasker,LTR,927714,932085,305,1.00
ptg014553l,666682,666977,295,RepeatMasker,LTR,666885,666951,67,0.23
ptg014553l,1367415,1367714,299,RepeatMasker,LTR,1367207,1367766,299,1.00
ptg014557l,2443861,2444158,297,RepeatMasker,LTR,2443820,2444210,297,1.00
ptg014557l,3357984,3358300,316,RepeatMasker,LTR,3357571,3358431,316,1.00
ptg014566l,222484,222810,326,RepeatMasker,LTR,222541,223926,270,0.83
ptg014584l,848329,848610,281,RepeatMasker,LTR,847288,849246,281,1.00
ptg014609l,1193079,1193370,291,RepeatMasker,LTR,1193188,1193279,92,0.32
ptg014609l,1193079,1193370,291,RepeatMasker,LTR,1193332,1193592,39,0.13
ptg014611l,224464,224758,294,RepeatMasker,LTR,224425,224810,294,1.00
ptg014612l,4445,4739,294,RepeatMasker,LTR,4269,4791,294,1.00
ptg014612l,746739,747030,291,RepeatMasker,LTR,746544,747082,291,1.00
ptg014612l,774207,774490,283,RepeatMasker,LTR,772780,775368,283,1.00
ptg014633l,2757032,2757352,320,RepeatMasker,LTR,2757174,2757227,54,0.17
ptg014638l,1224778,1225084,306,RepeatMasker,LTR,1224246,1225530,306,1.00
ptg014664l,131633,131913,280,RepeatMasker,LTR,131249,132582,280,1.00
ptg014668l,1341965,1342282,317,RepeatMasker,LTR,1341348,1343807,317,1.00
ptg014688l,482385,482680,295,RepeatMasker,LTR,482166,482732,295,1.00
ptg014688l,1438298,1438586,288,RepeatMasker,LTR,1438276,1438638,288,1.00
ptg014688l,1564985,1565278,293,RepeatMasker,LTR,1564780,1565312,293,1.00
ptg014722l,789293,789572,279,RepeatMasker,LTR,789243,789378,85,0.30
ptg014727l,187833,188146,313,RepeatMasker,LTR,187743,188267,313,1.00
ptg014728l,418134,418454,320,RepeatMasker,LTR,418404,424652,51,0.16
ptg014734l,160352,160642,290,RepeatMasker,LTR,159440,163077,290,1.00
ptg014735l,966329,966644,315,RepeatMasker,LTR,966495,966959,150,0.48
ptg014745l,653750,654030,280,RepeatMasker,LTR,653357,654043,280,1.00
ptg014745l,664154,664434,280,RepeatMasker,LTR,663771,664447,280,1.00
ptg014748l,10823,11084,261,RepeatMasker,LTR,10767,10873,50,0.19
ptg014762l,1768321,1768626,305,RepeatMasker,LTR,1767939,1768424,103,0.34
ptg014765l,556927,557241,314,RepeatMasker,LTR,556897,557846,314,1.00
ptg014785l,278985,279233,248,RepeatMasker,LTR,274782,284915,248,1.00
ptg014788l,39971,40274,303,RepeatMasker,LTR,39423,40755,303,1.00
ptg014789l,301193,301508,315,RepeatMasker,LTR,300179,301521,315,1.00
ptg014789l,308396,308676,280,RepeatMasker,LTR,307260,308689,280,1.00
ptg014792l,367117,367397,280,RepeatMasker,LTR,366078,368033,280,1.00
ptg014793l,2268505,2268800,295,RepeatMasker,LTR,2268482,2268528,23,0.08
ptg014793l,2268505,2268800,295,RepeatMasker,LTR,2268794,2269021,7,0.02
ptg014807l,504675,504990,315,RepeatMasker,LTR,504546,505120,315,1.00
ptg014814l,155754,156034,280,RepeatMasker,LTR,155365,156047,280,1.00
ptg014819l,636084,636379,295,RepeatMasker,LTR,635958,636176,92,0.31
ptg014819l,636084,636379,295,RepeatMasker,LTR,636330,637241,50,0.17
ptg014822l,150472,150742,270,RepeatMasker,LTR,147957,150848,270,1.00
ptg014822l,150472,150742,270,RepeatMasker,LTR,150557,151195,186,0.69
ptg014836l,434994,435259,265,RepeatMasker,LTR,435114,435747,146,0.55
ptg014836l,737124,737395,271,RepeatMasker,LTR,737250,738151,146,0.54
ptg014838l,200893,201187,294,RepeatMasker,LTR,200699,201239,294,1.00
ptg014838l,249819,250109,290,RepeatMasker,LTR,248926,252367,290,1.00
ptg014838l,580149,580453,304,RepeatMasker,LTR,577147,580753,304,1.00
ptg014838l,698524,698823,299,RepeatMasker,LTR,698444,698875,299,1.00
ptg014842l,551623,551912,289,RepeatMasker,LTR,551871,552854,42,0.15
ptg014844l,665658,665966,308,RepeatMasker,LTR,665523,665811,153,0.50
ptg014845l,72219,72527,308,RepeatMasker,LTR,72395,72791,133,0.43
ptg014845l,1728234,1728520,286,RepeatMasker,LTR,1727831,1734652,286,1.00
ptg014857l,109057,109338,281,RepeatMasker,LTR,108668,109984,281,1.00
ptg014874l,475099,475405,306,RepeatMasker,LTR,472820,476729,306,1.00
ptg014879l,7652,7953,301,RepeatMasker,LTR,7797,13522,157,0.52
ptg014894l,891353,891674,321,RepeatMasker,LTR,891596,891930,79,0.25
ptg014898l,72081,72377,296,RepeatMasker,LTR,71998,72429,296,1.00
ptg014898l,2061195,2061472,277,RepeatMasker,LTR,2057767,2061462,267,0.96
ptg014898l,2061195,2061472,277,RepeatMasker,LTR,2061463,2061594,10,0.04
ptg014904l,496767,497059,292,RepeatMasker,LTR,496605,496960,193,0.66
ptg014904l,496767,497059,292,RepeatMasker,LTR,496605,497014,247,0.85
ptg014913l,355546,355841,295,RepeatMasker,LTR,355368,355893,295,1.00
ptg014918l,180195,180494,299,RepeatMasker,LTR,180115,180546,299,1.00
ptg014918l,250579,250872,293,RepeatMasker,LTR,250401,250924,293,1.00
ptg014918l,304741,305034,293,RepeatMasker,LTR,304547,305086,293,1.00
ptg014936l,49295,49592,297,RepeatMasker,LTR,48999,50383,297,1.00
ptg014937l,244027,244326,299,RepeatMasker,LTR,243819,244378,299,1.00
ptg014947l,1233998,1234307,309,RepeatMasker,LTR,1234197,1234402,111,0.36
ptg014947l,1233998,1234307,309,RepeatMasker,LTR,1234200,1234380,108,0.35
ptg014951l,178013,178338,325,RepeatMasker,LTR,177676,178050,37,0.11
ptg014951l,178013,178338,325,RepeatMasker,LTR,178056,178264,209,0.64
ptg014955l,84720,84988,268,RepeatMasker,LTR,84338,85790,268,1.00
ptg014957l,246971,247250,279,RepeatMasker,LTR,245489,247281,279,1.00
ptg014985l,237041,237314,273,RepeatMasker,LTR,236487,237246,205,0.75
ptg014995l,752541,752827,286,RepeatMasker,LTR,752142,755932,286,1.00
ptg014996l,1240022,1240319,297,RepeatMasker,LTR,1239857,1240371,297,1.00
ptg015002l,583036,583332,296,RepeatMasker,LTR,582956,583384,296,1.00
ptg015004l,10230,10516,286,RepeatMasker,LTR,8674,11378,286,1.00
ptg015010l,9996,10306,310,RepeatMasker,LTR,9604,10221,225,0.73
ptg015014l,223423,223725,302,RepeatMasker,LTR,223634,225160,92,0.30
ptg015014l,223423,223725,302,RepeatMasker,LTR,223644,224976,82,0.27
ptg015026l,33905,34149,244,RepeatMasker,LTR,29695,39201,244,1.00
ptg015031l,1037323,1037632,309,RepeatMasker,LTR,1036293,1038276,309,1.00
ptg015031l,1142058,1142338,280,RepeatMasker,LTR,1141668,1142349,280,1.00
ptg015031l,1142058,1142338,280,RepeatMasker,LTR,1141740,1142986,280,1.00
ptg015032c,597345,597632,287,RepeatMasker,LTR,595775,598494,287,1.00
ptg015035l,1340764,1341062,298,RepeatMasker,LTR,1340556,1341114,298,1.00
ptg015041l,1035647,1035946,299,RepeatMasker,LTR,1035469,1035998,299,1.00
ptg015051l,567439,567736,297,RepeatMasker,LTR,567710,570816,27,0.09
ptg015051l,2037187,2037466,279,RepeatMasker,LTR,2037413,2037903,54,0.19
ptg015053l,1053248,1053543,295,RepeatMasker,LTR,1052995,1053824,295,1.00
ptg015067l,121598,121878,280,RepeatMasker,LTR,121218,122669,280,1.00
ptg015082l,189066,189361,295,RepeatMasker,LTR,187939,190008,295,1.00
ptg015095l,65354,65676,322,RepeatMasker,LTR,65626,67317,51,0.16
ptg015096l,416216,416451,235,RepeatMasker,LTR,412016,418196,235,1.00
ptg015099l,354211,354492,281,RepeatMasker,LTR,353829,355137,281,1.00
ptg015102l,241437,241752,315,RepeatMasker,LTR,241373,242898,315,1.00
ptg015110l,297962,298261,299,RepeatMasker,LTR,297755,298313,299,1.00
ptg015128l,18147,18446,299,RepeatMasker,LTR,18422,19424,25,0.08
ptg015131l,2880272,2880574,302,RepeatMasker,LTR,2880172,2880686,302,1.00
ptg015143l,919079,919365,286,RepeatMasker,LTR,918418,923246,286,1.00
ptg015146l,510445,510742,297,RepeatMasker,LTR,510422,510794,297,1.00
ptg015154l,281591,281899,308,RepeatMasker,LTR,281205,282702,308,1.00
ptg015168l,854664,854926,262,RepeatMasker,LTR,854586,855808,262,1.00
ptg015170l,549673,549976,303,RepeatMasker,LTR,544919,549829,156,0.51
ptg015180l,166572,166870,298,RepeatMasker,LTR,166684,166739,56,0.19
ptg015222l,368486,368768,282,RepeatMasker,LTR,368472,368781,282,1.00
ptg015222l,375667,375949,282,RepeatMasker,LTR,374527,375962,282,1.00
ptg015231l,1732262,1732556,294,RepeatMasker,LTR,1729214,1735344,294,1.00
ptg015231l,1896789,1897086,297,RepeatMasker,LTR,1896577,1897138,297,1.00
ptg015239l,119855,120129,274,RepeatMasker,LTR,119056,120519,274,1.00
ptg015268l,831267,831573,306,RepeatMasker,LTR,830227,836318,306,1.00
ptg015281l,528951,529232,281,RepeatMasker,LTR,528569,529264,281,1.00
ptg015281l,536095,536376,281,RepeatMasker,LTR,535713,537019,281,1.00
ptg015292l,243286,243582,296,RepeatMasker,LTR,242920,243594,296,1.00
ptg015297l,2450121,2450408,287,RepeatMasker,LTR,2445443,2451261,287,1.00
ptg015297l,2469265,2469551,286,RepeatMasker,LTR,2465023,2470411,286,1.00
ptg015301l,1013131,1013441,310,RepeatMasker,LTR,1010646,1016750,310,1.00
ptg015326l,210188,210463,275,RepeatMasker,LTR,208760,210596,275,1.00
ptg015328l,592443,592723,280,RepeatMasker,LTR,592052,593357,280,1.00
ptg015330l,586510,586796,286,RepeatMasker,LTR,585615,587118,286,1.00
ptg015335l,227389,227675,286,RepeatMasker,LTR,226148,227476,87,0.30
ptg015338l,455496,455780,284,RepeatMasker,LTR,455298,456026,284,1.00
ptg015338l,455496,455780,284,RepeatMasker,LTR,455462,460901,284,1.00
ptg015344l,1802373,1802660,287,RepeatMasker,LTR,1797728,1803502,287,1.00
ptg015346l,126088,126387,299,RepeatMasker,LTR,125910,126439,299,1.00
ptg015351l,651994,652302,308,RepeatMasker,LTR,651554,652622,308,1.00
ptg015357l,3724659,3724985,326,RepeatMasker,LTR,3723755,3724692,33,0.10
ptg015357l,3724659,3724985,326,RepeatMasker,LTR,3724689,3726486,297,0.91
ptg015357l,3724659,3724985,326,RepeatMasker,LTR,3724695,3726759,291,0.89
ptg015358l,646417,646713,296,RepeatMasker,LTR,645925,646894,296,1.00
ptg015364l,807777,808076,299,RepeatMasker,LTR,807576,808128,299,1.00
ptg015369l,268271,268561,290,RepeatMasker,LTR,267978,268392,121,0.42
ptg015374l,186505,186805,300,RepeatMasker,LTR,186383,186857,300,1.00
ptg015380l,1333771,1334048,277,RepeatMasker,LTR,1333386,1334851,277,1.00
ptg015386l,463011,463334,323,RepeatMasker,LTR,462781,463327,316,0.98
ptg015389l,394568,394848,280,RepeatMasker,LTR,394166,395495,280,1.00
ptg015397l,206673,206971,298,RepeatMasker,LTR,206593,207023,298,1.00
ptg015398l,184369,184655,286,RepeatMasker,LTR,182400,185505,286,1.00
ptg015405l,515539,515819,280,RepeatMasker,LTR,515153,516619,280,1.00
ptg015410l,402568,402867,299,RepeatMasker,LTR,402488,402919,299,1.00
ptg015412l,793364,793642,278,RepeatMasker,LTR,793465,793552,88,0.32
ptg015418l,93153,93433,280,RepeatMasker,LTR,92771,93460,280,1.00
ptg015418l,93153,93433,280,RepeatMasker,LTR,92842,93445,280,1.00
ptg015427l,637223,637526,303,RepeatMasker,LTR,637066,637284,61,0.20
ptg015427l,637223,637526,303,RepeatMasker,LTR,637334,638246,193,0.64
ptg015427l,934604,934903,299,RepeatMasker,LTR,934410,934955,299,1.00
ptg015427l,1168493,1168792,299,RepeatMasker,LTR,1168296,1168844,299,1.00
ptg015435l,487755,488046,291,RepeatMasker,LTR,487776,489148,271,0.93
ptg015444l,292981,293283,302,RepeatMasker,LTR,293148,293187,40,0.13
ptg015446l,281419,281729,310,RepeatMasker,LTR,281514,284337,216,0.70
ptg015459l,192898,193203,305,RepeatMasker,LTR,192249,192968,70,0.23
ptg015462l,331079,331358,279,RepeatMasker,LTR,329623,333509,279,1.00
ptg015468l,817596,817891,295,RepeatMasker,LTR,817388,817943,295,1.00
ptg015468l,1619520,1619825,305,RepeatMasker,LTR,1619626,1620413,200,0.66
ptg015470l,1181327,1181609,282,RepeatMasker,LTR,1180821,1181499,172,0.61
ptg015470l,1181327,1181609,282,RepeatMasker,LTR,1181478,1182717,132,0.47
ptg015470l,3336547,3336824,277,RepeatMasker,LTR,3335907,3339244,277,1.00
ptg015483l,315541,315851,310,RepeatMasker,LTR,315159,316497,310,1.00
ptg015490l,242251,242549,298,RepeatMasker,LTR,242039,242601,298,1.00
ptg015490l,502576,502873,297,RepeatMasker,LTR,502369,502925,297,1.00
ptg015496l,273282,273577,295,RepeatMasker,LTR,273202,273629,295,1.00
ptg015496l,557465,557758,293,RepeatMasker,LTR,557311,557810,293,1.00
ptg015504l,474518,474848,330,RepeatMasker,LTR,474340,475138,330,1.00
ptg015506l,2642245,2642532,287,RepeatMasker,LTR,2640474,2643366,287,1.00
ptg015506l,3387452,3387760,308,RepeatMasker,LTR,3386981,3387539,87,0.28
ptg015506l,3387452,3387760,308,RepeatMasker,LTR,3387732,3389660,29,0.09
ptg015509l,311030,311310,280,RepeatMasker,LTR,310630,311964,280,1.00
ptg015514l,136443,136740,297,RepeatMasker,LTR,136423,136467,24,0.08
ptg015543l,84553,84870,317,RepeatMasker,LTR,84820,87068,51,0.16
ptg015552l,1762789,1763067,278,RepeatMasker,LTR,1762827,1763307,241,0.87
ptg015552l,1778052,1778326,274,RepeatMasker,LTR,1778090,1778566,237,0.86
ptg015557l,24105,24404,299,RepeatMasker,LTR,23940,24456,299,1.00
ptg015575l,466064,466373,309,RepeatMasker,LTR,465337,466396,309,1.00
ptg015578l,1563623,1563941,318,RepeatMasker,LTR,1562089,1564252,318,1.00
ptg015578l,1563623,1563941,318,RepeatMasker,LTR,1563858,1564330,84,0.26
ptg015583l,254776,255074,298,RepeatMasker,LTR,254758,254873,97,0.33
ptg015583l,254776,255074,298,RepeatMasker,LTR,254817,254880,64,0.21
ptg015586l,259674,259956,282,RepeatMasker,LTR,259259,260201,282,1.00
ptg015588l,674656,674963,307,RepeatMasker,LTR,674588,675015,307,1.00
ptg015588l,1273364,1273662,298,RepeatMasker,LTR,1273390,1275229,273,0.92
ptg015604l,673087,673367,280,RepeatMasker,LTR,671934,674146,280,1.00
ptg015611l,540300,540596,296,RepeatMasker,LTR,540217,540648,296,1.00
ptg015619l,1894924,1895216,292,RepeatMasker,LTR,1894582,1898049,292,1.00
ptg015620l,1364989,1365318,329,RepeatMasker,LTR,1364412,1365133,144,0.44
ptg015620l,1364989,1365318,329,RepeatMasker,LTR,1365084,1365410,235,0.71
ptg015620l,1364989,1365318,329,RepeatMasker,LTR,1365130,1365410,189,0.57
ptg015630l,446702,447008,306,RepeatMasker,LTR,446886,448571,123,0.40
ptg015644l,248761,249056,295,RepeatMasker,LTR,247734,249683,295,1.00
ptg015645l,402567,402879,312,RepeatMasker,LTR,401285,403708,312,1.00
ptg015683l,87286,87581,295,RepeatMasker,LTR,87118,87633,295,1.00
ptg015685l,1393276,1393574,298,RepeatMasker,LTR,1393228,1393606,298,1.00
ptg015691l,1079223,1079549,326,RepeatMasker,LTR,1079379,1079428,50,0.15
ptg015691l,1313807,1314103,296,RepeatMasker,LTR,1313587,1314155,296,1.00
ptg015696l,235400,235681,281,RepeatMasker,LTR,234998,235714,281,1.00
ptg015703l,279531,279862,331,RepeatMasker,LTR,277816,280199,331,1.00
ptg015712l,681039,681319,280,RepeatMasker,LTR,680647,681332,280,1.00
ptg015715l,81824,82120,296,RepeatMasker,LTR,81746,82172,296,1.00
ptg015720l,118134,118426,292,RepeatMasker,LTR,117914,119388,292,1.00
ptg015722l,102335,102658,323,RepeatMasker,LTR,102111,103224,323,1.00
ptg015726l,275028,275309,281,RepeatMasker,LTR,273849,275952,281,1.00
ptg015734l,430503,430811,308,RepeatMasker,LTR,430156,431851,308,1.00
ptg015738l,165608,165946,338,RepeatMasker,LTR,165740,166499,207,0.61
ptg015746l,925807,926087,280,RepeatMasker,LTR,925491,926867,280,1.00
ptg015749l,1061953,1062239,286,RepeatMasker,LTR,1059178,1063923,286,1.00
ptg015749l,1143486,1143784,298,RepeatMasker,LTR,1143758,1149380,27,0.09
ptg015752l,198447,198746,299,RepeatMasker,LTR,198269,198798,299,1.00
ptg015765l,1150075,1150394,319,RepeatMasker,LTR,1149904,1150942,319,1.00
ptg015766l,1091001,1091282,281,RepeatMasker,LTR,1090619,1091315,281,1.00
ptg015766l,1263025,1263305,280,RepeatMasker,LTR,1262643,1263944,280,1.00
ptg015768l,727888,728182,294,RepeatMasker,LTR,727603,730756,294,1.00
ptg015772l,1813638,1813919,281,RepeatMasker,LTR,1812500,1813952,281,1.00
ptg015774l,490016,490319,303,RepeatMasker,LTR,490157,492203,163,0.54
ptg015774l,490016,490319,303,RepeatMasker,LTR,490204,497178,116,0.38
ptg015782l,2585900,2586199,299,RepeatMasker,LTR,2585722,2586251,299,1.00
ptg015786l,622786,623066,280,RepeatMasker,LTR,622473,623099,280,1.00
ptg015791l,628522,628830,308,RepeatMasker,LTR,628199,628780,258,0.84
ptg015801l,2123877,2124156,279,RepeatMasker,LTR,2122829,2124936,279,1.00
ptg015817l,55064,55341,277,RepeatMasker,LTR,51637,55331,267,0.96
ptg015817l,55064,55341,277,RepeatMasker,LTR,55003,55469,277,1.00
ptg015819l,337973,338254,281,RepeatMasker,LTR,337591,338287,281,1.00
ptg015819l,730500,730795,295,RepeatMasker,LTR,730480,730829,295,1.00
ptg015834l,315282,315592,310,RepeatMasker,LTR,314177,315693,310,1.00
ptg015838l,133151,133470,319,RepeatMasker,LTR,133421,134062,50,0.16
ptg015845l,1463283,1463564,281,RepeatMasker,LTR,1462865,1463575,281,1.00
ptg015845l,1463283,1463564,281,RepeatMasker,LTR,1463277,1464362,281,1.00
ptg015845l,1470407,1470704,297,RepeatMasker,LTR,1470039,1471329,297,1.00
ptg015853l,377100,377396,296,RepeatMasker,LTR,377059,377448,296,1.00
ptg015857l,483349,483661,312,RepeatMasker,LTR,479960,484771,312,1.00
ptg015872l,365802,366101,299,RepeatMasker,LTR,365043,366480,299,1.00
ptg015872l,868106,868387,281,RepeatMasker,LTR,867723,869189,281,1.00
ptg015884l,1729546,1729845,299,RepeatMasker,LTR,1728791,1731413,299,1.00
ptg015890l,427149,427429,280,RepeatMasker,LTR,426760,427441,280,1.00
ptg015890l,463091,463371,280,RepeatMasker,LTR,462440,463403,280,1.00
ptg015890l,470250,470530,280,RepeatMasker,LTR,469116,470562,280,1.00
ptg015894l,115318,115603,285,RepeatMasker,LTR,115384,115549,166,0.58
ptg015939l,354781,355079,298,RepeatMasker,LTR,352582,357000,298,1.00
ptg015947l,359348,359626,278,RepeatMasker,LTR,359460,366476,167,0.60
ptg015950l,904741,905026,285,RepeatMasker,LTR,904343,907384,285,1.00
ptg015952l,428278,428555,277,RepeatMasker,LTR,428217,428777,277,1.00
ptg015952l,428278,428555,277,RepeatMasker,LTR,424849,428545,267,0.96
ptg015952l,695741,696042,301,RepeatMasker,LTR,695533,696094,301,1.00
ptg015952l,976049,976348,299,RepeatMasker,LTR,975871,976400,299,1.00
ptg015968l,145363,145666,303,RepeatMasker,LTR,144468,145415,52,0.17
ptg015985l,243077,243376,299,RepeatMasker,LTR,243079,243428,298,1.00
ptg015985l,358414,358744,330,RepeatMasker,LTR,357398,359795,330,1.00
ptg016006l,872974,873257,283,RepeatMasker,LTR,871933,874032,283,1.00
ptg016011l,103053,103338,285,RepeatMasker,LTR,103032,103076,23,0.08
ptg016016l,1072010,1072290,280,RepeatMasker,LTR,1070962,1072303,280,1.00
ptg016029l,99219,99499,280,RepeatMasker,LTR,98837,100290,280,1.00
ptg016043l,201846,202167,321,RepeatMasker,LTR,202117,206470,51,0.16
ptg016065l,432598,432879,281,RepeatMasker,LTR,432258,432911,281,1.00
ptg016072l,53060,53343,283,RepeatMasker,LTR,52360,53119,59,0.21
ptg016072l,53060,53343,283,RepeatMasker,LTR,53254,53323,70,0.25
ptg016075l,203317,203616,299,RepeatMasker,LTR,203139,203668,299,1.00
ptg016083l,447804,448084,280,RepeatMasker,LTR,447798,448735,280,1.00
ptg016083l,831051,831331,280,RepeatMasker,LTR,830052,831992,280,1.00
ptg016083l,866360,866642,282,RepeatMasker,LTR,865903,867270,282,1.00
ptg016098l,28259,28560,301,RepeatMasker,LTR,28536,32468,25,0.08
ptg016098l,83259,83558,299,RepeatMasker,LTR,83218,83610,299,1.00
ptg016098l,128192,128512,320,RepeatMasker,LTR,128462,129765,51,0.16
ptg016102l,1481787,1482067,280,RepeatMasker,LTR,1481414,1482691,280,1.00
ptg016106l,670685,670975,290,RepeatMasker,LTR,670312,671008,290,1.00
ptg016106l,815229,815510,281,RepeatMasker,LTR,814847,815544,281,1.00
ptg016109l,654431,654744,313,RepeatMasker,LTR,652461,654432,1,0.00
ptg016128l,106114,106400,286,RepeatMasker,LTR,101489,107237,286,1.00
ptg016139l,722633,722940,307,RepeatMasker,LTR,722272,722843,210,0.68
ptg016152l,88795,89094,299,RepeatMasker,LTR,88617,89146,299,1.00
ptg016164l,27299,27591,292,RepeatMasker,LTR,26924,28235,292,1.00
ptg016168l,349778,350067,289,RepeatMasker,LTR,349623,350078,289,1.00
ptg016168l,349778,350067,289,RepeatMasker,LTR,349703,350079,289,1.00
ptg016183l,1188706,1188985,279,RepeatMasker,LTR,1184611,1194032,279,1.00
ptg016203l,1129897,1130039,142,RepeatMasker,LTR,1130023,1130198,17,0.12
ptg016209l,527110,527410,300,RepeatMasker,LTR,527278,528022,133,0.44
ptg016213l,161202,161504,302,RepeatMasker,LTR,160820,162269,302,1.00
ptg016220l,576566,576847,281,RepeatMasker,LTR,576162,577497,281,1.00
ptg016228l,688265,688575,310,RepeatMasker,LTR,687867,688351,86,0.28
ptg016228l,778800,779066,266,RepeatMasker,LTR,778770,780970,266,1.00
ptg016228l,778800,779066,266,RepeatMasker,LTR,778803,780260,264,0.99
ptg016244l,60496,60788,292,RepeatMasker,LTR,60738,65365,51,0.17
ptg016248l,912284,912574,290,RepeatMasker,LTR,911894,912587,290,1.00
ptg016248l,1677754,1678053,299,RepeatMasker,LTR,1677792,1678907,262,0.88
ptg016260l,286781,287116,335,RepeatMasker,LTR,286728,289323,335,1.00
ptg016270l,76994,77291,297,RepeatMasker,LTR,76654,77937,297,1.00
ptg016271l,990508,990837,329,RepeatMasker,LTR,990218,990969,329,1.00
ptg016292l,807353,807645,292,RepeatMasker,LTR,807595,808051,51,0.17
ptg016292l,1542614,1542934,320,RepeatMasker,LTR,1540468,1543778,320,1.00
ptg016307l,365855,366146,291,RepeatMasker,LTR,366122,367110,25,0.09
ptg016307l,913428,913714,286,RepeatMasker,LTR,913270,913896,286,1.00
ptg016308l,378218,378531,313,RepeatMasker,LTR,377079,378544,313,1.00
ptg016321l,211571,211853,282,RepeatMasker,LTR,210423,212488,282,1.00
ptg016321l,386260,386541,281,RepeatMasker,LTR,385878,387184,281,1.00
ptg016321l,494066,494346,280,RepeatMasker,LTR,493685,495147,280,1.00
ptg016326l,63917,64247,330,RepeatMasker,LTR,64034,64063,30,0.09
ptg016333l,163952,164231,279,RepeatMasker,LTR,163570,164243,279,1.00
ptg016344l,1797785,1798082,297,RepeatMasker,LTR,1797359,1798634,297,1.00
ptg016345l,3284743,3285026,283,RepeatMasker,LTR,3283825,3285647,283,1.00
ptg016349l,62389,62690,301,RepeatMasker,LTR,62462,63558,229,0.76
ptg016378l,1503049,1503355,306,RepeatMasker,LTR,1503049,1503505,306,1.00
ptg016380l,17028,17314,286,RepeatMasker,LTR,14014,18025,286,1.00
ptg016386l,128762,129010,248,RepeatMasker,LTR,124558,134061,248,1.00
ptg016386l,816640,816927,287,RepeatMasker,LTR,816289,816960,287,1.00
ptg016386l,1341278,1341558,280,RepeatMasker,LTR,1340897,1341570,280,1.00
ptg016388l,657258,657554,296,RepeatMasker,LTR,657178,657606,296,1.00
ptg016393l,267538,267822,284,RepeatMasker,LTR,265802,269169,284,1.00
ptg016408l,31632,31938,306,RepeatMasker,LTR,30925,32369,306,1.00
ptg016417l,211893,212180,287,RepeatMasker,LTR,210322,213040,287,1.00
ptg016417l,624490,624797,307,RepeatMasker,LTR,624399,624763,273,0.89
ptg016418l,1427398,1427694,296,RepeatMasker,LTR,1427647,1428447,48,0.16
ptg016420l,80879,81198,319,RepeatMasker,LTR,80909,81999,290,0.91
ptg016421l,312975,313269,294,RepeatMasker,LTR,312518,313083,108,0.37
ptg016422l,630172,630451,279,RepeatMasker,LTR,629504,630511,279,1.00
ptg016428l,1264636,1264916,280,RepeatMasker,LTR,1263503,1264929,280,1.00
ptg016435l,698706,698985,279,RepeatMasker,LTR,698324,699789,279,1.00
ptg016435l,705439,705719,280,RepeatMasker,LTR,705042,705732,280,1.00
ptg016449l,12206,12499,293,RepeatMasker,LTR,12359,12789,141,0.48
ptg016450l,437752,438051,299,RepeatMasker,LTR,437732,438085,299,1.00
ptg016451l,593054,593350,296,RepeatMasker,LTR,592842,593397,296,1.00
ptg016454l,383836,384123,287,RepeatMasker,LTR,383915,383965,51,0.18
ptg016455l,455900,456210,310,RepeatMasker,LTR,452916,455947,47,0.15
ptg016455l,472113,472423,310,RepeatMasker,LTR,470420,472160,47,0.15
ptg016458l,86850,87132,282,RepeatMasker,LTR,86441,87155,282,1.00
ptg016458l,115917,116197,280,RepeatMasker,LTR,115526,116209,280,1.00
ptg016458l,726107,726388,281,RepeatMasker,LTR,725725,727027,281,1.00
ptg016466l,1670885,1671176,291,RepeatMasker,LTR,1669792,1673978,291,1.00
ptg016469l,631879,632210,331,RepeatMasker,LTR,632090,636363,121,0.37
ptg016484l,863137,863417,280,RepeatMasker,LTR,862755,864063,280,1.00
ptg016491l,2306640,2306920,280,RepeatMasker,LTR,2305495,2307556,280,1.00
ptg016498l,584897,585197,300,RepeatMasker,LTR,584109,585312,300,1.00
ptg016502l,296568,296848,280,RepeatMasker,LTR,295514,297630,280,1.00
ptg016509l,1462581,1462885,304,RepeatMasker,LTR,1462399,1462937,304,1.00
ptg016526l,2855748,2856074,326,RepeatMasker,LTR,2855958,2856631,117,0.36
ptg016533l,614708,614988,280,RepeatMasker,LTR,613657,615021,280,1.00
ptg016534l,79956,80240,284,RepeatMasker,LTR,79649,80275,284,1.00
ptg016534l,175523,175804,281,RepeatMasker,LTR,175163,175839,281,1.00
ptg016552l,731614,731913,299,RepeatMasker,LTR,731436,731965,299,1.00
ptg016552l,788280,788575,295,RepeatMasker,LTR,788085,788627,295,1.00
ptg016563l,442726,443036,310,RepeatMasker,LTR,441946,444739,310,1.00
ptg016568l,261471,261781,310,RepeatMasker,LTR,261092,261859,310,1.00
ptg016574l,285192,285472,280,RepeatMasker,LTR,284130,285485,280,1.00
ptg016581l,347282,347611,329,RepeatMasker,LTR,346354,348867,329,1.00
ptg016581l,347282,347611,329,RepeatMasker,LTR,346881,348935,329,1.00
ptg016589l,1045287,1045576,289,RepeatMasker,LTR,1045411,1045914,166,0.57
ptg016598l,1309761,1310060,299,RepeatMasker,LTR,1309593,1310082,299,1.00
ptg016606l,334776,335073,297,RepeatMasker,LTR,332299,336255,297,1.00
ptg016614l,513573,513862,289,RepeatMasker,LTR,510205,514549,289,1.00
ptg016619l,735459,735742,283,RepeatMasker,LTR,735343,735621,162,0.57
ptg016619l,735459,735742,283,RepeatMasker,LTR,735619,735665,47,0.17
ptg016619l,735459,735742,283,RepeatMasker,LTR,735674,736482,69,0.24
ptg016639l,328827,329126,299,RepeatMasker,LTR,328649,329178,299,1.00
ptg016644l,869691,870021,330,RepeatMasker,LTR,868574,870687,330,1.00
ptg016648l,532961,533273,312,RepeatMasker,LTR,532862,533172,211,0.68
ptg016648l,532961,533273,312,RepeatMasker,LTR,532862,533316,312,1.00
ptg016659l,818988,819298,310,RepeatMasker,LTR,819111,819221,111,0.36
ptg016662l,1405485,1405821,336,RepeatMasker,LTR,1405595,1405673,79,0.24
ptg016662l,1405485,1405821,336,RepeatMasker,LTR,1405663,1406064,159,0.47
ptg016684l,531428,531737,309,RepeatMasker,LTR,531290,532001,309,1.00
ptg016694l,18957,19249,292,RepeatMasker,LTR,18575,19283,292,1.00
ptg016695l,521311,521605,294,RepeatMasker,LTR,521231,521657,294,1.00
ptg016720l,1026231,1026511,280,RepeatMasker,LTR,1025922,1026524,280,1.00
ptg016720l,1033740,1034027,287,RepeatMasker,LTR,1033358,1034040,287,1.00
ptg016727l,78777,79062,285,RepeatMasker,LTR,77730,79693,285,1.00
ptg016727l,1022257,1022537,280,RepeatMasker,LTR,1021877,1023178,280,1.00
ptg016728l,126029,126349,320,RepeatMasker,LTR,123976,128992,320,1.00
ptg016729l,66099,66347,248,RepeatMasker,LTR,65336,70056,248,1.00
ptg016744l,230863,231155,292,RepeatMasker,LTR,231135,232119,21,0.07
ptg016745l,337069,337350,281,RepeatMasker,LTR,336680,337363,281,1.00
ptg016748l,1055902,1056188,286,RepeatMasker,LTR,1055497,1062311,286,1.00
ptg016748l,1178730,1179029,299,RepeatMasker,LTR,1178710,1179063,299,1.00
ptg016750l,221161,221461,300,RepeatMasker,LTR,220863,221450,289,0.96
ptg016755l,965227,965506,279,RepeatMasker,LTR,964838,965533,279,1.00
ptg016755l,965227,965506,279,RepeatMasker,LTR,964908,965518,279,1.00
ptg016774l,968659,968946,287,RepeatMasker,LTR,965107,969808,287,1.00
ptg016805l,14166,14465,299,RepeatMasker,LTR,13974,14517,299,1.00
ptg016810l,293222,293506,284,RepeatMasker,LTR,293268,293328,61,0.21
ptg016817l,868437,868760,323,RepeatMasker,LTR,868732,868804,29,0.09
ptg016817l,868437,868760,323,RepeatMasker,LTR,866683,868710,273,0.85
ptg016831l,486676,486957,281,RepeatMasker,LTR,485532,486970,281,1.00
ptg016838l,349350,349628,278,RepeatMasker,LTR,349010,349640,278,1.00
ptg016851l,533253,533551,298,RepeatMasker,LTR,533231,533276,23,0.08
ptg016853l,326231,326511,280,RepeatMasker,LTR,325913,327303,280,1.00
ptg016905l,766750,767056,306,RepeatMasker,LTR,766126,767539,306,1.00
ptg016905l,766750,767056,306,RepeatMasker,LTR,766199,767430,306,1.00
ptg016915l,19393,19694,301,RepeatMasker,LTR,19431,20567,264,0.88
ptg016919l,303980,304279,299,RepeatMasker,LTR,303802,304331,299,1.00
ptg016921l,477189,477475,286,RepeatMasker,LTR,476793,483608,286,1.00
ptg016923l,838489,838768,279,RepeatMasker,LTR,838095,839576,279,1.00
ptg016937l,513067,513346,279,RepeatMasker,LTR,513328,514200,19,0.07
ptg016937l,815594,815913,319,RepeatMasker,LTR,815863,816724,51,0.16
ptg016939l,232247,232546,299,RepeatMasker,LTR,232053,232574,299,1.00
ptg016942l,367963,368249,286,RepeatMasker,LTR,367941,367986,23,0.08
ptg016943l,203517,203816,299,RepeatMasker,LTR,203497,203850,299,1.00
ptg016943l,280849,281146,297,RepeatMasker,LTR,280769,281180,297,1.00
ptg016952l,442867,443164,297,RepeatMasker,LTR,442421,443541,297,1.00
ptg016954l,1016353,1016659,306,RepeatMasker,LTR,1015831,1016409,56,0.18
ptg016970l,276219,276521,302,RepeatMasker,LTR,275836,277159,302,1.00
ptg016970l,280921,281249,328,RepeatMasker,LTR,280164,281982,328,1.00
ptg016982l,566404,566725,321,RepeatMasker,LTR,566608,566641,34,0.11
ptg016990l,76546,76863,317,RepeatMasker,LTR,76797,76917,67,0.21
ptg017003l,5568,5848,280,RepeatMasker,LTR,5167,6646,280,1.00
ptg017003l,28435,28715,280,RepeatMasker,LTR,28044,29352,280,1.00
ptg017003l,324583,324863,280,RepeatMasker,LTR,324201,325509,280,1.00
ptg017010l,125151,125457,306,RepeatMasker,LTR,124775,126261,306,1.00
ptg017015l,1369299,1369579,280,RepeatMasker,LTR,1368130,1370217,280,1.00
ptg017017l,72868,73159,291,RepeatMasker,LTR,71744,73172,291,1.00
ptg017037l,1079579,1079887,308,RepeatMasker,LTR,1079592,1080686,296,0.96
ptg017037l,1901372,1901658,286,RepeatMasker,LTR,1900973,1906689,286,1.00
ptg017045l,376872,377178,306,RepeatMasker,LTR,376372,377486,306,1.00
ptg017061l,270019,270335,316,RepeatMasker,LTR,269006,271119,316,1.00
ptg017061l,286977,287258,281,RepeatMasker,LTR,285834,287879,281,1.00
ptg017064l,591226,591536,310,RepeatMasker,LTR,590366,591811,310,1.00
ptg017067l,749349,749630,281,RepeatMasker,LTR,748954,750277,281,1.00
ptg017079l,942044,942324,280,RepeatMasker,LTR,941371,942337,280,1.00
ptg017101l,62249,62533,284,RepeatMasker,LTR,62061,62324,75,0.26
ptg017102l,1130246,1130560,314,RepeatMasker,LTR,1126684,1130297,51,0.16
ptg017123l,577844,578125,281,RepeatMasker,LTR,577462,578158,281,1.00
ptg017150l,430781,431079,298,RepeatMasker,LTR,430754,431683,298,1.00
ptg017151l,284609,284937,328,RepeatMasker,LTR,284715,284773,59,0.18
ptg017155l,392470,392765,295,RepeatMasker,LTR,392108,393409,295,1.00
ptg017156l,1111498,1111795,297,RepeatMasker,LTR,1111320,1111847,297,1.00
ptg017170l,632880,633193,313,RepeatMasker,LTR,632718,633338,313,1.00
ptg017179l,884188,884483,295,RepeatMasker,LTR,884023,884535,295,1.00
ptg017200l,478838,479131,293,RepeatMasker,LTR,477588,478932,94,0.32
ptg017200l,478838,479131,293,RepeatMasker,LTR,479070,479261,62,0.21
ptg017218l,1091883,1092173,290,RepeatMasker,LTR,1091122,1094367,290,1.00
ptg017223l,417904,418192,288,RepeatMasker,LTR,417726,418244,288,1.00
ptg017225l,115824,116105,281,RepeatMasker,LTR,115435,116751,281,1.00
ptg017234l,743688,744011,323,RepeatMasker,LTR,743653,743876,188,0.58
ptg017234l,743688,744011,323,RepeatMasker,LTR,743656,743974,286,0.89
ptg017234l,743688,744011,323,RepeatMasker,LTR,743824,744167,188,0.58
ptg017234l,1232152,1232451,299,RepeatMasker,LTR,1232132,1232503,299,1.00
ptg017234l,1446680,1446979,299,RepeatMasker,LTR,1446708,1447031,272,0.91
ptg017234l,1522283,1522579,296,RepeatMasker,LTR,1522260,1522613,296,1.00
ptg017234l,1558944,1559244,300,RepeatMasker,LTR,1558946,1559278,299,1.00
ptg017273l,393398,393679,281,RepeatMasker,LTR,393016,394323,281,1.00
ptg017273l,493160,493449,289,RepeatMasker,LTR,492787,494252,289,1.00
ptg017274l,1200620,1200927,307,RepeatMasker,LTR,1200237,1200940,307,1.00
ptg017291l,270573,270857,284,RepeatMasker,LTR,267162,270844,271,0.95
ptg017291l,270573,270857,284,RepeatMasker,LTR,270519,271177,284,1.00
ptg017296l,731003,731311,308,RepeatMasker,LTR,730777,731045,42,0.14
ptg017300l,2023461,2023786,325,RepeatMasker,LTR,2022734,2026510,325,1.00
ptg017304l,50801,51103,302,RepeatMasker,LTR,50825,51249,279,0.92
ptg017308l,838795,839075,280,RepeatMasker,LTR,834369,840688,280,1.00
ptg017313l,995901,996181,280,RepeatMasker,LTR,995519,996208,280,1.00
ptg017313l,995901,996181,280,RepeatMasker,LTR,995590,996193,280,1.00
ptg017313l,1003555,1003849,294,RepeatMasker,LTR,1003176,1003876,294,1.00
ptg017313l,1003555,1003849,294,RepeatMasker,LTR,1003247,1003861,294,1.00
ptg017313l,1028322,1028602,280,RepeatMasker,LTR,1027934,1028614,280,1.00
ptg017345l,100753,101044,291,RepeatMasker,LTR,100819,101192,226,0.78
ptg017364l,256548,256848,300,RepeatMasker,LTR,256468,256899,300,1.00
ptg017364l,1644867,1645166,299,RepeatMasker,LTR,1644675,1645218,299,1.00
ptg017389l,78993,79328,335,RepeatMasker,LTR,78997,79069,73,0.22
ptg017392l,520562,520858,296,RepeatMasker,LTR,520817,520856,40,0.14
ptg017433l,561047,561345,298,RepeatMasker,LTR,560145,561089,42,0.14
ptg017434l,432680,432999,319,RepeatMasker,LTR,430446,432731,51,0.16
ptg017458l,375313,375626,313,RepeatMasker,LTR,375161,375908,313,1.00
ptg017471l,1165180,1165461,281,RepeatMasker,LTR,1164788,1165494,281,1.00
ptg017475l,839964,840259,295,RepeatMasker,LTR,839754,840293,295,1.00
ptg017489l,233249,233529,280,RepeatMasker,LTR,232841,234330,280,1.00
ptg017489l,915459,915737,278,RepeatMasker,LTR,914398,915560,101,0.36
ptg017510l,110358,110638,280,RepeatMasker,LTR,110056,111287,280,1.00
ptg017527l,8541,8840,299,RepeatMasker,LTR,8376,8892,299,1.00
ptg017531l,613136,613420,284,RepeatMasker,LTR,613313,615432,108,0.38
ptg017536l,45562,45861,299,RepeatMasker,LTR,45355,45913,299,1.00
ptg017541l,122649,122933,284,RepeatMasker,LTR,120083,124282,284,1.00
ptg017551l,452256,452536,280,RepeatMasker,LTR,451874,453186,280,1.00
ptg017563l,927362,927658,296,RepeatMasker,LTR,927339,927692,296,1.00
ptg017576l,1772562,1772844,282,RepeatMasker,LTR,1769780,1773465,282,1.00
ptg017576l,1953384,1953699,315,RepeatMasker,LTR,1951944,1954388,315,1.00
ptg017591l,483999,484301,302,RepeatMasker,LTR,483245,484511,302,1.00
ptg017591l,483999,484301,302,RepeatMasker,LTR,484169,485539,133,0.44
ptg017595l,831110,831409,299,RepeatMasker,LTR,831090,831461,299,1.00
ptg017603l,336555,336863,308,RepeatMasker,LTR,334443,336908,308,1.00
ptg017610l,197124,197408,284,RepeatMasker,LTR,197103,197147,23,0.08
ptg017614l,496058,496338,280,RepeatMasker,LTR,495739,496987,280,1.00
ptg017618l,88505,88786,281,RepeatMasker,LTR,88123,89590,281,1.00
ptg017628l,3359698,3359992,294,RepeatMasker,LTR,3358563,3360005,294,1.00
ptg017628l,3684918,3685226,308,RepeatMasker,LTR,3684535,3686020,308,1.00
ptg017634l,693774,694091,317,RepeatMasker,LTR,693430,693912,138,0.44
ptg017634l,693774,694091,317,RepeatMasker,LTR,693913,694088,176,0.56
ptg017634l,693774,694091,317,RepeatMasker,LTR,694089,694421,3,0.01
ptg017661l,491797,492105,308,RepeatMasker,LTR,491743,492931,308,1.00
ptg017665l,677540,677836,296,RepeatMasker,LTR,677347,677888,296,1.00
ptg017673l,327193,327508,315,RepeatMasker,LTR,326556,327521,315,1.00
ptg017677l,357012,357293,281,RepeatMasker,LTR,356630,357326,281,1.00
ptg017703l,1154795,1155112,317,RepeatMasker,LTR,1151213,1154846,51,0.16
ptg017704l,484168,484482,314,RepeatMasker,LTR,483896,484868,314,1.00
ptg017704l,484168,484482,314,RepeatMasker,LTR,483916,484699,314,1.00
ptg017708l,106452,106765,313,RepeatMasker,LTR,106546,106670,125,0.40
ptg017708l,106452,106765,313,RepeatMasker,LTR,106671,109583,95,0.30
ptg017709l,22704,23011,307,RepeatMasker,LTR,21876,23534,307,1.00
ptg017730l,260145,260433,288,RepeatMasker,LTR,258997,261069,288,1.00
ptg017732l,83108,83388,280,RepeatMasker,LTR,82805,84018,280,1.00
ptg017747l,122730,123018,288,RepeatMasker,LTR,121287,122756,26,0.09
ptg017747l,122730,123018,288,RepeatMasker,LTR,122755,123706,264,0.92
ptg017771l,620529,620809,280,RepeatMasker,LTR,619482,621586,280,1.00
ptg017771l,2673112,2673410,298,RepeatMasker,LTR,2672077,2673423,298,1.00
ptg017771l,2680322,2680603,281,RepeatMasker,LTR,2679180,2680616,281,1.00
ptg017785l,1605197,1605501,304,RepeatMasker,LTR,1605376,1606556,126,0.41
ptg017798l,23882,24160,278,RepeatMasker,LTR,23572,24951,278,1.00
ptg017811l,443335,443623,288,RepeatMasker,LTR,443360,451614,264,0.92
ptg017825l,58271,58571,300,RepeatMasker,LTR,57941,58344,73,0.24
ptg017825l,149944,150243,299,RepeatMasker,LTR,149903,150295,299,1.00
ptg017826l,1534598,1534869,271,RepeatMasker,LTR,1532042,1534635,37,0.14
ptg017862l,470774,471054,280,RepeatMasker,LTR,470366,471688,280,1.00
ptg017870l,725454,725752,298,RepeatMasker,LTR,724744,726893,298,1.00
ptg017870l,725834,726114,280,RepeatMasker,LTR,724744,726893,280,1.00
ptg017880l,489260,489544,284,RepeatMasker,LTR,489155,489280,20,0.07
ptg017888l,274092,274383,291,RepeatMasker,LTR,273922,274665,291,1.00
ptg017889l,139354,139651,297,RepeatMasker,LTR,139014,139626,272,0.92
ptg017889l,7058140,7058423,283,RepeatMasker,LTR,7057962,7058475,283,1.00
ptg017898l,1362400,1362702,302,RepeatMasker,LTR,1362000,1362716,302,1.00
ptg017898l,4277949,4278236,287,RepeatMasker,LTR,4276379,4279135,287,1.00
ptg017901l,157209,157520,311,RepeatMasker,LTR,156832,157532,311,1.00
ptg017912l,171848,172139,291,RepeatMasker,LTR,171817,172082,234,0.80
ptg017928l,369427,369704,277,RepeatMasker,LTR,368378,370486,277,1.00
ptg017928l,580051,580350,299,RepeatMasker,LTR,579861,580402,299,1.00
ptg017946l,1518397,1518696,299,RepeatMasker,LTR,1518317,1518748,299,1.00
ptg017951l,150540,150827,287,RepeatMasker,LTR,146611,151682,287,1.00
ptg017953l,343133,343439,306,RepeatMasker,LTR,343425,343736,15,0.05
ptg017953l,1601964,1602229,265,RepeatMasker,LTR,1601992,1602141,150,0.57
ptg017959l,689695,689985,290,RepeatMasker,LTR,689239,690550,290,1.00
ptg017959l,855886,856193,307,RepeatMasker,LTR,855606,856554,307,1.00
ptg017982l,30748,31029,281,RepeatMasker,LTR,30355,31827,281,1.00
ptg017985l,94293,94573,280,RepeatMasker,LTR,93910,95377,280,1.00
ptg018003l,968830,969140,310,RepeatMasker,LTR,967773,969923,310,1.00
ptg018007l,78408,78705,297,RepeatMasker,LTR,78210,78728,297,1.00
ptg018007l,301746,302034,288,RepeatMasker,LTR,300843,302036,288,1.00
ptg018008l,693900,694188,288,RepeatMasker,LTR,693826,693946,46,0.16
ptg018008l,693900,694188,288,RepeatMasker,LTR,694008,694273,181,0.63
ptg018008l,693900,694188,288,RepeatMasker,LTR,694036,694338,153,0.53
ptg018008l,693900,694188,288,RepeatMasker,LTR,694046,694485,143,0.50
ptg018059l,393355,393661,306,RepeatMasker,LTR,393545,393686,117,0.38
ptg018066l,1879787,1880107,320,RepeatMasker,LTR,1880057,1880553,51,0.16
ptg018083l,399322,399602,280,RepeatMasker,LTR,398528,400380,280,1.00
ptg018101l,314315,314629,314,RepeatMasker,LTR,313728,314622,307,0.98
ptg018108l,26211,26490,279,RepeatMasker,LTR,25829,27291,279,1.00
ptg018147l,375919,376218,299,RepeatMasker,LTR,375012,377800,299,1.00
ptg018153l,237574,237873,299,RepeatMasker,LTR,237396,237925,299,1.00
ptg018153l,594293,594589,296,RepeatMasker,LTR,594213,594641,296,1.00
ptg018153l,695323,695622,299,RepeatMasker,LTR,695115,695674,299,1.00
ptg018158l,372301,372599,298,RepeatMasker,LTR,372590,372888,10,0.03
ptg018158l,466469,466766,297,RepeatMasker,LTR,466261,466818,297,1.00
ptg018170l,196177,196490,313,RepeatMasker,LTR,196238,197312,253,0.81
ptg018199l,80472,80775,303,RepeatMasker,LTR,80681,81955,95,0.31
ptg018206l,260825,261110,285,RepeatMasker,LTR,261097,261282,14,0.05
ptg018206l,260825,261110,285,RepeatMasker,LTR,261097,261520,14,0.05
ptg018213l,159304,159617,313,RepeatMasker,LTR,155484,160453,313,1.00
ptg018219l,633640,633976,336,RepeatMasker,LTR,633434,633654,14,0.04
ptg018227l,1341343,1341639,296,RepeatMasker,LTR,1341302,1341691,296,1.00
ptg018228l,35544,35831,287,RepeatMasker,LTR,34640,35590,46,0.16
ptg018243l,429468,429774,306,RepeatMasker,LTR,422882,432345,306,1.00
ptg018243l,963836,964145,309,RepeatMasker,LTR,963251,964341,309,1.00
ptg018252l,1425072,1425352,280,RepeatMasker,LTR,1424008,1426135,280,1.00
ptg018270l,4225778,4226077,299,RepeatMasker,LTR,4225698,4226129,299,1.00
ptg018275l,422930,423228,298,RepeatMasker,LTR,422740,423280,298,1.00
ptg018281l,372511,372814,303,RepeatMasker,LTR,372077,372601,90,0.30
ptg018281l,372511,372814,303,RepeatMasker,LTR,372596,377620,219,0.72
ptg018300l,363437,363718,281,RepeatMasker,LTR,362390,364494,281,1.00
ptg018300l,372841,373122,281,RepeatMasker,LTR,371657,373757,281,1.00
ptg018300l,471070,471350,280,RepeatMasker,LTR,470332,472000,280,1.00
ptg018327l,417828,418109,281,RepeatMasker,LTR,417752,418758,281,1.00
ptg018333l,579790,580070,280,RepeatMasker,LTR,579467,580100,280,1.00
ptg018338l,6412,6700,288,RepeatMasker,LTR,5504,9120,288,1.00
ptg018378l,719500,719751,251,RepeatMasker,LTR,719423,719949,251,1.00
ptg018390l,316528,316852,324,RepeatMasker,LTR,316481,316708,180,0.56
ptg018402l,225670,225979,309,RepeatMasker,LTR,225914,226012,66,0.21
ptg018412l,526014,526317,303,RepeatMasker,LTR,526052,527192,266,0.88
ptg018430l,213909,214208,299,RepeatMasker,LTR,213829,214242,299,1.00
ptg018431l,214866,215150,284,RepeatMasker,LTR,215143,215370,8,0.03
ptg018436l,6469352,6469669,317,RepeatMasker,LTR,6467910,6471045,317,1.00
ptg018437l,96137,96417,280,RepeatMasker,LTR,95753,97218,280,1.00
ptg018437l,112950,113229,279,RepeatMasker,LTR,112567,113874,279,1.00
ptg018437l,152880,153157,277,RepeatMasker,LTR,152464,153169,277,1.00
ptg018445l,533127,533408,281,RepeatMasker,LTR,532741,533421,281,1.00
ptg018459l,793504,793785,281,RepeatMasker,LTR,793201,793818,281,1.00
ptg018471l,1283488,1283769,281,RepeatMasker,LTR,1282434,1284552,281,1.00
ptg018471l,1726187,1726496,309,RepeatMasker,LTR,1726466,1728651,31,0.10
ptg018478l,563937,564237,300,RepeatMasker,LTR,563975,565117,263,0.88
ptg018488l,152919,153198,279,RepeatMasker,LTR,152810,153071,152,0.54
ptg018488l,390467,390767,300,RepeatMasker,LTR,390717,394200,51,0.17
ptg018510l,30807,31088,281,RepeatMasker,LTR,30425,31878,281,1.00
ptg018520l,127314,127614,300,RepeatMasker,LTR,127027,127425,111,0.37
ptg018520l,127314,127614,300,RepeatMasker,LTR,127422,127826,193,0.64
ptg018520l,127314,127614,300,RepeatMasker,LTR,127535,127826,80,0.27
ptg018520l,653395,653721,326,RepeatMasker,LTR,653093,656716,326,1.00
ptg018521l,967382,967696,314,RepeatMasker,LTR,967356,967469,87,0.28
ptg018521l,967382,967696,314,RepeatMasker,LTR,967668,971291,29,0.09
ptg018529l,124027,124326,299,RepeatMasker,LTR,124007,124360,299,1.00
ptg018529l,223306,223599,293,RepeatMasker,LTR,223228,223651,293,1.00
ptg018549l,74515,74795,280,RepeatMasker,LTR,73462,74808,280,1.00
ptg018559l,1102098,1102384,286,RepeatMasker,LTR,1100528,1103236,286,1.00
ptg018559l,1729868,1730158,290,RepeatMasker,LTR,1728846,1730801,290,1.00
ptg018561l,39171,39469,298,RepeatMasker,LTR,38814,40138,298,1.00
ptg018571l,528409,528726,317,RepeatMasker,LTR,528564,529835,163,0.51
ptg018580l,2312499,2312803,304,RepeatMasker,LTR,2312272,2313734,304,1.00
ptg018590l,258480,258776,296,RepeatMasker,LTR,258460,258810,296,1.00
ptg018592l,484973,485276,303,RepeatMasker,LTR,484952,484996,23,0.08
ptg018607l,223867,224188,321,RepeatMasker,LTR,223801,224709,321,1.00
ptg018616l,129482,129792,310,RepeatMasker,LTR,128370,129500,18,0.06
ptg018616l,129482,129792,310,RepeatMasker,LTR,129779,132461,14,0.05
ptg018620l,225980,226262,282,RepeatMasker,LTR,225336,226649,282,1.00
ptg018620l,225980,226262,282,RepeatMasker,LTR,225922,228156,282,1.00
ptg018632l,763106,763400,294,RepeatMasker,LTR,762701,764034,294,1.00
ptg018642l,123073,123384,311,RepeatMasker,LTR,123104,123153,50,0.16
ptg018655l,675629,675933,304,RepeatMasker,LTR,675883,678474,51,0.17
ptg018664l,238305,238588,283,RepeatMasker,LTR,237926,239228,283,1.00
ptg018666l,788598,788879,281,RepeatMasker,LTR,788216,789513,281,1.00
ptg018668l,277943,278238,295,RepeatMasker,LTR,277863,278285,295,1.00
ptg018670l,563996,564296,300,RepeatMasker,LTR,563797,564348,300,1.00
ptg018680l,456934,457215,281,RepeatMasker,LTR,455886,457228,281,1.00
ptg018696l,597828,598127,299,RepeatMasker,LTR,597105,597851,23,0.08
ptg018736l,597646,597952,306,RepeatMasker,LTR,597143,598380,306,1.00
ptg018743l,139721,140004,283,RepeatMasker,LTR,139418,140835,283,1.00
ptg018769l,452417,452716,299,RepeatMasker,LTR,452337,452768,299,1.00
ptg018773l,53969,54249,280,RepeatMasker,LTR,53430,55047,280,1.00
ptg018778l,257378,257671,293,RepeatMasker,LTR,254817,257406,28,0.10
ptg018795l,252887,253136,249,RepeatMasker,LTR,248681,258195,249,1.00
ptg018798l,178643,178916,273,RepeatMasker,LTR,178878,182370,39,0.14
ptg018805l,133019,133340,321,RepeatMasker,LTR,130852,133864,321,1.00
ptg018828l,1159315,1159592,277,RepeatMasker,LTR,1158265,1160375,277,1.00
ptg018845l,194808,195105,297,RepeatMasker,LTR,194785,195139,297,1.00
ptg018845l,290573,290870,297,RepeatMasker,LTR,290493,290922,297,1.00
ptg018845l,391443,391740,297,RepeatMasker,LTR,391363,391792,297,1.00
ptg018857l,1583538,1583863,325,RepeatMasker,LTR,1582628,1583983,325,1.00
ptg018870l,1251234,1251534,300,RepeatMasker,LTR,1251106,1252061,300,1.00
ptg018871l,328964,329256,292,RepeatMasker,LTR,329239,330478,18,0.06
ptg018872l,69313,69610,297,RepeatMasker,LTR,69288,70567,297,1.00
ptg018882l,273800,274096,296,RepeatMasker,LTR,273434,274546,296,1.00
ptg018891l,4715562,4715868,306,RepeatMasker,LTR,4715757,4715847,91,0.30
ptg018891l,4715562,4715868,306,RepeatMasker,LTR,4715782,4715847,66,0.22
ptg018903l,390635,390916,281,RepeatMasker,LTR,390230,391538,281,1.00
ptg018904l,1005260,1005566,306,RepeatMasker,LTR,1005146,1005363,103,0.34
ptg018922l,754166,754453,287,RepeatMasker,LTR,749481,755309,287,1.00
ptg018928l,498287,498587,300,RepeatMasker,LTR,497893,499381,300,1.00
ptg018928l,515252,515566,314,RepeatMasker,LTR,514904,516206,314,1.00
ptg018937l,208340,208626,286,RepeatMasker,LTR,207942,214760,286,1.00
ptg018937l,901866,902165,299,RepeatMasker,LTR,901786,902217,299,1.00
ptg018955l,56301,56582,281,RepeatMasker,LTR,55249,57366,281,1.00
ptg018957l,1290774,1291072,298,RepeatMasker,LTR,1290409,1291716,298,1.00
ptg018967l,667915,668207,292,RepeatMasker,LTR,667609,667937,22,0.08
ptg018971l,224230,224513,283,RepeatMasker,LTR,224199,224253,23,0.08
ptg018998l,761544,761843,299,RepeatMasker,LTR,761464,761895,299,1.00
ptg019023l,324493,324774,281,RepeatMasker,LTR,324101,324807,281,1.00
ptg019039l,189320,189604,284,RepeatMasker,LTR,189246,189348,28,0.10
ptg019061l,143314,143591,277,RepeatMasker,LTR,143293,143337,23,0.08
ptg019061l,193826,194154,328,RepeatMasker,LTR,193373,193933,107,0.33
ptg019061l,193826,194154,328,RepeatMasker,LTR,194126,197677,29,0.09
ptg019090l,304182,304480,298,RepeatMasker,LTR,303982,304532,298,1.00
ptg019092l,51003,51302,299,RepeatMasker,LTR,51276,51324,27,0.09
ptg019092l,51003,51302,299,RepeatMasker,LTR,51288,51354,15,0.05
ptg019095l,211572,211878,306,RepeatMasker,LTR,211253,211744,172,0.56
ptg019095l,211572,211878,306,RepeatMasker,LTR,211655,217705,224,0.73
ptg019120l,3471,3763,292,RepeatMasker,LTR,3263,3815,292,1.00
ptg019131l,410349,410668,319,RepeatMasker,LTR,410103,410550,201,0.63
ptg019131l,941608,941941,333,RepeatMasker,LTR,941779,943044,163,0.49
ptg019131l,941608,941941,333,RepeatMasker,LTR,941779,943476,163,0.49
ptg019180l,1726997,1727295,298,RepeatMasker,LTR,1723104,1728016,298,1.00
ptg019197l,927154,927473,319,RepeatMasker,LTR,927423,927722,51,0.16
ptg019204l,242094,242376,282,RepeatMasker,LTR,242036,244260,282,1.00
ptg019216l,74326,74621,295,RepeatMasker,LTR,74140,74673,295,1.00
ptg019225l,54475,54790,315,RepeatMasker,LTR,49906,55691,315,1.00
ptg019229l,153034,153359,325,RepeatMasker,LTR,153331,154319,29,0.09
ptg019255l,271318,271600,282,RepeatMasker,LTR,270940,272240,282,1.00
ptg019257l,40484,40782,298,RepeatMasker,LTR,40404,40834,298,1.00
ptg019263l,611802,612115,313,RepeatMasker,LTR,610187,611961,159,0.51
ptg019263l,611802,612115,313,RepeatMasker,LTR,610609,613405,313,1.00
ptg019263l,1012654,1012954,300,RepeatMasker,LTR,1012434,1013006,300,1.00
ptg019265l,763172,763455,283,RepeatMasker,LTR,760794,763373,201,0.71
ptg019265l,763172,763455,283,RepeatMasker,LTR,763370,763844,86,0.30
ptg019277l,368318,368617,299,RepeatMasker,LTR,368140,368669,299,1.00
ptg019277l,1202166,1202450,284,RepeatMasker,LTR,1198717,1203305,284,1.00
ptg019277l,1644514,1644795,281,RepeatMasker,LTR,1644105,1645440,281,1.00
ptg019288l,2237107,2237406,299,RepeatMasker,LTR,2236901,2237458,299,1.00
ptg019288l,2643589,2643888,299,RepeatMasker,LTR,2643548,2643940,299,1.00
ptg019288l,2648931,2649220,289,RepeatMasker,LTR,2648729,2649273,289,1.00
ptg019288l,2834877,2835176,299,RepeatMasker,LTR,2834836,2835228,299,1.00
ptg019297l,147780,148094,314,RepeatMasker,LTR,148066,148153,29,0.09
ptg019297l,147780,148094,314,RepeatMasker,LTR,147304,147867,87,0.28
ptg019300l,1850121,1850407,286,RepeatMasker,LTR,1849790,1850550,286,1.00
ptg019300l,1850121,1850407,286,RepeatMasker,LTR,1849875,1851982,286,1.00
ptg019303l,223477,223776,299,RepeatMasker,LTR,223299,223828,299,1.00
ptg019303l,958613,958895,282,RepeatMasker,LTR,958236,959689,282,1.00
ptg019303l,970895,971177,282,RepeatMasker,LTR,970521,971820,282,1.00
ptg019316l,409520,409828,308,RepeatMasker,LTR,409671,410941,158,0.51
ptg019316l,409520,409828,308,RepeatMasker,LTR,409374,409671,151,0.49
ptg019316l,1140883,1141178,295,RepeatMasker,LTR,1140515,1141839,295,1.00
ptg019326l,414271,414552,281,RepeatMasker,LTR,413889,415347,281,1.00
ptg019326l,422116,422396,280,RepeatMasker,LTR,421726,423039,280,1.00
ptg019327l,107938,108245,307,RepeatMasker,LTR,105647,111277,307,1.00
ptg019343l,792912,793192,280,RepeatMasker,LTR,792896,793220,280,1.00
ptg019344l,79115,79419,304,RepeatMasker,LTR,78116,79934,304,1.00
ptg019344l,417474,417770,296,RepeatMasker,LTR,417674,419194,97,0.33
ptg019347l,213778,214064,286,RepeatMasker,LTR,214012,214921,53,0.19
ptg019347l,474311,474610,299,RepeatMasker,LTR,473652,475631,299,1.00
ptg019372l,273304,273584,280,RepeatMasker,LTR,272913,274376,280,1.00
ptg019373l,6564,6863,299,RepeatMasker,LTR,6388,6915,299,1.00
ptg019388l,326316,326633,317,RepeatMasker,LTR,326207,326367,51,0.16
ptg019388l,792581,792887,306,RepeatMasker,LTR,792135,794551,306,1.00
ptg019401l,158547,158846,299,RepeatMasker,LTR,158467,158898,299,1.00
ptg019401l,1253805,1254104,299,RepeatMasker,LTR,1253725,1254156,299,1.00
ptg019440l,254285,254589,304,RepeatMasker,LTR,254580,254811,10,0.03
ptg019449l,232640,232934,294,RepeatMasker,LTR,232917,232965,18,0.06
ptg019451l,133824,134148,324,RepeatMasker,LTR,133338,134124,300,0.93
ptg019455l,24338,24639,301,RepeatMasker,LTR,18855,24339,1,0.00
ptg019455l,104372,104669,297,RepeatMasker,LTR,104292,104716,297,1.00
ptg019459l,9059,9356,297,RepeatMasker,LTR,9038,9082,23,0.08
ptg019483l,649657,649949,292,RepeatMasker,LTR,649596,650010,292,1.00
ptg019483l,1664679,1664978,299,RepeatMasker,LTR,1664618,1668573,299,1.00
ptg019492l,502251,502555,304,RepeatMasker,LTR,500597,507661,304,1.00
ptg019541l,3124310,3124609,299,RepeatMasker,LTR,3124132,3124656,299,1.00
ptg019553l,38688,38983,295,RepeatMasker,LTR,38621,38741,53,0.18
ptg019592l,613808,614088,280,RepeatMasker,LTR,613497,614736,280,1.00
ptg019599l,143079,143375,296,RepeatMasker,LTR,143320,143870,56,0.19
ptg019603l,939103,939432,329,RepeatMasker,LTR,939262,940526,171,0.52
ptg019615l,139076,139381,305,RepeatMasker,LTR,137005,139985,305,1.00
ptg019615l,139076,139381,305,RepeatMasker,LTR,137008,140549,305,1.00
ptg019617l,391568,391868,300,RepeatMasker,LTR,391196,391856,288,0.96
ptg019617l,391568,391868,300,RepeatMasker,LTR,391277,392311,300,1.00
ptg019619l,154108,154404,296,RepeatMasker,LTR,153300,155181,296,1.00
ptg019619l,161293,161573,280,RepeatMasker,LTR,160160,162213,280,1.00
ptg019622l,578069,578397,328,RepeatMasker,LTR,577027,578089,20,0.06
ptg019622l,578069,578397,328,RepeatMasker,LTR,578085,579179,313,0.95
ptg019646l,589590,589887,297,RepeatMasker,LTR,586640,589880,290,0.98
ptg019657l,117548,117829,281,RepeatMasker,LTR,117166,117863,281,1.00
ptg019667l,171383,171693,310,RepeatMasker,LTR,171353,171491,108,0.35
ptg019669l,533003,533292,289,RepeatMasker,LTR,532982,533026,23,0.08
ptg019698l,678345,678625,280,RepeatMasker,LTR,677963,679269,280,1.00
ptg019716l,668957,669252,295,RepeatMasker,LTR,668889,669203,246,0.83
ptg019716l,668957,669252,295,RepeatMasker,LTR,669214,669475,39,0.13
ptg019719l,461106,461426,320,RepeatMasker,LTR,461376,462716,51,0.16
ptg019727l,327262,327543,281,RepeatMasker,LTR,326217,328335,281,1.00
ptg019732l,1218927,1219251,324,RepeatMasker,LTR,1218463,1219393,324,1.00
ptg019736l,107185,107484,299,RepeatMasker,LTR,107165,107518,299,1.00
ptg019741l,205253,205559,306,RepeatMasker,LTR,203060,205462,209,0.68
ptg019742l,405007,405300,293,RepeatMasker,LTR,404814,405352,293,1.00
ptg019763l,631808,632092,284,RepeatMasker,LTR,631430,632737,284,1.00
ptg019788l,271227,271544,317,RepeatMasker,LTR,269189,272204,317,1.00
ptg019790l,365034,365345,311,RepeatMasker,LTR,363522,366180,311,1.00
ptg019793l,167908,168205,297,RepeatMasker,LTR,167615,168852,297,1.00
ptg019793l,514204,514484,280,RepeatMasker,LTR,513823,514496,280,1.00
ptg019805l,90414,90694,280,RepeatMasker,LTR,90017,90724,280,1.00
ptg019810l,1880693,1880988,295,RepeatMasker,LTR,1880500,1881040,295,1.00
ptg019825l,132858,133148,290,RepeatMasker,LTR,132486,133155,290,1.00
ptg019838l,219752,220032,280,RepeatMasker,LTR,218705,220815,280,1.00
ptg019839l,240453,240759,306,RepeatMasker,LTR,233832,243333,306,1.00
ptg019863l,123305,123604,299,RepeatMasker,LTR,123139,123646,299,1.00
ptg019865l,666348,666646,298,RepeatMasker,LTR,666170,666698,298,1.00
ptg019879l,406433,406732,299,RepeatMasker,LTR,406255,406784,299,1.00
ptg019879l,467602,467901,299,RepeatMasker,LTR,467443,467953,299,1.00
ptg019881l,329148,329432,284,RepeatMasker,LTR,328060,330073,284,1.00
ptg019884l,1067490,1067799,309,RepeatMasker,LTR,1067769,1070467,31,0.10
ptg019885l,459529,459841,312,RepeatMasker,LTR,459533,459912,309,0.99
ptg019900l,1016653,1016974,321,RepeatMasker,LTR,1016895,1016942,48,0.15
ptg019900l,1016653,1016974,321,RepeatMasker,LTR,1016973,1017013,2,0.01
ptg019911l,66155,66297,142,RepeatMasker,LTR,66132,66209,54,0.38
ptg019922l,167990,168280,290,RepeatMasker,LTR,167917,168173,183,0.63
ptg019922l,167990,168280,290,RepeatMasker,LTR,168176,171593,105,0.36
ptg019945l,53006,53300,294,RepeatMasker,LTR,53256,53609,45,0.15
ptg019947l,412647,412927,280,RepeatMasker,LTR,411583,412941,280,1.00
ptg019954l,632922,633203,281,RepeatMasker,LTR,631784,633236,281,1.00
ptg019962l,940827,941114,287,RepeatMasker,LTR,939066,941954,287,1.00
ptg019987l,1343855,1344147,292,RepeatMasker,LTR,1343489,1346981,292,1.00
ptg020005l,314825,315139,314,RepeatMasker,LTR,314598,318050,314,1.00
ptg020010l,34967,35270,303,RepeatMasker,LTR,35167,35225,59,0.19
ptg020035l,214625,214941,316,RepeatMasker,LTR,214422,214814,189,0.60
ptg020040l,34496,34794,298,RepeatMasker,LTR,34341,34846,298,1.00
ptg020040l,439601,439900,299,RepeatMasker,LTR,439581,439934,299,1.00
ptg020043l,444663,444943,280,RepeatMasker,LTR,444268,445580,280,1.00
ptg020051l,52214,52534,320,RepeatMasker,LTR,52484,52734,51,0.16
ptg020078l,958130,958411,281,RepeatMasker,LTR,957748,958423,281,1.00
ptg020092l,781896,782217,321,RepeatMasker,LTR,781294,783372,321,1.00
ptg020092l,1450165,1450452,287,RepeatMasker,LTR,1448768,1451306,287,1.00
ptg020097l,905099,905408,309,RepeatMasker,LTR,904705,905441,309,1.00
ptg020097l,905099,905408,309,RepeatMasker,LTR,905112,906215,297,0.96
ptg020097l,912231,912512,281,RepeatMasker,LTR,911860,913157,281,1.00
ptg020106l,1036769,1037055,286,RepeatMasker,LTR,1036371,1041491,286,1.00
ptg020110l,18878,19190,312,RepeatMasker,LTR,17996,18916,38,0.12
ptg020123l,1028334,1028614,280,RepeatMasker,LTR,1028319,1029246,280,1.00
ptg020152l,3729,4031,302,RepeatMasker,LTR,3006,3752,23,0.08
ptg020161l,740000,740281,281,RepeatMasker,LTR,739681,740923,281,1.00
ptg020163l,43607,43887,280,RepeatMasker,LTR,42559,43900,280,1.00
ptg020163l,484896,485227,331,RepeatMasker,LTR,485140,485307,88,0.27
ptg020164l,235386,235679,293,RepeatMasker,LTR,235005,236469,293,1.00
ptg020165l,700498,700828,330,RepeatMasker,LTR,699636,702098,330,1.00
ptg020168l,726019,726314,295,RepeatMasker,LTR,725812,726366,295,1.00
ptg020171l,864304,864609,305,RepeatMasker,LTR,863932,865254,305,1.00
ptg020179l,154110,154430,320,RepeatMasker,LTR,154380,154892,51,0.16
ptg020179l,169715,170035,320,RepeatMasker,LTR,169986,172469,50,0.16
ptg020217l,415774,416102,328,RepeatMasker,LTR,415890,416016,127,0.39
ptg020226l,363839,364135,296,RepeatMasker,LTR,363861,364287,275,0.93
ptg020261l,474614,474909,295,RepeatMasker,LTR,474374,474905,291,0.99
ptg020261l,474614,474909,295,RepeatMasker,LTR,474657,475063,253,0.86
ptg020278l,541365,541657,292,RepeatMasker,LTR,541023,544489,292,1.00
ptg020281l,220766,221052,286,RepeatMasker,LTR,216051,221889,286,1.00
ptg020345l,185895,186176,281,RepeatMasker,LTR,185493,186850,281,1.00
ptg020364l,431038,431329,291,RepeatMasker,LTR,430721,432604,291,1.00
ptg020367l,263276,263577,301,RepeatMasker,LTR,260929,268437,301,1.00
ptg020367l,417994,418274,280,RepeatMasker,LTR,417612,419064,280,1.00
ptg020367l,630775,631087,312,RepeatMasker,LTR,630945,631083,139,0.45
ptg020378l,492555,492841,286,RepeatMasker,LTR,492534,492578,23,0.08
ptg020397l,579292,579590,298,RepeatMasker,LTR,579086,579642,298,1.00
ptg020397l,708262,708561,299,RepeatMasker,LTR,708056,708608,299,1.00
ptg020424l,74641,74924,283,RepeatMasker,LTR,73595,74958,283,1.00
ptg020428l,35177,35459,282,RepeatMasker,LTR,34797,35481,282,1.00
ptg020428l,35177,35459,282,RepeatMasker,LTR,34868,35472,282,1.00
ptg020443l,104656,104936,280,RepeatMasker,LTR,103603,104949,280,1.00
ptg020445l,282512,282805,293,RepeatMasker,LTR,282614,283154,192,0.66
ptg020471l,2443511,2443811,300,RepeatMasker,LTR,2443800,2444970,12,0.04
ptg020501l,308206,308534,328,RepeatMasker,LTR,308028,308451,245,0.75
ptg020515l,566031,566335,304,RepeatMasker,LTR,566173,566673,163,0.54
ptg020518l,148528,148829,301,RepeatMasker,LTR,148748,149266,82,0.27
ptg020547l,715756,716041,285,RepeatMasker,LTR,714567,716857,285,1.00
ptg020550l,239140,239470,330,RepeatMasker,LTR,238031,242497,330,1.00
ptg020550l,778002,778320,318,RepeatMasker,LTR,778068,778139,72,0.23
ptg020560l,280341,280621,280,RepeatMasker,LTR,279938,281448,280,1.00
ptg020560l,420523,420832,309,RepeatMasker,LTR,419774,421050,309,1.00
ptg020569l,25698,25994,296,RepeatMasker,LTR,25475,26046,296,1.00
ptg020569l,233093,233393,300,RepeatMasker,LTR,232890,233445,300,1.00
ptg020579l,230663,230986,323,RepeatMasker,LTR,230806,233006,181,0.56
ptg020579l,2475811,2476108,297,RepeatMasker,LTR,2475764,2476154,297,1.00
ptg020588l,415423,415714,291,RepeatMasker,LTR,415692,415739,23,0.08
ptg020588l,824754,825067,313,RepeatMasker,LTR,820255,825904,313,1.00
ptg020595l,8508,8820,312,RepeatMasker,LTR,8527,8596,70,0.22
ptg020602l,654229,654515,286,RepeatMasker,LTR,653831,659140,286,1.00
ptg020604l,266039,266338,299,RepeatMasker,LTR,266196,270145,143,0.48
ptg020605l,238995,239313,318,RepeatMasker,LTR,237721,241758,318,1.00
ptg020652l,561864,562162,298,RepeatMasker,LTR,560955,564050,298,1.00
ptg020652l,561864,562162,298,RepeatMasker,LTR,562051,564569,112,0.38
ptg020656l,552841,553122,281,RepeatMasker,LTR,552446,553154,281,1.00
ptg020683l,735187,735443,256,RepeatMasker,LTR,735362,736901,82,0.32
ptg020686l,338834,339121,287,RepeatMasker,LTR,337264,339912,287,1.00
ptg020694l,1110482,1110788,306,RepeatMasker,LTR,1109413,1113362,306,1.00
ptg020702l,130561,130847,286,RepeatMasker,LTR,130553,130584,23,0.08
ptg020719l,362485,362787,302,RepeatMasker,LTR,362655,364038,133,0.44
ptg020719l,362485,362787,302,RepeatMasker,LTR,362658,364345,130,0.43
ptg020724l,64997,65297,300,RepeatMasker,LTR,64695,65943,300,1.00
ptg020748l,262149,262429,280,RepeatMasker,LTR,261767,262441,280,1.00
ptg020756l,751288,751562,274,RepeatMasker,LTR,751438,751495,58,0.21
ptg020795l,65923,66195,272,RepeatMasker,LTR,64876,66835,272,1.00
ptg020802l,881165,881477,312,RepeatMasker,LTR,879835,882616,312,1.00
ptg020802l,1309370,1309673,303,RepeatMasker,LTR,1307327,1309397,27,0.09
ptg020802l,1451671,1451971,300,RepeatMasker,LTR,1449894,1453289,300,1.00
ptg020841l,934379,934662,283,RepeatMasker,LTR,933250,934692,283,1.00
ptg020841l,988077,988357,280,RepeatMasker,LTR,987695,989002,280,1.00
ptg020864l,98869,99152,283,RepeatMasker,LTR,97335,99765,283,1.00
ptg020864l,210535,210838,303,RepeatMasker,LTR,208108,211108,303,1.00
ptg020868l,177241,177538,297,RepeatMasker,LTR,176201,178321,297,1.00
ptg020883l,354724,355008,284,RepeatMasker,LTR,354221,354911,187,0.66
ptg020883l,354724,355008,284,RepeatMasker,LTR,354813,355011,196,0.69
ptg020897l,244416,244716,300,RepeatMasker,LTR,244145,244669,253,0.84
ptg020900l,488681,488984,303,RepeatMasker,LTR,488328,489150,303,1.00
ptg020942l,309797,310079,282,RepeatMasker,LTR,308779,310878,282,1.00
ptg020972l,664096,664376,280,RepeatMasker,LTR,663714,665177,280,1.00
ptg020984l,330518,330814,296,RepeatMasker,LTR,330306,330861,296,1.00
ptg021012l,766979,767297,318,RepeatMasker,LTR,763041,767012,33,0.10
ptg021016l,513618,513903,285,RepeatMasker,LTR,513697,514920,207,0.73
ptg021016l,582756,583037,281,RepeatMasker,LTR,582378,583682,281,1.00
ptg021031l,440126,440425,299,RepeatMasker,LTR,440199,441290,227,0.76
ptg021038l,726262,726592,330,RepeatMasker,LTR,726033,726369,107,0.32
ptg021038l,726262,726592,330,RepeatMasker,LTR,726567,730148,26,0.08
ptg021045l,19633,19914,281,RepeatMasker,LTR,19218,19950,281,1.00
ptg021047l,822910,823203,293,RepeatMasker,LTR,823156,823837,48,0.16
ptg021058l,38984,39267,283,RepeatMasker,LTR,38671,39300,283,1.00
ptg021078l,247656,247980,324,RepeatMasker,LTR,247784,247841,58,0.18
ptg021083l,309709,310015,306,RepeatMasker,LTR,309955,310026,61,0.20
ptg021083l,309709,310015,306,RepeatMasker,LTR,309990,310041,26,0.08
ptg021091l,1374322,1374621,299,RepeatMasker,LTR,1374144,1374673,299,1.00
ptg021091l,2009041,2009340,299,RepeatMasker,LTR,2009000,2009386,299,1.00
ptg021091l,2356064,2356363,299,RepeatMasker,LTR,2356044,2356397,299,1.00
ptg021118l,233362,233642,280,RepeatMasker,LTR,232979,234416,280,1.00
ptg021164l,250004,250315,311,RepeatMasker,LTR,250049,253665,267,0.86
ptg021176l,297708,298011,303,RepeatMasker,LTR,297601,297840,132,0.44
ptg021176l,297708,298011,303,RepeatMasker,LTR,297872,297942,71,0.23
ptg021176l,297708,298011,303,RepeatMasker,LTR,297973,299583,39,0.13
ptg021181l,324078,324358,280,RepeatMasker,LTR,323420,324349,271,0.97
ptg021197l,581883,582181,298,RepeatMasker,LTR,581704,585494,298,1.00
ptg021216l,352747,353034,287,RepeatMasker,LTR,351454,353073,287,1.00
ptg021229l,210535,210783,248,RepeatMasker,LTR,206327,215848,248,1.00
ptg021235l,1164806,1165139,333,RepeatMasker,LTR,1164773,1164981,175,0.53
ptg021241l,38986,39293,307,RepeatMasker,LTR,38988,39306,306,1.00
ptg021264l,1429223,1429527,304,RepeatMasker,LTR,1429231,1429322,92,0.30
ptg021269l,759805,760095,290,RepeatMasker,LTR,759933,760157,163,0.56
ptg021282l,626823,627133,310,RepeatMasker,LTR,624344,626860,37,0.12
ptg021282l,626823,627133,310,RepeatMasker,LTR,626867,627298,267,0.86
ptg021287l,2045092,2045399,307,RepeatMasker,LTR,2044616,2045179,87,0.28
ptg021287l,2045092,2045399,307,RepeatMasker,LTR,2045371,2045425,29,0.09
ptg021287l,2443842,2444162,320,RepeatMasker,LTR,2444112,2446632,51,0.16
ptg021299l,116729,117027,298,RepeatMasker,LTR,116436,117039,298,1.00
ptg021299l,390230,390503,273,RepeatMasker,LTR,388875,390238,8,0.03
ptg021331l,349993,350284,291,RepeatMasker,LTR,349602,350922,291,1.00
ptg021333l,292701,293000,299,RepeatMasker,LTR,292519,293052,299,1.00
ptg021338l,256878,257176,298,RepeatMasker,LTR,256843,260842,298,1.00
ptg021346l,125062,125350,288,RepeatMasker,LTR,124855,125402,288,1.00
ptg021350l,133738,134023,285,RepeatMasker,LTR,133338,134035,285,1.00
ptg021350l,259390,259673,283,RepeatMasker,LTR,256756,259471,81,0.29
ptg021355l,73982,74278,296,RepeatMasker,LTR,73297,74224,242,0.82
ptg021366l,125030,125346,316,RepeatMasker,LTR,125011,125786,316,1.00
ptg021367l,521526,521808,282,RepeatMasker,LTR,521051,521694,168,0.60
ptg021371l,371140,371425,285,RepeatMasker,LTR,371167,371351,185,0.65
ptg021402l,107576,107895,319,RepeatMasker,LTR,107437,107628,52,0.16
ptg021420l,1177033,1177336,303,RepeatMasker,LTR,1177172,1178524,165,0.54
ptg021421l,836430,836729,299,RepeatMasker,LTR,836432,836775,298,1.00
ptg021421l,860477,860768,291,RepeatMasker,LTR,860312,860820,291,1.00
ptg021432l,224308,224607,299,RepeatMasker,LTR,224131,224659,299,1.00
ptg021436l,91814,92113,299,RepeatMasker,LTR,91060,93683,299,1.00
ptg021442l,1159665,1159948,283,RepeatMasker,LTR,1158237,1164225,283,1.00
ptg021466l,427865,428145,280,RepeatMasker,LTR,427545,428749,280,1.00
ptg021484l,2008,2313,305,RepeatMasker,LTR,2103,3648,211,0.69
ptg021492l,652862,653187,325,RepeatMasker,LTR,653007,654325,181,0.56
ptg021495l,278242,278545,303,RepeatMasker,LTR,278323,278361,39,0.13
ptg021510l,390636,390951,315,RepeatMasker,LTR,388149,395323,315,1.00
ptg021539l,204659,204940,281,RepeatMasker,LTR,204277,205586,281,1.00
ptg021539l,272571,272847,276,RepeatMasker,LTR,272575,272868,273,0.99
ptg021543l,1325913,1326218,305,RepeatMasker,LTR,1324262,1330045,305,1.00
ptg021556l,143797,144092,295,RepeatMasker,LTR,143603,144144,295,1.00
ptg021562l,247698,247998,300,RepeatMasker,LTR,247635,247922,224,0.75
ptg021565l,172921,173205,284,RepeatMasker,LTR,173199,173426,7,0.02
ptg021569l,262240,262522,282,RepeatMasker,LTR,261196,263159,282,1.00
ptg021575l,445129,445429,300,RepeatMasker,LTR,444917,445481,300,1.00
ptg021588l,490773,491054,281,RepeatMasker,LTR,490372,491648,281,1.00
ptg021601l,955343,955660,317,RepeatMasker,LTR,954692,956710,317,1.00
ptg021626l,202701,202981,280,RepeatMasker,LTR,202316,203783,280,1.00
ptg021642l,826834,827115,281,RepeatMasker,LTR,826457,827779,281,1.00
ptg021649l,460828,461108,280,RepeatMasker,LTR,459779,461121,280,1.00
ptg021735l,69270,69584,314,RepeatMasker,LTR,67151,69527,257,0.82
ptg021735l,69270,69584,314,RepeatMasker,LTR,67152,70091,314,1.00
ptg021737l,773249,773536,287,RepeatMasker,LTR,768592,774397,287,1.00
ptg021811l,168630,168915,285,RepeatMasker,LTR,168606,168651,21,0.07
ptg021811l,1378517,1378812,295,RepeatMasker,LTR,1376818,1383218,295,1.00
ptg021820l,116230,116508,278,RepeatMasker,LTR,116307,118468,202,0.73
ptg021824l,114888,115198,310,RepeatMasker,LTR,114599,115231,310,1.00
ptg021824l,122069,122350,281,RepeatMasker,LTR,121681,122995,281,1.00
ptg021827l,664912,665199,287,RepeatMasker,LTR,661212,666053,287,1.00
ptg021833l,183836,184155,319,RepeatMasker,LTR,184105,190359,51,0.16
ptg021833l,195911,196220,309,RepeatMasker,LTR,194941,196471,309,1.00
ptg021833l,195911,196220,309,RepeatMasker,LTR,195104,196472,309,1.00
ptg021833l,211069,211388,319,RepeatMasker,LTR,211338,216274,51,0.16
ptg021836l,485492,485811,319,RepeatMasker,LTR,484786,485646,154,0.48
ptg021838l,106215,106463,248,RepeatMasker,LTR,101995,112142,248,1.00
ptg021846l,476198,476473,275,RepeatMasker,LTR,476201,476229,29,0.11
ptg021848l,152100,152385,285,RepeatMasker,LTR,150728,152826,285,1.00
ptg021848l,1636207,1636506,299,RepeatMasker,LTR,1636187,1636540,299,1.00
ptg021860l,342017,342347,330,RepeatMasker,LTR,341563,342124,107,0.32
ptg021860l,342017,342347,330,RepeatMasker,LTR,342319,342777,29,0.09
ptg021867l,93770,94085,315,RepeatMasker,LTR,94054,100722,32,0.10
ptg021870l,943000,943315,315,RepeatMasker,LTR,943291,945229,25,0.08
ptg021875l,661557,661839,282,RepeatMasker,LTR,661526,661580,23,0.08
ptg021877l,201237,201562,325,RepeatMasker,LTR,201238,201413,176,0.54
ptg021877l,201237,201562,325,RepeatMasker,LTR,201526,201585,37,0.11
ptg021922l,375082,375362,280,RepeatMasker,LTR,374771,375394,280,1.00
ptg021943l,469252,469551,299,RepeatMasker,LTR,469172,469601,299,1.00
ptg021943l,1018139,1018429,290,RepeatMasker,LTR,1017974,1018481,290,1.00
ptg021949l,45935,46234,299,RepeatMasker,LTR,42362,46485,299,1.00
ptg021960l,467277,467598,321,RepeatMasker,LTR,467375,467412,38,0.12
ptg021969l,692002,692320,318,RepeatMasker,LTR,692303,692491,18,0.06
ptg022003l,391904,392214,310,RepeatMasker,LTR,390760,392850,310,1.00
ptg022003l,1695576,1695856,280,RepeatMasker,LTR,1695197,1695869,280,1.00
ptg022003l,2320031,2320311,280,RepeatMasker,LTR,2318998,2320324,280,1.00
ptg022006l,490666,490975,309,RepeatMasker,LTR,489137,491400,309,1.00
ptg022031l,33153,33444,291,RepeatMasker,LTR,33178,33496,267,0.92
ptg022033l,63573,63855,282,RepeatMasker,LTR,63791,64833,65,0.23
ptg022059l,191335,191615,280,RepeatMasker,LTR,190955,191646,280,1.00
ptg022059l,191335,191615,280,RepeatMasker,LTR,191026,191627,280,1.00
ptg022061l,2193744,2194038,294,RepeatMasker,LTR,2193523,2193925,181,0.62
ptg022066l,544012,544318,306,RepeatMasker,LTR,543836,545244,306,1.00
ptg022066l,588729,589010,281,RepeatMasker,LTR,587679,589043,281,1.00
ptg022067l,202637,202936,299,RepeatMasker,LTR,202442,202988,299,1.00
ptg022080l,438200,438481,281,RepeatMasker,LTR,437818,438494,281,1.00
ptg022081l,586953,587267,314,RepeatMasker,LTR,584967,587023,70,0.22
ptg022116l,419720,419991,271,RepeatMasker,LTR,419920,420962,72,0.27
ptg022116l,419720,419991,271,RepeatMasker,LTR,419928,420753,64,0.24
ptg022139l,309659,309961,302,RepeatMasker,LTR,308933,309970,302,1.00
ptg022151l,32654,32934,280,RepeatMasker,LTR,32332,32946,280,1.00
ptg022166l,18715,18963,248,RepeatMasker,LTR,14521,20661,248,1.00
ptg022192l,779321,779601,280,RepeatMasker,LTR,778163,779614,280,1.00
ptg022220l,119734,120014,280,RepeatMasker,LTR,119352,120048,280,1.00
ptg022229l,186291,186572,281,RepeatMasker,LTR,185902,187374,281,1.00
ptg022243l,524806,525086,280,RepeatMasker,LTR,524424,525732,280,1.00
ptg022264l,512941,513251,310,RepeatMasker,LTR,513071,514444,181,0.58
ptg022276l,210283,210564,281,RepeatMasker,LTR,209231,211202,281,1.00
ptg022278l,903847,904121,274,RepeatMasker,LTR,904085,905512,37,0.14
ptg022287l,77747,78034,287,RepeatMasker,LTR,77726,77770,23,0.08
ptg022294l,159186,159491,305,RepeatMasker,LTR,153340,159581,305,1.00
ptg022294l,545703,545995,292,RepeatMasker,LTR,545970,546197,26,0.09
ptg022315l,231483,231731,248,RepeatMasker,LTR,228967,236788,248,1.00
ptg022343l,257326,257610,284,RepeatMasker,LTR,254679,257454,128,0.45
ptg022362l,249867,250185,318,RepeatMasker,LTR,250145,252133,41,0.13
ptg022371l,376411,376698,287,RepeatMasker,LTR,376486,376751,213,0.74
ptg022371l,376411,376698,287,RepeatMasker,LTR,376477,376868,222,0.77
ptg022403l,80050,80360,310,RepeatMasker,LTR,80314,80496,47,0.15
ptg022413l,129458,129744,286,RepeatMasker,LTR,129561,129950,184,0.64
ptg022427l,2177088,2177384,296,RepeatMasker,LTR,2176721,2178044,296,1.00
ptg022446l,80579,80860,281,RepeatMasker,LTR,80654,81188,207,0.74
ptg022460l,119924,120256,332,RepeatMasker,LTR,119516,120552,332,1.00
ptg022464l,151042,151342,300,RepeatMasker,LTR,151176,152016,167,0.56
ptg022479l,197574,197855,281,RepeatMasker,LTR,196452,197868,281,1.00
ptg022480l,89514,89808,294,RepeatMasker,LTR,89800,90022,9,0.03
ptg022482l,287371,287641,270,RepeatMasker,LTR,287586,287693,56,0.21
ptg022488l,240054,240347,293,RepeatMasker,LTR,238920,241128,293,1.00
ptg022506l,233736,234022,286,RepeatMasker,LTR,230964,237931,286,1.00
ptg022532l,149038,149337,299,RepeatMasker,LTR,148997,149389,299,1.00
ptg022542l,250803,251084,281,RepeatMasker,LTR,250421,251116,281,1.00
ptg022551l,1145181,1145480,299,RepeatMasker,LTR,1145318,1146834,163,0.55
ptg022568l,155872,156183,311,RepeatMasker,LTR,156101,156179,79,0.25
ptg022588l,554964,555263,299,RepeatMasker,LTR,554884,555315,299,1.00
ptg022594l,428250,428505,255,RepeatMasker,LTR,426126,431780,255,1.00
ptg022599l,40387,40669,282,RepeatMasker,LTR,40544,41752,126,0.45
ptg022608l,56161,56443,282,RepeatMasker,LTR,56411,56454,33,0.12
ptg022608l,56161,56443,282,RepeatMasker,LTR,56421,56468,23,0.08
ptg022618l,505001,505298,297,RepeatMasker,LTR,503950,506100,297,1.00
ptg022619l,191755,192031,276,RepeatMasker,LTR,191591,192000,245,0.89
ptg022634l,235730,236039,309,RepeatMasker,LTR,236009,237412,31,0.10
ptg022672l,514087,514392,305,RepeatMasker,LTR,513694,514425,305,1.00
ptg022697l,26935,27228,293,RepeatMasker,LTR,26760,27280,293,1.00
ptg022720l,205371,205690,319,RepeatMasker,LTR,205281,205502,131,0.41
ptg022720l,205371,205690,319,RepeatMasker,LTR,205528,212536,163,0.51
ptg022755l,161963,162240,277,RepeatMasker,LTR,161590,162252,277,1.00
ptg022760l,51657,51937,280,RepeatMasker,LTR,51275,51970,280,1.00
ptg022774l,250332,250620,288,RepeatMasker,LTR,248767,251460,288,1.00
ptg022787l,81235,81516,281,RepeatMasker,LTR,80099,81549,281,1.00
ptg022807l,93805,94129,324,RepeatMasker,LTR,93961,94191,169,0.52
ptg022817l,506286,506590,304,RepeatMasker,LTR,506584,506801,7,0.02
ptg022829l,255677,255963,286,RepeatMasker,LTR,250986,256799,286,1.00
ptg022829l,2921240,2921521,281,RepeatMasker,LTR,2920187,2922314,281,1.00
ptg022834l,44026,44340,314,RepeatMasker,LTR,43984,44263,237,0.75
ptg022847l,23621,23956,335,RepeatMasker,LTR,23643,24755,314,0.94
ptg022880l,486681,486980,299,RepeatMasker,LTR,486503,487032,299,1.00
ptg022880l,640361,640660,299,RepeatMasker,LTR,640183,640712,299,1.00
ptg022882l,285141,285424,283,RepeatMasker,LTR,284832,286223,283,1.00
ptg022884l,53513,53791,278,RepeatMasker,LTR,53124,54422,278,1.00
ptg022887l,607033,607313,280,RepeatMasker,LTR,603552,610114,280,1.00
ptg022899l,972286,972585,299,RepeatMasker,LTR,972092,972637,299,1.00
ptg022904l,251725,252018,293,RepeatMasker,LTR,251414,252819,293,1.00
ptg022913l,72176,72499,323,RepeatMasker,LTR,72169,72946,323,1.00
ptg022931l,199759,200069,310,RepeatMasker,LTR,199296,201497,310,1.00
ptg022936l,227244,227524,280,RepeatMasker,LTR,226207,227537,280,1.00
ptg022936l,234417,234698,281,RepeatMasker,LTR,233271,234711,281,1.00
ptg022983l,40457,40738,281,RepeatMasker,LTR,40140,40751,281,1.00
ptg022996l,454036,454332,296,RepeatMasker,LTR,453953,454384,296,1.00
ptg023003l,234322,234627,305,RepeatMasker,LTR,234504,234566,63,0.21
ptg023032l,39256,39565,309,RepeatMasker,LTR,38467,39807,309,1.00
ptg023032l,39256,39565,309,RepeatMasker,LTR,38477,39648,309,1.00
ptg023032l,39256,39565,309,RepeatMasker,LTR,38642,39813,309,1.00
ptg023044l,381247,381518,271,RepeatMasker,LTR,379811,381336,89,0.33
ptg023063l,152062,152361,299,RepeatMasker,LTR,151892,152413,299,1.00
ptg023071l,219256,219555,299,RepeatMasker,LTR,219060,219589,299,1.00
ptg023073l,74615,74903,288,RepeatMasker,LTR,69708,76669,288,1.00
ptg023074l,252331,252631,300,RepeatMasker,LTR,252490,253872,142,0.47
ptg023147l,81474,81785,311,RepeatMasker,LTR,80996,81587,113,0.36
ptg023150l,281380,281672,292,RepeatMasker,LTR,281145,282382,292,1.00
ptg023159l,305997,306291,294,RepeatMasker,LTR,304952,306924,294,1.00
ptg023180l,220897,221212,315,RepeatMasker,LTR,217371,221463,315,1.00
ptg023211l,228824,229120,296,RepeatMasker,LTR,228744,229172,296,1.00
ptg023228l,258696,258977,281,RepeatMasker,LTR,258685,259625,281,1.00
ptg023230l,111460,111741,281,RepeatMasker,LTR,111122,112544,281,1.00
ptg023261l,52197,52520,323,RepeatMasker,LTR,51181,53340,323,1.00
ptg023261l,52197,52520,323,RepeatMasker,LTR,52384,53558,137,0.42
ptg023297l,309723,310048,325,RepeatMasker,LTR,309503,313102,325,1.00
ptg023341l,296935,297250,315,RepeatMasker,LTR,297190,297792,61,0.19
ptg023343l,453950,454256,306,RepeatMasker,LTR,452609,454420,306,1.00
ptg023346l,113137,113442,305,RepeatMasker,LTR,112833,114242,305,1.00
ptg023360l,212235,212524,289,RepeatMasker,LTR,207566,213358,289,1.00
ptg023381l,25689,25983,294,RepeatMasker,LTR,25929,26127,55,0.19
ptg023386l,126900,127196,296,RepeatMasker,LTR,126436,127622,296,1.00
ptg023397l,283900,284198,298,RepeatMasker,LTR,283355,284431,298,1.00
ptg023420l,179561,179854,293,RepeatMasker,LTR,177666,180977,293,1.00
ptg023427l,45495,45776,281,RepeatMasker,LTR,45116,46420,281,1.00
ptg023428l,571531,571828,297,RepeatMasker,LTR,571322,572228,297,1.00
ptg023428l,571531,571828,297,RepeatMasker,LTR,571642,572442,187,0.63
ptg023462l,130423,130722,299,RepeatMasker,LTR,130382,130774,299,1.00
ptg023470l,724599,724886,287,RepeatMasker,LTR,724578,724622,23,0.08
ptg023472l,885028,885323,295,RepeatMasker,LTR,883566,885642,295,1.00
ptg023488l,151885,152236,351,RepeatMasker,LTR,151600,152198,313,0.89
ptg023527l,111433,111723,290,RepeatMasker,LTR,110542,111526,93,0.32
ptg023527l,111433,111723,290,RepeatMasker,LTR,111687,111773,37,0.13
ptg023527l,111433,111723,290,RepeatMasker,LTR,111705,111919,19,0.07
ptg023530l,202082,202363,281,RepeatMasker,LTR,200946,202376,281,1.00
ptg023532l,1103752,1104049,297,RepeatMasker,LTR,1103672,1104101,297,1.00
ptg023532l,1383294,1383588,294,RepeatMasker,LTR,1383128,1383640,294,1.00
ptg023567l,539307,539605,298,RepeatMasker,LTR,538909,539746,298,1.00
ptg023600l,315126,315425,299,RepeatMasker,LTR,314929,315477,299,1.00
ptg023606l,99405,99691,286,RepeatMasker,LTR,97554,103581,286,1.00
ptg023617l,106730,107016,286,RepeatMasker,LTR,105160,107870,286,1.00
ptg023656l,440919,441199,280,RepeatMasker,LTR,435878,444226,280,1.00
ptg023656l,749350,749637,287,RepeatMasker,LTR,744670,750494,287,1.00
ptg023670l,607032,607313,281,RepeatMasker,LTR,606714,608115,281,1.00
ptg023670l,658639,658919,280,RepeatMasker,LTR,658328,659566,280,1.00
ptg023711l,288682,288982,300,RepeatMasker,LTR,288482,289034,300,1.00
ptg023711l,445641,445941,300,RepeatMasker,LTR,445414,445993,300,1.00
ptg023750l,605714,606019,305,RepeatMasker,LTR,605871,606243,149,0.49
ptg023763l,32264,32588,324,RepeatMasker,LTR,31938,32359,95,0.29
ptg023775l,3607235,3607529,294,RepeatMasker,LTR,3606866,3608332,294,1.00
ptg023786l,922855,923159,304,RepeatMasker,LTR,922736,922942,87,0.29
ptg023786l,922855,923159,304,RepeatMasker,LTR,922927,923826,233,0.77
ptg023791l,1108100,1108380,280,RepeatMasker,LTR,1108084,1109025,280,1.00
ptg023796l,11489,11770,281,RepeatMasker,LTR,11099,12413,281,1.00
ptg023796l,40874,41157,283,RepeatMasker,LTR,40990,41385,168,0.59
ptg023796l,40874,41157,283,RepeatMasker,LTR,31517,40999,125,0.44
ptg023829l,44031,44359,328,RepeatMasker,LTR,44171,45663,189,0.58
ptg023829l,522723,523020,297,RepeatMasker,LTR,522528,523072,297,1.00
ptg023889l,24063,24393,330,RepeatMasker,LTR,23052,26847,330,1.00
ptg023909l,355245,355539,294,RepeatMasker,LTR,353771,356971,294,1.00
ptg023923l,160238,160486,248,RepeatMasker,LTR,156032,165540,248,1.00
ptg023952l,744790,745107,317,RepeatMasker,LTR,742481,745026,236,0.74
ptg023957l,344387,344659,272,RepeatMasker,LTR,344574,345541,86,0.32
ptg023973l,414991,415283,292,RepeatMasker,LTR,415241,415281,41,0.14
ptg023980l,319984,320268,284,RepeatMasker,LTR,319723,320890,284,1.00
ptg023980l,802186,802464,278,RepeatMasker,LTR,801009,802477,278,1.00
ptg023995l,203173,203470,297,RepeatMasker,LTR,202968,203522,297,1.00
ptg024042l,866052,866350,298,RepeatMasker,LTR,866246,868856,105,0.35
ptg024044l,68445,68725,280,RepeatMasker,LTR,68063,68747,280,1.00
ptg024044l,76200,76480,280,RepeatMasker,LTR,75821,76492,280,1.00
ptg024044l,256647,256927,280,RepeatMasker,LTR,256242,257543,280,1.00
ptg024045l,248836,249119,283,RepeatMasker,LTR,248600,249089,253,0.89
ptg024045l,248836,249119,283,RepeatMasker,LTR,248600,249370,283,1.00
ptg024045l,248836,249119,283,RepeatMasker,LTR,248792,249455,283,1.00
ptg024045l,431150,431430,280,RepeatMasker,LTR,430829,432064,280,1.00
ptg024045l,651114,651422,308,RepeatMasker,LTR,650730,652218,308,1.00
ptg024083l,165070,165371,301,RepeatMasker,LTR,164626,165271,201,0.67
ptg024083l,165070,165371,301,RepeatMasker,LTR,165145,165374,227,0.75
ptg024140l,814756,815036,280,RepeatMasker,LTR,813701,815827,280,1.00
ptg024140l,821905,822204,299,RepeatMasker,LTR,820786,822868,299,1.00
ptg024148l,34378,34694,316,RepeatMasker,LTR,34437,34463,27,0.09
ptg024148l,34378,34694,316,RepeatMasker,LTR,34608,34636,29,0.09
ptg024149l,393903,394182,279,RepeatMasker,LTR,393514,394195,279,1.00
ptg024161l,291057,291363,306,RepeatMasker,LTR,290975,291212,155,0.51
ptg024161l,291057,291363,306,RepeatMasker,LTR,291328,291570,36,0.12
ptg024161l,427755,428035,280,RepeatMasker,LTR,427740,428058,280,1.00
ptg024189l,467302,467582,280,RepeatMasker,LTR,466920,467615,280,1.00
ptg024189l,474426,474706,280,RepeatMasker,LTR,474117,474739,280,1.00
ptg024208l,73531,73830,299,RepeatMasker,LTR,73336,73882,299,1.00
ptg024225l,504727,505014,287,RepeatMasker,LTR,502759,505870,287,1.00
ptg024228l,1132463,1132743,280,RepeatMasker,LTR,1132074,1133388,280,1.00
ptg024238l,110332,110635,303,RepeatMasker,LTR,110002,110641,303,1.00
ptg024304l,57120,57428,308,RepeatMasker,LTR,56647,57207,87,0.28
ptg024304l,57120,57428,308,RepeatMasker,LTR,57400,59251,29,0.09
ptg024308l,308307,308599,292,RepeatMasker,LTR,307941,311432,292,1.00
ptg024330l,13449,13755,306,RepeatMasker,LTR,6935,13550,101,0.33
ptg024330l,13449,13755,306,RepeatMasker,LTR,13549,17910,207,0.68
ptg024349l,83777,84057,280,RepeatMasker,LTR,83385,84857,280,1.00
ptg024349l,522533,522838,305,RepeatMasker,LTR,515901,524067,305,1.00
ptg024358l,427449,427730,281,RepeatMasker,LTR,426304,428367,281,1.00
ptg024366l,463029,463327,298,RepeatMasker,LTR,463251,463319,69,0.23
ptg024407l,75018,75302,284,RepeatMasker,LTR,75255,76892,48,0.17
ptg024420l,939864,940172,308,RepeatMasker,LTR,939562,940721,308,1.00
ptg024427l,163305,163601,296,RepeatMasker,LTR,162957,163357,52,0.18
ptg024427l,163305,163601,296,RepeatMasker,LTR,163432,163937,170,0.57
ptg024450l,62011,62335,324,RepeatMasker,LTR,62001,63118,324,1.00
ptg024456l,91469,91749,280,RepeatMasker,LTR,91098,91783,280,1.00
ptg024493l,518375,518672,297,RepeatMasker,LTR,517373,519441,297,1.00
ptg024505l,250307,250592,285,RepeatMasker,LTR,249908,250844,285,1.00
ptg024508l,476798,477079,281,RepeatMasker,LTR,476793,477729,281,1.00
ptg024508l,714964,715262,298,RepeatMasker,LTR,711699,717869,298,1.00
ptg024524l,37203,37508,305,RepeatMasker,LTR,36658,38275,305,1.00
ptg024524l,594018,594324,306,RepeatMasker,LTR,593167,595239,306,1.00
ptg024569l,100861,101171,310,RepeatMasker,LTR,100935,101068,134,0.43
ptg024569l,100861,101171,310,RepeatMasker,LTR,101144,101232,28,0.09
ptg024597l,44748,45082,334,RepeatMasker,LTR,44399,45362,334,1.00
ptg024601l,2080325,2080606,281,RepeatMasker,LTR,2079926,2081401,281,1.00
ptg024607l,499806,500128,322,RepeatMasker,LTR,499458,500798,322,1.00
ptg024609l,267699,267990,291,RepeatMasker,LTR,267774,268540,217,0.75
ptg024609l,268098,268402,304,RepeatMasker,LTR,267774,268540,304,1.00
ptg024611l,475955,476235,280,RepeatMasker,LTR,475575,477036,280,1.00
ptg024622l,31150,31449,299,RepeatMasker,LTR,31070,31501,299,1.00
ptg024662l,101656,101974,318,RepeatMasker,LTR,101943,104274,32,0.10
ptg024683l,228275,228601,326,RepeatMasker,LTR,226413,228317,42,0.13
ptg024703l,25692,25991,299,RepeatMasker,LTR,25523,26043,299,1.00
ptg024703l,257562,257857,295,RepeatMasker,LTR,257364,257909,295,1.00
ptg024706l,1236896,1237191,295,RepeatMasker,LTR,1236882,1236992,96,0.33
ptg024722l,469867,470163,296,RepeatMasker,LTR,469787,470215,296,1.00
ptg024782l,129667,129994,327,RepeatMasker,LTR,129303,130640,327,1.00
ptg024812l,232114,232399,285,RepeatMasker,LTR,231152,233256,285,1.00
ptg024860l,60937,61235,298,RepeatMasker,LTR,57636,63432,298,1.00
ptg024872l,430685,430994,309,RepeatMasker,LTR,430721,432575,274,0.89
ptg024875l,161100,161385,285,RepeatMasker,LTR,161365,162350,21,0.07
ptg024875l,365477,365757,280,RepeatMasker,LTR,365096,366399,280,1.00
ptg024881l,176253,176581,328,RepeatMasker,LTR,176494,176582,88,0.27
ptg024881l,511835,512115,280,RepeatMasker,LTR,511508,512895,280,1.00
ptg024881l,519238,519518,280,RepeatMasker,LTR,518840,520153,280,1.00
ptg024881l,647286,647566,280,RepeatMasker,LTR,646897,647579,280,1.00
ptg024899l,418161,418460,299,RepeatMasker,LTR,417967,418512,299,1.00
ptg024910l,393274,393569,295,RepeatMasker,LTR,392152,394207,295,1.00
ptg024929l,391649,391930,281,RepeatMasker,LTR,391255,391963,281,1.00
ptg024961l,23711,24010,299,RepeatMasker,LTR,23533,24062,299,1.00
ptg024966l,214757,215056,299,RepeatMasker,LTR,214586,215108,299,1.00
ptg024970l,468859,469158,299,RepeatMasker,LTR,468678,469210,299,1.00
ptg024970l,520064,520363,299,RepeatMasker,LTR,519857,520396,299,1.00
ptg024974l,7838,8119,281,RepeatMasker,LTR,7519,8765,281,1.00
ptg025047l,705050,705373,323,RepeatMasker,LTR,705241,706636,133,0.41
ptg025068l,601689,601976,287,RepeatMasker,LTR,597041,602825,287,1.00
ptg025074l,792694,792990,296,RepeatMasker,LTR,792673,793024,296,1.00
ptg025074l,994881,995172,291,RepeatMasker,LTR,994883,995206,290,1.00
ptg025083l,684656,684936,280,RepeatMasker,LTR,683710,685354,280,1.00
ptg025085l,789135,789459,324,RepeatMasker,LTR,786963,789173,38,0.12
ptg025085l,789135,789459,324,RepeatMasker,LTR,789318,792120,142,0.44
ptg025086l,284788,285079,291,RepeatMasker,LTR,282275,284832,44,0.15
ptg025093l,847677,847979,302,RepeatMasker,LTR,845926,849608,302,1.00
ptg025109l,345415,345689,274,RepeatMasker,LTR,345394,345438,23,0.08
ptg025120l,79321,79623,302,RepeatMasker,LTR,79581,85563,43,0.14
ptg025140l,157039,157354,315,RepeatMasker,LTR,155465,157825,315,1.00
ptg025152l,148368,148675,307,RepeatMasker,LTR,148401,148899,275,0.90
ptg025161l,278893,279192,299,RepeatMasker,LTR,278895,279238,298,1.00
ptg025182l,447875,448187,312,RepeatMasker,LTR,447227,448804,312,1.00
ptg025201l,226223,226536,313,RepeatMasker,LTR,224632,227099,313,1.00
ptg025210l,217835,218083,248,RepeatMasker,LTR,213634,223140,248,1.00
ptg025217l,806085,806366,281,RepeatMasker,LTR,805694,806400,281,1.00
ptg025240l,301905,302188,283,RepeatMasker,LTR,300488,305458,283,1.00
ptg025270l,124036,124317,281,RepeatMasker,LTR,123654,124951,281,1.00
ptg025285l,1217445,1217745,300,RepeatMasker,LTR,1217236,1217797,300,1.00
ptg025287l,715303,715584,281,RepeatMasker,LTR,714921,715617,281,1.00
ptg025308l,372683,372979,296,RepeatMasker,LTR,372312,373624,296,1.00
ptg025352l,319497,319796,299,RepeatMasker,LTR,319358,319848,299,1.00
ptg025369l,262498,262814,316,RepeatMasker,LTR,261447,263617,316,1.00
ptg025376l,2078938,2079243,305,RepeatMasker,LTR,2078556,2079256,305,1.00
ptg025376l,3308849,3309165,316,RepeatMasker,LTR,3309121,3309236,45,0.14
ptg025382l,369112,369427,315,RepeatMasker,LTR,367571,369339,227,0.72
ptg025382l,369112,369427,315,RepeatMasker,LTR,369333,369498,95,0.30
ptg025396l,247743,248042,299,RepeatMasker,LTR,247535,248092,299,1.00
ptg025402l,104202,104483,281,RepeatMasker,LTR,103820,105240,281,1.00
ptg025409l,322402,322682,280,RepeatMasker,LTR,321355,323481,280,1.00
ptg025422l,38460,38746,286,RepeatMasker,LTR,38062,44863,286,1.00
ptg025422l,157964,158240,276,RepeatMasker,LTR,156031,158002,38,0.14
ptg025422l,317587,317907,320,RepeatMasker,LTR,317857,320070,51,0.16
ptg025438l,471649,471959,310,RepeatMasker,LTR,467162,473080,310,1.00
ptg025450l,223415,223716,301,RepeatMasker,LTR,223453,224589,264,0.88
ptg025466l,1302554,1302873,319,RepeatMasker,LTR,1301878,1302648,94,0.29
ptg025466l,1302554,1302873,319,RepeatMasker,LTR,1302638,1303479,236,0.74
ptg025494l,531473,531784,311,RepeatMasker,LTR,530060,533269,311,1.00
ptg025510l,663587,663854,267,RepeatMasker,LTR,663608,663655,48,0.18
ptg025510l,663587,663854,267,RepeatMasker,LTR,663629,663696,68,0.25
ptg025514l,221819,222100,281,RepeatMasker,LTR,220747,222884,281,1.00
ptg025514l,226930,227210,280,RepeatMasker,LTR,226675,227826,280,1.00
ptg025530l,35330,35610,280,RepeatMasker,LTR,35003,36255,280,1.00
ptg025536l,907769,908056,287,RepeatMasker,LTR,907727,908054,285,0.99
ptg025551l,288717,289043,326,RepeatMasker,LTR,288411,289779,326,1.00
ptg025554l,280286,280582,296,RepeatMasker,LTR,278412,280923,296,1.00
ptg025579l,114094,114394,300,RepeatMasker,LTR,113916,114446,300,1.00
ptg025582l,102626,102923,297,RepeatMasker,LTR,102446,102975,297,1.00
ptg025590l,150359,150643,284,RepeatMasker,LTR,150114,150563,204,0.72
ptg025590l,150359,150643,284,RepeatMasker,LTR,150561,151072,83,0.29
ptg025657l,301773,302080,307,RepeatMasker,LTR,301366,303647,307,1.00
ptg025682l,217002,217285,283,RepeatMasker,LTR,215445,217905,283,1.00
ptg025718l,116033,116335,302,RepeatMasker,LTR,115280,117912,302,1.00
ptg025718l,116033,116335,302,RepeatMasker,LTR,116203,117593,133,0.44
ptg025743l,429224,429505,281,RepeatMasker,LTR,428090,429518,281,1.00
ptg025767l,58589,58894,305,RepeatMasker,LTR,58562,58612,23,0.08
ptg025771l,271312,271592,280,RepeatMasker,LTR,270275,272375,280,1.00
ptg025792l,260770,261055,285,RepeatMasker,LTR,260744,261082,285,1.00
ptg025805l,659349,659652,303,RepeatMasker,LTR,659453,660010,200,0.66
ptg025807l,496251,496540,289,RepeatMasker,LTR,495386,498561,289,1.00
ptg025862l,1986259,1986574,315,RepeatMasker,LTR,1984444,1986601,315,1.00
ptg025870l,152491,152822,331,RepeatMasker,LTR,151921,152820,329,0.99
ptg025880l,204900,205198,298,RepeatMasker,LTR,204606,205841,298,1.00
ptg025880l,249245,249556,311,RepeatMasker,LTR,248911,249404,159,0.51
ptg025880l,249245,249556,311,RepeatMasker,LTR,249030,249404,159,0.51
ptg025988l,524592,524881,289,RepeatMasker,LTR,524527,524933,289,1.00
ptg026003l,304657,304944,287,RepeatMasker,LTR,300029,304982,287,1.00
ptg026031l,956355,956636,281,RepeatMasker,LTR,955974,956667,281,1.00
ptg026036l,368651,368950,299,RepeatMasker,LTR,368486,369002,299,1.00
ptg026118l,172449,172762,313,RepeatMasker,LTR,172487,172907,276,0.88
ptg026121l,326625,326924,299,RepeatMasker,LTR,326545,326976,299,1.00
ptg026128l,51988,52279,291,RepeatMasker,LTR,52125,52175,51,0.18
ptg026133l,126601,126880,279,RepeatMasker,LTR,126219,126891,279,1.00
ptg026133l,126601,126880,279,RepeatMasker,LTR,126290,127671,279,1.00
ptg026136l,285751,286050,299,RepeatMasker,LTR,285543,286101,299,1.00
ptg026146l,481239,481536,297,RepeatMasker,LTR,481161,481588,297,1.00
ptg026221l,804313,804593,280,RepeatMasker,LTR,804307,805203,280,1.00
ptg026264l,499909,500218,309,RepeatMasker,LTR,499626,500231,309,1.00
ptg026278l,114402,114683,281,RepeatMasker,LTR,113383,115000,281,1.00
ptg026289l,425793,426079,286,RepeatMasker,LTR,423857,426812,286,1.00
ptg026289l,425793,426079,286,RepeatMasker,LTR,424988,427367,286,1.00
ptg026291l,124687,124986,299,RepeatMasker,LTR,124645,125038,299,1.00
ptg026297l,225894,226211,317,RepeatMasker,LTR,223845,227534,317,1.00
ptg026306l,324603,324918,315,RepeatMasker,LTR,324358,324887,284,0.90
ptg026382l,96454,96739,285,RepeatMasker,LTR,96537,96576,40,0.14
ptg026392l,29700,29981,281,RepeatMasker,LTR,29313,30013,281,1.00
ptg026465l,129157,129452,295,RepeatMasker,LTR,129159,129504,294,1.00
ptg026465l,307376,307689,313,RepeatMasker,LTR,307251,307481,105,0.34
ptg026465l,307376,307689,313,RepeatMasker,LTR,307486,307741,204,0.65
ptg026488l,78528,78860,332,RepeatMasker,LTR,78617,78675,59,0.18
ptg026489l,368016,368338,322,RepeatMasker,LTR,364489,368067,51,0.16
ptg026598l,9416,9740,324,RepeatMasker,LTR,8918,9627,211,0.65
ptg026608l,535681,535967,286,RepeatMasker,LTR,531053,536776,286,1.00
ptg026614l,275053,275348,295,RepeatMasker,LTR,274315,276355,295,1.00
ptg026661l,121630,121915,285,RepeatMasker,LTR,121739,121946,177,0.62
ptg026711l,40581,40862,281,RepeatMasker,LTR,40197,40875,281,1.00
ptg026743l,691897,692168,271,RepeatMasker,LTR,691943,691981,39,0.14
ptg026763l,87210,87514,304,RepeatMasker,LTR,87489,91756,26,0.09
ptg026767l,163557,163844,287,RepeatMasker,LTR,163320,164699,287,1.00
ptg026769l,184766,185044,278,RepeatMasker,LTR,180656,184825,59,0.21
ptg026781l,110026,110332,306,RepeatMasker,LTR,109453,110325,299,0.98
ptg026825l,297126,297425,299,RepeatMasker,LTR,296918,297477,299,1.00
ptg026825l,381333,381613,280,RepeatMasker,LTR,375162,381436,103,0.37
ptg026825l,441066,441361,295,RepeatMasker,LTR,440888,441413,295,1.00
ptg026825l,742858,743152,294,RepeatMasker,LTR,742679,743204,294,1.00
ptg026829l,468849,469136,287,RepeatMasker,LTR,468932,469029,98,0.34
ptg026829l,770678,770950,272,RepeatMasker,LTR,769628,770987,272,1.00
ptg026851l,258997,259296,299,RepeatMasker,LTR,258802,259348,299,1.00
ptg026870l,366937,367237,300,RepeatMasker,LTR,366773,367289,300,1.00
ptg026870l,601035,601334,299,RepeatMasker,LTR,600868,601386,299,1.00
ptg026903l,68556,68868,312,RepeatMasker,LTR,68706,76149,163,0.52
ptg026936l,516572,516887,315,RepeatMasker,LTR,516768,517914,120,0.38
ptg026936l,779284,779572,288,RepeatMasker,LTR,779410,779691,163,0.57
ptg026940l,314375,314684,309,RepeatMasker,LTR,314654,316817,31,0.10
ptg026959l,95844,96125,281,RepeatMasker,LTR,95462,96769,281,1.00
ptg026975l,153825,154119,294,RepeatMasker,LTR,153464,154921,294,1.00
ptg026975l,160968,161249,281,RepeatMasker,LTR,160582,161904,281,1.00
ptg027017l,447781,448080,299,RepeatMasker,LTR,447616,448132,299,1.00
ptg027018l,144056,144358,302,RepeatMasker,LTR,143738,144138,82,0.27
ptg027040l,172643,172954,311,RepeatMasker,LTR,172009,172782,139,0.45
ptg027052l,311348,311661,313,RepeatMasker,LTR,311364,311483,120,0.38
ptg027100l,672306,672605,299,RepeatMasker,LTR,672128,672657,299,1.00
ptg027105l,206937,207236,299,RepeatMasker,LTR,206857,207288,299,1.00
ptg027105l,212284,212583,299,RepeatMasker,LTR,212117,212635,299,1.00
ptg027105l,300990,301289,299,RepeatMasker,LTR,300910,301341,299,1.00
ptg027105l,390219,390518,299,RepeatMasker,LTR,390043,390570,299,1.00
ptg027148l,167936,168234,298,RepeatMasker,LTR,167724,168286,298,1.00
ptg027206l,226174,226487,313,RepeatMasker,LTR,221064,227326,313,1.00
ptg027238l,140977,141275,298,RepeatMasker,LTR,139049,141495,298,1.00
ptg027251l,596092,596415,323,RepeatMasker,LTR,595519,596093,1,0.00
ptg027251l,596092,596415,323,RepeatMasker,LTR,596093,597229,323,1.00
ptg027272l,232692,232979,287,RepeatMasker,LTR,228004,233834,287,1.00
ptg027305l,238945,239270,325,RepeatMasker,LTR,237272,239867,325,1.00
ptg027326l,400914,401195,281,RepeatMasker,LTR,399796,401228,281,1.00
ptg027385l,220357,220674,317,RepeatMasker,LTR,218635,220574,217,0.68
ptg027385l,220357,220674,317,RepeatMasker,LTR,219978,220653,296,0.93
ptg027395l,183829,184137,308,RepeatMasker,LTR,183035,183951,122,0.40
ptg027429l,2180442,2180729,287,RepeatMasker,LTR,2180060,2181609,287,1.00
ptg027431l,513814,514100,286,RepeatMasker,LTR,513395,514394,286,1.00
ptg027433l,541797,542077,280,RepeatMasker,LTR,541044,542858,280,1.00
ptg027439l,498952,499233,281,RepeatMasker,LTR,498570,500035,281,1.00
ptg027462l,21413,21694,281,RepeatMasker,LTR,21031,22339,281,1.00
ptg027465l,34998,35293,295,RepeatMasker,LTR,34819,35345,295,1.00
ptg027474l,66682,66962,280,RepeatMasker,LTR,66624,66975,280,1.00
ptg027482l,54861,55158,297,RepeatMasker,LTR,54889,55204,270,0.91
ptg027490l,106796,107076,280,RepeatMasker,LTR,106407,107109,280,1.00
ptg027529l,131667,131948,281,RepeatMasker,LTR,131285,132577,281,1.00
ptg027533l,67672,67971,299,RepeatMasker,LTR,66913,68969,299,1.00
ptg027542l,199689,200049,360,RepeatMasker,LTR,198763,200449,360,1.00
ptg027548l,152722,153019,297,RepeatMasker,LTR,152642,153071,297,1.00
ptg027548l,178058,178352,294,RepeatMasker,LTR,177978,178398,294,1.00
ptg027563l,38059,38358,299,RepeatMasker,LTR,38083,43895,276,0.92
ptg027575l,411445,411754,309,RepeatMasker,LTR,410457,412012,309,1.00
ptg027575l,411445,411754,309,RepeatMasker,LTR,410666,412008,309,1.00
ptg027585l,23839,24126,287,RepeatMasker,LTR,19164,25027,287,1.00
ptg027611l,227826,228105,279,RepeatMasker,LTR,228022,228734,84,0.30
ptg027611l,347702,348008,306,RepeatMasker,LTR,346922,348314,306,1.00
ptg027688l,123445,123744,299,RepeatMasker,LTR,123237,123796,299,1.00
ptg027710l,323577,323868,291,RepeatMasker,LTR,323818,326788,51,0.18
ptg027711l,79754,80064,310,RepeatMasker,LTR,79360,80097,310,1.00
ptg027711l,79754,80064,310,RepeatMasker,LTR,79770,80869,295,0.95
ptg027729l,108463,108798,335,RepeatMasker,LTR,108710,109872,89,0.27
ptg027730l,389040,389350,310,RepeatMasker,LTR,387858,389335,295,0.95
ptg027768l,32848,33168,320,RepeatMasker,LTR,32401,32957,109,0.34
ptg027823l,170895,171207,312,RepeatMasker,LTR,166079,174511,312,1.00
ptg027846l,290950,291274,324,RepeatMasker,LTR,291115,291571,160,0.49
ptg027887l,42988,43282,294,RepeatMasker,LTR,42908,43334,294,1.00
ptg027903l,254765,255055,290,RepeatMasker,LTR,254161,254956,191,0.66
ptg027903l,254765,255055,290,RepeatMasker,LTR,254830,255058,226,0.78
ptg027914l,97227,97508,281,RepeatMasker,LTR,96845,98151,281,1.00
ptg027915l,59548,59847,299,RepeatMasker,LTR,58877,60996,299,1.00
ptg027920l,124769,125086,317,RepeatMasker,LTR,124923,128865,164,0.52
ptg027928l,52836,53126,290,RepeatMasker,LTR,52634,52863,27,0.09
ptg027928l,52836,53126,290,RepeatMasker,LTR,52964,53462,163,0.56
ptg027940l,80520,80820,300,RepeatMasker,LTR,77450,80521,1,0.00
ptg027949l,175106,175388,282,RepeatMasker,LTR,174708,176035,282,1.00
ptg027958l,299304,299599,295,RepeatMasker,LTR,299224,299651,295,1.00
ptg027971l,386328,386623,295,RepeatMasker,LTR,384656,386931,295,1.00
ptg027971l,713570,713890,320,RepeatMasker,LTR,713840,714207,51,0.16
ptg028003l,263959,264238,279,RepeatMasker,LTR,264003,264124,122,0.44
ptg028014l,264854,265153,299,RepeatMasker,LTR,264660,265205,299,1.00
ptg028081l,75953,76271,318,RepeatMasker,LTR,76231,82082,41,0.13
ptg028107l,123253,123542,289,RepeatMasker,LTR,122366,125972,289,1.00
ptg028128l,442063,442355,292,RepeatMasker,LTR,442305,442605,51,0.17
ptg028156l,77619,77914,295,RepeatMasker,LTR,77578,77948,295,1.00
ptg028156l,116421,116720,299,RepeatMasker,LTR,116241,116772,299,1.00
ptg028156l,140626,140939,313,RepeatMasker,LTR,139732,140672,46,0.15
ptg028156l,140626,140939,313,RepeatMasker,LTR,140676,141261,264,0.84
ptg028174l,10936,11248,312,RepeatMasker,LTR,9497,11059,123,0.39
ptg028174l,53066,53361,295,RepeatMasker,LTR,50315,53533,295,1.00
ptg028196l,318088,318387,299,RepeatMasker,LTR,318341,321237,47,0.16
ptg028230l,95938,96219,281,RepeatMasker,LTR,94884,97000,281,1.00
ptg028238l,755124,755421,297,RepeatMasker,LTR,754946,755473,297,1.00
ptg028238l,1335784,1336063,279,RepeatMasker,LTR,1335773,1335957,173,0.62
ptg028238l,1335784,1336063,279,RepeatMasker,LTR,1335951,1336832,113,0.41
ptg028251l,231779,232078,299,RepeatMasker,LTR,231699,232130,299,1.00
ptg028251l,239341,239620,279,RepeatMasker,LTR,238959,240267,279,1.00
ptg028277l,38629,38927,298,RepeatMasker,LTR,38451,38979,298,1.00
ptg028307l,205483,205785,302,RepeatMasker,LTR,205128,206565,302,1.00
ptg028391l,22891,23189,298,RepeatMasker,LTR,22972,23319,218,0.73
ptg028392l,134673,134969,296,RepeatMasker,LTR,134497,135021,296,1.00
ptg028414l,153338,153647,309,RepeatMasker,LTR,152835,154193,309,1.00
ptg028442l,724654,724935,281,RepeatMasker,LTR,724294,725555,281,1.00
ptg028458l,2413,2698,285,RepeatMasker,LTR,2015,7133,285,1.00
ptg028488l,43361,43665,304,RepeatMasker,LTR,43610,43676,56,0.18
ptg028488l,43361,43665,304,RepeatMasker,LTR,43640,43689,26,0.09
ptg028515l,262729,263052,323,RepeatMasker,LTR,262755,262901,147,0.46
ptg028550l,375995,376311,316,RepeatMasker,LTR,375186,376250,255,0.81
ptg028550l,375995,376311,316,RepeatMasker,LTR,375435,378999,316,1.00
ptg028550l,375995,376311,316,RepeatMasker,LTR,375551,378739,316,1.00
ptg028550l,375995,376311,316,RepeatMasker,LTR,376279,378999,33,0.10
ptg028599l,1107991,1108290,299,RepeatMasker,LTR,1107698,1109091,299,1.00
ptg028644l,110460,110754,294,RepeatMasker,LTR,110074,111388,294,1.00
ptg028652l,73355,73642,287,RepeatMasker,LTR,73032,74496,287,1.00
ptg028652l,568225,568512,287,RepeatMasker,LTR,565409,569375,287,1.00
ptg028657l,83649,83958,309,RepeatMasker,LTR,83338,84608,309,1.00
ptg028666l,425953,426234,281,RepeatMasker,LTR,425558,426872,281,1.00
ptg028727l,146402,146695,293,RepeatMasker,LTR,146211,146747,293,1.00
ptg028748l,102509,102790,281,RepeatMasker,LTR,101365,103443,281,1.00
ptg028799l,407089,407368,279,RepeatMasker,LTR,406064,407381,279,1.00
ptg028801l,290338,290620,282,RepeatMasker,LTR,290259,290672,282,1.00
ptg028816l,199093,199372,279,RepeatMasker,LTR,198704,200021,279,1.00
ptg028847l,172273,172553,280,RepeatMasker,LTR,171885,172586,280,1.00
ptg028918l,620005,620304,299,RepeatMasker,LTR,620007,620350,298,1.00
ptg028946l,74719,75025,306,RepeatMasker,LTR,74739,75038,287,0.94
ptg028946l,804946,805239,293,RepeatMasker,LTR,804591,805283,293,1.00
ptg028946l,3223134,3223413,279,RepeatMasker,LTR,3222750,3223426,279,1.00
ptg028959l,55955,56251,296,RepeatMasker,LTR,55914,56303,296,1.00
ptg028986l,91404,91697,293,RepeatMasker,LTR,91521,91837,177,0.60
ptg029001l,19939,20219,280,RepeatMasker,LTR,19925,21021,280,1.00
ptg029055l,200242,200523,281,RepeatMasker,LTR,199859,200536,281,1.00
ptg029080l,43775,44061,286,RepeatMasker,LTR,43377,44706,286,1.00
ptg029100l,1692865,1693181,316,RepeatMasker,LTR,1693141,1693394,41,0.13
ptg029150l,71095,71372,277,RepeatMasker,LTR,71177,71340,164,0.59
ptg029186l,163651,163947,296,RepeatMasker,LTR,163600,163999,296,1.00
ptg029224l,2269769,2270078,309,RepeatMasker,LTR,2269915,2270127,164,0.53
ptg029237l,213480,213808,328,RepeatMasker,LTR,213721,213855,88,0.27
ptg029260l,256091,256407,316,RepeatMasker,LTR,251495,256310,219,0.69
ptg029338l,39783,40114,331,RepeatMasker,LTR,37831,43572,331,1.00
ptg029351l,205876,206177,301,RepeatMasker,LTR,206031,206960,147,0.49
ptg029411l,441489,441775,286,RepeatMasker,LTR,440792,445681,286,1.00
ptg029423l,123781,124086,305,RepeatMasker,LTR,124061,128196,26,0.09
ptg029474l,19159,19440,281,RepeatMasker,LTR,18777,19473,281,1.00
ptg029541l,17641,17932,291,RepeatMasker,LTR,17274,18570,291,1.00
ptg029552l,103723,104004,281,RepeatMasker,LTR,103341,104649,281,1.00
ptg029559l,158551,158860,309,RepeatMasker,LTR,158762,159083,99,0.32
ptg029565l,101828,102126,298,RepeatMasker,LTR,101693,102178,298,1.00
ptg029627l,679984,680283,299,RepeatMasker,LTR,679904,680335,299,1.00
ptg029679l,81687,81967,280,RepeatMasker,LTR,81297,81979,280,1.00
ptg029679l,89142,89422,280,RepeatMasker,LTR,88761,89434,280,1.00
ptg029679l,301864,302112,248,RepeatMasker,LTR,297660,307180,248,1.00
ptg029680l,189074,189376,302,RepeatMasker,LTR,188702,189803,302,1.00
ptg029724l,50131,50427,296,RepeatMasker,LTR,49765,51225,296,1.00
ptg029725l,249835,250136,301,RepeatMasker,LTR,249453,250149,301,1.00
ptg029746l,304442,304722,280,RepeatMasker,LTR,304131,305373,280,1.00
ptg029799l,299076,299361,285,RepeatMasker,LTR,299347,299553,15,0.05
ptg029809l,289434,289728,294,RepeatMasker,LTR,289206,289780,294,1.00
ptg029855l,121902,122183,281,RepeatMasker,LTR,121520,122216,281,1.00
ptg029855l,743179,743468,289,RepeatMasker,LTR,742421,743862,289,1.00
ptg029893l,43126,43421,295,RepeatMasker,LTR,43046,43473,295,1.00
ptg029893l,225107,225402,295,RepeatMasker,LTR,224916,225454,295,1.00
ptg029897l,57532,57828,296,RepeatMasker,LTR,57166,58598,296,1.00
ptg029913l,225840,226127,287,RepeatMasker,LTR,222123,226987,287,1.00
ptg029939l,107332,107648,316,RepeatMasker,LTR,107308,109583,316,1.00
ptg029940l,132129,132450,321,RepeatMasker,LTR,132286,139307,165,0.51
ptg029969l,41457,41738,281,RepeatMasker,LTR,41067,42541,281,1.00
ptg029969l,48615,48898,283,RepeatMasker,LTR,48222,49541,283,1.00
ptg029969l,62746,63026,280,RepeatMasker,LTR,62364,63038,280,1.00
ptg029969l,69578,69893,315,RepeatMasker,LTR,69196,69930,315,1.00
ptg029995l,48648,48959,311,RepeatMasker,LTR,48850,50542,110,0.35
ptg030008l,170063,170343,280,RepeatMasker,LTR,165626,173091,280,1.00
ptg030028l,24004,24300,296,RepeatMasker,LTR,23631,24333,296,1.00
ptg030030l,406228,406541,313,RepeatMasker,LTR,405881,410096,313,1.00
ptg030036l,68861,69156,295,RepeatMasker,LTR,68486,69169,295,1.00
ptg030069l,110153,110440,287,RepeatMasker,LTR,105456,111302,287,1.00
ptg030098l,236664,236949,285,RepeatMasker,LTR,235151,237810,285,1.00
ptg030180l,234699,235023,324,RepeatMasker,LTR,234868,234917,50,0.15
ptg030180l,234699,235023,324,RepeatMasker,LTR,234898,234949,52,0.16
ptg030229l,76944,77243,299,RepeatMasker,LTR,76903,77295,299,1.00
ptg030249l,5903797,5904084,287,RepeatMasker,LTR,5898897,5904949,287,1.00
ptg030283l,685259,685543,284,RepeatMasker,LTR,682472,685262,3,0.01
ptg030283l,685259,685543,284,RepeatMasker,LTR,683935,685598,284,1.00
ptg030283l,685259,685543,284,RepeatMasker,LTR,685407,685698,137,0.48
ptg030290l,520688,520974,286,RepeatMasker,LTR,520289,525078,286,1.00
ptg030348l,157312,157641,329,RepeatMasker,LTR,155062,160919,329,1.00
ptg030382l,449126,449432,306,RepeatMasker,LTR,449180,451808,253,0.83
ptg030413l,151145,151455,310,RepeatMasker,LTR,151396,156305,60,0.19
ptg030455l,22375,22685,310,RepeatMasker,LTR,21902,22432,57,0.18
ptg030455l,22375,22685,310,RepeatMasker,LTR,22657,26252,29,0.09
ptg030456l,333009,333290,281,RepeatMasker,LTR,332694,334091,281,1.00
ptg030456l,495096,495393,297,RepeatMasker,LTR,495068,495868,297,1.00
ptg030473l,197011,197303,292,RepeatMasker,LTR,196669,200140,292,1.00
ptg030477l,198782,199074,292,RepeatMasker,LTR,199024,204571,51,0.17
ptg030559l,70758,71020,262,RepeatMasker,LTR,70814,70987,174,0.66
ptg030624l,483927,484229,302,RepeatMasker,LTR,483097,483975,48,0.16
ptg030712l,65728,66007,279,RepeatMasker,LTR,65326,66815,279,1.00
ptg030736l,488993,489273,280,RepeatMasker,LTR,488611,489924,280,1.00
ptg030736l,690025,690304,279,RepeatMasker,LTR,689643,691112,279,1.00
ptg030766l,351449,351729,280,RepeatMasker,LTR,351060,351763,280,1.00
ptg030785l,275037,275317,280,RepeatMasker,LTR,273979,275330,280,1.00
ptg030831l,3424,3723,299,RepeatMasker,LTR,3344,3775,299,1.00
ptg030834l,7079,7396,317,RepeatMasker,LTR,7354,8234,43,0.14
ptg030845l,115048,115343,295,RepeatMasker,LTR,114659,116144,295,1.00
ptg030858l,49449,49730,281,RepeatMasker,LTR,49254,49782,281,1.00
ptg030881l,372172,372467,295,RepeatMasker,LTR,372131,372519,295,1.00
ptg030909l,264009,264329,320,RepeatMasker,LTR,264279,265924,51,0.16
ptg030944l,52844,53124,280,RepeatMasker,LTR,52462,53136,280,1.00
ptg031119l,16819,17119,300,RepeatMasker,LTR,16607,17171,300,1.00
ptg031130l,154375,154674,299,RepeatMasker,LTR,154355,154708,299,1.00
ptg031188l,61268,61574,306,RepeatMasker,LTR,61227,61620,306,1.00
ptg031205l,533529,533797,268,RepeatMasker,LTR,533187,534264,268,1.00
ptg031210l,1134966,1135246,280,RepeatMasker,LTR,1134981,1135012,32,0.11
ptg031211l,271029,271324,295,RepeatMasker,LTR,270745,271503,295,1.00
ptg031211l,292267,292553,286,RepeatMasker,LTR,292132,293412,286,1.00
ptg031216l,127330,127611,281,RepeatMasker,LTR,126948,127644,281,1.00
ptg031230l,84550,84799,249,RepeatMasker,LTR,82945,89883,249,1.00
ptg031279l,108667,108947,280,RepeatMasker,LTR,108285,109750,280,1.00
ptg031297l,212720,213001,281,RepeatMasker,LTR,212407,213033,281,1.00
ptg031332l,33848,34129,281,RepeatMasker,LTR,33464,34162,281,1.00
ptg031367l,388651,388958,307,RepeatMasker,LTR,388509,388694,43,0.14
ptg031371l,113777,114063,286,RepeatMasker,LTR,112917,117727,286,1.00
ptg031375l,36161,36463,302,RepeatMasker,LTR,35758,36302,141,0.47
ptg031375l,36161,36463,302,RepeatMasker,LTR,36300,38612,164,0.54
ptg031546l,246300,246599,299,RepeatMasker,LTR,245936,246633,299,1.00
ptg031584l,728310,728630,320,RepeatMasker,LTR,728580,733578,51,0.16
ptg031663l,37122,37425,303,RepeatMasker,LTR,36594,38121,303,1.00
ptg031676l,212521,212812,291,RepeatMasker,LTR,211631,212560,39,0.13
ptg031744l,88091,88391,300,RepeatMasker,LTR,87888,88443,300,1.00
ptg031807l,336672,336973,301,RepeatMasker,LTR,336745,337005,229,0.76
ptg031893l,123718,124018,300,RepeatMasker,LTR,123790,124042,229,0.76
ptg031923l,287027,287344,317,RepeatMasker,LTR,285723,287038,11,0.03
ptg031923l,287027,287344,317,RepeatMasker,LTR,287255,288575,90,0.28
ptg031923l,462629,462951,322,RepeatMasker,LTR,462671,463142,281,0.87
ptg032175l,204631,204919,288,RepeatMasker,LTR,204192,204822,191,0.66
ptg032175l,204631,204919,288,RepeatMasker,LTR,204707,204933,213,0.74
ptg032211l,14920,15209,289,RepeatMasker,LTR,15005,15102,98,0.34
ptg032214l,22041,22321,280,RepeatMasker,LTR,21659,23125,280,1.00
ptg032261l,80701,80982,281,RepeatMasker,LTR,80310,81015,281,1.00
ptg032282l,8598,8895,297,RepeatMasker,LTR,8420,8947,297,1.00
ptg032356l,62428,62722,294,RepeatMasker,LTR,62702,65094,21,0.07
ptg032402l,29389,29705,316,RepeatMasker,LTR,29492,29545,54,0.17
ptg032402l,29389,29705,316,RepeatMasker,LTR,29543,31508,163,0.52
ptg032445l,25003,25326,323,RepeatMasker,LTR,25231,25263,33,0.10
ptg032454l,34355,34646,291,RepeatMasker,LTR,34471,35578,176,0.60
ptg032456l,253857,254138,281,RepeatMasker,LTR,253455,254940,281,1.00
ptg032472l,36330,36629,299,RepeatMasker,LTR,35374,38595,299,1.00
ptg032562l,339905,340216,311,RepeatMasker,LTR,338359,341093,311,1.00
ptg032654l,118056,118336,280,RepeatMasker,LTR,117008,119120,280,1.00
ptg032664l,49157,49437,280,RepeatMasker,LTR,48846,50220,280,1.00
ptg032690l,265428,265708,280,RepeatMasker,LTR,265046,265720,280,1.00
ptg032733l,99957,100252,295,RepeatMasker,LTR,99751,100304,295,1.00
ptg032741l,389369,389687,318,RepeatMasker,LTR,389187,389961,318,1.00
ptg032761l,142597,142910,313,RepeatMasker,LTR,141949,142907,310,0.99
ptg032766l,126537,126837,300,RepeatMasker,LTR,126329,126889,300,1.00
ptg032767l,363823,364154,331,RepeatMasker,LTR,361691,363891,68,0.21
ptg032767l,363823,364154,331,RepeatMasker,LTR,363273,364119,296,0.89
ptg032784l,238529,238816,287,RepeatMasker,LTR,238524,238829,287,1.00
ptg032830l,352056,352337,281,RepeatMasker,LTR,351682,352982,281,1.00
ptg032849l,104281,104594,313,RepeatMasker,LTR,104271,104380,99,0.32
ptg032966l,324647,324927,280,RepeatMasker,LTR,324265,324939,280,1.00
ptg033040l,207544,207792,248,RepeatMasker,LTR,205694,212842,248,1.00
ptg033096l,180339,180638,299,RepeatMasker,LTR,180576,180647,63,0.21
ptg033096l,180339,180638,299,RepeatMasker,LTR,179614,180362,23,0.08
ptg033102l,110905,111216,311,RepeatMasker,LTR,110620,110995,90,0.29
ptg033103l,112168,112448,280,RepeatMasker,LTR,111758,113092,280,1.00
ptg033161l,81240,81535,295,RepeatMasker,LTR,80886,82178,295,1.00
ptg033296l,64227,64508,281,RepeatMasker,LTR,63886,64521,281,1.00
ptg033362l,61874,62177,303,RepeatMasker,LTR,62142,63141,36,0.12
ptg033417l,207773,208068,295,RepeatMasker,LTR,207595,208120,295,1.00
ptg033440l,832868,833155,287,RepeatMasker,LTR,828170,834016,287,1.00
ptg033440l,1138837,1139125,288,RepeatMasker,LTR,1137967,1139796,288,1.00
ptg033469l,207036,207316,280,RepeatMasker,LTR,204511,207713,280,1.00
ptg033521l,3219,3516,297,RepeatMasker,LTR,3139,3568,297,1.00
ptg033648l,125911,126226,315,RepeatMasker,LTR,125912,126897,315,1.00
ptg033703l,273285,273584,299,RepeatMasker,LTR,273077,273636,299,1.00
ptg033933l,495627,495911,284,RepeatMasker,LTR,495802,495954,110,0.39
ptg034056l,167615,167913,298,RepeatMasker,LTR,167863,171047,51,0.17
ptg034080l,220981,221279,298,RepeatMasker,LTR,220798,221226,245,0.82
ptg034173l,126985,127309,324,RepeatMasker,LTR,126604,126995,10,0.03
ptg034173l,126985,127309,324,RepeatMasker,LTR,127014,128113,296,0.91
ptg034173l,142090,142371,281,RepeatMasker,LTR,141708,143018,281,1.00
ptg034183l,97415,97696,281,RepeatMasker,LTR,97033,98338,281,1.00
ptg034319l,60878,61159,281,RepeatMasker,LTR,60496,61192,281,1.00
ptg034323l,85097,85363,266,RepeatMasker,LTR,85157,85317,161,0.61
ptg034495l,707232,707523,291,RepeatMasker,LTR,707202,708105,291,1.00
ptg034588l,89282,89576,294,RepeatMasker,LTR,88905,90213,294,1.00
ptg034774l,182319,182605,286,RepeatMasker,LTR,181919,188530,286,1.00
ptg034816l,33044,33320,276,RepeatMasker,LTR,33153,40187,168,0.61
ptg034836l,7012,7289,277,RepeatMasker,LTR,6916,7324,277,1.00
ptg034978l,144826,145148,322,RepeatMasker,LTR,144440,145915,322,1.00
ptg034990l,424069,424348,279,RepeatMasker,LTR,422189,425998,279,1.00
ptg034990l,1203613,1203911,298,RepeatMasker,LTR,1203861,1204604,51,0.17
ptg035071l,50872,51207,335,RepeatMasker,LTR,51159,51303,49,0.15
ptg035260l,449170,449450,280,RepeatMasker,LTR,448788,449463,280,1.00
ptg035309l,101614,101900,286,RepeatMasker,LTR,100039,102751,286,1.00
ptg035327l,22789,23070,281,RepeatMasker,LTR,22390,23103,281,1.00
ptg035351l,200441,200751,310,RepeatMasker,LTR,199817,201575,310,1.00
ptg035427l,165841,166132,291,RepeatMasker,LTR,165458,166780,291,1.00
ptg035428l,36932,37213,281,RepeatMasker,LTR,32223,38072,281,1.00
ptg035535l,147004,147310,306,RepeatMasker,LTR,146185,147564,306,1.00
ptg035636l,2510466,2510780,314,RepeatMasker,LTR,2510755,2510805,26,0.08
ptg035669l,278754,279050,296,RepeatMasker,LTR,278373,278785,31,0.10
ptg035675l,118865,119167,302,RepeatMasker,LTR,118991,119303,177,0.59
ptg035703l,955595,955910,315,RepeatMasker,LTR,955697,958152,214,0.68
ptg035716l,1596646,1596932,286,RepeatMasker,LTR,1596257,1598868,286,1.00
ptg035734l,255544,255883,339,RepeatMasker,LTR,254418,255564,20,0.06
ptg035734l,255544,255883,339,RepeatMasker,LTR,255586,255896,298,0.88
ptg035801l,338216,338515,299,RepeatMasker,LTR,338196,338549,299,1.00
ptg035817l,79596,79891,295,RepeatMasker,LTR,79516,79943,295,1.00
ptg035838l,230174,230455,281,RepeatMasker,LTR,229032,230899,281,1.00
ptg035848l,116907,117207,300,RepeatMasker,LTR,116689,117035,128,0.43
ptg035983l,137915,138195,280,RepeatMasker,LTR,137604,138966,280,1.00
ptg035989l,572001,572280,279,RepeatMasker,LTR,571526,572047,46,0.16
ptg035989l,572001,572280,279,RepeatMasker,LTR,571870,572099,98,0.35
ptg036011l,174793,175111,318,RepeatMasker,LTR,174720,174906,113,0.36
ptg036152l,119803,120117,314,RepeatMasker,LTR,118592,119933,130,0.41
ptg036152l,119803,120117,314,RepeatMasker,LTR,120068,120718,50,0.16
ptg036179l,226953,227251,298,RepeatMasker,LTR,226588,228053,298,1.00
ptg036223l,188806,189122,316,RepeatMasker,LTR,187919,188919,113,0.36
ptg036262l,298212,298498,286,RepeatMasker,LTR,295986,299358,286,1.00
ptg036277l,28507,28801,294,RepeatMasker,LTR,28299,28853,294,1.00
ptg036290l,423521,423806,285,RepeatMasker,LTR,423122,427853,285,1.00
ptg036353l,65833,66119,286,RepeatMasker,LTR,62689,66961,286,1.00
ptg036453l,16605,16884,279,RepeatMasker,LTR,16284,17666,279,1.00
ptg036714l,708910,709198,288,RepeatMasker,LTR,709036,715794,163,0.57
ptg036723l,151920,152234,314,RepeatMasker,LTR,151669,152383,314,1.00
ptg036866l,2444822,2445103,281,RepeatMasker,LTR,2444462,2445135,281,1.00
ptg037129l,129387,129666,279,RepeatMasker,LTR,129005,130307,279,1.00
ptg037129l,132249,132529,280,RepeatMasker,LTR,131947,133303,280,1.00
ptg037173l,138597,138905,308,RepeatMasker,LTR,138116,138684,87,0.28
ptg037173l,138597,138905,308,RepeatMasker,LTR,138877,141852,29,0.09
ptg037218l,51128,51430,302,RepeatMasker,LTR,51205,51575,226,0.75
ptg037256l,30602,30899,297,RepeatMasker,LTR,30562,31392,297,1.00
ptg037256l,30602,30899,297,RepeatMasker,LTR,30806,31392,94,0.32
ptg037280l,192141,192393,252,RepeatMasker,LTR,187943,197436,252,1.00
ptg037358l,52385,52675,290,RepeatMasker,LTR,52442,53339,234,0.81
ptg037442l,98169,98499,330,RepeatMasker,LTR,97896,102404,330,1.00
ptg037477l,16393,16688,295,RepeatMasker,LTR,16218,16740,295,1.00
ptg037498l,299012,299329,317,RepeatMasker,LTR,299286,299936,44,0.14
ptg037656l,33564,33861,297,RepeatMasker,LTR,33356,33913,297,1.00
ptg037699l,127101,127423,322,RepeatMasker,LTR,127188,127227,40,0.12
ptg037699l,146660,146973,313,RepeatMasker,LTR,145385,148444,313,1.00
ptg037800l,392337,392637,300,RepeatMasker,LTR,392507,393888,131,0.44
ptg037800l,392337,392637,300,RepeatMasker,LTR,392549,394207,89,0.30
ptg037895l,749635,749922,287,RepeatMasker,LTR,748066,750513,287,1.00
ptg037939l,535895,536180,285,RepeatMasker,LTR,535619,537035,285,1.00
ptg037940l,53709,54008,299,RepeatMasker,LTR,53515,54060,299,1.00
ptg037964l,24920,25221,301,RepeatMasker,LTR,24964,28279,258,0.86
ptg038140l,4607,4915,308,RepeatMasker,LTR,4591,4715,108,0.35
ptg038144l,45591,45896,305,RepeatMasker,LTR,45044,46354,305,1.00
ptg038144l,45591,45896,305,RepeatMasker,LTR,45044,46661,305,1.00
ptg038181l,280030,280310,280,RepeatMasker,LTR,279648,280953,280,1.00
ptg038185l,47584,47891,307,RepeatMasker,LTR,46145,48345,307,1.00
ptg038227l,22285,22579,294,RepeatMasker,LTR,21251,22592,294,1.00
ptg038237l,2411487,2411786,299,RepeatMasker,LTR,2411294,2411838,299,1.00
ptg038237l,2504823,2505122,299,RepeatMasker,LTR,2504614,2505174,299,1.00
ptg038297l,31766,32096,330,RepeatMasker,LTR,31089,31780,14,0.04
ptg038328l,58529,58817,288,RepeatMasker,LTR,58350,59432,288,1.00
ptg038338l,179849,180130,281,RepeatMasker,LTR,179467,180165,281,1.00
ptg038389l,6687,6988,301,RepeatMasker,LTR,4176,6692,5,0.02
ptg038389l,6687,6988,301,RepeatMasker,LTR,6714,7173,275,0.91
ptg038417l,60966,61275,309,RepeatMasker,LTR,60792,61206,240,0.78
ptg038446l,223363,223643,280,RepeatMasker,LTR,222981,224289,280,1.00
ptg038673l,19738,20046,308,RepeatMasker,LTR,18869,19775,37,0.12
ptg038705l,61962,62259,297,RepeatMasker,LTR,61785,62311,297,1.00
ptg038801l,16338,16621,283,RepeatMasker,LTR,15949,17415,283,1.00
ptg038845l,212188,212468,280,RepeatMasker,LTR,211509,212481,280,1.00
ptg038850l,187433,187714,281,RepeatMasker,LTR,186296,187747,281,1.00
ptg038890l,135453,135742,289,RepeatMasker,LTR,135080,136381,289,1.00
ptg038912l,124972,125261,289,RepeatMasker,LTR,124094,125066,94,0.33
ptg038915l,3176,3459,283,RepeatMasker,LTR,383,3894,283,1.00
ptg038915l,98722,99001,279,RepeatMasker,LTR,98756,98818,63,0.23
ptg039082l,240807,241087,280,RepeatMasker,LTR,236348,241173,280,1.00
ptg039233l,71339,71587,248,RepeatMasker,LTR,67130,76644,248,1.00
ptg039362l,26346,26632,286,RepeatMasker,LTR,23576,30542,286,1.00
ptg039452l,1984497,1984803,306,RepeatMasker,LTR,1984756,1990965,48,0.16
ptg039662l,433730,434038,308,RepeatMasker,LTR,433907,434186,132,0.43
ptg039662l,1117638,1117919,281,RepeatMasker,LTR,1116591,1118701,281,1.00
ptg039662l,4102618,4102898,280,RepeatMasker,LTR,4102223,4102921,280,1.00
ptg039662l,4117600,4117889,289,RepeatMasker,LTR,4117314,4117927,289,1.00
ptg039662l,4345390,4345677,287,RepeatMasker,LTR,4345266,4346500,287,1.00
ptg040029l,11724,12037,313,RepeatMasker,LTR,11100,12525,313,1.00
ptg040204l,2961503,2961813,310,RepeatMasker,LTR,2961736,2962000,78,0.25
ptg040204l,2961503,2961813,310,RepeatMasker,LTR,2961756,2961988,58,0.19
ptg040328l,171196,171477,281,RepeatMasker,LTR,170889,172270,281,1.00
ptg040356l,17067,17347,280,RepeatMasker,LTR,16687,17970,280,1.00
ptg040380l,80133,80424,291,RepeatMasker,LTR,79791,83252,291,1.00
ptg040422l,185004,185303,299,RepeatMasker,LTR,184806,185355,299,1.00
ptg040502l,196230,196510,280,RepeatMasker,LTR,195850,197144,280,1.00
ptg040535l,34266,34554,288,RepeatMasker,LTR,34145,34390,124,0.43
ptg040703l,11089,11370,281,RepeatMasker,LTR,10791,11403,281,1.00
ptg040780l,1025,1300,275,RepeatMasker,LTR,1109,1861,192,0.70
ptg041005l,23529,23822,293,RepeatMasker,LTR,23364,23874,293,1.00
ptg041081l,51741,52067,326,RepeatMasker,LTR,50798,53257,326,1.00
ptg041347l,232753,233042,289,RepeatMasker,LTR,232732,232860,107,0.37
ptg041579l,2843,3124,281,RepeatMasker,LTR,2534,3915,281,1.00
ptg041778l,2414996,2415289,293,RepeatMasker,LTR,2414614,2416095,293,1.00
ptg041778l,2425706,2425995,289,RepeatMasker,LTR,2425333,2426644,289,1.00
ptg041801l,354732,355034,302,RepeatMasker,LTR,355005,355174,30,0.10
ptg041904l,56299,56580,281,RepeatMasker,LTR,55917,56593,281,1.00
ptg041984l,174010,174296,286,RepeatMasker,LTR,173631,175087,286,1.00
ptg042030l,361915,362186,271,RepeatMasker,LTR,361978,362336,209,0.77
ptg042262l,13033,13327,294,RepeatMasker,LTR,12853,13379,294,1.00
ptg042415l,819318,819621,303,RepeatMasker,LTR,819469,822711,153,0.50
ptg042415l,1367981,1368318,337,RepeatMasker,LTR,1368151,1375178,168,0.50
ptg042615l,106617,106935,318,RepeatMasker,LTR,105565,106627,10,0.03
ptg042615l,106617,106935,318,RepeatMasker,LTR,106635,106948,301,0.95
ptg042706l,287162,287470,308,RepeatMasker,LTR,287051,287254,92,0.30
ptg042824l,64304,64600,296,RepeatMasker,LTR,64232,65330,296,1.00
ptg042835l,78509,78808,299,RepeatMasker,LTR,78581,79674,228,0.76
ptg042944l,203126,203417,291,RepeatMasker,LTR,202680,203235,109,0.37
ptg043175l,113865,114145,280,RepeatMasker,LTR,113612,114945,280,1.00
ptg043251l,74260,74537,277,RepeatMasker,LTR,73867,74571,277,1.00
ptg043349l,268271,268577,306,RepeatMasker,LTR,268008,268308,37,0.12
ptg043672l,105675,105956,281,RepeatMasker,LTR,104695,106718,281,1.00
ptg043870l,74192,74487,295,RepeatMasker,LTR,73989,74539,295,1.00
ptg044028l,215916,216207,291,RepeatMasker,LTR,215654,216849,291,1.00
ptg044072l,85712,86000,288,RepeatMasker,LTR,83330,85963,251,0.87
ptg044162l,1102161,1102488,327,RepeatMasker,LTR,1101143,1103713,327,1.00
ptg044212l,56922,57230,308,RepeatMasker,LTR,57008,57072,65,0.21
ptg044475l,303741,304032,291,RepeatMasker,LTR,303375,306864,291,1.00
ptg044716l,61489,61779,290,RepeatMasker,LTR,61466,61512,23,0.08
ptg044788l,57041,57321,280,RepeatMasker,LTR,56659,57957,280,1.00
ptg044987l,568680,568961,281,RepeatMasker,LTR,567539,568990,281,1.00
ptg045146l,166,446,280,RepeatMasker,LTR,100,1095,280,1.00
ptg045146l,166,446,280,RepeatMasker,LTR,20,468,280,1.00
ptg045652l,550441,550728,287,RepeatMasker,LTR,548872,550835,287,1.00
ptg046020l,48852,49187,335,RepeatMasker,LTR,48783,48858,6,0.02
ptg046020l,48852,49187,335,RepeatMasker,LTR,48859,50135,329,0.98
ptg046153l,46810,47091,281,RepeatMasker,LTR,46428,47125,281,1.00
ptg046165l,36307,36608,301,RepeatMasker,LTR,36080,36660,301,1.00
ptg046350l,93796,94077,281,RepeatMasker,LTR,93413,94539,281,1.00
ptg046514l,67688,67951,263,RepeatMasker,LTR,67841,68370,111,0.42
ptg046538l,1387545,1387847,302,RepeatMasker,LTR,1387715,1389225,133,0.44
ptg046538l,1387545,1387847,302,RepeatMasker,LTR,1387765,1389098,83,0.27
ptg046574l,2062150,2062461,311,RepeatMasker,LTR,2062129,2062173,23,0.07
ptg046618l,17597,17897,300,RepeatMasker,LTR,17391,17949,300,1.00
ptg046633l,37586,37878,292,RepeatMasker,LTR,37220,40700,292,1.00
ptg047162l,11769,12062,293,RepeatMasker,LTR,11593,12114,293,1.00
ptg047372l,14204,14478,274,RepeatMasker,LTR,13939,14986,274,1.00
ptg047540l,19799,20110,311,RepeatMasker,LTR,19921,20004,84,0.27
ptg047540l,19799,20110,311,RepeatMasker,LTR,20055,20614,56,0.18
ptg047848l,34884,35200,316,RepeatMasker,LTR,34837,35231,316,1.00
ptg049042l,5551,5850,299,RepeatMasker,LTR,5382,5902,299,1.00
ptg049108l,22446,22729,283,RepeatMasker,LTR,22705,24559,25,0.09
ptg050038l,306926,307227,301,RepeatMasker,LTR,306750,307261,301,1.00
ptg050335l,43815,44125,310,RepeatMasker,LTR,43422,44158,310,1.00
ptg050335l,43815,44125,310,RepeatMasker,LTR,43828,44771,298,0.96
ptg050564l,61195,61490,295,RepeatMasker,LTR,60822,61503,295,1.00
ptg051007l,26611,26891,280,RepeatMasker,LTR,26595,27682,280,1.00
ptg051921l,385619,385919,300,RepeatMasker,LTR,385407,385970,300,1.00
ptg052222l,13335,13648,313,RepeatMasker,LTR,12746,13641,306,0.98
ptg052625l,40946,41247,301,RepeatMasker,LTR,40578,41892,301,1.00
ptg054119l,629,909,280,RepeatMasker,LTR,554,922,280,1.00
ptg054196l,226935,227234,299,RepeatMasker,LTR,226570,227247,299,1.00
ptg054642l,119185,119487,302,RepeatMasker,LTR,118420,121044,302,1.00
ptg054642l,119185,119487,302,RepeatMasker,LTR,119355,120737,133,0.44
ptg054646l,31944,32223,279,RepeatMasker,LTR,32183,32468,41,0.15
ptg054741l,12770,13077,307,RepeatMasker,LTR,12551,12778,8,0.03
ptg054741l,12770,13077,307,RepeatMasker,LTR,12927,13138,151,0.49
ptg055941l,27863,28166,303,RepeatMasker,LTR,27831,28409,303,1.00
ptg056172l,17909,18244,335,RepeatMasker,LTR,18162,18291,83,0.25
ptg056500l,1227,1507,280,RepeatMasker,LTR,845,2152,280,1.00
ptg057316l,2103,2397,294,RepeatMasker,LTR,1735,3189,294,1.00
ptg057408l,27605,27896,291,RepeatMasker,LTR,27314,27928,291,1.00
ptg057408l,27605,27896,291,RepeatMasker,LTR,27561,28541,291,1.00
ptg057618l,34723,35021,298,RepeatMasker,LTR,34734,35662,288,0.97
ptg057861l,11662,11943,281,RepeatMasker,LTR,11260,11956,281,1.00
ptg058107l,23704,23981,277,RepeatMasker,LTR,19501,23889,185,0.67
ptg058107l,23704,23981,277,RepeatMasker,LTR,23884,24866,98,0.35
ptg058446l,11104,11403,299,RepeatMasker,LTR,10924,11455,299,1.00
ptg058523l,23293,23591,298,RepeatMasker,LTR,23366,23799,226,0.76
ptg000002l,184842,185142,300,RepeatMasker,LTR,184790,185183,300,1.00
ptg000002l,1757469,1757782,313,RepeatMasker,LTR,1756012,1758593,313,1.00
ptg000002l,4304798,4305097,299,RepeatMasker,LTR,4304746,4305291,299,1.00
ptg000004l,2589753,2590047,294,RepeatMasker,LTR,2589742,2590395,294,1.00
ptg000004l,2596735,2597015,280,RepeatMasker,LTR,2595939,2597397,280,1.00
ptg000004l,2638325,2638605,280,RepeatMasker,LTR,2638313,2638990,280,1.00
ptg000005l,4323209,4323535,326,RepeatMasker,LTR,4323191,4323413,204,0.63
ptg000005l,7205266,7205547,281,RepeatMasker,LTR,7203999,7206482,281,1.00
ptg000006l,3774075,3774384,309,RepeatMasker,LTR,3774133,3774347,215,0.70
ptg000006l,5058099,5058423,324,RepeatMasker,LTR,5057298,5058791,324,1.00
ptg000010l,933465,933792,327,RepeatMasker,LTR,930319,934084,327,1.00
ptg000011l,881636,881936,300,RepeatMasker,LTR,881643,882961,294,0.98
ptg000012l,192208,192505,297,RepeatMasker,LTR,192156,192683,297,1.00
ptg000014l,1613814,1614112,298,RepeatMasker,LTR,1613024,1615143,298,1.00
ptg000015l,2153023,2153343,320,RepeatMasker,LTR,2153173,2153938,171,0.53
ptg000018l,719804,720127,323,RepeatMasker,LTR,719331,721549,323,1.00
ptg000020l,487621,487907,286,RepeatMasker,LTR,487884,487928,24,0.08
ptg000020l,1719117,1719430,313,RepeatMasker,LTR,1719228,1719883,203,0.65
ptg000023l,2374781,2375060,279,RepeatMasker,LTR,2372736,2374913,132,0.47
ptg000037l,321175,321474,299,RepeatMasker,LTR,321123,321652,299,1.00
ptg000037l,2708761,2709050,289,RepeatMasker,LTR,2708709,2709091,289,1.00
ptg000039l,360481,360804,323,RepeatMasker,LTR,360700,361061,105,0.33
ptg000039l,4383643,4383946,303,RepeatMasker,LTR,4383876,4384168,71,0.23
ptg000042l,1429813,1430120,307,RepeatMasker,LTR,1428945,1430365,307,1.00
ptg000044l,451840,452165,325,RepeatMasker,LTR,452125,452267,41,0.13
ptg000046l,515125,515397,272,RepeatMasker,LTR,515111,515317,192,0.71
ptg000046l,515125,515397,272,RepeatMasker,LTR,515222,515892,176,0.65
ptg000048l,4169851,4170132,281,RepeatMasker,LTR,4169208,4171176,281,1.00
ptg000048l,6208551,6208864,313,RepeatMasker,LTR,6207488,6210464,313,1.00
ptg000048l,7927842,7928138,296,RepeatMasker,LTR,7927790,7928361,296,1.00
ptg000048l,11334589,11334906,317,RepeatMasker,LTR,11334315,11334854,265,0.84
ptg000048l,11393754,11394020,266,RepeatMasker,LTR,11393828,11393897,70,0.26
ptg000048l,11393754,11394020,266,RepeatMasker,LTR,11393906,11396677,115,0.43
ptg000052l,56468,56766,298,RepeatMasker,LTR,56416,56980,298,1.00
ptg000052l,967130,967418,288,RepeatMasker,LTR,967123,967353,223,0.77
ptg000052l,967130,967418,288,RepeatMasker,LTR,967227,967865,192,0.67
ptg000056l,1193817,1194108,291,RepeatMasker,LTR,1193030,1194479,291,1.00
ptg000058l,225006,225305,299,RepeatMasker,LTR,224954,225483,299,1.00
ptg000061l,1341860,1342140,280,RepeatMasker,LTR,1341078,1343191,280,1.00
ptg000061l,1811982,1812282,300,RepeatMasker,LTR,1811930,1812475,300,1.00
ptg000062l,1723766,1724099,333,RepeatMasker,LTR,1724021,1724603,79,0.24
ptg000064l,88982,89299,317,RepeatMasker,LTR,87683,89556,317,1.00
ptg000066l,261337,261629,292,RepeatMasker,LTR,260111,261995,292,1.00
ptg000066l,557358,557657,299,RepeatMasker,LTR,557306,557835,299,1.00
ptg000066l,669445,669744,299,RepeatMasker,LTR,669393,669921,299,1.00
ptg000066l,707337,707636,299,RepeatMasker,LTR,707285,707813,299,1.00
ptg000066l,863073,863372,299,RepeatMasker,LTR,863021,863550,299,1.00
ptg000071l,1199785,1200087,302,RepeatMasker,LTR,1199533,1199950,165,0.55
ptg000071l,2280143,2280428,285,RepeatMasker,LTR,2279420,2285038,285,1.00
ptg000080l,294944,295238,294,RepeatMasker,LTR,294298,295611,294,1.00
ptg000080l,302079,302372,293,RepeatMasker,LTR,301280,302753,293,1.00
ptg000080l,769614,769899,285,RepeatMasker,LTR,769859,770233,41,0.14
ptg000080l,1494609,1494889,280,RepeatMasker,LTR,1494575,1495276,280,1.00
ptg000080l,1501763,1502043,280,RepeatMasker,LTR,1501729,1502425,280,1.00
ptg000080l,2459292,2459572,280,RepeatMasker,LTR,2458654,2460149,280,1.00
ptg000080l,2464375,2464671,296,RepeatMasker,LTR,2463591,2465669,296,1.00
ptg000080l,3233117,3233398,281,RepeatMasker,LTR,3233104,3233797,281,1.00
ptg000082l,3886476,3886791,315,RepeatMasker,LTR,3886607,3887070,185,0.59
ptg000084l,3542318,3542648,330,RepeatMasker,LTR,3542268,3542416,98,0.30
ptg000089l,1753396,1753676,280,RepeatMasker,LTR,1753368,1754057,280,1.00
ptg000091l,226362,226671,309,RepeatMasker,LTR,225769,226410,48,0.16
ptg000091l,226362,226671,309,RepeatMasker,LTR,226408,231663,264,0.85
ptg000093l,48352,48650,298,RepeatMasker,LTR,47562,48615,263,0.88
ptg000093l,48352,48650,298,RepeatMasker,LTR,48597,49385,54,0.18
ptg000094l,3063532,3063832,300,RepeatMasker,LTR,3063480,3063912,300,1.00
ptg000094l,3226180,3226479,299,RepeatMasker,LTR,3226128,3226657,299,1.00
ptg000094l,7634743,7635068,325,RepeatMasker,LTR,7634869,7635320,200,0.62
ptg000096l,386963,387253,290,RepeatMasker,LTR,387242,389197,12,0.04
ptg000097l,1515822,1516103,281,RepeatMasker,LTR,1515030,1517149,281,1.00
ptg000098l,2905524,2905822,298,RepeatMasker,LTR,2905491,2906138,298,1.00
ptg000105l,591025,591321,296,RepeatMasker,LTR,591297,591341,25,0.08
ptg000107l,9468560,9468881,321,RepeatMasker,LTR,9468264,9468585,25,0.08
ptg000107l,9468560,9468881,321,RepeatMasker,LTR,9468848,9468975,34,0.11
ptg000109l,630356,630655,299,RepeatMasker,LTR,630304,630820,299,1.00
ptg000109l,801732,802031,299,RepeatMasker,LTR,801680,802111,299,1.00
ptg000109l,2522137,2522418,281,RepeatMasker,LTR,2521483,2522800,281,1.00
ptg000110l,1830647,1830927,280,RepeatMasker,LTR,1830634,1831974,280,1.00
ptg000118l,1134679,1135009,330,RepeatMasker,LTR,1130296,1136088,330,1.00
ptg000118l,1794033,1794323,290,RepeatMasker,LTR,1793665,1794340,290,1.00
ptg000119l,71442,71769,327,RepeatMasker,LTR,70958,71495,53,0.16
ptg000119l,650579,650871,292,RepeatMasker,LTR,647746,651211,292,1.00
ptg000121l,407805,408096,291,RepeatMasker,LTR,407644,408563,291,1.00
ptg000122l,1730259,1730569,310,RepeatMasker,LTR,1730420,1730738,150,0.48
ptg000122l,1730259,1730569,310,RepeatMasker,LTR,1730421,1730920,149,0.48
ptg000123l,3146470,3146766,296,RepeatMasker,LTR,3146321,3146762,292,0.99
ptg000124l,118156,118473,317,RepeatMasker,LTR,118210,119150,264,0.83
ptg000125l,285803,286101,298,RepeatMasker,LTR,285771,286063,260,0.87
ptg000126l,1242025,1242320,295,RepeatMasker,LTR,1241991,1242340,295,1.00
ptg000132l,1188076,1188358,282,RepeatMasker,LTR,1187111,1188111,35,0.12
ptg000138l,508577,508888,311,RepeatMasker,LTR,508851,512465,38,0.12
ptg000138l,1811153,1811446,293,RepeatMasker,LTR,1811101,1811663,293,1.00
ptg000142l,1992862,1993155,293,RepeatMasker,LTR,1992836,1993042,180,0.61
ptg000148l,2180944,2181236,292,RepeatMasker,LTR,2180608,2181106,162,0.55
ptg000150l,1289238,1289540,302,RepeatMasker,LTR,1289234,1289293,55,0.18
ptg000152l,1061636,1061934,298,RepeatMasker,LTR,1061584,1062102,298,1.00
ptg000155l,2442500,2442823,323,RepeatMasker,LTR,2441267,2442621,121,0.37
ptg000156l,3804229,3804528,299,RepeatMasker,LTR,3804195,3804569,299,1.00
ptg000156l,6435400,6435685,285,RepeatMasker,LTR,6435662,6435706,24,0.08
ptg000157l,2306542,2306841,299,RepeatMasker,LTR,2306490,2306922,299,1.00
ptg000160l,1006139,1006428,289,RepeatMasker,LTR,1006222,1006407,186,0.64
ptg000160l,1006139,1006428,289,RepeatMasker,LTR,1006267,1006478,162,0.56
ptg000160l,1663330,1663640,310,RepeatMasker,LTR,1663321,1663397,67,0.22
ptg000161l,2221964,2222250,286,RepeatMasker,LTR,2221125,2225286,286,1.00
ptg000170l,2201292,2201600,308,RepeatMasker,LTR,2199955,2201588,296,0.96
ptg000175l,767436,767752,316,RepeatMasker,LTR,762840,767639,203,0.64
ptg000177l,2681862,2682147,285,RepeatMasker,LTR,2681008,2682737,285,1.00
ptg000180l,7383111,7383410,299,RepeatMasker,LTR,7383059,7383593,299,1.00
ptg000184l,564282,564562,280,RepeatMasker,LTR,563648,564958,280,1.00
ptg000186l,7297316,7297656,340,RepeatMasker,LTR,7290422,7297510,194,0.57
ptg000190l,386470,386753,283,RepeatMasker,LTR,385839,387074,283,1.00
ptg000193l,290479,290759,280,RepeatMasker,LTR,290466,291904,280,1.00
ptg000193l,1248171,1248452,281,RepeatMasker,LTR,1247525,1248836,281,1.00
ptg000200l,36391,36718,327,RepeatMasker,LTR,36622,37200,97,0.30
ptg000201l,429289,429593,304,RepeatMasker,LTR,426896,431326,304,1.00
ptg000205l,11650,11978,328,RepeatMasker,LTR,11259,12609,328,1.00
ptg000206l,2992153,2992434,281,RepeatMasker,LTR,2991511,2992826,281,1.00
ptg000207l,304458,304761,303,RepeatMasker,LTR,300884,305070,303,1.00
ptg000208l,724963,725299,336,RepeatMasker,LTR,724911,725438,336,1.00
ptg000208l,773107,773403,296,RepeatMasker,LTR,773055,773581,296,1.00
ptg000210l,5028185,5028506,321,RepeatMasker,LTR,5027798,5028278,93,0.29
ptg000215l,2825293,2825572,279,RepeatMasker,LTR,2825235,2825366,73,0.26
ptg000217l,1448955,1449281,326,RepeatMasker,LTR,1447616,1450250,326,1.00
ptg000218l,98027,98345,318,RepeatMasker,LTR,97451,98224,197,0.62
ptg000218l,98027,98345,318,RepeatMasker,LTR,98243,98457,103,0.32
ptg000219l,4345066,4345360,294,RepeatMasker,LTR,4344101,4345086,20,0.07
ptg000221l,1391322,1391624,302,RepeatMasker,LTR,1390782,1393778,302,1.00
ptg000231l,468824,469119,295,RepeatMasker,LTR,468682,469612,295,1.00
ptg000234l,640824,641143,319,RepeatMasker,LTR,639728,640986,162,0.51
ptg000234l,640824,641143,319,RepeatMasker,LTR,640974,642253,170,0.53
ptg000234l,640824,641143,319,RepeatMasker,LTR,640986,642092,158,0.50
ptg000234l,2884542,2884818,276,RepeatMasker,LTR,2881879,2884599,57,0.21
ptg000234l,3447174,3447466,292,RepeatMasker,LTR,3446474,3447801,292,1.00
ptg000236l,2436789,2437069,280,RepeatMasker,LTR,2436165,2437378,280,1.00
ptg000240l,886990,887269,279,RepeatMasker,LTR,886957,887015,25,0.09
ptg000240l,886990,887269,279,RepeatMasker,LTR,886979,887047,57,0.20
ptg000241l,2148578,2148864,286,RepeatMasker,LTR,2148841,2148885,24,0.08
ptg000243l,1130447,1130741,294,RepeatMasker,LTR,1130681,1131736,61,0.21
ptg000243l,1130447,1130741,294,RepeatMasker,LTR,1128227,1130587,140,0.48
ptg000244l,5403113,5403404,291,RepeatMasker,LTR,5402566,5403114,1,0.00
ptg000244l,5403113,5403404,291,RepeatMasker,LTR,5402708,5403114,1,0.00
ptg000247l,1114004,1114308,304,RepeatMasker,LTR,1113888,1114171,167,0.55
ptg000247l,1114004,1114308,304,RepeatMasker,LTR,1113970,1114142,138,0.45
ptg000248l,1961221,1961521,300,RepeatMasker,LTR,1961169,1961702,300,1.00
ptg000248l,2294179,2294454,275,RepeatMasker,LTR,2293745,2297246,275,1.00
ptg000255l,967709,968021,312,RepeatMasker,LTR,967820,967922,103,0.33
ptg000255l,967709,968021,312,RepeatMasker,LTR,967925,968022,97,0.31
ptg000257l,1459858,1460178,320,RepeatMasker,LTR,1458055,1459908,50,0.16
ptg000258l,3045004,3045284,280,RepeatMasker,LTR,3044209,3046337,280,1.00
ptg000261l,817632,817913,281,RepeatMasker,LTR,816829,818295,281,1.00
ptg000267l,3678373,3678672,299,RepeatMasker,LTR,3678321,3678851,299,1.00
ptg000267l,6627569,6627864,295,RepeatMasker,LTR,6627517,6628057,295,1.00
ptg000268l,521678,521961,283,RepeatMasker,LTR,521693,521806,114,0.40
ptg000268l,521678,521961,283,RepeatMasker,LTR,521907,522597,55,0.19
ptg000270l,1880420,1880707,287,RepeatMasker,LTR,1879569,1882271,287,1.00
ptg000273l,2243678,2243977,299,RepeatMasker,LTR,2243626,2244159,299,1.00
ptg000276l,5507256,5507534,278,RepeatMasker,LTR,5506615,5507919,278,1.00
ptg000280l,207660,207975,315,RepeatMasker,LTR,207745,208269,231,0.73
ptg000281l,318802,319099,297,RepeatMasker,LTR,318789,319891,297,1.00
ptg000282l,1473197,1473477,280,RepeatMasker,LTR,1472556,1473855,280,1.00
ptg000282l,4234536,4234822,286,RepeatMasker,LTR,4233042,4235221,286,1.00
ptg000283l,4841828,4842156,328,RepeatMasker,LTR,4841358,4842978,328,1.00
ptg000284l,541225,541529,304,RepeatMasker,LTR,540260,541245,20,0.07
ptg000286l,381120,381419,299,RepeatMasker,LTR,381068,381597,299,1.00
ptg000291l,983964,984263,299,RepeatMasker,LTR,983912,984443,299,1.00
ptg000291l,2775079,2775359,280,RepeatMasker,LTR,2775046,2775375,280,1.00
ptg000291l,3706708,3707010,302,RepeatMasker,LTR,3705135,3707765,302,1.00
ptg000291l,3706708,3707010,302,RepeatMasker,LTR,3705468,3706840,132,0.44
ptg000297l,2413364,2413660,296,RepeatMasker,LTR,2410780,2414557,296,1.00
ptg000297l,2447001,2447322,321,RepeatMasker,LTR,2447005,2447070,66,0.21
ptg000298l,1888180,1888479,299,RepeatMasker,LTR,1888128,1888657,299,1.00
ptg000300l,188485,188784,299,RepeatMasker,LTR,188433,188868,299,1.00
ptg000300l,1202329,1202622,293,RepeatMasker,LTR,1199279,1202355,26,0.09
ptg000305l,1698027,1698326,299,RepeatMasker,LTR,1697975,1698504,299,1.00
ptg000305l,1924217,1924508,291,RepeatMasker,LTR,1923959,1925522,291,1.00
ptg000305l,2328238,2328537,299,RepeatMasker,LTR,2328186,2328702,299,1.00
ptg000307l,850505,850804,299,RepeatMasker,LTR,850453,850982,299,1.00
ptg000307l,1050182,1050481,299,RepeatMasker,LTR,1050130,1050649,299,1.00
ptg000311l,663913,664171,258,RepeatMasker,LTR,663906,664923,258,1.00
ptg000313l,3000702,3001009,307,RepeatMasker,LTR,2999950,3003017,307,1.00
ptg000320l,1967518,1967816,298,RepeatMasker,LTR,1966773,1967547,29,0.10
ptg000321l,600986,601293,307,RepeatMasker,LTR,600352,601680,307,1.00
ptg000321l,1120520,1120768,248,RepeatMasker,LTR,1115444,1124970,248,1.00
ptg000322l,129039,129347,308,RepeatMasker,LTR,126584,129375,308,1.00
ptg000322l,3716161,3716506,345,RepeatMasker,LTR,3716184,3716233,50,0.14
ptg000323l,707445,707734,289,RepeatMasker,LTR,707393,707936,289,1.00
ptg000323l,901447,901746,299,RepeatMasker,LTR,900150,902256,299,1.00
ptg000325l,840691,841023,332,RepeatMasker,LTR,840807,840857,51,0.15
ptg000327l,346449,346765,316,RepeatMasker,LTR,346649,346886,117,0.37
ptg000330l,778457,778756,299,RepeatMasker,LTR,778410,778922,299,1.00
ptg000336l,903715,903985,270,RepeatMasker,LTR,903072,903905,190,0.70
ptg000337l,3680732,3681042,310,RepeatMasker,LTR,3680688,3680995,263,0.85
ptg000337l,3680732,3681042,310,RepeatMasker,LTR,3680745,3680995,251,0.81
ptg000337l,7072159,7072474,315,RepeatMasker,LTR,7072107,7072605,315,1.00
ptg000337l,7887170,7887469,299,RepeatMasker,LTR,7887124,7887510,299,1.00
ptg000337l,8668861,8669155,294,RepeatMasker,LTR,8668809,8669333,294,1.00
ptg000337l,10508770,10509067,297,RepeatMasker,LTR,10508718,10509271,297,1.00
ptg000337l,10812902,10813201,299,RepeatMasker,LTR,10812868,10813199,297,0.99
ptg000341l,109772,110067,295,RepeatMasker,LTR,109720,110260,295,1.00
ptg000341l,486430,486729,299,RepeatMasker,LTR,486379,486938,299,1.00
ptg000341l,710151,710448,297,RepeatMasker,LTR,710099,710642,297,1.00
ptg000348l,334265,334591,326,RepeatMasker,LTR,334468,334588,121,0.37
ptg000348l,334265,334591,326,RepeatMasker,LTR,334576,334756,16,0.05
ptg000348l,2047082,2047384,302,RepeatMasker,LTR,2046740,2048137,302,1.00
ptg000349l,1224459,1224758,299,RepeatMasker,LTR,1224407,1224936,299,1.00
ptg000349l,1702930,1703224,294,RepeatMasker,LTR,1702878,1703304,294,1.00
ptg000351l,1346326,1346618,292,RepeatMasker,LTR,1344374,1346956,292,1.00
ptg000355l,3473032,3473323,291,RepeatMasker,LTR,3472980,3473518,291,1.00
ptg000359l,3708860,3709123,263,RepeatMasker,LTR,3708555,3709109,249,0.95
ptg000359l,5317434,5317734,300,RepeatMasker,LTR,5315878,5317484,50,0.17
ptg000359l,5511903,5512224,321,RepeatMasker,LTR,5512080,5512873,145,0.45
ptg000360l,4428658,4428801,143,RepeatMasker,LTR,4428645,4429970,143,1.00
ptg000364l,253526,253816,290,RepeatMasker,LTR,253524,253614,88,0.30
ptg000364l,253526,253816,290,RepeatMasker,LTR,253577,254331,240,0.83
ptg000365l,2391800,2392099,299,RepeatMasker,LTR,2391748,2392179,299,1.00
ptg000367l,843153,843469,316,RepeatMasker,LTR,843141,843449,296,0.94
ptg000367l,843153,843469,316,RepeatMasker,LTR,843452,843779,18,0.06
ptg000368l,1021215,1021498,283,RepeatMasker,LTR,1020935,1021370,155,0.55
ptg000372l,316529,316835,306,RepeatMasker,LTR,314683,317380,306,1.00
ptg000373l,1013522,1013809,287,RepeatMasker,LTR,1012662,1014045,287,1.00
ptg000377l,1416217,1416533,316,RepeatMasker,LTR,1415375,1418939,316,1.00
ptg000381l,601344,601667,323,RepeatMasker,LTR,601092,601536,192,0.59
ptg000383l,2974823,2975110,287,RepeatMasker,LTR,2973968,2979738,287,1.00
ptg000384l,219667,219947,280,RepeatMasker,LTR,217408,223141,280,1.00
ptg000392l,885033,885355,322,RepeatMasker,LTR,883296,888208,322,1.00
ptg000392l,1001876,1002124,248,RepeatMasker,LTR,996821,1006326,248,1.00
ptg000395l,728697,728969,272,RepeatMasker,LTR,728662,728807,110,0.40
ptg000397l,1190910,1191222,312,RepeatMasker,LTR,1189802,1195626,312,1.00
ptg000405l,806690,806988,298,RepeatMasker,LTR,805681,807748,298,1.00
ptg000405l,813513,813818,305,RepeatMasker,LTR,812729,814836,305,1.00
ptg000405l,813898,814197,299,RepeatMasker,LTR,812729,814836,299,1.00
ptg000407l,8909323,8909610,287,RepeatMasker,LTR,8908494,8914298,287,1.00
ptg000408l,6055314,6055608,294,RepeatMasker,LTR,6055262,6055826,294,1.00
ptg000410l,1533134,1533432,298,RepeatMasker,LTR,1533082,1533512,298,1.00
ptg000412l,1137858,1138178,320,RepeatMasker,LTR,1137236,1137908,50,0.16
ptg000412l,1200762,1201048,286,RepeatMasker,LTR,1194643,1201448,286,1.00
ptg000413l,426385,426699,314,RepeatMasker,LTR,426112,426904,314,1.00
ptg000413l,426385,426699,314,RepeatMasker,LTR,426126,426813,314,1.00
ptg000413l,636108,636393,285,RepeatMasker,LTR,636370,636414,24,0.08
ptg000414l,1123766,1124061,295,RepeatMasker,LTR,1123714,1124239,295,1.00
ptg000420l,848202,848501,299,RepeatMasker,LTR,848150,848709,299,1.00
ptg000421l,483063,483354,291,RepeatMasker,LTR,482730,483215,152,0.52
ptg000434l,605022,605336,314,RepeatMasker,LTR,605133,605178,46,0.15
ptg000434l,1763150,1763452,302,RepeatMasker,LTR,1762607,1763688,302,1.00
ptg000440l,441100,441400,300,RepeatMasker,LTR,441225,442542,176,0.59
ptg000445l,3195549,3195838,289,RepeatMasker,LTR,3195497,3195858,289,1.00
ptg000445l,4812939,4813238,299,RepeatMasker,LTR,4812887,4813414,299,1.00
ptg000450l,1996026,1996325,299,RepeatMasker,LTR,1995974,1996490,299,1.00
ptg000450l,2277597,2277889,292,RepeatMasker,LTR,2277551,2277930,292,1.00
ptg000450l,2499853,2500146,293,RepeatMasker,LTR,2499801,2500226,293,1.00
ptg000450l,2555571,2555868,297,RepeatMasker,LTR,2555519,2556060,297,1.00
ptg000451l,3532948,3533257,309,RepeatMasker,LTR,3532974,3533233,260,0.84
ptg000451l,4698454,4698752,298,RepeatMasker,LTR,4697408,4698888,298,1.00
ptg000452l,4439539,4439823,284,RepeatMasker,LTR,4439703,4439774,72,0.25
ptg000454l,2582064,2582367,303,RepeatMasker,LTR,2581975,2582253,189,0.62
ptg000454l,2582064,2582367,303,RepeatMasker,LTR,2582201,2582262,62,0.20
ptg000460l,702480,702779,299,RepeatMasker,LTR,702428,702986,299,1.00
ptg000472l,1641686,1641978,292,RepeatMasker,LTR,1641743,1642276,236,0.81
ptg000474l,269719,270028,309,RepeatMasker,LTR,269500,269725,6,0.02
ptg000478l,842797,843078,281,RepeatMasker,LTR,842765,843387,281,1.00
ptg000483l,1230095,1230375,280,RepeatMasker,LTR,1229297,1230752,280,1.00
ptg000483l,1809701,1810011,310,RepeatMasker,LTR,1809903,1810041,109,0.35
ptg000484l,2324238,2324537,299,RepeatMasker,LTR,2324186,2324557,299,1.00
ptg000484l,4060683,4060976,293,RepeatMasker,LTR,4060631,4061154,293,1.00
ptg000491l,663728,664029,301,RepeatMasker,LTR,663648,663820,92,0.31
ptg000491l,663728,664029,301,RepeatMasker,LTR,663744,663877,134,0.45
ptg000491l,2117253,2117564,311,RepeatMasker,LTR,2117458,2117580,107,0.34
ptg000502l,948277,948584,307,RepeatMasker,LTR,948491,948641,94,0.31
ptg000502l,3132792,3133091,299,RepeatMasker,LTR,3132740,3133171,299,1.00
ptg000503l,99655,99989,334,RepeatMasker,LTR,99818,100389,172,0.51
ptg000505l,731132,731419,287,RepeatMasker,LTR,730277,733633,287,1.00
ptg000511l,6923029,6923338,309,RepeatMasker,LTR,6921630,6923265,236,0.76
ptg000513l,301971,302263,292,RepeatMasker,LTR,295784,302021,50,0.17
ptg000513l,707115,707430,315,RepeatMasker,LTR,706817,707262,147,0.47
ptg000513l,707115,707430,315,RepeatMasker,LTR,707262,707487,169,0.54
ptg000515l,1944076,1944375,299,RepeatMasker,LTR,1944024,1944552,299,1.00
ptg000515l,2113315,2113624,309,RepeatMasker,LTR,2112672,2113611,296,0.96
ptg000518l,855029,855355,326,RepeatMasker,LTR,855213,855284,72,0.22
ptg000518l,855029,855355,326,RepeatMasker,LTR,855224,855261,38,0.12
ptg000518l,975291,975568,277,RepeatMasker,LTR,975169,975300,9,0.03
ptg000518l,975291,975568,277,RepeatMasker,LTR,975301,977892,268,0.97
ptg000519l,10501040,10501351,311,RepeatMasker,LTR,10500818,10501708,311,1.00
ptg000519l,11363923,11364218,295,RepeatMasker,LTR,11363871,11364396,295,1.00
ptg000519l,11611916,11612212,296,RepeatMasker,LTR,11611909,11611958,42,0.14
ptg000520l,1607931,1608217,286,RepeatMasker,LTR,1607097,1612639,286,1.00
ptg000520l,1891519,1891796,277,RepeatMasker,LTR,1891529,1895221,268,0.97
ptg000522l,2182769,2183079,310,RepeatMasker,LTR,2182671,2183580,310,1.00
ptg000523l,889088,889387,299,RepeatMasker,LTR,887165,891158,299,1.00
ptg000523l,3857662,3857947,285,RepeatMasker,LTR,3856244,3857842,180,0.63
ptg000523l,4912951,4913232,281,RepeatMasker,LTR,4912148,4913621,281,1.00
ptg000526l,78002,78300,298,RepeatMasker,LTR,77286,79954,298,1.00
ptg000526l,575273,575579,306,RepeatMasker,LTR,574850,575312,39,0.13
ptg000526l,575273,575579,306,RepeatMasker,LTR,574871,575370,97,0.32
ptg000526l,575273,575579,306,RepeatMasker,LTR,575496,576389,84,0.27
ptg000526l,2959731,2960023,292,RepeatMasker,LTR,2959679,2960231,292,1.00
ptg000528l,1219146,1219444,298,RepeatMasker,LTR,1217230,1222742,298,1.00
ptg000528l,3134192,3134491,299,RepeatMasker,LTR,3134140,3134669,299,1.00
ptg000531l,1508152,1508468,316,RepeatMasker,LTR,1508077,1508445,293,0.93
ptg000539l,421137,421436,299,RepeatMasker,LTR,421085,421630,299,1.00
ptg000550l,2126723,2127025,302,RepeatMasker,LTR,2126284,2126774,51,0.17
ptg000555l,396284,396583,299,RepeatMasker,LTR,396232,396748,299,1.00
ptg000559l,1076265,1076560,295,RepeatMasker,LTR,1076213,1076738,295,1.00
ptg000559l,3057066,3057364,298,RepeatMasker,LTR,3057014,3057444,298,1.00
ptg000563l,1880383,1880678,295,RepeatMasker,LTR,1880349,1880395,12,0.04
ptg000566l,1794607,1794935,328,RepeatMasker,LTR,1793197,1794810,203,0.62
ptg000567l,768844,769124,280,RepeatMasker,LTR,766605,769172,280,1.00
ptg000576l,3059569,3059881,312,RepeatMasker,LTR,3059679,3060153,203,0.65
ptg000586l,302091,302406,315,RepeatMasker,LTR,302058,302784,315,1.00
ptg000586l,1741141,1741461,320,RepeatMasker,LTR,1741275,1741404,130,0.41
ptg000586l,1741141,1741461,320,RepeatMasker,LTR,1741287,1741402,116,0.36
ptg000588l,1059921,1060239,318,RepeatMasker,LTR,1059786,1060057,136,0.43
ptg000588l,1059921,1060239,318,RepeatMasker,LTR,1060091,1060168,78,0.25
ptg000592l,2092360,2092652,292,RepeatMasker,LTR,2089527,2093018,292,1.00
ptg000596l,171686,171986,300,RepeatMasker,LTR,171634,172164,300,1.00
ptg000607l,6180351,6180628,277,RepeatMasker,LTR,6179512,6180845,277,1.00
ptg000608l,206298,206600,302,RepeatMasker,LTR,206050,206324,26,0.09
ptg000612l,2994061,2994374,313,RepeatMasker,LTR,2993869,2996063,313,1.00
ptg000613l,1927797,1928096,299,RepeatMasker,LTR,1927746,1928308,299,1.00
ptg000613l,5539867,5540148,281,RepeatMasker,LTR,5539068,5540541,281,1.00
ptg000618l,1450521,1450814,293,RepeatMasker,LTR,1450594,1451109,221,0.75
ptg000620l,3247101,3247409,308,RepeatMasker,LTR,3247000,3248307,308,1.00
ptg000620l,3533105,3533403,298,RepeatMasker,LTR,3533059,3533444,298,1.00
ptg000624l,695169,695469,300,RepeatMasker,LTR,695202,695764,268,0.89
ptg000627l,9209431,9209730,299,RepeatMasker,LTR,9209379,9209937,299,1.00
ptg000627l,10192383,10192694,311,RepeatMasker,LTR,10191985,10192479,96,0.31
ptg000627l,10192383,10192694,311,RepeatMasker,LTR,10192555,10195764,140,0.45
ptg000630l,3200560,3200859,299,RepeatMasker,LTR,3200301,3204428,299,1.00
ptg000632l,2675066,2675392,326,RepeatMasker,LTR,2675357,2676301,36,0.11
ptg000633l,4168095,4168380,285,RepeatMasker,LTR,4168243,4168284,42,0.15
ptg000640l,261642,261932,290,RepeatMasker,LTR,261590,261973,290,1.00
ptg000640l,279177,279470,293,RepeatMasker,LTR,279131,279501,293,1.00
ptg000640l,905121,905416,295,RepeatMasker,LTR,905069,905620,295,1.00
ptg000640l,941862,942155,293,RepeatMasker,LTR,941810,942362,293,1.00
ptg000642l,18985,19301,316,RepeatMasker,LTR,18314,20571,316,1.00
ptg000642l,1895572,1895871,299,RepeatMasker,LTR,1895848,1895900,24,0.08
ptg000645l,1670783,1671064,281,RepeatMasker,LTR,1670771,1671445,281,1.00
ptg000653l,2852792,2853073,281,RepeatMasker,LTR,2852759,2853455,281,1.00
ptg000654l,206838,207137,299,RepeatMasker,LTR,206618,206854,16,0.05
ptg000654l,206838,207137,299,RepeatMasker,LTR,206802,206876,38,0.13
ptg000655l,1507559,1507894,335,RepeatMasker,LTR,1507717,1510645,178,0.53
ptg000655l,1507559,1507894,335,RepeatMasker,LTR,1507073,1507560,1,0.00
ptg000656l,1049632,1049918,286,RepeatMasker,LTR,1048773,1052405,286,1.00
ptg000658l,1519684,1519980,296,RepeatMasker,LTR,1519630,1520003,296,1.00
ptg000664l,2530551,2530873,322,RepeatMasker,LTR,2530777,2531350,97,0.30
ptg000665l,3070624,3070921,297,RepeatMasker,LTR,3069998,3071966,297,1.00
ptg000665l,9004922,9005221,299,RepeatMasker,LTR,9004870,9005388,299,1.00
ptg000665l,9355616,9355921,305,RepeatMasker,LTR,9355893,9356227,29,0.10
ptg000670l,173424,173721,297,RepeatMasker,LTR,173372,173902,297,1.00
ptg000670l,192481,192774,293,RepeatMasker,LTR,192429,192937,293,1.00
ptg000670l,2663741,2664058,317,RepeatMasker,LTR,2663899,2663987,89,0.28
ptg000674l,882880,883179,299,RepeatMasker,LTR,882529,883919,299,1.00
ptg000675l,134338,134646,308,RepeatMasker,LTR,134643,136209,4,0.01
ptg000680l,1069799,1070120,321,RepeatMasker,LTR,1069773,1069821,22,0.07
ptg000682l,1261362,1261683,321,RepeatMasker,LTR,1254462,1261530,168,0.52
ptg000684l,490225,490524,299,RepeatMasker,LTR,490173,490702,299,1.00
ptg000686l,540505,540784,279,RepeatMasker,LTR,538912,541489,279,1.00
ptg000686l,942557,942849,292,RepeatMasker,LTR,941776,943898,292,1.00
ptg000689l,1920963,1921287,324,RepeatMasker,LTR,1921039,1926843,249,0.77
ptg000689l,2236860,2237158,298,RepeatMasker,LTR,2236026,2238710,298,1.00
ptg000689l,3558454,3558734,280,RepeatMasker,LTR,3557825,3559113,280,1.00
ptg000689l,3565584,3565864,280,RepeatMasker,LTR,3564805,3566244,280,1.00
ptg000697l,3405299,3405586,287,RepeatMasker,LTR,3404444,3410210,287,1.00
ptg000701l,1559389,1559686,297,RepeatMasker,LTR,1556079,1562550,297,1.00
ptg000702l,904375,904668,293,RepeatMasker,LTR,903729,905038,293,1.00
ptg000704l,433472,433769,297,RepeatMasker,LTR,433420,433947,297,1.00
ptg000704l,552683,552977,294,RepeatMasker,LTR,552637,553018,294,1.00
ptg000704l,942371,942658,287,RepeatMasker,LTR,942325,942699,287,1.00
ptg000704l,1378391,1378690,299,RepeatMasker,LTR,1378339,1378884,299,1.00
ptg000714l,296832,297120,288,RepeatMasker,LTR,296947,297318,174,0.60
ptg000714l,296832,297120,288,RepeatMasker,LTR,297106,297174,15,0.05
ptg000714l,312999,313288,289,RepeatMasker,LTR,313142,313489,147,0.51
ptg000719l,2304585,2304899,314,RepeatMasker,LTR,2304845,2304943,55,0.18
ptg000719l,2682558,2682871,313,RepeatMasker,LTR,2682834,2683929,38,0.12
ptg000720l,2334830,2335123,293,RepeatMasker,LTR,2334194,2336162,293,1.00
ptg000720l,2437677,2437978,301,RepeatMasker,LTR,2436571,2437809,132,0.44
ptg000721l,643185,643460,275,RepeatMasker,LTR,643145,643188,3,0.01
ptg000721l,643185,643460,275,RepeatMasker,LTR,643257,643367,111,0.40
ptg000723l,2600839,2601133,294,RepeatMasker,LTR,2600202,2601529,294,1.00
ptg000724l,726298,726604,306,RepeatMasker,LTR,725157,726409,111,0.36
ptg000724l,726298,726604,306,RepeatMasker,LTR,726545,727942,60,0.20
ptg000729l,77202,77483,281,RepeatMasker,LTR,76421,77875,281,1.00
ptg000729l,351436,351752,316,RepeatMasker,LTR,350743,351486,50,0.16
ptg000729l,1668609,1668890,281,RepeatMasker,LTR,1667971,1669272,281,1.00
ptg000730l,94608,94936,328,RepeatMasker,LTR,94452,94777,169,0.52
ptg000730l,264971,265287,316,RepeatMasker,LTR,265173,271461,115,0.36
ptg000731l,2341614,2341944,330,RepeatMasker,LTR,2340308,2342806,330,1.00
ptg000733l,54100,54399,299,RepeatMasker,LTR,54068,54273,173,0.58
ptg000735l,525435,525745,310,RepeatMasker,LTR,525182,526188,310,1.00
ptg000735l,2894625,2894936,311,RepeatMasker,LTR,2893510,2896770,311,1.00
ptg000739l,1901580,1901857,277,RepeatMasker,LTR,1901834,1901879,24,0.09
ptg000739l,6569449,6569751,302,RepeatMasker,LTR,6569239,6569455,6,0.02
ptg000740l,1259020,1259304,284,RepeatMasker,LTR,1259015,1259212,192,0.68
ptg000741l,4884766,4885080,314,RepeatMasker,LTR,4884799,4885542,282,0.90
ptg000741l,7267235,7267530,295,RepeatMasker,LTR,7267183,7267725,295,1.00
ptg000742l,2954953,2955262,309,RepeatMasker,LTR,2954863,2955430,309,1.00
ptg000742l,3020548,3020841,293,RepeatMasker,LTR,3020496,3021018,293,1.00
ptg000742l,3045993,3046288,295,RepeatMasker,LTR,3045941,3046466,295,1.00
ptg000742l,3252763,3253062,299,RepeatMasker,LTR,3252711,3253142,299,1.00
ptg000748l,834887,835189,302,RepeatMasker,LTR,833452,834978,91,0.30
ptg000748l,834887,835189,302,RepeatMasker,LTR,833636,834969,82,0.27
ptg000753l,1970796,1971080,284,RepeatMasker,LTR,1970522,1970950,154,0.54
ptg000760l,586145,586469,324,RepeatMasker,LTR,585753,586296,151,0.47
ptg000762l,1983264,1983563,299,RepeatMasker,LTR,1983233,1983949,299,1.00
ptg000763l,486723,487004,281,RepeatMasker,LTR,485168,488401,281,1.00
ptg000769l,3139742,3140058,316,RepeatMasker,LTR,3139598,3139973,231,0.73
ptg000788l,3432302,3432589,287,RepeatMasker,LTR,3431705,3432622,287,1.00
ptg000788l,3976635,3976923,288,RepeatMasker,LTR,3975596,3980539,288,1.00
ptg000788l,5394257,5394556,299,RepeatMasker,LTR,5394205,5394636,299,1.00
ptg000788l,5691689,5691988,299,RepeatMasker,LTR,5691637,5692068,299,1.00
ptg000788l,5744708,5745005,297,RepeatMasker,LTR,5744656,5745085,297,1.00
ptg000795l,2200736,2201016,280,RepeatMasker,LTR,2200101,2201398,280,1.00
ptg000796l,1169390,1169683,293,RepeatMasker,LTR,1169014,1169748,293,1.00
ptg000798l,3222939,3223241,302,RepeatMasker,LTR,3222296,3223226,287,0.95
ptg000801l,2148718,2149025,307,RepeatMasker,LTR,2148314,2148813,95,0.31
ptg000802l,1375649,1375934,285,RepeatMasker,LTR,1375911,1375955,24,0.08
ptg000803l,256495,256792,297,RepeatMasker,LTR,256443,256832,297,1.00
ptg000804l,476593,476889,296,RepeatMasker,LTR,476541,476969,296,1.00
ptg000805l,907552,907833,281,RepeatMasker,LTR,906910,909020,281,1.00
ptg000805l,924561,924842,281,RepeatMasker,LTR,923761,925886,281,1.00
ptg000805l,1108034,1108348,314,RepeatMasker,LTR,1108002,1108710,314,1.00
ptg000806l,992590,992908,318,RepeatMasker,LTR,992857,995071,52,0.16
ptg000806l,3797327,3797656,329,RepeatMasker,LTR,3797568,3798127,89,0.27
ptg000817l,745887,746187,300,RepeatMasker,LTR,745019,746114,227,0.76
ptg000818l,668679,668987,308,RepeatMasker,LTR,668036,670122,308,1.00
ptg000818l,928250,928577,327,RepeatMasker,LTR,928167,928540,290,0.89
ptg000819l,5134933,5135230,297,RepeatMasker,LTR,5135137,5135993,94,0.32
ptg000819l,5134933,5135230,297,RepeatMasker,LTR,5135164,5135608,67,0.23
ptg000819l,6489099,6489399,300,RepeatMasker,LTR,6484969,6489104,5,0.02
ptg000819l,6726323,6726625,302,RepeatMasker,LTR,6726400,6726551,152,0.50
ptg000823l,1565226,1565543,317,RepeatMasker,LTR,1565480,1565532,53,0.17
ptg000825l,334350,334634,284,RepeatMasker,LTR,334535,334588,54,0.19
ptg000836l,402755,403051,296,RepeatMasker,LTR,398467,402893,138,0.47
ptg000836l,402755,403051,296,RepeatMasker,LTR,402931,403047,117,0.40
ptg000836l,757713,758012,299,RepeatMasker,LTR,756943,757851,138,0.46
ptg000840l,2719849,2720144,295,RepeatMasker,LTR,2719836,2720529,295,1.00
ptg000841l,313521,313857,336,RepeatMasker,LTR,313747,313941,111,0.33
ptg000843l,172785,173086,301,RepeatMasker,LTR,172733,173084,299,0.99
ptg000844l,1124963,1125273,310,RepeatMasker,LTR,1124165,1126319,310,1.00
ptg000847l,2092300,2092615,315,RepeatMasker,LTR,2092275,2092327,27,0.09
ptg000847l,2092300,2092615,315,RepeatMasker,LTR,2092289,2092360,60,0.19
ptg000847l,2907987,2908305,318,RepeatMasker,LTR,2908184,2908216,33,0.10
ptg000847l,2907987,2908305,318,RepeatMasker,LTR,2908222,2916016,84,0.26
ptg000853l,5441710,5441990,280,RepeatMasker,LTR,5440916,5442379,280,1.00
ptg000855l,2972889,2973196,307,RepeatMasker,LTR,2972767,2972943,54,0.18
ptg000867l,382439,382736,297,RepeatMasker,LTR,382387,382816,297,1.00
ptg000867l,662503,662800,297,RepeatMasker,LTR,662451,662995,297,1.00
ptg000867l,1017360,1017657,297,RepeatMasker,LTR,1017308,1017835,297,1.00
ptg000867l,1027622,1027902,280,RepeatMasker,LTR,1027581,1029429,280,1.00
ptg000867l,2524652,2524947,295,RepeatMasker,LTR,2524600,2525125,295,1.00
ptg000867l,2943012,2943306,294,RepeatMasker,LTR,2942960,2943350,294,1.00
ptg000867l,4730290,4730612,322,RepeatMasker,LTR,4730468,4730561,94,0.29
ptg000868l,529680,529975,295,RepeatMasker,LTR,529628,530152,295,1.00
ptg000868l,1782867,1783164,297,RepeatMasker,LTR,1782671,1782878,11,0.04
ptg000868l,1782867,1783164,297,RepeatMasker,LTR,1782849,1783152,285,0.96
ptg000878l,1175455,1175731,276,RepeatMasker,LTR,1175402,1175589,134,0.49
ptg000878l,5153999,5154299,300,RepeatMasker,LTR,5153947,5154521,300,1.00
ptg000878l,5475588,5475883,295,RepeatMasker,LTR,5475538,5475964,295,1.00
ptg000884l,6107,6393,286,RepeatMasker,LTR,5247,6532,286,1.00
ptg000886l,1071114,1071409,295,RepeatMasker,LTR,1070324,1072954,295,1.00
ptg000886l,6446439,6446732,293,RepeatMasker,LTR,6446491,6446809,242,0.83
ptg000893l,4449663,4449948,285,RepeatMasker,LTR,4449442,4449692,29,0.10
ptg000893l,9738299,9738594,295,RepeatMasker,LTR,9738373,9738448,76,0.26
ptg000895l,2156431,2156732,301,RepeatMasker,LTR,2155841,2156544,113,0.38
ptg000896l,4136580,4136919,339,RepeatMasker,LTR,4136173,4136880,300,0.88
ptg000896l,4136580,4136919,339,RepeatMasker,LTR,4136909,4137169,11,0.03
ptg000896l,4880558,4880867,309,RepeatMasker,LTR,4879726,4884145,309,1.00
ptg000909l,1276202,1276510,308,RepeatMasker,LTR,1276387,1277926,124,0.40
ptg000912l,319231,319513,282,RepeatMasker,LTR,318429,319894,282,1.00
ptg000913l,2492815,2493110,295,RepeatMasker,LTR,2492820,2492872,53,0.18
ptg000913l,2492815,2493110,295,RepeatMasker,LTR,2492836,2492898,63,0.21
ptg000913l,4256582,4256885,303,RepeatMasker,LTR,4256429,4256808,226,0.75
ptg000914l,435367,435655,288,RepeatMasker,LTR,435449,435546,98,0.34
ptg000918l,338580,338882,302,RepeatMasker,LTR,338586,339109,297,0.98
ptg000925l,743809,744120,311,RepeatMasker,LTR,743796,745241,311,1.00
ptg000925l,758253,758534,281,RepeatMasker,LTR,758240,759567,281,1.00
ptg000925l,915850,916148,298,RepeatMasker,LTR,916139,916191,10,0.03
ptg000926l,1424265,1424592,327,RepeatMasker,LTR,1424258,1424376,111,0.34
ptg000927l,633870,634150,280,RepeatMasker,LTR,633224,634455,280,1.00
ptg000927l,640992,641288,296,RepeatMasker,LTR,640980,641286,294,0.99
ptg000928l,1896842,1897118,276,RepeatMasker,LTR,1896629,1898044,276,1.00
ptg000929l,2203330,2203611,281,RepeatMasker,LTR,2202527,2203993,281,1.00
ptg000931l,725638,725929,291,RepeatMasker,LTR,724940,726295,291,1.00
ptg000934l,439907,440185,278,RepeatMasker,LTR,440162,440211,24,0.09
ptg000934l,1386709,1387039,330,RepeatMasker,LTR,1386537,1386910,201,0.61
ptg000937l,4087502,4087811,309,RepeatMasker,LTR,4087145,4087532,30,0.10
ptg000939l,277022,277320,298,RepeatMasker,LTR,273712,282211,298,1.00
ptg000941l,99690,99970,280,RepeatMasker,LTR,95973,101089,280,1.00
ptg000951l,176010,176291,281,RepeatMasker,LTR,175208,176673,281,1.00
ptg000957l,1607808,1608107,299,RepeatMasker,LTR,1607756,1608315,299,1.00
ptg000958l,2014886,2015166,280,RepeatMasker,LTR,2014980,2015010,31,0.11
ptg000958l,2014886,2015166,280,RepeatMasker,LTR,2015142,2016075,25,0.09
ptg000958l,4016444,4016730,286,RepeatMasker,LTR,4011705,4017129,286,1.00
ptg000959l,92681,92969,288,RepeatMasker,LTR,86841,92717,36,0.13
ptg000965l,5291583,5291885,302,RepeatMasker,LTR,5290332,5291715,132,0.44
ptg000965l,5291583,5291885,302,RepeatMasker,LTR,5290013,5292638,302,1.00
ptg000966l,988238,988520,282,RepeatMasker,LTR,987303,988320,82,0.29
ptg000966l,988238,988520,282,RepeatMasker,LTR,988308,988386,79,0.28
ptg000966l,988238,988520,282,RepeatMasker,LTR,988386,989468,135,0.48
ptg000966l,6081955,6082254,299,RepeatMasker,LTR,6081903,6082462,299,1.00
ptg000967l,858946,859240,294,RepeatMasker,LTR,859011,859097,87,0.30
ptg000967l,879182,879485,303,RepeatMasker,LTR,879313,883600,173,0.57
ptg000967l,3212980,3213301,321,RepeatMasker,LTR,3206837,3213030,50,0.16
ptg000971l,247045,247325,280,RepeatMasker,LTR,245764,247178,133,0.48
ptg000973l,567117,567398,281,RepeatMasker,LTR,567104,568548,281,1.00
ptg000973l,574302,574583,281,RepeatMasker,LTR,574289,575631,281,1.00
ptg000973l,974580,974907,327,RepeatMasker,LTR,974739,974853,115,0.35
ptg000975l,971002,971285,283,RepeatMasker,LTR,970364,972330,283,1.00
ptg000975l,4769978,4770258,280,RepeatMasker,LTR,4769333,4770569,280,1.00
ptg000980l,2080122,2080417,295,RepeatMasker,LTR,2080070,2080599,295,1.00
ptg000980l,3742148,3742420,272,RepeatMasker,LTR,3738491,3742431,272,1.00
ptg000983l,63866,64172,306,RepeatMasker,LTR,64122,64244,51,0.17
ptg000984l,271131,271452,321,RepeatMasker,LTR,270878,271341,210,0.65
ptg000996l,403071,403367,296,RepeatMasker,LTR,402189,403187,116,0.39
ptg000996l,3425583,3425893,310,RepeatMasker,LTR,3425589,3426410,305,0.98
ptg001001l,3252372,3252648,276,RepeatMasker,LTR,3250063,3256639,276,1.00
ptg001004l,532057,532349,292,RepeatMasker,LTR,527872,532108,51,0.17
ptg001004l,734047,734353,306,RepeatMasker,LTR,733913,734867,306,1.00
ptg001010l,3312953,3313250,297,RepeatMasker,LTR,3311763,3313308,297,1.00
ptg001010l,5197657,5197935,278,RepeatMasker,LTR,5197912,5197956,24,0.09
ptg001010l,6084491,6084790,299,RepeatMasker,LTR,6084635,6084808,156,0.52
ptg001010l,6084491,6084790,299,RepeatMasker,LTR,6084667,6084918,124,0.41
ptg001010l,6084491,6084790,299,RepeatMasker,LTR,6084680,6084901,111,0.37
ptg001012l,941815,942132,317,RepeatMasker,LTR,941781,942152,317,1.00
ptg001014l,875151,875439,288,RepeatMasker,LTR,875146,875356,205,0.71
ptg001014l,875151,875439,288,RepeatMasker,LTR,875272,875396,125,0.43
ptg001018l,156537,156829,292,RepeatMasker,LTR,156490,157008,292,1.00
ptg001018l,1401657,1401940,283,RepeatMasker,LTR,1401059,1404166,283,1.00
ptg001018l,2100417,2100716,299,RepeatMasker,LTR,2100664,2101295,53,0.18
ptg001018l,5696940,5697255,315,RepeatMasker,LTR,5697173,5697235,63,0.20
ptg001022l,287938,288248,310,RepeatMasker,LTR,288231,288786,18,0.06
ptg001022l,553568,553877,309,RepeatMasker,LTR,553421,553800,232,0.75
ptg001027l,735290,735589,299,RepeatMasker,LTR,735238,735669,299,1.00
ptg001027l,2967510,2967796,286,RepeatMasker,LTR,2966655,2969361,286,1.00
ptg001028l,1838684,1838971,287,RepeatMasker,LTR,1837834,1843426,287,1.00
ptg001029l,1380692,1381001,309,RepeatMasker,LTR,1377968,1380722,30,0.10
ptg001029l,2182535,2182834,299,RepeatMasker,LTR,2182522,2182700,165,0.55
ptg001029l,2182535,2182834,299,RepeatMasker,LTR,2182727,2183079,108,0.36
ptg001039l,2266484,2266784,300,RepeatMasker,LTR,2266432,2267004,300,1.00
ptg001040l,1646276,1646595,319,RepeatMasker,LTR,1646507,1646810,89,0.28
ptg001046l,664925,665221,296,RepeatMasker,LTR,664891,665241,296,1.00
ptg001046l,767963,768240,277,RepeatMasker,LTR,767841,768301,277,1.00
ptg001046l,767963,768240,277,RepeatMasker,LTR,767973,769682,268,0.97
ptg001046l,1575579,1575862,283,RepeatMasker,LTR,1573636,1576816,283,1.00
ptg001051l,105565,105846,281,RepeatMasker,LTR,104921,107037,281,1.00
ptg001051l,112756,113064,308,RepeatMasker,LTR,112722,113585,308,1.00
ptg001051l,1344142,1344459,317,RepeatMasker,LTR,1344283,1347484,177,0.56
ptg001052l,1156636,1156928,292,RepeatMasker,LTR,1153803,1157270,292,1.00
ptg001055l,1026180,1026465,285,RepeatMasker,LTR,1025535,1026847,285,1.00
ptg001056l,756354,756653,299,RepeatMasker,LTR,756320,756673,299,1.00
ptg001056l,2971082,2971382,300,RepeatMasker,LTR,2971030,2971590,300,1.00
ptg001056l,3075378,3075671,293,RepeatMasker,LTR,3075326,3075849,293,1.00
ptg001056l,3429944,3430245,301,RepeatMasker,LTR,3429976,3430349,270,0.90
ptg001056l,3429944,3430245,301,RepeatMasker,LTR,3424067,3429981,37,0.12
ptg001064l,3002850,3003172,322,RepeatMasker,LTR,3002831,3003037,187,0.58
ptg001065l,901932,902219,287,RepeatMasker,LTR,901974,902203,230,0.80
ptg001065l,1754329,1754613,284,RepeatMasker,LTR,1754032,1754476,147,0.52
ptg001066l,854329,854627,298,RepeatMasker,LTR,854277,854836,298,1.00
ptg001068l,291169,291484,315,RepeatMasker,LTR,288861,291494,315,1.00
ptg001077l,7898084,7898378,294,RepeatMasker,LTR,7897855,7898163,79,0.27
ptg001085l,3199641,3199936,295,RepeatMasker,LTR,3198708,3199805,164,0.56
ptg001085l,3199641,3199936,295,RepeatMasker,LTR,3199807,3201838,130,0.44
ptg001086l,224828,225132,304,RepeatMasker,LTR,221935,227925,304,1.00
ptg001098l,661946,662227,281,RepeatMasker,LTR,661164,662609,281,1.00
ptg001101l,861744,862042,298,RepeatMasker,LTR,859501,864506,298,1.00
ptg001101l,917038,917336,298,RepeatMasker,LTR,914795,920599,298,1.00
ptg001102l,4613178,4613486,308,RepeatMasker,LTR,4609602,4613206,28,0.09
ptg001102l,4613178,4613486,308,RepeatMasker,LTR,4613399,4613969,88,0.29
ptg001102l,5059152,5059451,299,RepeatMasker,LTR,5059105,5059492,299,1.00
ptg001103l,2209556,2209855,299,RepeatMasker,LTR,2209504,2210048,299,1.00
ptg001103l,4730031,4730332,301,RepeatMasker,LTR,4729886,4730254,223,0.74
ptg001106l,3830292,3830586,294,RepeatMasker,LTR,3827495,3833643,294,1.00
ptg001110l,1225295,1225614,319,RepeatMasker,LTR,1225590,1226488,25,0.08
ptg001111l,979407,979693,286,RepeatMasker,LTR,978546,984334,286,1.00
ptg001115l,3458763,3459055,292,RepeatMasker,LTR,3455919,3459398,292,1.00
ptg001122l,4063838,4064118,280,RepeatMasker,LTR,4063057,4064486,280,1.00
ptg001124l,947031,947345,314,RepeatMasker,LTR,946241,947705,314,1.00
ptg001124l,954186,954471,285,RepeatMasker,LTR,954153,954869,285,1.00
ptg001126l,690229,690477,248,RepeatMasker,LTR,685176,694680,248,1.00
ptg001131l,3068883,3069185,302,RepeatMasker,LTR,3069162,3069704,24,0.08
ptg001131l,4532799,4533099,300,RepeatMasker,LTR,4533063,4533111,37,0.12
ptg001139l,703182,703509,327,RepeatMasker,LTR,703362,703399,38,0.12
ptg001143l,1628045,1628337,292,RepeatMasker,LTR,1627993,1628531,292,1.00
ptg001150l,192082,192396,314,RepeatMasker,LTR,190353,192110,28,0.09
ptg001150l,192082,192396,314,RepeatMasker,LTR,192309,192872,88,0.28
ptg001155l,860227,860526,299,RepeatMasker,LTR,860175,860704,299,1.00
ptg001155l,1545238,1545525,287,RepeatMasker,LTR,1544376,1545936,287,1.00
ptg001165l,1132725,1133017,292,RepeatMasker,LTR,1129907,1133357,292,1.00
ptg001166l,1932555,1932862,307,RepeatMasker,LTR,1932432,1932867,307,1.00
ptg001170l,1187505,1187804,299,RepeatMasker,LTR,1187453,1187884,299,1.00
ptg001181l,354891,355188,297,RepeatMasker,LTR,355174,355478,15,0.05
ptg001184l,538926,539255,329,RepeatMasker,LTR,539068,539315,188,0.57
ptg001185l,1776990,1777288,298,RepeatMasker,LTR,1776484,1777045,55,0.18
ptg001185l,1776990,1777288,298,RepeatMasker,LTR,1777035,1777353,254,0.85
ptg001192l,1637670,1637990,320,RepeatMasker,LTR,1637944,1638895,47,0.15
ptg001193l,2932212,2932492,280,RepeatMasker,LTR,2932170,2932954,280,1.00
ptg001193l,3484554,3484850,296,RepeatMasker,LTR,3484432,3485058,296,1.00
ptg001194l,1158049,1158342,293,RepeatMasker,LTR,1157213,1162977,293,1.00
ptg001194l,2462457,2462766,309,RepeatMasker,LTR,2462160,2462604,147,0.48
ptg001208l,2931871,2932166,295,RepeatMasker,LTR,2932034,2932148,115,0.39
ptg001210l,383880,384160,280,RepeatMasker,LTR,383868,384542,280,1.00
ptg001215l,6001131,6001453,322,RepeatMasker,LTR,6001287,6002019,167,0.52
ptg001218l,3777791,3778095,304,RepeatMasker,LTR,3778007,3778075,69,0.23
ptg001221l,322159,322475,316,RepeatMasker,LTR,322466,328723,10,0.03
ptg001221l,1130003,1130323,320,RepeatMasker,LTR,1130089,1130227,139,0.43
ptg001223l,2438848,2439143,295,RepeatMasker,LTR,2436924,2441342,295,1.00
ptg001223l,4381735,4382039,304,RepeatMasker,LTR,4381514,4381741,6,0.02
ptg001223l,4381735,4382039,304,RepeatMasker,LTR,4381800,4382581,240,0.79
ptg001225l,69221,69519,298,RepeatMasker,LTR,69169,69727,298,1.00
ptg001231l,1278503,1278784,281,RepeatMasker,LTR,1277748,1279830,281,1.00
ptg001232l,5218455,5218764,309,RepeatMasker,LTR,5218363,5218754,299,0.97
ptg001232l,5218455,5218764,309,RepeatMasker,LTR,5218484,5218754,271,0.88
ptg001232l,7871328,7871615,287,RepeatMasker,LTR,7870505,7875448,287,1.00
ptg001232l,8405712,8406012,300,RepeatMasker,LTR,8405660,8406223,300,1.00
ptg001232l,16201032,16201331,299,RepeatMasker,LTR,16200980,16201509,299,1.00
ptg001239l,2691254,2691535,281,RepeatMasker,LTR,2691221,2691925,281,1.00
ptg001241l,1552786,1553092,306,RepeatMasker,LTR,1550211,1559709,306,1.00
ptg001242l,224461,224763,302,RepeatMasker,LTR,223757,224692,231,0.76
ptg001244l,853778,854089,311,RepeatMasker,LTR,853440,853940,162,0.52
ptg001247l,269346,269652,306,RepeatMasker,LTR,267210,270198,306,1.00
ptg001248l,3767124,3767456,332,RepeatMasker,LTR,3767082,3767210,86,0.26
ptg001249l,829925,830205,280,RepeatMasker,LTR,829124,830595,280,1.00
ptg001253l,823288,823587,299,RepeatMasker,LTR,821353,824771,299,1.00
ptg001253l,1234225,1234523,298,RepeatMasker,LTR,1234173,1234705,298,1.00
ptg001254l,733678,733962,284,RepeatMasker,LTR,733859,734076,104,0.37
ptg001259l,1179647,1179933,286,RepeatMasker,LTR,1179490,1180123,286,1.00
ptg001259l,1179647,1179933,286,RepeatMasker,LTR,1179639,1180085,286,1.00
ptg001260l,1651457,1651749,292,RepeatMasker,LTR,1651432,1651479,22,0.08
ptg001260l,1651457,1651749,292,RepeatMasker,LTR,1651446,1651557,100,0.34
ptg001260l,1651457,1651749,292,RepeatMasker,LTR,1651476,1651581,106,0.36
ptg001262l,376195,376506,311,RepeatMasker,LTR,375359,381043,311,1.00
ptg001262l,387977,388288,311,RepeatMasker,LTR,387161,389955,311,1.00
ptg001262l,428768,429080,312,RepeatMasker,LTR,427931,434163,312,1.00
ptg001263l,95767,96048,281,RepeatMasker,LTR,95734,96431,281,1.00
ptg001268l,1607905,1608204,299,RepeatMasker,LTR,1607853,1608413,299,1.00
ptg001272l,388986,389285,299,RepeatMasker,LTR,388934,389463,299,1.00
ptg001279l,2176128,2176418,290,RepeatMasker,LTR,2175018,2177387,290,1.00
ptg001283l,815782,816081,299,RepeatMasker,LTR,815730,816289,299,1.00
ptg001286l,590854,591163,309,RepeatMasker,LTR,590210,591545,309,1.00
ptg001292l,688199,688484,285,RepeatMasker,LTR,688461,688505,24,0.08
ptg001302l,2325628,2325928,300,RepeatMasker,LTR,2325576,2326154,300,1.00
ptg001302l,3533058,3533356,298,RepeatMasker,LTR,3533006,3533548,298,1.00
ptg001302l,3876019,3876311,292,RepeatMasker,LTR,3875967,3876489,292,1.00
ptg001302l,4197426,4197721,295,RepeatMasker,LTR,4197374,4197899,295,1.00
ptg001302l,4378503,4378796,293,RepeatMasker,LTR,4378451,4378974,293,1.00
ptg001302l,4846513,4846821,308,RepeatMasker,LTR,4846633,4847032,189,0.61
ptg001302l,4886510,4886805,295,RepeatMasker,LTR,4886458,4886980,295,1.00
ptg001302l,4971803,4972098,295,RepeatMasker,LTR,4971751,4972276,295,1.00
ptg001305l,4947163,4947462,299,RepeatMasker,LTR,4947111,4947632,299,1.00
ptg001305l,6114539,6114838,299,RepeatMasker,LTR,6114487,6115016,299,1.00
ptg001307l,1605455,1605780,325,RepeatMasker,LTR,1604842,1605513,58,0.18
ptg001307l,1605455,1605780,325,RepeatMasker,LTR,1605452,1606202,325,1.00
ptg001307l,2089941,2090238,297,RepeatMasker,LTR,2089889,2090433,297,1.00
ptg001310l,667360,667670,310,RepeatMasker,LTR,667567,667647,81,0.26
ptg001312l,43288,43565,277,RepeatMasker,LTR,43167,43297,9,0.03
ptg001312l,43288,43565,277,RepeatMasker,LTR,43298,46995,268,0.97
ptg001317l,728827,729114,287,RepeatMasker,LTR,726322,729549,287,1.00
ptg001329l,149727,150008,281,RepeatMasker,LTR,149714,151145,281,1.00
ptg001339l,3510743,3511042,299,RepeatMasker,LTR,3510691,3511197,299,1.00
ptg001342l,194898,195169,271,RepeatMasker,LTR,195060,195183,110,0.41
ptg001344l,1252795,1253093,298,RepeatMasker,LTR,1252761,1253113,298,1.00
ptg001344l,1643328,1643627,299,RepeatMasker,LTR,1643276,1643805,299,1.00
ptg001358l,370269,370581,312,RepeatMasker,LTR,369911,370649,312,1.00
ptg001358l,3530390,3530677,287,RepeatMasker,LTR,3530387,3530612,222,0.77
ptg001358l,3530390,3530677,287,RepeatMasker,LTR,3530487,3531180,191,0.67
ptg001359l,1698480,1698777,297,RepeatMasker,LTR,1692304,1698503,23,0.08
ptg001363l,4672055,4672347,292,RepeatMasker,LTR,4671810,4672601,292,1.00
ptg001369l,2254938,2255216,278,RepeatMasker,LTR,2254901,2255535,278,1.00
ptg001371l,8654464,8654744,280,RepeatMasker,LTR,8654721,8654765,24,0.09
ptg001371l,11776574,11776907,333,RepeatMasker,LTR,11776359,11778961,333,1.00
ptg001372l,1890627,1890916,289,RepeatMasker,LTR,1890035,1891091,289,1.00
ptg001379l,2598387,2598694,307,RepeatMasker,LTR,2598652,2598838,43,0.14
ptg001381l,6239244,6239576,332,RepeatMasker,LTR,6239226,6239308,64,0.19
ptg001381l,6239244,6239576,332,RepeatMasker,LTR,6239564,6239665,13,0.04
ptg001381l,6260545,6260871,326,RepeatMasker,LTR,6260335,6260552,7,0.02
ptg001390l,3166778,3167075,297,RepeatMasker,LTR,3166726,3167253,297,1.00
ptg001393l,1373419,1373733,314,RepeatMasker,LTR,1369063,1373743,314,1.00
ptg001396l,246956,247280,324,RepeatMasker,LTR,246913,247650,324,1.00
ptg001398l,2461306,2461587,281,RepeatMasker,LTR,2461273,2462706,281,1.00
ptg001398l,2468473,2468754,281,RepeatMasker,LTR,2468440,2469872,281,1.00
ptg001401l,1614210,1614486,276,RepeatMasker,LTR,1614084,1616337,276,1.00
ptg001409l,879201,879509,308,RepeatMasker,LTR,875644,879229,28,0.09
ptg001409l,879201,879509,308,RepeatMasker,LTR,879422,879989,88,0.29
ptg001413l,1423116,1423423,307,RepeatMasker,LTR,1422282,1425012,307,1.00
ptg001415l,2314558,2314805,247,RepeatMasker,LTR,2313401,2319003,247,1.00
ptg001415l,2314558,2314805,247,RepeatMasker,LTR,2309506,2315400,247,1.00
ptg001415l,3022370,3022674,304,RepeatMasker,LTR,3015488,3022533,163,0.54
ptg001416l,937066,937384,318,RepeatMasker,LTR,936457,937155,89,0.28
ptg001416l,4255755,4256057,302,RepeatMasker,LTR,4255035,4255887,132,0.44
ptg001416l,6678571,6678851,280,RepeatMasker,LTR,6677788,6679896,280,1.00
ptg001417l,519125,519411,286,RepeatMasker,LTR,519107,519156,31,0.11
ptg001419l,2388830,2389111,281,RepeatMasker,LTR,2388196,2390255,281,1.00
ptg001419l,2396032,2396313,281,RepeatMasker,LTR,2395248,2397369,281,1.00
ptg001422l,1908703,1909019,316,RepeatMasker,LTR,1908934,1909123,86,0.27
ptg001422l,2270844,2271143,299,RepeatMasker,LTR,2270792,2271223,299,1.00
ptg001424l,1109008,1109287,279,RepeatMasker,LTR,1108976,1109680,279,1.00
ptg001426l,3165612,3165915,303,RepeatMasker,LTR,3165893,3165936,23,0.08
ptg001427l,2747421,2747720,299,RepeatMasker,LTR,2747369,2747884,299,1.00
ptg001429l,1898261,1898588,327,RepeatMasker,LTR,1895545,1898896,327,1.00
ptg001437l,1402459,1402770,311,RepeatMasker,LTR,1402392,1402694,235,0.76
ptg001437l,1402459,1402770,311,RepeatMasker,LTR,1402397,1402468,9,0.03
ptg001451l,2493306,2493593,287,RepeatMasker,LTR,2492451,2498239,287,1.00
ptg001459l,1277455,1277737,282,RepeatMasker,LTR,1277442,1278037,282,1.00
ptg001459l,1312212,1312493,281,RepeatMasker,LTR,1311409,1313537,281,1.00
ptg001460l,922015,922320,305,RepeatMasker,LTR,921996,922031,16,0.05
ptg001472l,1735571,1735855,284,RepeatMasker,LTR,1735833,1735876,23,0.08
ptg001475l,48591,48890,299,RepeatMasker,LTR,48539,49068,299,1.00
ptg001475l,464862,465179,317,RepeatMasker,LTR,465071,466054,109,0.34
ptg001480l,1738664,1738945,281,RepeatMasker,LTR,1738747,1738902,156,0.56
ptg001480l,2404780,2405092,312,RepeatMasker,LTR,2404720,2405568,312,1.00
ptg001481l,1168054,1168355,301,RepeatMasker,LTR,1167737,1168107,53,0.18
ptg001491l,424721,425018,297,RepeatMasker,LTR,424687,425196,297,1.00
ptg001493l,1374604,1374888,284,RepeatMasker,LTR,1373639,1374639,35,0.12
ptg001496l,16458,16755,297,RepeatMasker,LTR,16406,16835,297,1.00
ptg001496l,232342,232635,293,RepeatMasker,LTR,232290,232843,293,1.00
ptg001498l,5985146,5985445,299,RepeatMasker,LTR,5985094,5985525,299,1.00
ptg001498l,6116799,6117098,299,RepeatMasker,LTR,6116753,6117179,299,1.00
ptg001502l,1714630,1714914,284,RepeatMasker,LTR,1713812,1715755,284,1.00
ptg001502l,2144158,2144474,316,RepeatMasker,LTR,2144451,2147182,24,0.08
ptg001505l,9079988,9080290,302,RepeatMasker,LTR,9079380,9081378,302,1.00
ptg001506l,2443204,2443481,277,RepeatMasker,LTR,2443183,2444617,277,1.00
ptg001506l,2450782,2451081,299,RepeatMasker,LTR,2450358,2451748,299,1.00
ptg001510l,85690,86020,330,RepeatMasker,LTR,84367,86129,330,1.00
ptg001513l,360905,361210,305,RepeatMasker,LTR,361096,362368,115,0.38
ptg001513l,1196835,1197115,280,RepeatMasker,LTR,1196802,1198165,280,1.00
ptg001513l,2334948,2335240,292,RepeatMasker,LTR,2331576,2334982,34,0.12
ptg001513l,3522310,3522608,298,RepeatMasker,LTR,3522258,3522833,298,1.00
ptg001513l,5569358,5569653,295,RepeatMasker,LTR,5567823,5569538,180,0.61
ptg001513l,5569358,5569653,295,RepeatMasker,LTR,5568254,5569521,163,0.55
ptg001522l,14451,14744,293,RepeatMasker,LTR,14439,15129,293,1.00
ptg001527l,133911,134210,299,RepeatMasker,LTR,133879,134384,299,1.00
ptg001527l,2269982,2270275,293,RepeatMasker,LTR,2269930,2270469,293,1.00
ptg001527l,2674277,2674577,300,RepeatMasker,LTR,2674225,2674804,300,1.00
ptg001529l,234532,234845,313,RepeatMasker,LTR,234798,234853,48,0.15
ptg001538l,145735,146015,280,RepeatMasker,LTR,145090,146398,280,1.00
ptg001538l,154503,154786,283,RepeatMasker,LTR,153858,155168,283,1.00
ptg001548l,249823,250110,287,RepeatMasker,LTR,248961,251683,287,1.00
ptg001548l,302142,302422,280,RepeatMasker,LTR,301506,302827,280,1.00
ptg001548l,486792,487091,299,RepeatMasker,LTR,485999,487453,299,1.00
ptg001561l,130954,131234,280,RepeatMasker,LTR,130320,131567,280,1.00
ptg001561l,130954,131234,280,RepeatMasker,LTR,130923,131694,280,1.00
ptg001567l,423322,423613,291,RepeatMasker,LTR,420498,423955,291,1.00
ptg001571l,78545,78831,286,RepeatMasker,LTR,77653,83469,286,1.00
ptg001577l,1267352,1267654,302,RepeatMasker,LTR,1261862,1267630,278,0.92
ptg001577l,2249622,2249898,276,RepeatMasker,LTR,2249162,2249661,39,0.14
ptg001577l,2249622,2249898,276,RepeatMasker,LTR,2249657,2250095,242,0.88
ptg001577l,4433908,4434190,282,RepeatMasker,LTR,4433287,4434749,282,1.00
ptg001579l,2495724,2496028,304,RepeatMasker,LTR,2495293,2495978,254,0.84
ptg001579l,2495724,2496028,304,RepeatMasker,LTR,2495870,2496080,159,0.52
ptg001585l,2571965,2572265,300,RepeatMasker,LTR,2571913,2572458,300,1.00
ptg001594l,1378489,1378769,280,RepeatMasker,LTR,1378456,1379151,280,1.00
ptg001598l,890680,890988,308,RepeatMasker,LTR,890566,891457,308,1.00
ptg001600l,1107689,1107988,299,RepeatMasker,LTR,1106635,1107786,97,0.32
ptg001601l,580338,580619,281,RepeatMasker,LTR,579703,581000,281,1.00
ptg001601l,587799,588088,289,RepeatMasker,LTR,586998,588455,289,1.00
ptg001606l,1651929,1652255,326,RepeatMasker,LTR,1652104,1652832,152,0.47
ptg001606l,2421517,2421801,284,RepeatMasker,LTR,2421688,2422242,114,0.40
ptg001607l,324980,325268,288,RepeatMasker,LTR,322549,326171,288,1.00
ptg001608l,725188,725479,291,RepeatMasker,LTR,720732,725350,162,0.56
ptg001612l,302180,302470,290,RepeatMasker,LTR,302128,302550,290,1.00
ptg001613l,2696306,2696585,279,RepeatMasker,LTR,2693537,2701583,279,1.00
ptg001614l,140730,141011,281,RepeatMasker,LTR,139929,141027,281,1.00
ptg001616l,2795728,2796017,289,RepeatMasker,LTR,2793316,2796930,289,1.00
ptg001616l,3434878,3435178,300,RepeatMasker,LTR,3434826,3435356,300,1.00
ptg001617l,216531,216819,288,RepeatMasker,LTR,215302,217739,288,1.00
ptg001617l,216531,216819,288,RepeatMasker,LTR,215665,217770,288,1.00
ptg001617l,1899362,1899650,288,RepeatMasker,LTR,1899167,1899510,148,0.51
ptg001623l,417313,417604,291,RepeatMasker,LTR,416515,417997,291,1.00
ptg001627l,2108311,2108620,309,RepeatMasker,LTR,2105925,2108608,297,0.96
ptg001630l,3641450,3641765,315,RepeatMasker,LTR,3641728,3645315,38,0.12
ptg001631l,3673855,3674154,299,RepeatMasker,LTR,3673803,3674351,299,1.00
ptg001631l,6137287,6137606,319,RepeatMasker,LTR,6136661,6137533,246,0.77
ptg001631l,6137287,6137606,319,RepeatMasker,LTR,6137531,6138483,76,0.24
ptg001631l,8578205,8578487,282,RepeatMasker,LTR,8577566,8578232,27,0.10
ptg001633l,1456560,1456840,280,RepeatMasker,LTR,1455758,1457230,280,1.00
ptg001635l,1191976,1192275,299,RepeatMasker,LTR,1191924,1192355,299,1.00
ptg001637l,1444095,1444425,330,RepeatMasker,LTR,1442838,1445341,330,1.00
ptg001641l,1905702,1905992,290,RepeatMasker,LTR,1905524,1906895,290,1.00
ptg001641l,3868739,3869038,299,RepeatMasker,LTR,3868687,3869207,299,1.00
ptg001646l,2034886,2035186,300,RepeatMasker,LTR,2034092,2035554,300,1.00
ptg001649l,354715,355010,295,RepeatMasker,LTR,353857,355038,295,1.00
ptg001652l,801841,802140,299,RepeatMasker,LTR,801794,802220,299,1.00
ptg001656l,1761273,1761570,297,RepeatMasker,LTR,1761261,1761951,297,1.00
ptg001656l,4527782,4528069,287,RepeatMasker,LTR,4526938,4532714,287,1.00
ptg001656l,7127437,7127733,296,RepeatMasker,LTR,7127345,7128351,296,1.00
ptg001656l,7127437,7127733,296,RepeatMasker,LTR,7127475,7128351,259,0.88
ptg001657l,3742118,3742412,294,RepeatMasker,LTR,3742380,3742432,33,0.11
ptg001659l,1097619,1097901,282,RepeatMasker,LTR,1097006,1099296,282,1.00
ptg001660l,638488,638802,314,RepeatMasker,LTR,635411,638609,121,0.39
ptg001660l,638488,638802,314,RepeatMasker,LTR,638723,639962,80,0.25
ptg001660l,5568826,5569111,285,RepeatMasker,LTR,5567964,5573734,285,1.00
ptg001660l,5932630,5932943,313,RepeatMasker,LTR,5932257,5932937,307,0.98
ptg001660l,5932630,5932943,313,RepeatMasker,LTR,5932848,5933040,96,0.31
ptg001669l,218911,219191,280,RepeatMasker,LTR,218898,219573,280,1.00
ptg001671l,29566,29886,320,RepeatMasker,LTR,29665,30845,222,0.69
ptg001671l,949359,949663,304,RepeatMasker,LTR,948615,949469,110,0.36
ptg001672l,1064821,1065124,303,RepeatMasker,LTR,1065101,1065145,24,0.08
ptg001672l,4197229,4197512,283,RepeatMasker,LTR,4194574,4199546,283,1.00
ptg001674l,278813,279100,287,RepeatMasker,LTR,277958,282740,287,1.00
ptg001677l,849454,849754,300,RepeatMasker,LTR,849402,849963,300,1.00
ptg001677l,953041,953345,304,RepeatMasker,LTR,951909,953077,36,0.12
ptg001677l,1139937,1140234,297,RepeatMasker,LTR,1139885,1140442,297,1.00
ptg001682l,2266230,2266509,279,RepeatMasker,LTR,2265836,2270930,279,1.00
ptg001682l,4884801,4885095,294,RepeatMasker,LTR,4884719,4885049,248,0.84
ptg001682l,6646528,6646843,315,RepeatMasker,LTR,6645730,6647214,315,1.00
ptg001684l,1609994,1610281,287,RepeatMasker,LTR,1609136,1614220,287,1.00
ptg001685l,5567113,5567403,290,RepeatMasker,LTR,5566680,5567905,290,1.00
ptg001687l,1800534,1800835,301,RepeatMasker,LTR,1800482,1801013,301,1.00
ptg001689l,2082903,2083227,324,RepeatMasker,LTR,2082883,2083782,324,1.00
ptg001701l,3212946,3213227,281,RepeatMasker,LTR,3212310,3214276,281,1.00
ptg001704l,4297811,4298115,304,RepeatMasker,LTR,4297794,4297833,22,0.07
ptg001711l,608688,608966,278,RepeatMasker,LTR,608520,609456,278,1.00
ptg001711l,3732234,3732544,310,RepeatMasker,LTR,3731435,3732540,306,0.99
ptg001712l,1076212,1076506,294,RepeatMasker,LTR,1073417,1079550,294,1.00
ptg001713l,2140817,2141117,300,RepeatMasker,LTR,2140780,2141329,300,1.00
ptg001714l,656176,656456,280,RepeatMasker,LTR,656134,656931,280,1.00
ptg001714l,656176,656456,280,RepeatMasker,LTR,656362,658008,95,0.34
ptg001714l,1130043,1130342,299,RepeatMasker,LTR,1130318,1130361,25,0.08
ptg001714l,2000621,2000906,285,RepeatMasker,LTR,2000569,2000986,285,1.00
ptg001715l,777703,777983,280,RepeatMasker,LTR,777690,779039,280,1.00
ptg001718l,196352,196645,293,RepeatMasker,LTR,195697,197025,293,1.00
ptg001718l,515368,515679,311,RepeatMasker,LTR,515380,515446,67,0.22
ptg001722l,1248095,1248375,280,RepeatMasker,LTR,1247451,1249423,280,1.00
ptg001724l,1586563,1586897,334,RepeatMasker,LTR,1582213,1586883,320,0.96
ptg001732l,710475,710783,308,RepeatMasker,LTR,710707,710861,77,0.25
ptg001732l,3231169,3231445,276,RepeatMasker,LTR,3231179,3234870,267,0.97
ptg001733l,774039,774338,299,RepeatMasker,LTR,773987,774533,299,1.00
ptg001733l,855106,855402,296,RepeatMasker,LTR,855054,855482,296,1.00
ptg001733l,1043095,1043394,299,RepeatMasker,LTR,1043043,1043549,299,1.00
ptg001733l,2105284,2105583,299,RepeatMasker,LTR,2105232,2105624,299,1.00
ptg001733l,2521029,2521334,305,RepeatMasker,LTR,2520006,2522045,305,1.00
ptg001733l,2575116,2575415,299,RepeatMasker,LTR,2574930,2575203,87,0.29
ptg001735l,1894490,1894773,283,RepeatMasker,LTR,1890938,1896213,283,1.00
ptg001735l,2019056,2019355,299,RepeatMasker,LTR,2019004,2019346,290,0.97
ptg001736l,279887,280219,332,RepeatMasker,LTR,278009,280802,332,1.00
ptg001736l,773797,774081,284,RepeatMasker,LTR,773708,773812,15,0.05
ptg001740l,338877,339158,281,RepeatMasker,LTR,338235,339540,281,1.00
ptg001742l,217642,217922,280,RepeatMasker,LTR,216998,218304,280,1.00
ptg001745l,84956,85236,280,RepeatMasker,LTR,85102,85157,56,0.20
ptg001745l,1000769,1001047,278,RepeatMasker,LTR,998952,1003016,278,1.00
ptg001746l,67202,67501,299,RepeatMasker,LTR,67168,67666,299,1.00
ptg001751l,2493342,2493634,292,RepeatMasker,LTR,2492531,2493539,197,0.67
ptg001758l,449965,450274,309,RepeatMasker,LTR,449625,449995,30,0.10
ptg001758l,673834,674115,281,RepeatMasker,LTR,673189,674497,281,1.00
ptg001768l,524247,524562,315,RepeatMasker,LTR,524332,524789,231,0.73
ptg001768l,524247,524562,315,RepeatMasker,LTR,524017,524848,315,1.00
ptg001786l,4769694,4769994,300,RepeatMasker,LTR,4769554,4771460,300,1.00
ptg001790l,597141,597440,299,RepeatMasker,LTR,597089,597664,299,1.00
ptg001791l,3267955,3268245,290,RepeatMasker,LTR,3265523,3269151,290,1.00
ptg001791l,3306044,3306359,315,RepeatMasker,LTR,3305974,3306047,3,0.01
ptg001792l,1785288,1785580,292,RepeatMasker,LTR,1784852,1786918,292,1.00
ptg001792l,1785288,1785580,292,RepeatMasker,LTR,1784920,1789182,292,1.00
ptg001792l,5227573,5227900,327,RepeatMasker,LTR,5227345,5227720,147,0.45
ptg001793l,1166818,1167118,300,RepeatMasker,LTR,1159927,1166981,163,0.54
ptg001798l,86308,86610,302,RepeatMasker,LTR,85564,86778,302,1.00
ptg001799l,6007287,6007568,281,RepeatMasker,LTR,6006659,6007420,133,0.47
ptg001806l,676818,677113,295,RepeatMasker,LTR,676766,677291,295,1.00
ptg001812l,912319,912581,262,RepeatMasker,LTR,911983,912484,165,0.63
ptg001813l,1089611,1089920,309,RepeatMasker,LTR,1089618,1090496,303,0.98
ptg001815l,647240,647521,281,RepeatMasker,LTR,646595,647908,281,1.00
ptg001815l,654388,654669,281,RepeatMasker,LTR,653585,655061,281,1.00
ptg001816l,1532054,1532345,291,RepeatMasker,LTR,1530801,1532201,147,0.51
ptg001818l,1494337,1494619,282,RepeatMasker,LTR,1494308,1495694,282,1.00
ptg001820l,5437928,5438197,269,RepeatMasker,LTR,5437706,5437934,6,0.02
ptg001826l,2221955,2222261,306,RepeatMasker,LTR,2221509,2222739,306,1.00
ptg001826l,4586228,4586551,323,RepeatMasker,LTR,4585632,4586260,32,0.10
ptg001826l,4586228,4586551,323,RepeatMasker,LTR,4585739,4586325,97,0.30
ptg001826l,4586228,4586551,323,RepeatMasker,LTR,4586233,4586536,304,0.94
ptg001830l,3281334,3281655,321,RepeatMasker,LTR,3277902,3281384,50,0.16
ptg001833l,468967,469248,281,RepeatMasker,LTR,469000,469062,63,0.22
ptg001834l,524527,524834,307,RepeatMasker,LTR,523460,524780,253,0.82
ptg001835l,480915,481202,287,RepeatMasker,LTR,480054,482633,287,1.00
ptg001836l,1102034,1102321,287,RepeatMasker,LTR,1101934,1102096,62,0.22
ptg001836l,1102034,1102321,287,RepeatMasker,LTR,1101981,1102123,89,0.31
ptg001837l,521946,522219,273,RepeatMasker,LTR,521491,522232,273,1.00
ptg001837l,521946,522219,273,RepeatMasker,LTR,521738,522241,273,1.00
ptg001847l,1087676,1087988,312,RepeatMasker,LTR,1087923,1089722,66,0.21
ptg001850l,790201,790496,295,RepeatMasker,LTR,790149,790691,295,1.00
ptg001851l,5791437,5791723,286,RepeatMasker,LTR,5790612,5794437,286,1.00
ptg001858l,2617850,2618157,307,RepeatMasker,LTR,2616723,2618012,162,0.53
ptg001859l,1188322,1188649,327,RepeatMasker,LTR,1188606,1189274,44,0.13
ptg001862l,5401717,5402043,326,RepeatMasker,LTR,5400098,5402336,326,1.00
ptg001863l,901094,901384,290,RepeatMasker,LTR,900832,902759,290,1.00
ptg001863l,8719722,8720052,330,RepeatMasker,LTR,8718382,8720348,330,1.00
ptg001864l,1191598,1191897,299,RepeatMasker,LTR,1191546,1191977,299,1.00
ptg001870l,387615,387895,280,RepeatMasker,LTR,386966,388305,280,1.00
ptg001878l,5424529,5424824,295,RepeatMasker,LTR,5424477,5425002,295,1.00
ptg001878l,5460237,5460532,295,RepeatMasker,LTR,5460185,5460694,295,1.00
ptg001899l,807972,808259,287,RepeatMasker,LTR,807112,810584,287,1.00
ptg001901l,580331,580651,320,RepeatMasker,LTR,579841,580368,37,0.12
ptg001906l,7269484,7269759,275,RepeatMasker,LTR,7267970,7270064,275,1.00
ptg001909l,1576498,1576822,324,RepeatMasker,LTR,1575724,1576642,144,0.44
ptg001910l,1080995,1081299,304,RepeatMasker,LTR,1081146,1081418,154,0.51
ptg001912l,1298276,1298570,294,RepeatMasker,LTR,1297944,1298722,294,1.00
ptg001913l,401273,401589,316,RepeatMasker,LTR,401207,404418,316,1.00
ptg001914l,1661673,1661943,270,RepeatMasker,LTR,1661512,1661680,7,0.03
ptg001916l,224169,224474,305,RepeatMasker,LTR,224021,224464,295,0.97
ptg001919l,135043,135329,286,RepeatMasker,LTR,134232,135729,286,1.00
ptg001923l,2796277,2796557,280,RepeatMasker,LTR,2796264,2797617,280,1.00
ptg001925l,3974440,3974738,298,RepeatMasker,LTR,3974388,3974779,298,1.00
ptg001927l,1203001,1203311,310,RepeatMasker,LTR,1203201,1203789,111,0.36
ptg001931l,1859753,1860044,291,RepeatMasker,LTR,1859500,1859922,169,0.58
ptg001931l,1859753,1860044,291,RepeatMasker,LTR,1859943,1860156,102,0.35
ptg001932l,153000,153314,314,RepeatMasker,LTR,152316,154777,314,1.00
ptg001932l,153000,153314,314,RepeatMasker,LTR,152782,155461,314,1.00
ptg001935l,378152,378458,306,RepeatMasker,LTR,377715,379129,306,1.00
ptg001936l,3643860,3644141,281,RepeatMasker,LTR,3643220,3644531,281,1.00
ptg001938l,1675259,1675551,292,RepeatMasker,LTR,1675457,1676883,95,0.33
ptg001949l,115733,116028,295,RepeatMasker,LTR,115681,116052,295,1.00
ptg001954l,1097666,1097984,318,RepeatMasker,LTR,1097931,1099650,54,0.17
ptg001956l,623285,623564,279,RepeatMasker,LTR,623061,623294,9,0.03
ptg001959l,606951,607232,281,RepeatMasker,LTR,606889,607113,162,0.58
ptg001960l,753237,753556,319,RepeatMasker,LTR,750631,753287,50,0.16
ptg001964l,558501,558781,280,RepeatMasker,LTR,557845,559925,280,1.00
ptg001964l,689383,689631,248,RepeatMasker,LTR,684333,692548,248,1.00
ptg001964l,2183390,2183689,299,RepeatMasker,LTR,2183338,2183897,299,1.00
ptg001965l,2472151,2472448,297,RepeatMasker,LTR,2472105,2472489,297,1.00
ptg001969l,258006,258324,318,RepeatMasker,LTR,257676,258188,182,0.57
ptg001971l,1608661,1608940,279,RepeatMasker,LTR,1608449,1608839,178,0.64
ptg001972l,351373,351676,303,RepeatMasker,LTR,351076,351520,147,0.49
ptg001972l,351373,351676,303,RepeatMasker,LTR,351642,351725,35,0.12
ptg001973l,969704,970014,310,RepeatMasker,LTR,969923,970044,92,0.30
ptg001973l,969704,970014,310,RepeatMasker,LTR,969989,970059,26,0.08
ptg001976l,430541,430840,299,RepeatMasker,LTR,430290,434382,299,1.00
ptg001979l,1281058,1281344,286,RepeatMasker,LTR,1281033,1281086,28,0.10
ptg001981l,322886,323185,299,RepeatMasker,LTR,322834,323343,299,1.00
ptg001993l,758012,758312,300,RepeatMasker,LTR,757960,758520,300,1.00
ptg001993l,1035940,1036239,299,RepeatMasker,LTR,1035888,1036404,299,1.00
ptg001993l,1049342,1049640,298,RepeatMasker,LTR,1049290,1049795,298,1.00
ptg002005l,274811,275094,283,RepeatMasker,LTR,274192,277864,283,1.00
ptg002005l,347884,348165,281,RepeatMasker,LTR,346958,347967,83,0.30
ptg002006l,3816761,3817045,284,RepeatMasker,LTR,3814593,3817443,284,1.00
ptg002011l,4391771,4392082,311,RepeatMasker,LTR,4391938,4394280,145,0.47
ptg002011l,4391771,4392082,311,RepeatMasker,LTR,4390482,4391939,168,0.54
ptg002015l,419700,419999,299,RepeatMasker,LTR,419648,420079,299,1.00
ptg002015l,3266516,3266813,297,RepeatMasker,LTR,3266469,3266991,297,1.00
ptg002017l,154456,154736,280,RepeatMasker,LTR,154444,155118,280,1.00
ptg002022l,331197,331484,287,RepeatMasker,LTR,330337,333046,287,1.00
ptg002022l,5924088,5924376,288,RepeatMasker,LTR,5920948,5925784,288,1.00
ptg002027l,757289,757592,303,RepeatMasker,LTR,753702,757936,303,1.00
ptg002036l,2334695,2335015,320,RepeatMasker,LTR,2334342,2335132,320,1.00
ptg002043l,680654,680931,277,RepeatMasker,LTR,680532,680992,277,1.00
ptg002043l,680654,680931,277,RepeatMasker,LTR,680664,684353,268,0.97
ptg002043l,1720769,1721068,299,RepeatMasker,LTR,1720717,1721275,299,1.00
ptg002048l,3949802,3950089,287,RepeatMasker,LTR,3948947,3954800,287,1.00
ptg002055l,3278553,3278837,284,RepeatMasker,LTR,3275732,3278662,109,0.38
ptg002057l,1246536,1246816,280,RepeatMasker,LTR,1246523,1247960,280,1.00
ptg002057l,1253721,1254000,279,RepeatMasker,LTR,1253708,1255053,279,1.00
ptg002058l,841363,841662,299,RepeatMasker,LTR,841329,841682,299,1.00
ptg002058l,1295128,1295423,295,RepeatMasker,LTR,1295076,1295576,295,1.00
ptg002065l,3106575,3106884,309,RepeatMasker,LTR,3106556,3106624,49,0.16
ptg002069l,778267,778596,329,RepeatMasker,LTR,778255,778882,329,1.00
ptg002070l,269015,269309,294,RepeatMasker,LTR,268963,269525,294,1.00
ptg002072l,224637,224932,295,RepeatMasker,LTR,224494,225422,295,1.00
ptg002072l,1103635,1103922,287,RepeatMasker,LTR,1102787,1105676,287,1.00
ptg002072l,1550559,1550858,299,RepeatMasker,LTR,1550507,1550938,299,1.00
ptg002073l,253493,253820,327,RepeatMasker,LTR,253149,254099,327,1.00
ptg002074l,1758878,1759177,299,RepeatMasker,LTR,1758826,1759332,299,1.00
ptg002081l,2059702,2060027,325,RepeatMasker,LTR,2057951,2061223,325,1.00
ptg002085l,2730162,2730460,298,RepeatMasker,LTR,2729947,2730168,6,0.02
ptg002085l,2730162,2730460,298,RepeatMasker,LTR,2730162,2730647,298,1.00
ptg002086l,2060845,2061126,281,RepeatMasker,LTR,2060198,2061513,281,1.00
ptg002087l,1225796,1226101,305,RepeatMasker,LTR,1226056,1226327,46,0.15
ptg002087l,1227718,1227996,278,RepeatMasker,LTR,1226931,1227873,155,0.56
ptg002087l,1227718,1227996,278,RepeatMasker,LTR,1227833,1227879,47,0.17
ptg002088l,189385,189699,314,RepeatMasker,LTR,187224,189413,28,0.09
ptg002088l,189385,189699,314,RepeatMasker,LTR,189612,190088,88,0.28
ptg002088l,669267,669545,278,RepeatMasker,LTR,667699,669840,278,1.00
ptg002088l,1736099,1736411,312,RepeatMasker,LTR,1735487,1738371,312,1.00
ptg002089l,3370271,3370595,324,RepeatMasker,LTR,3368901,3372683,324,1.00
ptg002089l,3826645,3826953,308,RepeatMasker,LTR,3823146,3826848,203,0.66
ptg002090l,148974,149260,286,RepeatMasker,LTR,147176,151296,286,1.00
ptg002094l,642315,642629,314,RepeatMasker,LTR,642437,646781,193,0.61
ptg002102l,144161,144442,281,RepeatMasker,LTR,143548,144669,281,1.00
ptg002102l,144161,144442,281,RepeatMasker,LTR,144424,144846,19,0.07
ptg002102l,2848993,2849291,298,RepeatMasker,LTR,2848970,2849456,298,1.00
ptg002106l,1261103,1261402,299,RepeatMasker,LTR,1261053,1261581,299,1.00
ptg002108l,894563,894852,289,RepeatMasker,LTR,893728,898572,289,1.00
ptg002109l,1528489,1528822,333,RepeatMasker,LTR,1528268,1528498,9,0.03
ptg002110l,1003250,1003534,284,RepeatMasker,LTR,1003105,1003266,16,0.06
ptg002116l,2820474,2820761,287,RepeatMasker,LTR,2819622,2822326,287,1.00
ptg002124l,3104196,3104496,300,RepeatMasker,LTR,3104144,3104708,300,1.00
ptg002129l,2931311,2931613,302,RepeatMasker,LTR,2931414,2931518,105,0.35
ptg002130l,3937169,3937454,285,RepeatMasker,LTR,3933878,3937336,167,0.59
ptg002134l,312131,312430,299,RepeatMasker,LTR,312079,312587,299,1.00
ptg002134l,655302,655601,299,RepeatMasker,LTR,655250,655599,297,0.99
ptg002135l,1412486,1412756,270,RepeatMasker,LTR,1412717,1414677,40,0.15
ptg002136l,180867,181159,292,RepeatMasker,LTR,178037,181501,292,1.00
ptg002136l,1973421,1973726,305,RepeatMasker,LTR,1973577,1973845,150,0.49
ptg002140l,1896723,1896992,269,RepeatMasker,LTR,1896719,1896928,205,0.76
ptg002140l,1896723,1896992,269,RepeatMasker,LTR,1896820,1897438,173,0.64
ptg002141l,1937083,1937402,319,RepeatMasker,LTR,1936746,1937251,168,0.53
ptg002141l,1937083,1937402,319,RepeatMasker,LTR,1937243,1938059,160,0.50
ptg002142l,3402955,3403253,298,RepeatMasker,LTR,3403056,3403091,36,0.12
ptg002142l,3402955,3403253,298,RepeatMasker,LTR,3403061,3403095,35,0.12
ptg002143l,170482,170762,280,RepeatMasker,LTR,170739,170783,24,0.09
ptg002143l,481283,481576,293,RepeatMasker,LTR,481510,482185,67,0.23
ptg002143l,3044579,3044898,319,RepeatMasker,LTR,3044362,3045366,319,1.00
ptg002144l,1698025,1698336,311,RepeatMasker,LTR,1696927,1699694,311,1.00
ptg002147l,3116542,3116855,313,RepeatMasker,LTR,3116717,3116757,41,0.13
ptg002150l,92174,92492,318,RepeatMasker,LTR,92121,92770,318,1.00
ptg002150l,3128127,3128462,335,RepeatMasker,LTR,3128220,3128325,106,0.32
ptg002150l,3128127,3128462,335,RepeatMasker,LTR,3128423,3129354,40,0.12
ptg002154l,542428,542712,284,RepeatMasker,LTR,541449,543335,284,1.00
ptg002163l,808857,809138,281,RepeatMasker,LTR,808213,809520,281,1.00
ptg002165l,2049121,2049422,301,RepeatMasker,LTR,2049274,2049821,149,0.50
ptg002166l,151949,152248,299,RepeatMasker,LTR,151961,152126,166,0.56
ptg002166l,1077887,1078167,280,RepeatMasker,LTR,1077227,1078242,280,1.00
ptg002166l,1077887,1078167,280,RepeatMasker,LTR,1077875,1078552,280,1.00
ptg002178l,1250633,1250912,279,RepeatMasker,LTR,1249989,1251293,279,1.00
ptg002181l,2190451,2190759,308,RepeatMasker,LTR,2190127,2190654,203,0.66
ptg002186l,232503,232829,326,RepeatMasker,LTR,232470,233842,326,1.00
ptg002186l,2344798,2345092,294,RepeatMasker,LTR,2344746,2345301,294,1.00
ptg002187l,709337,709644,307,RepeatMasker,LTR,707000,710585,307,1.00
ptg002187l,2175559,2175890,331,RepeatMasker,LTR,2175761,2176103,130,0.39
ptg002188l,1358868,1359174,306,RepeatMasker,LTR,1358567,1362172,306,1.00
ptg002188l,1969137,1969437,300,RepeatMasker,LTR,1969085,1969655,300,1.00
ptg002193l,618421,618723,302,RepeatMasker,LTR,616478,618974,302,1.00
ptg002193l,2117567,2117868,301,RepeatMasker,LTR,2117533,2118271,301,1.00
ptg002193l,3298254,3298550,296,RepeatMasker,LTR,3295874,3298614,296,1.00
ptg002193l,4112099,4112374,275,RepeatMasker,LTR,4111650,4112235,136,0.49
ptg002194l,1017657,1017946,289,RepeatMasker,LTR,1017430,1018028,289,1.00
ptg002194l,1017657,1017946,289,RepeatMasker,LTR,1017484,1018115,289,1.00
ptg002197l,1728788,1729075,287,RepeatMasker,LTR,1726353,1729986,287,1.00
ptg002197l,1799387,1799686,299,RepeatMasker,LTR,1799335,1799864,299,1.00
ptg002203l,1466685,1467002,317,RepeatMasker,LTR,1465890,1467216,317,1.00
ptg002213l,120591,120865,274,RepeatMasker,LTR,120255,120753,162,0.59
ptg002214l,2294161,2294463,302,RepeatMasker,LTR,2294305,2295432,159,0.53
ptg002217l,2600883,2601160,277,RepeatMasker,LTR,2600761,2601221,277,1.00
ptg002217l,2600883,2601160,277,RepeatMasker,LTR,2600893,2604587,268,0.97
ptg002220l,502640,502921,281,RepeatMasker,LTR,501996,503301,281,1.00
ptg002224l,494639,494932,293,RepeatMasker,LTR,494612,496050,293,1.00
ptg002224l,1155802,1156101,299,RepeatMasker,LTR,1154650,1156768,299,1.00
ptg002224l,1518387,1518695,308,RepeatMasker,LTR,1517632,1518531,144,0.47
ptg002224l,1518387,1518695,308,RepeatMasker,LTR,1517785,1518531,144,0.47
ptg002233l,3103767,3104065,298,RepeatMasker,LTR,3103715,3104273,298,1.00
ptg002233l,3737058,3737344,286,RepeatMasker,LTR,3737321,3737366,24,0.08
ptg002236l,17229,17524,295,RepeatMasker,LTR,17177,17702,295,1.00
ptg002236l,532108,532404,296,RepeatMasker,LTR,532056,532624,296,1.00
ptg002240l,1474276,1474559,283,RepeatMasker,LTR,1473422,1477743,283,1.00
ptg002243l,570009,570298,289,RepeatMasker,LTR,569368,571337,289,1.00
ptg002243l,1528537,1528857,320,RepeatMasker,LTR,1524844,1528587,50,0.16
ptg002256l,993368,993667,299,RepeatMasker,LTR,993316,993875,299,1.00
ptg002259l,1048921,1049220,299,RepeatMasker,LTR,1048879,1049398,299,1.00
ptg002261l,298818,299112,294,RepeatMasker,LTR,298805,299480,294,1.00
ptg002262l,3890015,3890304,289,RepeatMasker,LTR,3890008,3890059,44,0.15
ptg002272l,1246035,1246356,321,RepeatMasker,LTR,1245887,1246823,321,1.00
ptg002274l,1335199,1335480,281,RepeatMasker,LTR,1335166,1335869,281,1.00
ptg002277l,1435019,1435300,281,RepeatMasker,LTR,1435006,1436441,281,1.00
ptg002277l,1442211,1442502,291,RepeatMasker,LTR,1442198,1442498,287,0.99
ptg002279l,618844,619164,320,RepeatMasker,LTR,619039,619101,63,0.20
ptg002280l,1616759,1617052,293,RepeatMasker,LTR,1616707,1617230,293,1.00
ptg002284l,1982223,1982522,299,RepeatMasker,LTR,1982171,1982606,299,1.00
ptg002284l,2074689,2075012,323,RepeatMasker,LTR,2074676,2076132,323,1.00
ptg002284l,2082261,2082583,322,RepeatMasker,LTR,2082248,2083713,322,1.00
ptg002286l,159741,160021,280,RepeatMasker,LTR,159095,161159,280,1.00
ptg002291l,1481258,1481556,298,RepeatMasker,LTR,1481206,1481636,298,1.00
ptg002291l,2117221,2117498,277,RepeatMasker,LTR,2117288,2119269,211,0.76
ptg002292l,1695389,1695689,300,RepeatMasker,LTR,1695546,1696199,144,0.48
ptg002295l,1599211,1599528,317,RepeatMasker,LTR,1599057,1599986,317,1.00
ptg002299l,48758,49053,295,RepeatMasker,LTR,48706,49261,295,1.00
ptg002299l,839345,839645,300,RepeatMasker,LTR,839142,839378,33,0.11
ptg002302l,1681281,1681567,286,RepeatMasker,LTR,1680521,1682550,286,1.00
ptg002303l,1870950,1871259,309,RepeatMasker,LTR,1870958,1871869,302,0.98
ptg002303l,2482483,2482788,305,RepeatMasker,LTR,2482662,2482702,41,0.13
ptg002303l,2912035,2912336,301,RepeatMasker,LTR,2910329,2914274,301,1.00
ptg002306l,194191,194518,327,RepeatMasker,LTR,193866,194777,327,1.00
ptg002307l,464095,464374,279,RepeatMasker,LTR,463827,465490,279,1.00
ptg002308l,5273445,5273764,319,RepeatMasker,LTR,5273197,5273495,50,0.16
ptg002309l,493603,493851,248,RepeatMasker,LTR,488566,498055,248,1.00
ptg002309l,586256,586555,299,RepeatMasker,LTR,586204,586749,299,1.00
ptg002312l,1617254,1617553,299,RepeatMasker,LTR,1617202,1617731,299,1.00
ptg002319l,1704790,1705108,318,RepeatMasker,LTR,1704908,1704935,28,0.09
ptg002319l,1704790,1705108,318,RepeatMasker,LTR,1705040,1705069,30,0.09
ptg002320l,734576,734859,283,RepeatMasker,LTR,734836,734880,24,0.08
ptg002321l,880829,881142,313,RepeatMasker,LTR,880008,883391,313,1.00
ptg002323l,962821,963146,325,RepeatMasker,LTR,963083,963140,58,0.18
ptg002325l,3535874,3536155,281,RepeatMasker,LTR,3535982,3536174,174,0.62
ptg002325l,3535874,3536155,281,RepeatMasker,LTR,3536055,3536193,101,0.36
ptg002330l,1105974,1106273,299,RepeatMasker,LTR,1105533,1106253,279,0.93
ptg002332l,1529293,1529590,297,RepeatMasker,LTR,1529243,1529768,297,1.00
ptg002332l,5558481,5558772,291,RepeatMasker,LTR,5555136,5558516,35,0.12
ptg002332l,5558481,5558772,291,RepeatMasker,LTR,5558457,5558538,57,0.20
ptg002334l,121787,122090,303,RepeatMasker,LTR,121810,122311,281,0.93
ptg002334l,2211516,2211827,311,RepeatMasker,LTR,2211662,2211731,70,0.23
ptg002338l,4309944,4310239,295,RepeatMasker,LTR,4309892,4310432,295,1.00
ptg002338l,4593299,4593598,299,RepeatMasker,LTR,4593247,4593795,299,1.00
ptg002338l,5545187,5545480,293,RepeatMasker,LTR,5545393,5545606,88,0.30
ptg002345l,2269812,2270153,341,RepeatMasker,LTR,2269603,2269820,8,0.02
ptg002347l,4552885,4553173,288,RepeatMasker,LTR,4552699,4553677,288,1.00
ptg002354l,129403,129697,294,RepeatMasker,LTR,124338,132747,294,1.00
ptg002356l,2160175,2160482,307,RepeatMasker,LTR,2159529,2160467,292,0.95
ptg002357l,337649,337930,281,RepeatMasker,LTR,334875,342382,281,1.00
ptg002358l,4795199,4795487,288,RepeatMasker,LTR,4793049,4798793,288,1.00
ptg002358l,6255430,6255717,287,RepeatMasker,LTR,6254568,6260349,287,1.00
ptg002370l,3264317,3264628,311,RepeatMasker,LTR,3264493,3264531,39,0.13
ptg002374l,1659226,1659497,271,RepeatMasker,LTR,1659465,1659515,33,0.12
ptg002375l,2192553,2192859,306,RepeatMasker,LTR,2192665,2192833,169,0.55
ptg002379l,1195360,1195654,294,RepeatMasker,LTR,1195308,1195678,294,1.00
ptg002380l,502577,502863,286,RepeatMasker,LTR,497023,503261,286,1.00
ptg002380l,2193977,2194276,299,RepeatMasker,LTR,2193925,2194441,299,1.00
ptg002380l,2957260,2957542,282,RepeatMasker,LTR,2957519,2957563,24,0.09
ptg002381l,771646,771936,290,RepeatMasker,LTR,770996,772314,290,1.00
ptg002383l,1195626,1195926,300,RepeatMasker,LTR,1195574,1196138,300,1.00
ptg002387l,1889032,1889345,313,RepeatMasker,LTR,1888128,1889398,313,1.00
ptg002395l,511952,512270,318,RepeatMasker,LTR,512126,516089,145,0.46
ptg002397l,1248235,1248540,305,RepeatMasker,LTR,1248389,1248684,152,0.50
ptg002398l,34041,34326,285,RepeatMasker,LTR,33532,35222,285,1.00
ptg002399l,1420017,1420342,325,RepeatMasker,LTR,1419833,1421201,325,1.00
ptg002400l,428053,428356,303,RepeatMasker,LTR,427816,428301,248,0.82
ptg002404l,625844,626141,297,RepeatMasker,LTR,625792,626319,297,1.00
ptg002404l,911029,911337,308,RepeatMasker,LTR,910186,911151,122,0.40
ptg002408l,120051,120350,299,RepeatMasker,LTR,119680,121020,299,1.00
ptg002411l,995353,995644,291,RepeatMasker,LTR,995430,996014,215,0.74
ptg002412l,330584,330879,295,RepeatMasker,LTR,326255,330937,295,1.00
ptg002412l,1589208,1589502,294,RepeatMasker,LTR,1584856,1589559,294,1.00
ptg002415l,327609,327900,291,RepeatMasker,LTR,327557,327898,289,0.99
ptg002415l,1863531,1863813,282,RepeatMasker,LTR,1863312,1863549,18,0.06
ptg002417l,5076567,5076873,306,RepeatMasker,LTR,5073883,5077476,306,1.00
ptg002418l,827323,827604,281,RepeatMasker,LTR,826613,830651,281,1.00
ptg002425l,474972,475266,294,RepeatMasker,LTR,474459,475169,197,0.67
ptg002425l,474972,475266,294,RepeatMasker,LTR,474988,475197,210,0.71
ptg002428l,1109364,1109633,269,RepeatMasker,LTR,1109248,1109457,93,0.35
ptg002434l,380747,381027,280,RepeatMasker,LTR,380113,381408,280,1.00
ptg002435l,810577,810888,311,RepeatMasker,LTR,810054,810683,106,0.34
ptg002435l,810577,810888,311,RepeatMasker,LTR,810669,814608,220,0.71
ptg002440l,431527,431805,278,RepeatMasker,LTR,431346,432035,278,1.00
ptg002440l,431527,431805,278,RepeatMasker,LTR,431486,432011,278,1.00
ptg002442l,2772617,2772907,290,RepeatMasker,LTR,2770185,2773825,290,1.00
ptg002444l,5868945,5869254,309,RepeatMasker,LTR,5868154,5870310,309,1.00
ptg002444l,9038391,9038698,307,RepeatMasker,LTR,9037980,9040349,307,1.00
ptg002445l,1684175,1684473,298,RepeatMasker,LTR,1684163,1684836,298,1.00
ptg002445l,2031567,2031876,309,RepeatMasker,LTR,2031534,2032911,309,1.00
ptg002447l,27449,27754,305,RepeatMasker,LTR,27437,28117,305,1.00
ptg002447l,42441,42721,280,RepeatMasker,LTR,42429,43032,280,1.00
ptg002448l,663399,663695,296,RepeatMasker,LTR,663488,663602,115,0.39
ptg002448l,663399,663695,296,RepeatMasker,LTR,663499,663595,97,0.33
ptg002453l,1197557,1197855,298,RepeatMasker,LTR,1196128,1201457,298,1.00
ptg002453l,1838732,1838981,249,RepeatMasker,LTR,1837588,1843183,249,1.00
ptg002454l,2210465,2210788,323,RepeatMasker,LTR,2208742,2210725,260,0.80
ptg002454l,2465520,2465811,291,RepeatMasker,LTR,2464819,2466177,291,1.00
ptg002455l,418455,418749,294,RepeatMasker,LTR,418403,418972,294,1.00
ptg002468l,718334,718664,330,RepeatMasker,LTR,717994,718901,330,1.00
ptg002468l,1457477,1457774,297,RepeatMasker,LTR,1457443,1457772,295,0.99
ptg002470l,842436,842751,315,RepeatMasker,LTR,841541,842841,315,1.00
ptg002473l,6129386,6129672,286,RepeatMasker,LTR,6125485,6132279,286,1.00
ptg002475l,762681,762961,280,RepeatMasker,LTR,761900,764011,280,1.00
ptg002476l,932242,932564,322,RepeatMasker,LTR,931141,932406,164,0.51
ptg002476l,3944694,3944977,283,RepeatMasker,LTR,3943854,3945242,283,1.00
ptg002488l,3466368,3466628,260,RepeatMasker,LTR,3466437,3466718,192,0.74
ptg002489l,1634647,1634959,312,RepeatMasker,LTR,1633486,1636324,312,1.00
ptg002492l,612935,613215,280,RepeatMasker,LTR,612902,614269,280,1.00
ptg002495l,700051,700328,277,RepeatMasker,LTR,693205,700214,163,0.59
ptg002499l,2409414,2409702,288,RepeatMasker,LTR,2408271,2409862,288,1.00
ptg002502l,2042797,2043096,299,RepeatMasker,LTR,2042785,2043489,299,1.00
ptg002503l,1115786,1116071,285,RepeatMasker,LTR,1115512,1116509,285,1.00
ptg002506l,690886,691166,280,RepeatMasker,LTR,690261,691548,280,1.00
ptg002510l,6235040,6235344,304,RepeatMasker,LTR,6233947,6235201,161,0.53
ptg002510l,7834689,7835011,322,RepeatMasker,LTR,7834009,7835197,322,1.00
ptg002512l,713574,713861,287,RepeatMasker,LTR,712673,718512,287,1.00
ptg002516l,1239109,1239388,279,RepeatMasker,LTR,1238813,1239198,89,0.32
ptg002517l,2043304,2043607,303,RepeatMasker,LTR,2043508,2044240,100,0.33
ptg002528l,706686,707002,316,RepeatMasker,LTR,705830,708535,316,1.00
ptg002534l,183052,183353,301,RepeatMasker,LTR,183255,183838,99,0.33
ptg002538l,167026,167305,279,RepeatMasker,LTR,164637,167445,279,1.00
ptg002538l,167026,167305,279,RepeatMasker,LTR,163803,167098,72,0.26
ptg002540l,2805331,2805612,281,RepeatMasker,LTR,2805298,2806670,281,1.00
ptg002546l,2197888,2198186,298,RepeatMasker,LTR,2197245,2198566,298,1.00
ptg002546l,2205054,2205348,294,RepeatMasker,LTR,2204256,2205731,294,1.00
ptg002546l,2226321,2226635,314,RepeatMasker,LTR,2226302,2226350,29,0.09
ptg002548l,1739356,1739654,298,RepeatMasker,LTR,1739304,1739808,298,1.00
ptg002551l,287777,288073,296,RepeatMasker,LTR,287743,288093,296,1.00
ptg002552l,2052148,2052429,281,RepeatMasker,LTR,2051811,2053480,281,1.00
ptg002564l,1047071,1047370,299,RepeatMasker,LTR,1047019,1047411,299,1.00
ptg002570l,85613,85910,297,RepeatMasker,LTR,85561,86078,297,1.00
ptg002570l,2090841,2091142,301,RepeatMasker,LTR,2090480,2091769,301,1.00
ptg002570l,2254971,2255270,299,RepeatMasker,LTR,2254919,2255451,299,1.00
ptg002571l,640289,640588,299,RepeatMasker,LTR,640237,640766,299,1.00
ptg002571l,1492954,1493253,299,RepeatMasker,LTR,1492902,1493333,299,1.00
ptg002572l,757737,758016,279,RepeatMasker,LTR,756876,759973,279,1.00
ptg002573l,2725892,2726190,298,RepeatMasker,LTR,2725963,2726034,72,0.24
ptg002573l,2725892,2726190,298,RepeatMasker,LTR,2725984,2726097,114,0.38
ptg002573l,5031278,5031587,309,RepeatMasker,LTR,5031269,5031816,309,1.00
ptg002573l,6850946,6851265,319,RepeatMasker,LTR,6851216,6851433,50,0.16
ptg002573l,6850946,6851265,319,RepeatMasker,LTR,6851242,6851435,24,0.08
ptg002575l,3293961,3294274,313,RepeatMasker,LTR,3293509,3293989,28,0.09
ptg002575l,3293961,3294274,313,RepeatMasker,LTR,3294187,3294753,88,0.28
ptg002575l,3850017,3850324,307,RepeatMasker,LTR,3846433,3850045,28,0.09
ptg002575l,3850017,3850324,307,RepeatMasker,LTR,3850237,3850783,88,0.29
ptg002578l,22749,23048,299,RepeatMasker,LTR,22697,23203,299,1.00
ptg002578l,105755,106054,299,RepeatMasker,LTR,105703,106219,299,1.00
ptg002578l,468216,468515,299,RepeatMasker,LTR,468169,468695,299,1.00
ptg002583l,4738266,4738563,297,RepeatMasker,LTR,4738214,4738741,297,1.00
ptg002583l,4941431,4941726,295,RepeatMasker,LTR,4941379,4941902,295,1.00
ptg002586l,3282313,3282591,278,RepeatMasker,LTR,3281587,3284318,278,1.00
ptg002594l,4850258,4850576,318,RepeatMasker,LTR,4849873,4850475,217,0.68
ptg002609l,4844961,4845261,300,RepeatMasker,LTR,4844927,4845459,300,1.00
ptg002609l,5508307,5508579,272,RepeatMasker,LTR,5508190,5508598,272,1.00
ptg002610l,165222,165519,297,RepeatMasker,LTR,165175,165674,297,1.00
ptg002613l,104242,104542,300,RepeatMasker,LTR,104190,104754,300,1.00
ptg002614l,1911708,1912004,296,RepeatMasker,LTR,1911662,1912215,296,1.00
ptg002614l,2473421,2473720,299,RepeatMasker,LTR,2473369,2473928,299,1.00
ptg002616l,1468747,1469060,313,RepeatMasker,LTR,1468179,1468785,38,0.12
ptg002620l,240680,240979,299,RepeatMasker,LTR,240628,241172,299,1.00
ptg002620l,292679,292983,304,RepeatMasker,LTR,292511,292995,304,1.00
ptg002620l,1289191,1289483,292,RepeatMasker,LTR,1289139,1289563,292,1.00
ptg002621l,7000265,7000597,332,RepeatMasker,LTR,7000032,7000762,332,1.00
ptg002623l,1310654,1310949,295,RepeatMasker,LTR,1310602,1311102,295,1.00
ptg002623l,1355720,1356019,299,RepeatMasker,LTR,1355668,1356099,299,1.00
ptg002624l,1333638,1333924,286,RepeatMasker,LTR,1333605,1334243,286,1.00
ptg002625l,2609093,2609391,298,RepeatMasker,LTR,2609041,2609567,298,1.00
ptg002628l,1134428,1134727,299,RepeatMasker,LTR,1134376,1134895,299,1.00
ptg002630l,1073122,1073403,281,RepeatMasker,LTR,1072327,1073791,281,1.00
ptg002631l,1765300,1765596,296,RepeatMasker,LTR,1765253,1765679,296,1.00
ptg002637l,2686688,2687002,314,RepeatMasker,LTR,2686785,2686887,103,0.33
ptg002637l,3334853,3335134,281,RepeatMasker,LTR,3334840,3335524,281,1.00
ptg002643l,346970,347304,334,RepeatMasker,LTR,344523,347393,334,1.00
ptg002649l,280583,280861,278,RepeatMasker,LTR,274968,280923,278,1.00
ptg002650l,173918,174210,292,RepeatMasker,LTR,174187,174242,24,0.08
ptg002651l,94190,94504,314,RepeatMasker,LTR,94445,94531,60,0.19
ptg002654l,3278479,3278778,299,RepeatMasker,LTR,3278427,3278819,299,1.00
ptg002654l,3690996,3691295,299,RepeatMasker,LTR,3690944,3691473,299,1.00
ptg002654l,3805228,3805527,299,RepeatMasker,LTR,3805176,3805693,299,1.00
ptg002654l,4702572,4702871,299,RepeatMasker,LTR,4702538,4703050,299,1.00
ptg002654l,4727302,4727601,299,RepeatMasker,LTR,4727251,4727642,299,1.00
ptg002654l,5208439,5208734,295,RepeatMasker,LTR,5208387,5208889,295,1.00
ptg002654l,5343182,5343477,295,RepeatMasker,LTR,5343130,5343685,295,1.00
ptg002659l,4738704,4739019,315,RepeatMasker,LTR,4738744,4739278,276,0.88
ptg002660l,6638370,6638663,293,RepeatMasker,LTR,6638318,6638839,293,1.00
ptg002664l,312138,312419,281,RepeatMasker,LTR,311337,312735,281,1.00
ptg002665l,2549198,2549478,280,RepeatMasker,LTR,2549185,2550614,280,1.00
ptg002677l,2303605,2303885,280,RepeatMasker,LTR,2303572,2305021,280,1.00
ptg002677l,2316294,2316584,290,RepeatMasker,LTR,2315503,2317613,290,1.00
ptg002680l,2179162,2179461,299,RepeatMasker,LTR,2179110,2179655,299,1.00
ptg002692l,832934,833261,327,RepeatMasker,LTR,833182,833244,63,0.19
ptg002693l,77811,78092,281,RepeatMasker,LTR,77021,78500,281,1.00
ptg002695l,623991,624320,329,RepeatMasker,LTR,623489,625065,329,1.00
ptg002696l,193983,194272,289,RepeatMasker,LTR,193339,195398,289,1.00
ptg002702l,2100062,2100376,314,RepeatMasker,LTR,2099815,2100595,314,1.00
ptg002706l,44574,44856,282,RepeatMasker,LTR,42648,44724,150,0.53
ptg002706l,44574,44856,282,RepeatMasker,LTR,43364,45356,282,1.00
ptg002706l,44574,44856,282,RepeatMasker,LTR,43720,45353,282,1.00
ptg002706l,854174,854480,306,RepeatMasker,LTR,854226,854372,147,0.48
ptg002706l,854174,854480,306,RepeatMasker,LTR,849276,854222,48,0.16
ptg002706l,1260706,1261005,299,RepeatMasker,LTR,1260654,1261085,299,1.00
ptg002707l,581375,581656,281,RepeatMasker,LTR,581351,581395,20,0.07
ptg002707l,1538060,1538359,299,RepeatMasker,LTR,1538008,1538539,299,1.00
ptg002707l,2730002,2730323,321,RepeatMasker,LTR,2727937,2730052,50,0.16
ptg002707l,3300968,3301266,298,RepeatMasker,LTR,3300916,3301475,298,1.00
ptg002708l,3277895,3278194,299,RepeatMasker,LTR,3277848,3278274,299,1.00
ptg002718l,471247,471545,298,RepeatMasker,LTR,469902,474332,298,1.00
ptg002720l,2294355,2294635,280,RepeatMasker,LTR,2294342,2294913,280,1.00
ptg002720l,2361169,2361467,298,RepeatMasker,LTR,2360908,2362261,298,1.00
ptg002720l,2368337,2368635,298,RepeatMasker,LTR,2367196,2369430,298,1.00
ptg002723l,105239,105534,295,RepeatMasker,LTR,105023,105245,6,0.02
ptg002723l,1598384,1598701,317,RepeatMasker,LTR,1595124,1598409,25,0.08
ptg002723l,1598384,1598701,317,RepeatMasker,LTR,1598594,1598939,108,0.34
ptg002724l,31638,31969,331,RepeatMasker,LTR,31591,31717,79,0.24
ptg002725l,3819535,3819834,299,RepeatMasker,LTR,3819483,3819853,299,1.00
ptg002732l,3370432,3370714,282,RepeatMasker,LTR,3366039,3370467,35,0.12
ptg002733l,1655829,1656128,299,RepeatMasker,LTR,1655926,1656672,203,0.68
ptg002734l,632013,632300,287,RepeatMasker,LTR,630349,632051,38,0.13
ptg002741l,1025231,1025511,280,RepeatMasker,LTR,1022666,1028547,280,1.00
ptg002741l,1810483,1810806,323,RepeatMasker,LTR,1808700,1810959,323,1.00
ptg002741l,2216241,2216522,281,RepeatMasker,LTR,2215604,2216904,281,1.00
ptg002745l,1641650,1641979,329,RepeatMasker,LTR,1640850,1641999,329,1.00
ptg002745l,1641650,1641979,329,RepeatMasker,LTR,1641248,1641999,329,1.00
ptg002745l,1830023,1830303,280,RepeatMasker,LTR,1829252,1831384,280,1.00
ptg002746l,2382910,2383209,299,RepeatMasker,LTR,2382858,2383387,299,1.00
ptg002746l,2482698,2482979,281,RepeatMasker,LTR,2482052,2483359,281,1.00
ptg002746l,2704858,2705130,272,RepeatMasker,LTR,2702028,2704860,2,0.01
ptg002746l,5668632,5668953,321,RepeatMasker,LTR,5668075,5671111,321,1.00
ptg002749l,3138031,3138343,312,RepeatMasker,LTR,3136915,3138410,312,1.00
ptg002753l,1129504,1129792,288,RepeatMasker,LTR,1128539,1129524,20,0.07
ptg002766l,1829228,1829546,318,RepeatMasker,LTR,1828819,1829354,126,0.40
ptg002766l,1829228,1829546,318,RepeatMasker,LTR,1828843,1829354,126,0.40
ptg002766l,2316789,2317075,286,RepeatMasker,LTR,2316008,2321710,286,1.00
ptg002771l,6944611,6944912,301,RepeatMasker,LTR,6944336,6946455,301,1.00
ptg002771l,7380214,7380545,331,RepeatMasker,LTR,7378907,7381534,331,1.00
ptg002772l,6371567,6371892,325,RepeatMasker,LTR,6369803,6373087,325,1.00
ptg002773l,771243,771524,281,RepeatMasker,LTR,766928,773197,281,1.00
ptg002773l,818307,818642,335,RepeatMasker,LTR,818135,818397,90,0.27
ptg002773l,818307,818642,335,RepeatMasker,LTR,818464,819776,179,0.53
ptg002774l,406198,406487,289,RepeatMasker,LTR,405679,406756,289,1.00
ptg002780l,1275357,1275672,315,RepeatMasker,LTR,1275430,1275497,68,0.22
ptg002786l,1260835,1261150,315,RepeatMasker,LTR,1260703,1264477,315,1.00
ptg002789l,4366780,4367061,281,RepeatMasker,LTR,4359590,4366781,1,0.00
ptg002790l,442262,442564,302,RepeatMasker,LTR,442116,442560,298,0.99
ptg002810l,900252,900561,309,RepeatMasker,LTR,899428,900282,30,0.10
ptg002811l,150894,151207,313,RepeatMasker,LTR,150901,151794,307,0.98
ptg002813l,259436,259684,248,RepeatMasker,LTR,254336,263890,248,1.00
ptg002818l,2850875,2851168,293,RepeatMasker,LTR,2850823,2851166,291,0.99
ptg002818l,3506650,3506949,299,RepeatMasker,LTR,3506598,3507126,299,1.00
ptg002818l,4131620,4131932,312,RepeatMasker,LTR,4131536,4131933,312,1.00
ptg002823l,351255,351582,327,RepeatMasker,LTR,350396,352420,327,1.00
ptg002824l,102515,102806,291,RepeatMasker,LTR,101868,103821,291,1.00
ptg002828l,84574,84857,283,RepeatMasker,LTR,84530,84670,96,0.34
ptg002829l,1956213,1956494,281,RepeatMasker,LTR,1955589,1957535,281,1.00
ptg002829l,2692712,2693010,298,RepeatMasker,LTR,2688470,2692751,39,0.13
ptg002829l,4071658,4071988,330,RepeatMasker,LTR,4070344,4071794,136,0.41
ptg002830l,720638,720916,278,RepeatMasker,LTR,720893,720937,24,0.09
ptg002833l,1484890,1485202,312,RepeatMasker,LTR,1484677,1485216,312,1.00
ptg002834l,1118003,1118322,319,RepeatMasker,LTR,1117907,1119235,319,1.00
ptg002838l,1640232,1640513,281,RepeatMasker,LTR,1639592,1641572,281,1.00
ptg002848l,443375,443688,313,RepeatMasker,LTR,443378,443881,311,0.99
ptg002848l,443375,443688,313,RepeatMasker,LTR,443500,443945,189,0.60
ptg002851l,3055071,3055355,284,RepeatMasker,LTR,3055232,3055797,124,0.44
ptg002858l,3954819,3955100,281,RepeatMasker,LTR,3955030,3955098,69,0.25
ptg002859l,834017,834298,281,RepeatMasker,LTR,834004,835433,281,1.00
ptg002864l,1332202,1332529,327,RepeatMasker,LTR,1332287,1332447,161,0.49
ptg002867l,726844,727163,319,RepeatMasker,LTR,726584,726846,2,0.01
ptg002867l,726844,727163,319,RepeatMasker,LTR,726617,726877,33,0.10
ptg002867l,3231902,3232182,280,RepeatMasker,LTR,3231267,3233087,280,1.00
ptg002867l,3231902,3232182,280,RepeatMasker,LTR,3231889,3233302,280,1.00
ptg002867l,3406758,3407052,294,RepeatMasker,LTR,3406642,3407028,270,0.92
ptg002870l,750231,750511,280,RepeatMasker,LTR,750198,750840,280,1.00
ptg002871l,161944,162235,291,RepeatMasker,LTR,161898,162276,291,1.00
ptg002871l,1677597,1677906,309,RepeatMasker,LTR,1677811,1677884,74,0.24
ptg002871l,1677597,1677906,309,RepeatMasker,LTR,1677872,1678789,35,0.11
ptg002880l,881543,881848,305,RepeatMasker,LTR,881205,881705,162,0.53
ptg002880l,881543,881848,305,RepeatMasker,LTR,881728,881832,105,0.34
ptg002880l,881543,881848,305,RepeatMasker,LTR,881737,881818,82,0.27
ptg002880l,5329284,5329557,273,RepeatMasker,LTR,5328647,5330694,273,1.00
ptg002884l,276103,276389,286,RepeatMasker,LTR,276366,276428,24,0.08
ptg002886l,462472,462791,319,RepeatMasker,LTR,459994,462522,50,0.16
ptg002890l,1081700,1082028,328,RepeatMasker,LTR,1081933,1082874,96,0.29
ptg002890l,3276291,3276586,295,RepeatMasker,LTR,3276266,3276313,22,0.07
ptg002890l,3276291,3276586,295,RepeatMasker,LTR,3276280,3276321,30,0.10
ptg002901l,1047568,1047860,292,RepeatMasker,LTR,1047827,1048732,34,0.12
ptg002902l,748066,748347,281,RepeatMasker,LTR,747272,748746,281,1.00
ptg002903l,445804,446103,299,RepeatMasker,LTR,445771,446311,299,1.00
ptg002911l,1229597,1229903,306,RepeatMasker,LTR,1228440,1231378,306,1.00
ptg002919l,95038,95340,302,RepeatMasker,LTR,93469,96094,302,1.00
ptg002920l,5571806,5572114,308,RepeatMasker,LTR,5572048,5572353,67,0.22
ptg002929l,510784,511059,275,RepeatMasker,LTR,510818,510862,45,0.16
ptg002932l,6379859,6380143,284,RepeatMasker,LTR,6378759,6379870,11,0.04
ptg002941l,2786433,2786714,281,RepeatMasker,LTR,2785784,2787095,281,1.00
ptg002941l,2793956,2794247,291,RepeatMasker,LTR,2793153,2794635,291,1.00
ptg002941l,2807578,2807873,295,RepeatMasker,LTR,2806775,2808253,295,1.00
ptg002942l,108959,109266,307,RepeatMasker,LTR,108543,109811,307,1.00
ptg002949l,44146,44473,327,RepeatMasker,LTR,43652,44190,44,0.13
ptg002949l,44146,44473,327,RepeatMasker,LTR,44190,45403,284,0.87
ptg002949l,1570933,1571229,296,RepeatMasker,LTR,1570881,1571405,296,1.00
ptg002949l,3191746,3192038,292,RepeatMasker,LTR,3185579,3191796,50,0.17
ptg002954l,20868,21164,296,RepeatMasker,LTR,20822,21205,296,1.00
ptg002954l,416329,416628,299,RepeatMasker,LTR,416277,416795,299,1.00
ptg002954l,784716,785015,299,RepeatMasker,LTR,784664,785095,299,1.00
ptg002954l,2320318,2320621,303,RepeatMasker,LTR,2320326,2320898,296,0.98
ptg002955l,318264,318605,341,RepeatMasker,LTR,317462,318561,297,0.87
ptg002955l,318264,318605,341,RepeatMasker,LTR,318592,318986,14,0.04
ptg002955l,685330,685611,281,RepeatMasker,LTR,685297,685993,281,1.00
ptg002959l,1322740,1323047,307,RepeatMasker,LTR,1322241,1322758,18,0.06
ptg002959l,1322740,1323047,307,RepeatMasker,LTR,1322302,1323643,307,1.00
ptg002965l,1263351,1263667,316,RepeatMasker,LTR,1262318,1263734,316,1.00
ptg002965l,2050611,2050910,299,RepeatMasker,LTR,2050559,2051092,299,1.00
ptg002972l,1485228,1485564,336,RepeatMasker,LTR,1484876,1489140,336,1.00
ptg002977l,266600,266881,281,RepeatMasker,LTR,261775,266631,31,0.11
ptg002978l,2381941,2382239,298,RepeatMasker,LTR,2381909,2382048,107,0.36
ptg002982l,1499141,1499433,292,RepeatMasker,LTR,1498494,1499803,292,1.00
ptg002983l,509876,510195,319,RepeatMasker,LTR,509100,511248,319,1.00
ptg002983l,1185669,1185959,290,RepeatMasker,LTR,1185587,1185731,62,0.21
ptg003000l,1346882,1347163,281,RepeatMasker,LTR,1346098,1347545,281,1.00
ptg003000l,3916897,3917178,281,RepeatMasker,LTR,3916864,3917560,281,1.00
ptg003001l,1338369,1338694,325,RepeatMasker,LTR,1337934,1338517,148,0.46
ptg003004l,391487,391775,288,RepeatMasker,LTR,391395,394578,288,1.00
ptg003014l,720953,721284,331,RepeatMasker,LTR,720898,721056,103,0.31
ptg003015l,1184951,1185234,283,RepeatMasker,LTR,1185209,1186526,26,0.09
ptg003016l,1581601,1581913,312,RepeatMasker,LTR,1581488,1581932,312,1.00
ptg003016l,2414038,2414361,323,RepeatMasker,LTR,2414318,2414480,44,0.14
ptg003016l,2414038,2414361,323,RepeatMasker,LTR,2414341,2414838,21,0.07
ptg003016l,2414038,2414361,323,RepeatMasker,LTR,2414359,2414800,3,0.01
ptg003027l,2707087,2707392,305,RepeatMasker,LTR,2707075,2707784,305,1.00
ptg003029l,954485,954796,311,RepeatMasker,LTR,952172,955633,311,1.00
ptg003029l,1705380,1705684,304,RepeatMasker,LTR,1702618,1705400,20,0.07
ptg003042l,710715,711008,293,RepeatMasker,LTR,710663,711176,293,1.00
ptg003046l,793114,793389,275,RepeatMasker,LTR,788061,797605,275,1.00
ptg003047l,2359183,2359480,297,RepeatMasker,LTR,2359456,2359500,25,0.08
ptg003049l,759400,759715,315,RepeatMasker,LTR,758173,760377,315,1.00
ptg003050l,1897304,1897599,295,RepeatMasker,LTR,1897252,1897778,295,1.00
ptg003050l,2244742,2245035,293,RepeatMasker,LTR,2244690,2245205,293,1.00
ptg003050l,2262351,2262650,299,RepeatMasker,LTR,2262299,2262845,299,1.00
ptg003050l,2742633,2742931,298,RepeatMasker,LTR,2742581,2743109,298,1.00
ptg003050l,2781645,2781944,299,RepeatMasker,LTR,2781593,2782139,299,1.00
ptg003050l,2971839,2972138,299,RepeatMasker,LTR,2971787,2972215,299,1.00
ptg003055l,180549,180904,355,RepeatMasker,LTR,180519,180587,38,0.11
ptg003056l,193121,193405,284,RepeatMasker,LTR,190461,195432,284,1.00
ptg003058l,868255,868552,297,RepeatMasker,LTR,868203,868732,297,1.00
ptg003061l,114599,114898,299,RepeatMasker,LTR,114547,114918,299,1.00
ptg003064l,1374769,1375059,290,RepeatMasker,LTR,1374132,1375432,290,1.00
ptg003066l,1018832,1019124,292,RepeatMasker,LTR,1015998,1019404,292,1.00
ptg003069l,5356363,5356655,292,RepeatMasker,LTR,5355672,5356926,292,1.00
ptg003072l,318950,319284,334,RepeatMasker,LTR,319050,319158,109,0.33
ptg003075l,3705721,3706055,334,RepeatMasker,LTR,3702620,3706705,334,1.00
ptg003075l,3763983,3764298,315,RepeatMasker,LTR,3763696,3765617,315,1.00
ptg003078l,742171,742481,310,RepeatMasker,LTR,741097,742948,310,1.00
ptg003080l,4442685,4442976,291,RepeatMasker,LTR,4442817,4442883,67,0.23
ptg003080l,5245718,5246000,282,RepeatMasker,LTR,5244872,5246876,282,1.00
ptg003081l,4932461,4932742,281,RepeatMasker,LTR,4931707,4933053,281,1.00
ptg003083l,612474,612804,330,RepeatMasker,LTR,608132,612571,97,0.29
ptg003083l,612474,612804,330,RepeatMasker,LTR,610837,612792,318,0.96
ptg003083l,912254,912540,286,RepeatMasker,LTR,910071,912294,40,0.14
ptg003084l,3126894,3127204,310,RepeatMasker,LTR,3126871,3127622,310,1.00
ptg003091l,330933,331210,277,RepeatMasker,LTR,330134,332250,277,1.00
ptg003094l,494993,495287,294,RepeatMasker,LTR,493462,496543,294,1.00
ptg003094l,1099291,1099596,305,RepeatMasker,LTR,1099488,1100074,109,0.36
ptg003098l,926522,926845,323,RepeatMasker,LTR,926531,926617,87,0.27
ptg003098l,3767214,3767527,313,RepeatMasker,LTR,3767180,3767485,271,0.87
ptg003098l,6308462,6308761,299,RepeatMasker,LTR,6308415,6308999,299,1.00
ptg003102l,2020199,2020509,310,RepeatMasker,LTR,2018406,2020233,34,0.11
ptg003103l,142412,142716,304,RepeatMasker,LTR,138624,142623,211,0.69
ptg003103l,142412,142716,304,RepeatMasker,LTR,142616,143192,101,0.33
ptg003116l,320637,320917,280,RepeatMasker,LTR,319986,321306,280,1.00
ptg003116l,327798,328078,280,RepeatMasker,LTR,327786,328460,280,1.00
ptg003118l,2203472,2203769,297,RepeatMasker,LTR,2203447,2203497,25,0.08
ptg003121l,426283,426570,287,RepeatMasker,LTR,425378,430335,287,1.00
ptg003121l,1005132,1005454,322,RepeatMasker,LTR,1004987,1005434,302,0.94
ptg003121l,2005130,2005426,296,RepeatMasker,LTR,2005078,2005625,296,1.00
ptg003121l,2043770,2044069,299,RepeatMasker,LTR,2043718,2044247,299,1.00
ptg003121l,2350470,2350762,292,RepeatMasker,LTR,2350415,2350833,292,1.00
ptg003124l,4365299,4365601,302,RepeatMasker,LTR,4365363,4365570,208,0.69
ptg003124l,4365299,4365601,302,RepeatMasker,LTR,4365446,4365653,156,0.52
ptg003135l,531192,531491,299,RepeatMasker,LTR,531142,531687,299,1.00
ptg003136l,1911372,1911707,335,RepeatMasker,LTR,1911347,1911394,22,0.07
ptg003140l,2927566,2927869,303,RepeatMasker,LTR,2926315,2927698,132,0.44
ptg003140l,2927566,2927869,303,RepeatMasker,LTR,2927356,2928623,303,1.00
ptg003142l,699757,700054,297,RepeatMasker,LTR,699346,699948,191,0.64
ptg003143l,2531038,2531342,304,RepeatMasker,LTR,2530467,2531103,65,0.21
ptg003143l,2531038,2531342,304,RepeatMasker,LTR,2531103,2531717,240,0.79
ptg003143l,3942088,3942376,288,RepeatMasker,LTR,3940051,3942512,288,1.00
ptg003145l,2803524,2803823,299,RepeatMasker,LTR,2803472,2804005,299,1.00
ptg003149l,1696773,1697066,293,RepeatMasker,LTR,1696841,1697003,163,0.56
ptg003149l,1696773,1697066,293,RepeatMasker,LTR,1696895,1697250,172,0.59
ptg003155l,957530,957832,302,RepeatMasker,LTR,957532,957571,40,0.13
ptg003156l,156025,156324,299,RepeatMasker,LTR,155973,156502,299,1.00
ptg003156l,379995,380294,299,RepeatMasker,LTR,379961,380314,299,1.00
ptg003156l,702567,702866,299,RepeatMasker,LTR,702515,702946,299,1.00
ptg003156l,4985505,4985815,310,RepeatMasker,LTR,4985536,4987120,280,0.90
ptg003160l,266644,266964,320,RepeatMasker,LTR,262597,266694,50,0.16
ptg003162l,1046228,1046532,304,RepeatMasker,LTR,1046374,1046444,71,0.23
ptg003164l,1298350,1298633,283,RepeatMasker,LTR,1298284,1298533,183,0.65
ptg003164l,1298350,1298633,283,RepeatMasker,LTR,1298561,1298703,73,0.26
ptg003164l,1298350,1298633,283,RepeatMasker,LTR,1298608,1298847,26,0.09
ptg003177l,1257624,1257885,261,RepeatMasker,LTR,1257550,1257644,20,0.08
ptg003180l,489611,489900,289,RepeatMasker,LTR,489599,490281,289,1.00
ptg003187l,850352,850651,299,RepeatMasker,LTR,850578,850622,45,0.15
ptg003187l,3715216,3715520,304,RepeatMasker,LTR,3715497,3715541,24,0.08
ptg003192l,214095,214377,282,RepeatMasker,LTR,214082,214764,282,1.00
ptg003193l,176092,176387,295,RepeatMasker,LTR,176040,176567,295,1.00
ptg003204l,1202368,1202649,281,RepeatMasker,LTR,1201722,1203042,281,1.00
ptg003204l,1209533,1209842,309,RepeatMasker,LTR,1209521,1210235,309,1.00
ptg003206l,495907,496206,299,RepeatMasker,LTR,495276,497174,299,1.00
ptg003207l,1811862,1812190,328,RepeatMasker,LTR,1811999,1812049,51,0.16
ptg003214l,299149,299468,319,RepeatMasker,LTR,299051,299751,319,1.00
ptg003215l,1239519,1239818,299,RepeatMasker,LTR,1239467,1239980,299,1.00
ptg003215l,1531943,1532238,295,RepeatMasker,LTR,1531891,1532403,295,1.00
ptg003215l,1549048,1549337,289,RepeatMasker,LTR,1548996,1549512,289,1.00
ptg003215l,1708688,1708991,303,RepeatMasker,LTR,1708636,1709156,303,1.00
ptg003215l,3232355,3232654,299,RepeatMasker,LTR,3232303,3232810,299,1.00
ptg003216l,1011073,1011393,320,RepeatMasker,LTR,1004879,1011123,50,0.16
ptg003217l,621086,621382,296,RepeatMasker,LTR,620288,621758,296,1.00
ptg003219l,4028,4338,310,RepeatMasker,LTR,3388,4720,310,1.00
ptg003219l,2605318,2605610,292,RepeatMasker,LTR,2605288,2605982,292,1.00
ptg003230l,85026,85326,300,RepeatMasker,LTR,84974,85550,300,1.00
ptg003230l,143007,143306,299,RepeatMasker,LTR,142955,143484,299,1.00
ptg003230l,2761190,2761506,316,RepeatMasker,LTR,2761193,2762007,314,0.99
ptg003230l,5758101,5758397,296,RepeatMasker,LTR,5758049,5758480,296,1.00
ptg003234l,2366,2656,290,RepeatMasker,LTR,2314,2834,290,1.00
ptg003234l,390050,390345,295,RepeatMasker,LTR,389998,390520,295,1.00
ptg003240l,287406,287708,302,RepeatMasker,LTR,285837,288162,302,1.00
ptg003240l,287406,287708,302,RepeatMasker,LTR,286148,287538,132,0.44
ptg003240l,287406,287708,302,RepeatMasker,LTR,286204,288304,302,1.00
ptg003243l,1317219,1317518,299,RepeatMasker,LTR,1317185,1317538,299,1.00
ptg003245l,2008287,2008583,296,RepeatMasker,LTR,2008236,2008800,296,1.00
ptg003245l,2171424,2171720,296,RepeatMasker,LTR,2171372,2171942,296,1.00
ptg003248l,105187,105487,300,RepeatMasker,LTR,104541,105871,300,1.00
ptg003253l,533981,534302,321,RepeatMasker,LTR,533847,534174,193,0.60
ptg003255l,53278,53575,297,RepeatMasker,LTR,53226,53743,297,1.00
ptg003255l,1366188,1366487,299,RepeatMasker,LTR,1366136,1366667,299,1.00
ptg003264l,5471901,5472198,297,RepeatMasker,LTR,5471849,5472276,297,1.00
ptg003264l,6320113,6320414,301,RepeatMasker,LTR,6318762,6323023,301,1.00
ptg003268l,4292879,4293178,299,RepeatMasker,LTR,4292853,4292901,22,0.07
ptg003270l,525028,525319,291,RepeatMasker,LTR,524389,525702,291,1.00
ptg003272l,600226,600529,303,RepeatMasker,LTR,600129,606948,303,1.00
ptg003279l,77187,77481,294,RepeatMasker,LTR,76553,77861,294,1.00
ptg003283l,359669,359951,282,RepeatMasker,LTR,359278,359972,282,1.00
ptg003284l,602524,602840,316,RepeatMasker,LTR,602573,604824,268,0.85
ptg003284l,1092781,1093087,306,RepeatMasker,LTR,1092791,1092858,68,0.22
ptg003286l,906901,907181,280,RepeatMasker,LTR,906888,908315,280,1.00
ptg003286l,914063,914343,280,RepeatMasker,LTR,914050,915380,280,1.00
ptg003287l,1038008,1038329,321,RepeatMasker,LTR,1038066,1038234,169,0.53
ptg003290l,5019504,5019787,283,RepeatMasker,LTR,5018886,5022533,283,1.00
ptg003290l,5879345,5879628,283,RepeatMasker,LTR,5879336,5879765,283,1.00
ptg003291l,1337145,1337465,320,RepeatMasker,LTR,1334713,1338630,320,1.00
ptg003303l,1132478,1132758,280,RepeatMasker,LTR,1132445,1133814,280,1.00
ptg003309l,739807,740087,280,RepeatMasker,LTR,739161,740452,280,1.00
ptg003311l,709009,709308,299,RepeatMasker,LTR,708957,709486,299,1.00
ptg003311l,2057638,2057937,299,RepeatMasker,LTR,2057586,2058115,299,1.00
ptg003311l,3399112,3399414,302,RepeatMasker,LTR,3398703,3399316,204,0.68
ptg003317l,1728345,1728668,323,RepeatMasker,LTR,1728008,1728507,162,0.50
ptg003317l,3112404,3112691,287,RepeatMasker,LTR,3112490,3112631,142,0.49
ptg003321l,3423691,3423983,292,RepeatMasker,LTR,3423395,3423838,147,0.50
ptg003323l,467027,467353,326,RepeatMasker,LTR,467201,467266,66,0.20
ptg003325l,894746,895028,282,RepeatMasker,LTR,895005,895050,24,0.09
ptg003327l,55587,55877,290,RepeatMasker,LTR,55475,55948,290,1.00
ptg003329l,2768467,2768766,299,RepeatMasker,LTR,2768214,2772289,299,1.00
ptg003331l,347764,348045,281,RepeatMasker,LTR,347125,348382,281,1.00
ptg003339l,2043915,2044201,286,RepeatMasker,LTR,2043060,2046893,286,1.00
ptg003339l,3482705,3483023,318,RepeatMasker,LTR,3479731,3482755,50,0.16
ptg003349l,118247,118542,295,RepeatMasker,LTR,118195,118720,295,1.00
ptg003349l,1331587,1331879,292,RepeatMasker,LTR,1331378,1332732,292,1.00
ptg003351l,91822,92102,280,RepeatMasker,LTR,91792,92484,280,1.00
ptg003351l,91822,92102,280,RepeatMasker,LTR,91809,92413,280,1.00
ptg003351l,325127,325408,281,RepeatMasker,LTR,324366,325733,281,1.00
ptg003351l,1911759,1912080,321,RepeatMasker,LTR,1911524,1911856,97,0.30
ptg003352l,1018815,1019117,302,RepeatMasker,LTR,1017565,1019853,302,1.00
ptg003352l,1018821,1019117,296,RepeatMasker,LTR,1017565,1019853,296,1.00
ptg003352l,2177742,2178046,304,RepeatMasker,LTR,2177997,2178053,50,0.16
ptg003352l,2177742,2178046,304,RepeatMasker,LTR,2178009,2178735,38,0.13
ptg003355l,1328838,1329124,286,RepeatMasker,LTR,1327985,1332872,286,1.00
ptg003355l,2411237,2411535,298,RepeatMasker,LTR,2411185,2411615,298,1.00
ptg003355l,2823641,2823921,280,RepeatMasker,LTR,2823843,2823984,79,0.28
ptg003366l,366407,366713,306,RepeatMasker,LTR,366165,366455,48,0.16
ptg003366l,366407,366713,306,RepeatMasker,LTR,366645,368019,69,0.23
ptg003368l,33011,33309,298,RepeatMasker,LTR,32856,33036,25,0.08
ptg003368l,33011,33309,298,RepeatMasker,LTR,32967,33206,195,0.65
ptg003369l,315090,315401,311,RepeatMasker,LTR,315036,315442,311,1.00
ptg003383l,2717710,2717997,287,RepeatMasker,LTR,2716855,2722644,287,1.00
ptg003383l,3672240,3672527,287,RepeatMasker,LTR,3672095,3672494,254,0.89
ptg003389l,338336,338676,340,RepeatMasker,LTR,338289,338423,87,0.26
ptg003394l,426262,426572,310,RepeatMasker,LTR,422999,426808,310,1.00
ptg003394l,1635318,1635604,286,RepeatMasker,LTR,1631421,1635746,286,1.00
ptg003396l,2244665,2244973,308,RepeatMasker,LTR,2242564,2244802,137,0.44
ptg003399l,243963,244273,310,RepeatMasker,LTR,243743,243975,12,0.04
ptg003399l,243963,244273,310,RepeatMasker,LTR,243958,245119,310,1.00
ptg003399l,1878509,1878828,319,RepeatMasker,LTR,1878208,1878585,76,0.24
ptg003402l,1442560,1442841,281,RepeatMasker,LTR,1442651,1442782,132,0.47
ptg003403l,459582,459868,286,RepeatMasker,LTR,459542,459712,130,0.45
ptg003403l,459582,459868,286,RepeatMasker,LTR,459680,459985,189,0.66
ptg003404l,1352480,1352789,309,RepeatMasker,LTR,1352232,1353761,309,1.00
ptg003404l,1352480,1352789,309,RepeatMasker,LTR,1352281,1353569,309,1.00
ptg003405l,496764,497057,293,RepeatMasker,LTR,496751,498205,293,1.00
ptg003405l,3709940,3710220,280,RepeatMasker,LTR,3709307,3710631,280,1.00
ptg003408l,673624,673948,324,RepeatMasker,LTR,666746,673787,163,0.50
ptg003408l,4826759,4827064,305,RepeatMasker,LTR,4826542,4827424,305,1.00
ptg003410l,1576082,1576354,272,RepeatMasker,LTR,1575780,1576247,165,0.61
ptg003411l,110216,110511,295,RepeatMasker,LTR,110164,110717,295,1.00
ptg003411l,652022,652343,321,RepeatMasker,LTR,652005,652054,32,0.10
ptg003412l,869221,869521,300,RepeatMasker,LTR,869169,869729,300,1.00
ptg003412l,5292309,5292608,299,RepeatMasker,LTR,5292257,5292785,299,1.00
ptg003414l,213739,214020,281,RepeatMasker,LTR,213096,215066,281,1.00
ptg003414l,2248243,2248554,311,RepeatMasker,LTR,2247606,2248541,298,0.96
ptg003414l,2248243,2248554,311,RepeatMasker,LTR,2248230,2249038,311,1.00
ptg003423l,1947294,1947587,293,RepeatMasker,LTR,1947540,1948484,48,0.16
ptg003425l,595028,595342,314,RepeatMasker,LTR,595014,595327,299,0.95
ptg003425l,595028,595342,314,RepeatMasker,LTR,595324,595663,19,0.06
ptg003426l,2905107,2905405,298,RepeatMasker,LTR,2905161,2905509,245,0.82
ptg003431l,1268002,1268309,307,RepeatMasker,LTR,1268220,1268262,43,0.14
ptg003431l,1268002,1268309,307,RepeatMasker,LTR,1268258,1268614,52,0.17
ptg003433l,1925690,1925971,281,RepeatMasker,LTR,1925045,1926363,281,1.00
ptg003433l,1932846,1933127,281,RepeatMasker,LTR,1932043,1933509,281,1.00
ptg003434l,369904,370184,280,RepeatMasker,LTR,369260,370566,280,1.00
ptg003438l,862363,862671,308,RepeatMasker,LTR,862515,862578,64,0.21
ptg003440l,429790,430088,298,RepeatMasker,LTR,429738,430314,298,1.00
ptg003443l,363937,364236,299,RepeatMasker,LTR,363885,364431,299,1.00
ptg003455l,1396150,1396477,327,RepeatMasker,LTR,1390232,1396184,34,0.10
ptg003456l,35503,35790,287,RepeatMasker,LTR,34645,40506,287,1.00
ptg003457l,5882528,5882818,290,RepeatMasker,LTR,5882476,5882983,290,1.00
ptg003457l,6271173,6271498,325,RepeatMasker,LTR,6266882,6271381,208,0.64
ptg003458l,2729207,2729532,325,RepeatMasker,LTR,2728090,2729371,164,0.50
ptg003462l,292757,293072,315,RepeatMasker,LTR,289372,293717,315,1.00
ptg003468l,1489311,1489624,313,RepeatMasker,LTR,1489319,1489698,306,0.98
ptg003469l,1012985,1013284,299,RepeatMasker,LTR,1012933,1013461,299,1.00
ptg003471l,3357566,3357875,309,RepeatMasker,LTR,3357553,3358195,309,1.00
ptg003471l,3425612,3425893,281,RepeatMasker,LTR,3425599,3426275,281,1.00
ptg003472l,325982,326268,286,RepeatMasker,LTR,325123,330955,286,1.00
ptg003472l,2127643,2127950,307,RepeatMasker,LTR,2127705,2128465,246,0.80
ptg003472l,2127643,2127950,307,RepeatMasker,LTR,2127835,2129170,116,0.38
ptg003472l,2682237,2682577,340,RepeatMasker,LTR,2682192,2682324,87,0.26
ptg003473l,4787490,4787775,285,RepeatMasker,LTR,4786869,4790527,285,1.00
ptg003474l,2930366,2930664,298,RepeatMasker,LTR,2930314,2930882,298,1.00
ptg003478l,4225474,4225722,248,RepeatMasker,LTR,4220642,4229899,248,1.00
ptg003481l,516252,516543,291,RepeatMasker,LTR,516200,516762,291,1.00
ptg003486l,222785,223087,302,RepeatMasker,LTR,221528,223823,302,1.00
ptg003486l,222791,223087,296,RepeatMasker,LTR,221528,223823,296,1.00
ptg003497l,1116954,1117244,290,RepeatMasker,LTR,1115941,1117134,180,0.62
ptg003506l,482643,482935,292,RepeatMasker,LTR,479912,482693,50,0.17
ptg003507l,405111,405427,316,RepeatMasker,LTR,404803,405254,143,0.45
ptg003507l,828084,828365,281,RepeatMasker,LTR,828051,829413,281,1.00
ptg003512l,1327552,1327833,281,RepeatMasker,LTR,1326907,1328235,281,1.00
ptg003519l,2393080,2393379,299,RepeatMasker,LTR,2393028,2393549,299,1.00
ptg003522l,862182,862489,307,RepeatMasker,LTR,862099,862679,307,1.00
ptg003523l,1981410,1981697,287,RepeatMasker,LTR,1981675,1981737,23,0.08
ptg003526l,3392341,3392643,302,RepeatMasker,LTR,3391479,3392566,225,0.75
ptg003532l,483700,484011,311,RepeatMasker,LTR,483756,483867,112,0.36
ptg003532l,483700,484011,311,RepeatMasker,LTR,483810,483877,68,0.22
ptg003537l,1567221,1567517,296,RepeatMasker,LTR,1567422,1567655,96,0.32
ptg003537l,1662721,1663021,300,RepeatMasker,LTR,1662669,1663242,300,1.00
ptg003546l,1710665,1710945,280,RepeatMasker,LTR,1710653,1711327,280,1.00
ptg003553l,2261510,2261834,324,RepeatMasker,LTR,2261769,2261815,47,0.15
ptg003554l,531625,531938,313,RepeatMasker,LTR,530522,531788,163,0.52
ptg003554l,1354115,1354402,287,RepeatMasker,LTR,1353284,1358720,287,1.00
ptg003554l,3210170,3210490,320,RepeatMasker,LTR,3210319,3210387,69,0.22
ptg003554l,3992781,3993064,283,RepeatMasker,LTR,3991393,3993508,283,1.00
ptg003555l,241708,242004,296,RepeatMasker,LTR,240573,241872,164,0.55
ptg003559l,768036,768335,299,RepeatMasker,LTR,767633,769094,299,1.00
ptg003559l,1000673,1000953,280,RepeatMasker,LTR,999893,1001319,280,1.00
ptg003560l,1125473,1125801,328,RepeatMasker,LTR,1124136,1126728,328,1.00
ptg003561l,2971016,2971313,297,RepeatMasker,LTR,2971003,2972423,297,1.00
ptg003564l,1081114,1081413,299,RepeatMasker,LTR,1081062,1081578,299,1.00
ptg003574l,48182,48454,272,RepeatMasker,LTR,48050,48188,6,0.02
ptg003586l,185110,185393,283,RepeatMasker,LTR,185370,185424,24,0.08
ptg003586l,1035523,1035803,280,RepeatMasker,LTR,1034886,1036133,280,1.00
ptg003601l,753077,753357,280,RepeatMasker,LTR,752276,753739,280,1.00
ptg003601l,1656655,1656936,281,RepeatMasker,LTR,1656642,1657243,281,1.00
ptg003601l,1666701,1666982,281,RepeatMasker,LTR,1666661,1668027,281,1.00
ptg003601l,3965698,3966021,323,RepeatMasker,LTR,3965554,3966034,323,1.00
ptg003601l,3965698,3966021,323,RepeatMasker,LTR,3965554,3966417,323,1.00
ptg003605l,536339,536664,325,RepeatMasker,LTR,532574,538293,325,1.00
ptg003606l,4252332,4252631,299,RepeatMasker,LTR,4252577,4252749,55,0.18
ptg003607l,1028691,1028984,293,RepeatMasker,LTR,1028918,1029555,67,0.23
ptg003610l,1916754,1917051,297,RepeatMasker,LTR,1916539,1917369,297,1.00
ptg003611l,657043,657335,292,RepeatMasker,LTR,656752,657210,167,0.57
ptg003611l,657043,657335,292,RepeatMasker,LTR,657113,657231,119,0.41
ptg003614l,615192,615476,284,RepeatMasker,LTR,615070,615263,71,0.25
ptg003615l,1750378,1750677,299,RepeatMasker,LTR,1750326,1750885,299,1.00
ptg003617l,1610868,1611152,284,RepeatMasker,LTR,1611084,1611532,69,0.24
ptg003617l,1628714,1628998,284,RepeatMasker,LTR,1628930,1629378,69,0.24
ptg003620l,2850168,2850467,299,RepeatMasker,LTR,2850115,2850546,299,1.00
ptg003622l,414023,414331,308,RepeatMasker,LTR,414010,415405,308,1.00
ptg003622l,414440,414739,299,RepeatMasker,LTR,414010,415405,299,1.00
ptg003623l,148069,148372,303,RepeatMasker,LTR,148084,148234,151,0.50
ptg003633l,927596,927876,280,RepeatMasker,LTR,926793,928274,280,1.00
ptg003634l,6632543,6632839,296,RepeatMasker,LTR,6632509,6632862,296,1.00
ptg003634l,7712051,7712352,301,RepeatMasker,LTR,7708944,7712088,37,0.12
ptg003634l,10844826,10845157,331,RepeatMasker,LTR,10844424,10844908,82,0.25
ptg003635l,1077293,1077580,287,RepeatMasker,LTR,1076438,1078638,287,1.00
ptg003641l,984911,985215,304,RepeatMasker,LTR,985117,985278,99,0.33
ptg003641l,984911,985215,304,RepeatMasker,LTR,985164,985326,52,0.17
ptg003641l,993121,993413,292,RepeatMasker,LTR,986252,993285,164,0.56
ptg003641l,1790744,1791070,326,RepeatMasker,LTR,1790930,1791106,141,0.43
ptg003651l,849344,849633,289,RepeatMasker,LTR,848777,849412,68,0.24
ptg003651l,857789,858066,277,RepeatMasker,LTR,857871,858138,196,0.71
ptg003668l,366055,366350,295,RepeatMasker,LTR,366003,366515,295,1.00
ptg003668l,842923,843223,300,RepeatMasker,LTR,842871,843451,300,1.00
ptg003670l,1226256,1226546,290,RepeatMasker,LTR,1226347,1227322,200,0.69
ptg003674l,680334,680618,284,RepeatMasker,LTR,678324,681738,284,1.00
ptg003700l,441089,441381,292,RepeatMasker,LTR,439668,441652,292,1.00
ptg003700l,1907502,1907784,282,RepeatMasker,LTR,1907488,1908936,282,1.00
ptg003700l,1914691,1914972,281,RepeatMasker,LTR,1914678,1916005,281,1.00
ptg003703l,777296,777606,310,RepeatMasker,LTR,777270,777429,133,0.43
ptg003703l,777296,777606,310,RepeatMasker,LTR,777273,777409,113,0.36
ptg003707l,1484246,1484542,296,RepeatMasker,LTR,1484140,1484711,296,1.00
ptg003711l,1484322,1484635,313,RepeatMasker,LTR,1484329,1484968,307,0.98
ptg003715l,899285,899562,277,RepeatMasker,LTR,899227,901107,277,1.00
ptg003716l,273632,273910,278,RepeatMasker,LTR,272201,278352,278,1.00
ptg003719l,414160,414445,285,RepeatMasker,LTR,414407,416341,39,0.14
ptg003721l,3091753,3092048,295,RepeatMasker,LTR,3091707,3092089,295,1.00
ptg003722l,2731811,2732111,300,RepeatMasker,LTR,2726320,2732034,223,0.74
ptg003726l,1878673,1878959,286,RepeatMasker,LTR,1877821,1880482,286,1.00
ptg003733l,1501494,1501774,280,RepeatMasker,LTR,1500701,1502163,280,1.00
ptg003734l,1635048,1635379,331,RepeatMasker,LTR,1634996,1635525,331,1.00
ptg003737l,5766535,5766837,302,RepeatMasker,LTR,5766225,5767647,302,1.00
ptg003740l,197494,197781,287,RepeatMasker,LTR,196590,199341,287,1.00
ptg003747l,562177,562498,321,RepeatMasker,LTR,561989,562659,321,1.00
ptg003749l,7667867,7668143,276,RepeatMasker,LTR,7668049,7668086,38,0.14
ptg003750l,2180609,2180878,269,RepeatMasker,LTR,2180311,2180807,198,0.74
ptg003751l,1467978,1468267,289,RepeatMasker,LTR,1467333,1468659,289,1.00
ptg003751l,1845602,1845899,297,RepeatMasker,LTR,1844966,1846264,297,1.00
ptg003752l,1324102,1324417,315,RepeatMasker,LTR,1324272,1324406,135,0.43
ptg003752l,2446320,2446635,315,RepeatMasker,LTR,2446374,2446439,66,0.21
ptg003760l,1096328,1096660,332,RepeatMasker,LTR,1096627,1097043,34,0.10
ptg003767l,1070811,1071114,303,RepeatMasker,LTR,1070862,1071261,253,0.83
ptg003774l,455730,456029,299,RepeatMasker,LTR,455678,456226,299,1.00
ptg003774l,568497,568797,300,RepeatMasker,LTR,568445,569014,300,1.00
ptg003774l,1300444,1300726,282,RepeatMasker,LTR,1300437,1300665,221,0.78
ptg003774l,1300444,1300726,282,RepeatMasker,LTR,1300539,1301227,188,0.67
ptg003778l,445113,445404,291,RepeatMasker,LTR,444789,445147,34,0.12
ptg003778l,445113,445404,291,RepeatMasker,LTR,445150,445832,255,0.88
ptg003781l,734331,734579,248,RepeatMasker,LTR,729267,738775,248,1.00
ptg003781l,775389,775697,308,RepeatMasker,LTR,775377,776086,308,1.00
ptg003782l,1598643,1598888,245,RepeatMasker,LTR,1593577,1599056,245,1.00
ptg003783l,1491065,1491338,273,RepeatMasker,LTR,1489995,1491285,220,0.81
ptg003785l,1103562,1103865,303,RepeatMasker,LTR,1102955,1103895,303,1.00
ptg003793l,1332244,1332525,281,RepeatMasker,LTR,1331600,1333672,281,1.00
ptg003793l,1981230,1981551,321,RepeatMasker,LTR,1975635,1981280,50,0.16
ptg003795l,1932920,1933212,292,RepeatMasker,LTR,1932408,1933724,292,1.00
ptg003804l,1456882,1457205,323,RepeatMasker,LTR,1457084,1457150,67,0.21
ptg003804l,1456882,1457205,323,RepeatMasker,LTR,1457098,1458626,108,0.33
ptg003805l,68209,68510,301,RepeatMasker,LTR,64425,68462,253,0.84
ptg003809l,130296,130560,264,RepeatMasker,LTR,128347,130330,34,0.13
ptg003812l,67355,67632,277,RepeatMasker,LTR,67609,67653,24,0.09
ptg003825l,202672,202952,280,RepeatMasker,LTR,202211,203205,280,1.00
ptg003831l,642307,642588,281,RepeatMasker,LTR,642274,642981,281,1.00
ptg003832l,65709,65986,277,RepeatMasker,LTR,65076,66371,277,1.00
ptg003833l,3086925,3087219,294,RepeatMasker,LTR,3086988,3087932,232,0.79
ptg003837l,1324816,1325116,300,RepeatMasker,LTR,1324764,1325342,300,1.00
ptg003838l,316909,317190,281,RepeatMasker,LTR,316106,317572,281,1.00
ptg003839l,2574031,2574323,292,RepeatMasker,LTR,2572931,2574195,164,0.56
ptg003841l,1964356,1964656,300,RepeatMasker,LTR,1964304,1964868,300,1.00
ptg003843l,3253988,3254272,284,RepeatMasker,LTR,3254249,3254293,24,0.08
ptg003843l,4250190,4250496,306,RepeatMasker,LTR,4249420,4251038,306,1.00
ptg003862l,403483,403764,281,RepeatMasker,LTR,403679,404584,86,0.31
ptg003864l,118716,119042,326,RepeatMasker,LTR,118432,120077,326,1.00
ptg003872l,810315,810614,299,RepeatMasker,LTR,810263,810814,299,1.00
ptg003872l,1791615,1791914,299,RepeatMasker,LTR,1791569,1791955,299,1.00
ptg003873l,3868366,3868653,287,RepeatMasker,LTR,3867787,3868755,287,1.00
ptg003888l,1368452,1368753,301,RepeatMasker,LTR,1367950,1369037,301,1.00
ptg003889l,279710,280024,314,RepeatMasker,LTR,279869,279927,59,0.19
ptg003894l,2353972,2354284,312,RepeatMasker,LTR,2354241,2355190,44,0.14
ptg003895l,634258,634541,283,RepeatMasker,LTR,634088,634309,51,0.18
ptg003911l,925318,925611,293,RepeatMasker,LTR,925266,925819,293,1.00
ptg003913l,419074,419391,317,RepeatMasker,LTR,418810,419398,317,1.00
ptg003921l,2205823,2206117,294,RepeatMasker,LTR,2205409,2206585,294,1.00
ptg003925l,1424970,1425257,287,RepeatMasker,LTR,1422541,1426166,287,1.00
ptg003927l,664155,664451,296,RepeatMasker,LTR,663454,664202,47,0.16
ptg003931l,421246,421520,274,RepeatMasker,LTR,420602,421395,149,0.54
ptg003935l,246928,247220,292,RepeatMasker,LTR,246962,247435,259,0.89
ptg003935l,2498139,2498443,304,RepeatMasker,LTR,2498190,2498346,157,0.52
ptg003936l,1978026,1978307,281,RepeatMasker,LTR,1977229,1978687,281,1.00
ptg003936l,2664147,2664428,281,RepeatMasker,LTR,2663510,2664810,281,1.00
ptg003936l,2671278,2671559,281,RepeatMasker,LTR,2670485,2671937,281,1.00
ptg003938l,3436039,3436348,309,RepeatMasker,LTR,3434950,3437511,309,1.00
ptg003938l,3436039,3436348,309,RepeatMasker,LTR,3435934,3437844,309,1.00
ptg003938l,4534269,4534571,302,RepeatMasker,LTR,4534260,4534323,54,0.18
ptg003938l,4534269,4534571,302,RepeatMasker,LTR,4534548,4535294,24,0.08
ptg003940l,1539684,1539984,300,RepeatMasker,LTR,1539632,1540149,300,1.00
ptg003942l,860779,861069,290,RepeatMasker,LTR,859820,860799,20,0.07
ptg003944l,807789,808082,293,RepeatMasker,LTR,806987,808450,293,1.00
ptg003950l,1749975,1750287,312,RepeatMasker,LTR,1748794,1750156,181,0.58
ptg003950l,7040302,7040615,313,RepeatMasker,LTR,7033407,7040474,172,0.55
ptg003952l,475755,476073,318,RepeatMasker,LTR,473504,475804,49,0.15
ptg003959l,1425031,1425330,299,RepeatMasker,LTR,1424979,1425350,299,1.00
ptg003959l,2794027,2794317,290,RepeatMasker,LTR,2793380,2794696,290,1.00
ptg003959l,3122464,3122791,327,RepeatMasker,LTR,3122062,3122811,327,1.00
ptg003959l,3326786,3327092,306,RepeatMasker,LTR,3326686,3329286,306,1.00
ptg003963l,1642632,1642913,281,RepeatMasker,LTR,1641843,1644059,281,1.00
ptg003964l,1186190,1186483,293,RepeatMasker,LTR,1184255,1186557,293,1.00
ptg003964l,4270026,4270347,321,RepeatMasker,LTR,4269744,4270247,221,0.69
ptg003964l,4270026,4270347,321,RepeatMasker,LTR,4270253,4270919,95,0.30
ptg003964l,4940107,4940406,299,RepeatMasker,LTR,4940055,4940547,299,1.00
ptg003967l,2052905,2053185,280,RepeatMasker,LTR,2052268,2054283,280,1.00
ptg003968l,3857013,3857331,318,RepeatMasker,LTR,3856689,3857322,309,0.97
ptg003969l,400716,401006,290,RepeatMasker,LTR,400664,401217,290,1.00
ptg003975l,45994,46319,325,RepeatMasker,LTR,44467,46156,162,0.50
ptg003975l,45994,46319,325,RepeatMasker,LTR,44898,46156,162,0.50
ptg003989l,1377234,1377495,261,RepeatMasker,LTR,1377359,1377444,86,0.33
ptg003992l,414548,414843,295,RepeatMasker,LTR,413902,415211,295,1.00
ptg003994l,7270576,7270896,320,RepeatMasker,LTR,7266022,7271641,320,1.00
ptg003997l,2365564,2365870,306,RepeatMasker,LTR,2365637,2365796,160,0.52
ptg004010l,835549,835884,335,RepeatMasker,LTR,835749,836044,136,0.41
ptg004013l,201685,202024,339,RepeatMasker,LTR,201036,201986,301,0.89
ptg004013l,201685,202024,339,RepeatMasker,LTR,202014,202405,11,0.03
ptg004013l,389121,389442,321,RepeatMasker,LTR,387984,389209,88,0.27
ptg004013l,679905,680190,285,RepeatMasker,LTR,679050,682608,285,1.00
ptg004013l,2049338,2049618,280,RepeatMasker,LTR,2048705,2050658,280,1.00
ptg004013l,2197130,2197409,279,RepeatMasker,LTR,2196361,2197829,279,1.00
ptg004014l,4068709,4068990,281,RepeatMasker,LTR,4068087,4069688,281,1.00
ptg004022l,2545377,2545652,275,RepeatMasker,LTR,2545292,2545501,124,0.45
ptg004033l,8537456,8537749,293,RepeatMasker,LTR,8533964,8537624,168,0.57
ptg004033l,10467165,10467464,299,RepeatMasker,LTR,10467113,10467484,299,1.00
ptg004036l,2244691,2244833,142,RepeatMasker,LTR,2244452,2244766,75,0.53
ptg004036l,2846524,2846831,307,RepeatMasker,LTR,2846507,2846543,19,0.06
ptg004038l,4159665,4159946,281,RepeatMasker,LTR,4159632,4160322,281,1.00
ptg004038l,4790270,4790549,279,RepeatMasker,LTR,4789117,4790482,212,0.76
ptg004039l,1642676,1642966,290,RepeatMasker,LTR,1642626,1642727,51,0.18
ptg004039l,1642676,1642966,290,RepeatMasker,LTR,1642731,1642987,236,0.81
ptg004042l,200605,200886,281,RepeatMasker,LTR,199960,201289,281,1.00
ptg004050l,19893,20185,292,RepeatMasker,LTR,18458,20456,292,1.00
ptg004059l,400345,400648,303,RepeatMasker,LTR,400532,400563,32,0.11
ptg004060l,1070738,1071036,298,RepeatMasker,LTR,1068505,1073636,298,1.00
ptg004068l,2068961,2069275,314,RepeatMasker,LTR,2067884,2069077,116,0.37
ptg004071l,1417457,1417756,299,RepeatMasker,LTR,1417404,1417935,299,1.00
ptg004071l,1760421,1760720,299,RepeatMasker,LTR,1760369,1760898,299,1.00
ptg004080l,1017448,1017759,311,RepeatMasker,LTR,1017396,1017925,311,1.00
ptg004082l,3671362,3671659,297,RepeatMasker,LTR,3666334,3671397,35,0.12
ptg004082l,4892594,4892919,325,RepeatMasker,LTR,4891448,4893191,325,1.00
ptg004082l,7228146,7228419,273,RepeatMasker,LTR,7228268,7229476,152,0.56
ptg004092l,1017761,1018045,284,RepeatMasker,LTR,1015140,1021313,284,1.00
ptg004092l,1989169,1989454,285,RepeatMasker,LTR,1989431,1989477,24,0.08
ptg004096l,37876,38174,298,RepeatMasker,LTR,37961,38506,214,0.72
ptg004096l,1453094,1453375,281,RepeatMasker,LTR,1452448,1454511,281,1.00
ptg004103l,288330,288619,289,RepeatMasker,LTR,288586,291467,34,0.12
ptg004104l,169794,170091,297,RepeatMasker,LTR,169742,170132,297,1.00
ptg004104l,240932,241228,296,RepeatMasker,LTR,240880,241308,296,1.00
ptg004109l,1381613,1381912,299,RepeatMasker,LTR,1381561,1381910,297,0.99
ptg004109l,1583467,1583761,294,RepeatMasker,LTR,1583415,1583841,294,1.00
ptg004109l,1632429,1632728,299,RepeatMasker,LTR,1632377,1632936,299,1.00
ptg004109l,3368352,3368661,309,RepeatMasker,LTR,3368455,3368617,163,0.53
ptg004119l,6595269,6595568,299,RepeatMasker,LTR,6595217,6595733,299,1.00
ptg004119l,6777543,6777838,295,RepeatMasker,LTR,6777491,6778015,295,1.00
ptg004120l,1129296,1129576,280,RepeatMasker,LTR,1128650,1129965,280,1.00
ptg004121l,813118,813408,290,RepeatMasker,LTR,813252,813645,157,0.54
ptg004126l,519662,519958,296,RepeatMasker,LTR,518088,519758,96,0.32
ptg004127l,354950,355233,283,RepeatMasker,LTR,353025,355115,165,0.58
ptg004127l,354950,355233,283,RepeatMasker,LTR,354099,355608,283,1.00
ptg004128l,834349,834673,324,RepeatMasker,LTR,834436,835733,238,0.73
ptg004129l,387928,388230,302,RepeatMasker,LTR,386677,388060,132,0.44
ptg004129l,387928,388230,302,RepeatMasker,LTR,387586,388996,302,1.00
ptg004135l,2345485,2345795,310,RepeatMasker,LTR,2345712,2346349,84,0.27
ptg004135l,2345485,2345795,310,RepeatMasker,LTR,2345715,2346258,81,0.26
ptg004135l,2524254,2524567,313,RepeatMasker,LTR,2524261,2524778,307,0.98
ptg004135l,2548225,2548538,313,RepeatMasker,LTR,2548232,2548749,307,0.98
ptg004135l,2561699,2561981,282,RepeatMasker,LTR,2561667,2562391,282,1.00
ptg004137l,3014030,3014321,291,RepeatMasker,LTR,3013792,3014531,291,1.00
ptg004139l,3467447,3467762,315,RepeatMasker,LTR,3466446,3468088,315,1.00
ptg004145l,2622702,2623014,312,RepeatMasker,LTR,2621586,2626591,312,1.00
ptg004149l,2097443,2097743,300,RepeatMasker,LTR,2097451,2097516,66,0.22
ptg004162l,1920530,1920828,298,RepeatMasker,LTR,1917778,1923397,298,1.00
ptg004164l,388074,388385,311,RepeatMasker,LTR,387945,388267,193,0.62
ptg004172l,2052010,2052312,302,RepeatMasker,LTR,2052295,2053066,18,0.06
ptg004173l,2877234,2877545,311,RepeatMasker,LTR,2877528,2877636,18,0.06
ptg004176l,52440,52720,280,RepeatMasker,LTR,51649,53102,280,1.00
ptg004180l,775865,776164,299,RepeatMasker,LTR,775831,776184,299,1.00
ptg004180l,803316,803603,287,RepeatMasker,LTR,802524,803474,158,0.55
ptg004182l,439922,440201,279,RepeatMasker,LTR,440029,440059,31,0.11
ptg004185l,492078,492365,287,RepeatMasker,LTR,491242,494970,287,1.00
ptg004185l,798581,798860,279,RepeatMasker,LTR,797935,799251,279,1.00
ptg004189l,1801309,1801625,316,RepeatMasker,LTR,1800775,1801523,214,0.68
ptg004192l,4086783,4087107,324,RepeatMasker,LTR,4086299,4086838,55,0.17
ptg004194l,2670837,2671132,295,RepeatMasker,LTR,2671014,2671249,119,0.40
ptg004196l,4780396,4780677,281,RepeatMasker,LTR,4780364,4780988,281,1.00
ptg004196l,5205385,5205666,281,RepeatMasker,LTR,5204747,5206811,281,1.00
ptg004199l,6136210,6136510,300,RepeatMasker,LTR,6136158,6136722,300,1.00
ptg004200l,889178,889476,298,RepeatMasker,LTR,889141,889403,225,0.76
ptg004200l,3657672,3657959,287,RepeatMasker,LTR,3656825,3662601,287,1.00
ptg004200l,4807520,4807811,291,RepeatMasker,LTR,4807079,4808506,291,1.00
ptg004200l,4807520,4807811,291,RepeatMasker,LTR,4807311,4808538,291,1.00
ptg004207l,148369,148650,281,RepeatMasker,LTR,148336,148666,281,1.00
ptg004208l,3237307,3237587,280,RepeatMasker,LTR,3236657,3237987,280,1.00
ptg004209l,1189908,1190206,298,RepeatMasker,LTR,1189263,1190570,298,1.00
ptg004214l,658965,659275,310,RepeatMasker,LTR,659199,659782,77,0.25
ptg004217l,373346,373626,280,RepeatMasker,LTR,373313,374016,280,1.00
ptg004217l,869252,869534,282,RepeatMasker,LTR,869239,869928,282,1.00
ptg004222l,1211936,1212199,263,RepeatMasker,LTR,1211727,1211943,7,0.03
ptg004222l,1211936,1212199,263,RepeatMasker,LTR,1212096,1212313,104,0.40
ptg004222l,2199782,2200064,282,RepeatMasker,LTR,2200058,2200186,7,0.02
ptg004231l,78465,78751,286,RepeatMasker,LTR,77606,78890,286,1.00
ptg004231l,766072,766375,303,RepeatMasker,LTR,763887,766231,159,0.52
ptg004233l,4283327,4283620,293,RepeatMasker,LTR,4283275,4283796,293,1.00
ptg004233l,4909462,4909757,295,RepeatMasker,LTR,4909410,4909978,295,1.00
ptg004233l,5302591,5302894,303,RepeatMasker,LTR,5302493,5308554,303,1.00
ptg004233l,5429564,5429847,283,RepeatMasker,LTR,5429244,5431323,283,1.00
ptg004245l,192608,192908,300,RepeatMasker,LTR,192556,192987,300,1.00
ptg004245l,3166884,3167167,283,RepeatMasker,LTR,3166269,3168954,283,1.00
ptg004251l,588217,588510,293,RepeatMasker,LTR,588192,588239,22,0.08
ptg004253l,138871,139156,285,RepeatMasker,LTR,138845,138896,25,0.09
ptg004253l,138871,139156,285,RepeatMasker,LTR,138860,138926,55,0.19
ptg004253l,138871,139156,285,RepeatMasker,LTR,138916,140149,241,0.85
ptg004257l,840783,841089,306,RepeatMasker,LTR,840404,842079,306,1.00
ptg004262l,226586,226891,305,RepeatMasker,LTR,226874,227344,18,0.06
ptg004262l,538147,538441,294,RepeatMasker,LTR,538095,538623,294,1.00
ptg004264l,485874,486162,288,RepeatMasker,LTR,485870,486097,223,0.77
ptg004264l,485874,486162,288,RepeatMasker,LTR,485971,486658,192,0.67
ptg004270l,1606600,1606893,293,RepeatMasker,LTR,1606606,1606972,288,0.98
ptg004272l,78913,79194,281,RepeatMasker,LTR,78277,80262,281,1.00
ptg004277l,578070,578390,320,RepeatMasker,LTR,575181,578120,50,0.16
ptg004280l,1021707,1022001,294,RepeatMasker,LTR,1018939,1025036,294,1.00
ptg004281l,221199,221506,307,RepeatMasker,LTR,221170,221890,307,1.00
ptg004288l,1542012,1542292,280,RepeatMasker,LTR,1541375,1543139,280,1.00
ptg004291l,1864035,1864315,280,RepeatMasker,LTR,1864023,1865452,280,1.00
ptg004291l,2717199,2717479,280,RepeatMasker,LTR,2716432,2717858,280,1.00
ptg004291l,2864236,2864523,287,RepeatMasker,LTR,2863900,2864398,162,0.56
ptg004292l,111750,112031,281,RepeatMasker,LTR,110961,112422,281,1.00
ptg004292l,119476,119757,281,RepeatMasker,LTR,119443,120139,281,1.00
ptg004300l,1447438,1447686,248,RepeatMasker,LTR,1442384,1451892,248,1.00
ptg004303l,6654529,6654812,283,RepeatMasker,LTR,6653370,6654702,173,0.61
ptg004304l,1278517,1278819,302,RepeatMasker,LTR,1278484,1279856,302,1.00
ptg004308l,3248698,3248992,294,RepeatMasker,LTR,3241779,3248860,162,0.55
ptg004316l,1377915,1378169,254,RepeatMasker,LTR,1372864,1382364,254,1.00
ptg004316l,1430328,1430609,281,RepeatMasker,LTR,1429685,1430991,281,1.00
ptg004316l,1437848,1438135,287,RepeatMasker,LTR,1437053,1438512,287,1.00
ptg004323l,572787,573067,280,RepeatMasker,LTR,572003,574117,280,1.00
ptg004326l,3195647,3195947,300,RepeatMasker,LTR,3195595,3196160,300,1.00
ptg004327l,71011,71308,297,RepeatMasker,LTR,70959,71474,297,1.00
ptg004327l,123425,123720,295,RepeatMasker,LTR,123373,123894,295,1.00
ptg004327l,330728,331027,299,RepeatMasker,LTR,330677,331235,299,1.00
ptg004327l,366875,367174,299,RepeatMasker,LTR,366823,367368,299,1.00
ptg004331l,242885,243171,286,RepeatMasker,LTR,242030,247782,286,1.00
ptg004339l,158913,159233,320,RepeatMasker,LTR,156399,158963,50,0.16
ptg004342l,79646,79926,280,RepeatMasker,LTR,79613,80969,280,1.00
ptg004343l,1429372,1429680,308,RepeatMasker,LTR,1429066,1429399,27,0.09
ptg004351l,819118,819435,317,RepeatMasker,LTR,819399,821185,37,0.12
ptg004351l,1284429,1284712,283,RepeatMasker,LTR,1283855,1287482,283,1.00
ptg004358l,939386,939680,294,RepeatMasker,LTR,938599,940070,294,1.00
ptg004362l,409589,409908,319,RepeatMasker,LTR,408643,409922,319,1.00
ptg004365l,502888,503153,265,RepeatMasker,LTR,503105,503830,49,0.18
ptg004365l,576046,576332,286,RepeatMasker,LTR,575202,579549,286,1.00
ptg004367l,736742,737037,295,RepeatMasker,LTR,736455,736889,147,0.50
ptg004379l,570218,570505,287,RepeatMasker,LTR,569371,573378,287,1.00
ptg004382l,2675629,2675919,290,RepeatMasker,LTR,2675150,2675834,205,0.71
ptg004382l,2675629,2675919,290,RepeatMasker,LTR,2675838,2676397,82,0.28
ptg004386l,912269,912590,321,RepeatMasker,LTR,912030,912635,321,1.00
ptg004386l,2387316,2387621,305,RepeatMasker,LTR,2386803,2387607,291,0.95
ptg004387l,1139464,1139745,281,RepeatMasker,LTR,1139451,1140038,281,1.00
ptg004387l,1139464,1139745,281,RepeatMasker,LTR,1139453,1140109,281,1.00
ptg004388l,602740,603044,304,RepeatMasker,LTR,602503,603302,304,1.00
ptg004392l,515297,515596,299,RepeatMasker,LTR,515263,515761,299,1.00
ptg004392l,871193,871493,300,RepeatMasker,LTR,871159,871713,300,1.00
ptg004392l,1710776,1711064,288,RepeatMasker,LTR,1710928,1711150,137,0.48
ptg004395l,794809,795090,281,RepeatMasker,LTR,794777,795472,281,1.00
ptg004399l,3107238,3107525,287,RepeatMasker,LTR,3107416,3107970,110,0.38
ptg004401l,531319,531613,294,RepeatMasker,LTR,530205,531481,162,0.55
ptg004402l,1065788,1066090,302,RepeatMasker,LTR,1066061,1067018,30,0.10
ptg004402l,1065788,1066090,302,RepeatMasker,LTR,1064219,1066844,302,1.00
ptg004406l,528484,528756,272,RepeatMasker,LTR,528746,529639,11,0.04
ptg004406l,1850071,1850351,280,RepeatMasker,LTR,1850038,1851503,280,1.00
ptg004409l,1561620,1561934,314,RepeatMasker,LTR,1559244,1561674,54,0.17
ptg004411l,468932,469206,274,RepeatMasker,LTR,468403,470806,274,1.00
ptg004411l,1280989,1281295,306,RepeatMasker,LTR,1276770,1284137,306,1.00
ptg004411l,1656409,1656703,294,RepeatMasker,LTR,1656312,1656764,294,1.00
ptg004417l,1014667,1014953,286,RepeatMasker,LTR,1014901,1015425,53,0.19
ptg004421l,1406727,1407035,308,RepeatMasker,LTR,1405644,1409303,308,1.00
ptg004423l,322494,322794,300,RepeatMasker,LTR,322460,323006,300,1.00
ptg004423l,461849,462129,280,RepeatMasker,LTR,461787,462086,237,0.85
ptg004423l,1422752,1423036,284,RepeatMasker,LTR,1421787,1422772,20,0.07
ptg004429l,1224799,1225093,294,RepeatMasker,LTR,1224747,1225173,294,1.00
ptg004429l,1383675,1383974,299,RepeatMasker,LTR,1383623,1384178,299,1.00
ptg004434l,1907087,1907369,282,RepeatMasker,LTR,1907322,1910845,48,0.17
ptg004434l,4529240,4529547,307,RepeatMasker,LTR,4528999,4529412,172,0.56
ptg004439l,469800,470099,299,RepeatMasker,LTR,468997,470403,299,1.00
ptg004445l,3876918,3877217,299,RepeatMasker,LTR,3876866,3877398,299,1.00
ptg004445l,4154627,4154909,282,RepeatMasker,LTR,4153694,4156826,282,1.00
ptg004445l,4446166,4446461,295,RepeatMasker,LTR,4446114,4446669,295,1.00
ptg004447l,570372,570648,276,RepeatMasker,LTR,569253,570537,165,0.60
ptg004451l,1001962,1002282,320,RepeatMasker,LTR,996856,1002012,50,0.16
ptg004451l,1156528,1156809,281,RepeatMasker,LTR,1155733,1157199,281,1.00
ptg004456l,3148864,3149141,277,RepeatMasker,LTR,3148742,3149202,277,1.00
ptg004456l,3148864,3149141,277,RepeatMasker,LTR,3148874,3152556,268,0.97
ptg004456l,3307639,3307934,295,RepeatMasker,LTR,3307592,3307975,295,1.00
ptg004457l,1253469,1253768,299,RepeatMasker,LTR,1253417,1253935,299,1.00
ptg004458l,561406,561725,319,RepeatMasker,LTR,561384,561464,58,0.18
ptg004463l,376798,377090,292,RepeatMasker,LTR,376786,377476,292,1.00
ptg004468l,315180,315486,306,RepeatMasker,LTR,315346,315412,67,0.22
ptg004468l,315180,315486,306,RepeatMasker,LTR,315353,315402,50,0.16
ptg004468l,2584829,2585135,306,RepeatMasker,LTR,2585046,2585213,90,0.29
ptg004468l,3827586,3827885,299,RepeatMasker,LTR,3827534,3827926,299,1.00
ptg004486l,601484,601772,288,RepeatMasker,LTR,601479,601707,223,0.77
ptg004486l,601484,601772,288,RepeatMasker,LTR,601581,602276,192,0.67
ptg004487l,1361866,1362165,299,RepeatMasker,LTR,1361814,1362245,299,1.00
ptg004487l,1501521,1501817,296,RepeatMasker,LTR,1501469,1501897,296,1.00
ptg004487l,1712041,1712340,299,RepeatMasker,LTR,1711989,1712548,299,1.00
ptg004488l,820480,820774,294,RepeatMasker,LTR,820660,820753,94,0.32
ptg004489l,282491,282802,311,RepeatMasker,LTR,282506,284098,297,0.95
ptg004492l,94241,94528,287,RepeatMasker,LTR,93994,96707,287,1.00
ptg004492l,104607,104893,286,RepeatMasker,LTR,103745,105744,286,1.00
ptg004499l,326593,326874,281,RepeatMasker,LTR,325939,327269,281,1.00
ptg004502l,928199,928498,299,RepeatMasker,LTR,928147,928675,299,1.00
ptg004502l,1146755,1147039,284,RepeatMasker,LTR,1145896,1148055,284,1.00
ptg004505l,272056,272376,320,RepeatMasker,LTR,270949,272559,320,1.00
ptg004505l,272056,272376,320,RepeatMasker,LTR,271869,273286,320,1.00
ptg004508l,150007,150299,292,RepeatMasker,LTR,147077,150086,79,0.27
ptg004508l,1611373,1611654,281,RepeatMasker,LTR,1610576,1612733,281,1.00
ptg004513l,937142,937456,314,RepeatMasker,LTR,937126,937980,314,1.00
ptg004513l,937142,937456,314,RepeatMasker,LTR,937275,937739,182,0.58
ptg004514l,162568,162874,306,RepeatMasker,LTR,162262,163662,306,1.00
ptg004514l,162568,162874,306,RepeatMasker,LTR,162316,163886,306,1.00
ptg004521l,4790428,4790727,299,RepeatMasker,LTR,4790376,4790905,299,1.00
ptg004523l,5516527,5516807,280,RepeatMasker,LTR,5516537,5517061,271,0.97
ptg004524l,682017,682303,286,RepeatMasker,LTR,681163,686983,286,1.00
ptg004530l,1938387,1938705,318,RepeatMasker,LTR,1938233,1938686,299,0.94
ptg004530l,4081443,4081728,285,RepeatMasker,LTR,4080478,4081463,20,0.07
ptg004540l,675335,675655,320,RepeatMasker,LTR,674908,675529,194,0.61
ptg004541l,16479,16760,281,RepeatMasker,LTR,15688,17150,281,1.00
ptg004543l,2564337,2564617,280,RepeatMasker,LTR,2563552,2565035,280,1.00
ptg004543l,2592299,2592614,315,RepeatMasker,LTR,2590386,2594191,315,1.00
ptg004556l,553823,554142,319,RepeatMasker,LTR,553409,554473,319,1.00
ptg004562l,313097,313411,314,RepeatMasker,LTR,312761,313266,169,0.54
ptg004564l,86971,87252,281,RepeatMasker,LTR,86165,87635,281,1.00
ptg004567l,2350870,2351154,284,RepeatMasker,LTR,2350883,2351022,140,0.49
ptg004567l,3203759,3204080,321,RepeatMasker,LTR,3199139,3203809,50,0.16
ptg004568l,598219,598500,281,RepeatMasker,LTR,598186,598882,281,1.00
ptg004569l,1163785,1164063,278,RepeatMasker,LTR,1163249,1164888,278,1.00
ptg004571l,1931603,1931899,296,RepeatMasker,LTR,1931551,1932064,296,1.00
ptg004579l,279995,280289,294,RepeatMasker,LTR,279943,280369,294,1.00
ptg004580l,2555570,2555850,280,RepeatMasker,LTR,2554787,2556897,280,1.00
ptg004587l,1188275,1188574,299,RepeatMasker,LTR,1188241,1188594,299,1.00
ptg004587l,1285520,1285819,299,RepeatMasker,LTR,1285468,1285899,299,1.00
ptg004596l,47475,47793,318,RepeatMasker,LTR,45882,47518,43,0.14
ptg004606l,752748,753060,312,RepeatMasker,LTR,752659,753081,312,1.00
ptg004620l,413629,413945,316,RepeatMasker,LTR,413602,414231,316,1.00
ptg004620l,413629,413945,316,RepeatMasker,LTR,413690,414231,256,0.81
ptg004637l,768197,768493,296,RepeatMasker,LTR,766909,768587,296,1.00
ptg004639l,864392,864703,311,RepeatMasker,LTR,864656,864699,44,0.14
ptg004641l,5374850,5375163,313,RepeatMasker,LTR,5374857,5375604,307,0.98
ptg004641l,7270447,7270756,309,RepeatMasker,LTR,7269990,7270475,28,0.09
ptg004643l,203347,203643,296,RepeatMasker,LTR,203295,203821,296,1.00
ptg004646l,871588,871880,292,RepeatMasker,LTR,871862,872088,19,0.07
ptg004654l,242163,242467,304,RepeatMasker,LTR,241348,242177,14,0.05
ptg004659l,225851,226139,288,RepeatMasker,LTR,225020,227060,288,1.00
ptg004659l,225851,226139,288,RepeatMasker,LTR,225061,230778,288,1.00
ptg004661l,588203,588469,266,RepeatMasker,LTR,587251,588389,186,0.70
ptg004661l,588203,588469,266,RepeatMasker,LTR,587878,589730,266,1.00
ptg004661l,1487320,1487619,299,RepeatMasker,LTR,1487268,1487784,299,1.00
ptg004663l,2762301,2762586,285,RepeatMasker,LTR,2762563,2762607,24,0.08
ptg004674l,2674428,2674727,299,RepeatMasker,LTR,2674376,2674922,299,1.00
ptg004677l,598214,598523,309,RepeatMasker,LTR,597568,598833,309,1.00
ptg004678l,531072,531356,284,RepeatMasker,LTR,529058,532442,284,1.00
ptg004678l,544818,545099,281,RepeatMasker,LTR,545011,545239,89,0.32
ptg004679l,587336,587652,316,RepeatMasker,LTR,587601,588770,52,0.16
ptg004681l,468164,468412,248,RepeatMasker,LTR,463114,472614,248,1.00
ptg004682l,4316297,4316620,323,RepeatMasker,LTR,4315843,4317309,323,1.00
ptg004683l,3121,3438,317,RepeatMasker,LTR,3404,3696,35,0.11
ptg004685l,1519482,1519789,307,RepeatMasker,LTR,1519430,1519997,307,1.00
ptg004685l,2098886,2099185,299,RepeatMasker,LTR,2098834,2099379,299,1.00
ptg004685l,2664759,2665058,299,RepeatMasker,LTR,2664707,2665266,299,1.00
ptg004687l,470958,471258,300,RepeatMasker,LTR,471129,471411,130,0.43
ptg004689l,228420,228730,310,RepeatMasker,LTR,228071,229934,310,1.00
ptg004694l,473070,473368,298,RepeatMasker,LTR,473018,473563,298,1.00
ptg004694l,486518,486813,295,RepeatMasker,LTR,486466,487021,295,1.00
ptg004694l,678002,678297,295,RepeatMasker,LTR,677950,678505,295,1.00
ptg004694l,779184,779483,299,RepeatMasker,LTR,779132,779648,299,1.00
ptg004694l,1065590,1065889,299,RepeatMasker,LTR,1065538,1066068,299,1.00
ptg004694l,1401097,1401396,299,RepeatMasker,LTR,1401063,1401476,299,1.00
ptg004694l,1912767,1913066,299,RepeatMasker,LTR,1912715,1913275,299,1.00
ptg004694l,2130389,2130684,295,RepeatMasker,LTR,2130339,2130849,295,1.00
ptg004694l,2612307,2612606,299,RepeatMasker,LTR,2612255,2612686,299,1.00
ptg004694l,2810924,2811224,300,RepeatMasker,LTR,2810872,2811304,300,1.00
ptg004695l,823532,823831,299,RepeatMasker,LTR,823485,823911,299,1.00
ptg004699l,1224398,1224697,299,RepeatMasker,LTR,1224346,1224905,299,1.00
ptg004699l,1303139,1303458,319,RepeatMasker,LTR,1303114,1303184,45,0.14
ptg004706l,1057674,1057973,299,RepeatMasker,LTR,1057622,1058181,299,1.00
ptg004707l,134812,135090,278,RepeatMasker,LTR,134800,135472,278,1.00
ptg004708l,1437596,1437917,321,RepeatMasker,LTR,1437670,1437814,145,0.45
ptg004708l,1776231,1776530,299,RepeatMasker,LTR,1776179,1776727,299,1.00
ptg004711l,1377711,1377983,272,RepeatMasker,LTR,1377726,1377825,100,0.37
ptg004717l,1805668,1805967,299,RepeatMasker,LTR,1805616,1806047,299,1.00
ptg004717l,2760202,2760488,286,RepeatMasker,LTR,2756322,2762502,286,1.00
ptg004717l,4518008,4518293,285,RepeatMasker,LTR,4518270,4518314,24,0.08
ptg004719l,111019,111317,298,RepeatMasker,LTR,110967,111397,298,1.00
ptg004726l,198841,199152,311,RepeatMasker,LTR,191984,199006,165,0.53
ptg004728l,2475439,2475744,305,RepeatMasker,LTR,2468578,2475601,162,0.53
ptg004734l,4833242,4833568,326,RepeatMasker,LTR,4830638,4836470,326,1.00
ptg004735l,332385,332679,294,RepeatMasker,LTR,332328,332832,294,1.00
ptg004735l,332385,332679,294,RepeatMasker,LTR,332364,332758,294,1.00
ptg004735l,880103,880397,294,RepeatMasker,LTR,879502,881364,294,1.00
ptg004735l,880103,880397,294,RepeatMasker,LTR,880090,881541,294,1.00
ptg004735l,1259795,1260112,317,RepeatMasker,LTR,1260016,1260082,67,0.21
ptg004736l,180897,181196,299,RepeatMasker,LTR,180844,181361,299,1.00
ptg004736l,2088683,2088995,312,RepeatMasker,LTR,2088746,2088872,127,0.41
ptg004748l,83002,83315,313,RepeatMasker,LTR,82803,83357,313,1.00
ptg004748l,83002,83315,313,RepeatMasker,LTR,82830,83240,238,0.76
ptg004756l,2408934,2409230,296,RepeatMasker,LTR,2408882,2409456,296,1.00
ptg004756l,3924316,3924635,319,RepeatMasker,LTR,3924236,3924421,105,0.33
ptg004757l,620951,621271,320,RepeatMasker,LTR,620726,621113,162,0.51
ptg004757l,1862766,1863085,319,RepeatMasker,LTR,1855925,1862931,165,0.52
ptg004758l,3231148,3231447,299,RepeatMasker,LTR,3231096,3231654,299,1.00
ptg004769l,851763,852069,306,RepeatMasker,LTR,852022,852095,48,0.16
ptg004772l,630431,630715,284,RepeatMasker,LTR,630422,630461,30,0.11
ptg004773l,399737,400020,283,RepeatMasker,LTR,399907,402738,114,0.40
ptg004775l,1517394,1517693,299,RepeatMasker,LTR,1517342,1517887,299,1.00
ptg004782l,2147460,2147774,314,RepeatMasker,LTR,2147105,2148202,314,1.00
ptg004783l,1610484,1610785,301,RepeatMasker,LTR,1604622,1610522,38,0.13
ptg004787l,2245058,2245350,292,RepeatMasker,LTR,2245239,2245406,112,0.38
ptg004787l,2245058,2245350,292,RepeatMasker,LTR,2245239,2245474,112,0.38
ptg004793l,747573,747866,293,RepeatMasker,LTR,747829,747881,38,0.13
ptg004795l,2060457,2060738,281,RepeatMasker,LTR,2059655,2061120,281,1.00
ptg004797l,203277,203580,303,RepeatMasker,LTR,203221,203306,29,0.10
ptg004801l,576158,576491,333,RepeatMasker,LTR,576133,576183,25,0.08
ptg004801l,576158,576491,333,RepeatMasker,LTR,576147,576216,58,0.17
ptg004805l,767148,767453,305,RepeatMasker,LTR,766183,767168,20,0.07
ptg004816l,1514220,1514543,323,RepeatMasker,LTR,1514189,1514382,162,0.50
ptg004820l,279829,280090,261,RepeatMasker,LTR,280072,280186,19,0.07
ptg004826l,1947495,1947812,317,RepeatMasker,LTR,1947470,1947520,25,0.08
ptg004826l,1947495,1947812,317,RepeatMasker,LTR,1947484,1947553,58,0.18
ptg004840l,165513,165793,280,RepeatMasker,LTR,165482,166193,280,1.00
ptg004841l,4061638,4061957,319,RepeatMasker,LTR,4061660,4062127,298,0.93
ptg004858l,84606,84911,305,RepeatMasker,LTR,84640,84935,272,0.89
ptg004859l,169138,169464,326,RepeatMasker,LTR,169289,169588,176,0.54
ptg004860l,1140244,1140524,280,RepeatMasker,LTR,1140148,1140295,51,0.18
ptg004864l,925533,925822,289,RepeatMasker,LTR,925374,925873,289,1.00
ptg004865l,675501,675811,310,RepeatMasker,LTR,675666,675707,42,0.14
ptg004867l,589158,589451,293,RepeatMasker,LTR,589106,589659,293,1.00
ptg004870l,2226427,2226715,288,RepeatMasker,LTR,2226691,2226736,25,0.09
ptg004871l,3256353,3256656,303,RepeatMasker,LTR,3256379,3256414,36,0.12
ptg004871l,5736472,5736770,298,RepeatMasker,LTR,5736420,5736953,298,1.00
ptg004871l,7431926,7432232,306,RepeatMasker,LTR,7431275,7432267,306,1.00
ptg004871l,7431926,7432232,306,RepeatMasker,LTR,7431442,7432592,306,1.00
ptg004872l,1310526,1310824,298,RepeatMasker,LTR,1310479,1311003,298,1.00
ptg004873l,129981,130308,327,RepeatMasker,LTR,129700,130211,230,0.70
ptg004874l,539498,539800,302,RepeatMasker,LTR,539692,540278,109,0.36
ptg004882l,337198,337478,280,RepeatMasker,LTR,336557,337859,280,1.00
ptg004883l,346877,347163,286,RepeatMasker,LTR,346018,348041,286,1.00
ptg004883l,2858108,2858393,285,RepeatMasker,LTR,2855277,2858759,285,1.00
ptg004885l,200373,200674,301,RepeatMasker,LTR,199107,200640,267,0.89
ptg004888l,1839507,1839805,298,RepeatMasker,LTR,1839455,1840012,298,1.00
ptg004888l,1912822,1913122,300,RepeatMasker,LTR,1912770,1913322,300,1.00
ptg004890l,66781,67076,295,RepeatMasker,LTR,66768,68035,295,1.00
ptg004890l,80622,80905,283,RepeatMasker,LTR,79838,81951,283,1.00
ptg004892l,375917,376197,280,RepeatMasker,LTR,375127,377245,280,1.00
ptg004898l,2098058,2098370,312,RepeatMasker,LTR,2097055,2098598,312,1.00
ptg004898l,4634503,4634809,306,RepeatMasker,LTR,4633733,4634509,6,0.02
ptg004902l,1076085,1076372,287,RepeatMasker,LTR,1075224,1077940,287,1.00
ptg004904l,84066,84352,286,RepeatMasker,LTR,78313,84749,286,1.00
ptg004904l,947120,947380,260,RepeatMasker,LTR,946338,947762,260,1.00
ptg004905l,3016066,3016377,311,RepeatMasker,LTR,3016101,3016209,109,0.35
ptg004906l,1936771,1937062,291,RepeatMasker,LTR,1936817,1936919,103,0.35
ptg004906l,1936771,1937062,291,RepeatMasker,LTR,1936817,1936936,120,0.41
ptg004906l,1936771,1937062,291,RepeatMasker,LTR,1936965,1937674,98,0.34
ptg004909l,59074,59386,312,RepeatMasker,LTR,59353,62937,34,0.11
ptg004926l,2372658,2372938,280,RepeatMasker,LTR,2372025,2373317,280,1.00
ptg004927l,1205266,1205587,321,RepeatMasker,LTR,1205120,1205298,32,0.10
ptg004928l,566195,566476,281,RepeatMasker,LTR,566182,566858,281,1.00
ptg004929l,3170852,3171133,281,RepeatMasker,LTR,3170202,3171508,281,1.00
ptg004937l,3205115,3205432,317,RepeatMasker,LTR,3205399,3205441,34,0.11
ptg004940l,108034,108320,286,RepeatMasker,LTR,107812,108040,6,0.02
ptg004940l,108034,108320,286,RepeatMasker,LTR,108041,108423,280,0.98
ptg004948l,850208,850506,298,RepeatMasker,LTR,850043,850244,36,0.12
ptg004950l,449645,449942,297,RepeatMasker,LTR,449598,450134,297,1.00
ptg004950l,497492,497784,292,RepeatMasker,LTR,497440,497989,292,1.00
ptg004954l,791715,792011,296,RepeatMasker,LTR,791740,791909,170,0.57
ptg004955l,149775,150076,301,RepeatMasker,LTR,147073,150056,281,0.93
ptg004955l,1758155,1758470,315,RepeatMasker,LTR,1755204,1758359,204,0.65
ptg004956l,1019171,1019448,277,RepeatMasker,LTR,1019181,1022478,268,0.97
ptg004956l,1476099,1476420,321,RepeatMasker,LTR,1476287,1477663,134,0.42
ptg004964l,598793,599103,310,RepeatMasker,LTR,597031,599524,310,1.00
ptg004968l,2084348,2084642,294,RepeatMasker,LTR,2081766,2084965,294,1.00
ptg004977l,1007296,1007572,276,RepeatMasker,LTR,1007549,1007785,24,0.09
ptg004984l,7748531,7748845,314,RepeatMasker,LTR,7747403,7753048,314,1.00
ptg004986l,479279,479559,280,RepeatMasker,LTR,479266,479947,280,1.00
ptg004986l,486423,486703,280,RepeatMasker,LTR,486410,487091,280,1.00
ptg004989l,144649,144946,297,RepeatMasker,LTR,144597,145026,297,1.00
ptg004990l,1300397,1300711,314,RepeatMasker,LTR,1300401,1300465,65,0.21
ptg004991l,1041196,1041492,296,RepeatMasker,LTR,1041192,1041292,96,0.32
ptg004991l,1659955,1660257,302,RepeatMasker,LTR,1658530,1660158,203,0.67
ptg004991l,1762557,1762844,287,RepeatMasker,LTR,1761651,1767559,287,1.00
ptg004996l,1000669,1000949,280,RepeatMasker,LTR,998055,1004215,280,1.00
ptg004999l,505169,505468,299,RepeatMasker,LTR,505117,505672,299,1.00
ptg004999l,677767,678066,299,RepeatMasker,LTR,677715,678086,299,1.00
ptg004999l,1149170,1149442,272,RepeatMasker,LTR,1149332,1150168,111,0.41
ptg005001l,29612,29893,281,RepeatMasker,LTR,28968,31037,281,1.00
ptg005001l,402356,402654,298,RepeatMasker,LTR,401599,402392,36,0.12
ptg005001l,402356,402654,298,RepeatMasker,LTR,402386,403935,269,0.90
ptg005001l,753490,753778,288,RepeatMasker,LTR,753755,753799,24,0.08
ptg005001l,1020877,1021157,280,RepeatMasker,LTR,1021134,1021190,24,0.09
ptg005009l,767757,768038,281,RepeatMasker,LTR,767754,767978,221,0.79
ptg005009l,767757,768038,281,RepeatMasker,LTR,767854,768454,185,0.66
ptg005011l,3263399,3263709,310,RepeatMasker,LTR,3263500,3263605,106,0.34
ptg005013l,520569,520876,307,RepeatMasker,LTR,520353,520609,40,0.13
ptg005013l,520569,520876,307,RepeatMasker,LTR,520404,520609,40,0.13
ptg005021l,2278439,2278733,294,RepeatMasker,LTR,2278554,2278898,180,0.61
ptg005024l,1113942,1114248,306,RepeatMasker,LTR,1114167,1114252,82,0.27
ptg005024l,2362018,2362298,280,RepeatMasker,LTR,2358141,2362044,26,0.09
ptg005025l,238045,238343,298,RepeatMasker,LTR,237677,239103,298,1.00
ptg005026l,3940005,3940297,292,RepeatMasker,LTR,3938342,3940639,292,1.00
ptg005026l,5012735,5013017,282,RepeatMasker,LTR,5011918,5013111,282,1.00
ptg005026l,5314209,5314511,302,RepeatMasker,LTR,5314131,5315287,302,1.00
ptg005033l,21905,22186,281,RepeatMasker,LTR,21106,23232,281,1.00
ptg005034l,2863211,2863516,305,RepeatMasker,LTR,2858196,2863254,43,0.14
ptg005037l,1399524,1399804,280,RepeatMasker,LTR,1398889,1400129,280,1.00
ptg005037l,1719389,1719637,248,RepeatMasker,LTR,1716871,1723843,248,1.00
ptg005037l,1744281,1744585,304,RepeatMasker,LTR,1743479,1744879,304,1.00
ptg005038l,770898,771197,299,RepeatMasker,LTR,770846,771376,299,1.00
ptg005058l,1941649,1941949,300,RepeatMasker,LTR,1941597,1941990,300,1.00
ptg005062l,738519,738825,306,RepeatMasker,LTR,737595,739001,306,1.00
ptg005062l,738519,738825,306,RepeatMasker,LTR,737760,739031,306,1.00
ptg005067l,702969,703264,295,RepeatMasker,LTR,702917,703442,295,1.00
ptg005069l,3286088,3286386,298,RepeatMasker,LTR,3286063,3286110,22,0.07
ptg005069l,3286088,3286386,298,RepeatMasker,LTR,3286077,3286118,30,0.10
ptg005070l,1210176,1210475,299,RepeatMasker,LTR,1210125,1210640,299,1.00
ptg005070l,3691115,3691402,287,RepeatMasker,LTR,3690260,3693325,287,1.00
ptg005072l,1313490,1313767,277,RepeatMasker,LTR,1313275,1313638,148,0.53
ptg005074l,169800,170086,286,RepeatMasker,LTR,169093,170425,286,1.00
ptg005085l,608771,609049,278,RepeatMasker,LTR,603720,613250,278,1.00
ptg005088l,5083912,5084210,298,RepeatMasker,LTR,5083860,5084290,298,1.00
ptg005094l,1092299,1092593,294,RepeatMasker,LTR,1091651,1092972,294,1.00
ptg005096l,163229,163514,285,RepeatMasker,LTR,157140,163913,285,1.00
ptg005097l,954444,954759,315,RepeatMasker,LTR,954651,954786,109,0.35
ptg005097l,2472923,2473220,297,RepeatMasker,LTR,2471089,2472942,19,0.06
ptg005103l,372505,372786,281,RepeatMasker,LTR,372472,373171,281,1.00
ptg005103l,427153,427433,280,RepeatMasker,LTR,427141,427837,280,1.00
ptg005115l,933163,933438,275,RepeatMasker,LTR,931705,933227,64,0.23
ptg005119l,246723,247004,281,RepeatMasker,LTR,246690,247393,281,1.00
ptg005121l,3220924,3221204,280,RepeatMasker,LTR,3220286,3222344,280,1.00
ptg005123l,101716,102024,308,RepeatMasker,LTR,101951,102171,74,0.24
ptg005123l,222696,222988,292,RepeatMasker,LTR,222256,223361,292,1.00
ptg005125l,182688,183009,321,RepeatMasker,LTR,182656,182987,299,0.93
ptg005125l,182688,183009,321,RepeatMasker,LTR,182999,183401,11,0.03
ptg005128l,148410,148689,279,RepeatMasker,LTR,148644,148716,46,0.16
ptg005128l,148410,148689,279,RepeatMasker,LTR,148665,149546,25,0.09
ptg005130l,1536370,1536651,281,RepeatMasker,LTR,1535724,1537026,281,1.00
ptg005135l,32629,32954,325,RepeatMasker,LTR,32407,32637,8,0.02
ptg005135l,32629,32954,325,RepeatMasker,LTR,32641,33470,314,0.97
ptg005142l,547387,547684,297,RepeatMasker,LTR,547354,548717,297,1.00
ptg005145l,339236,339574,338,RepeatMasker,LTR,339416,339454,39,0.12
ptg005146l,1649233,1649544,311,RepeatMasker,LTR,1649147,1649314,81,0.26
ptg005147l,958922,959225,303,RepeatMasker,LTR,957776,959729,303,1.00
ptg005147l,1008797,1009126,329,RepeatMasker,LTR,1008926,1009342,201,0.61
ptg005150l,2566780,2567098,318,RepeatMasker,LTR,2566570,2566788,8,0.03
ptg005150l,2566780,2567098,318,RepeatMasker,LTR,2566940,2570385,159,0.50
ptg005153l,222078,222391,313,RepeatMasker,LTR,222019,222228,150,0.48
ptg005153l,410336,410643,307,RepeatMasker,LTR,410245,410987,307,1.00
ptg005154l,113410,113691,281,RepeatMasker,LTR,112774,114862,281,1.00
ptg005156l,442874,443154,280,RepeatMasker,LTR,442245,443531,280,1.00
ptg005157l,1148826,1149117,291,RepeatMasker,LTR,1148126,1149484,291,1.00
ptg005165l,1131277,1131602,325,RepeatMasker,LTR,1131319,1131373,55,0.17
ptg005166l,889144,889429,285,RepeatMasker,LTR,888703,890064,285,1.00
ptg005173l,3519164,3519476,312,RepeatMasker,LTR,3518557,3522007,312,1.00
ptg005173l,3958285,3958598,313,RepeatMasker,LTR,3958260,3958310,25,0.08
ptg005173l,3958285,3958598,313,RepeatMasker,LTR,3958274,3958345,60,0.19
ptg005173l,4330021,4330329,308,RepeatMasker,LTR,4329996,4330047,26,0.08
ptg005173l,4330021,4330329,308,RepeatMasker,LTR,4330010,4330079,58,0.19
ptg005180l,3001726,3002018,292,RepeatMasker,LTR,2998894,3002393,292,1.00
ptg005180l,4151986,4152292,306,RepeatMasker,LTR,4151964,4152121,135,0.44
ptg005180l,4151986,4152292,306,RepeatMasker,LTR,4152167,4152270,104,0.34
ptg005202l,245101,245430,329,RepeatMasker,LTR,244641,245764,329,1.00
ptg005205l,784785,785075,290,RepeatMasker,LTR,784415,785284,290,1.00
ptg005208l,715059,715340,281,RepeatMasker,LTR,714258,715728,281,1.00
ptg005220l,1744915,1745203,288,RepeatMasker,LTR,1744788,1745081,166,0.58
ptg005220l,1744915,1745203,288,RepeatMasker,LTR,1744857,1746093,288,1.00
ptg005225l,1604126,1604425,299,RepeatMasker,LTR,1604074,1604603,299,1.00
ptg005230l,1181485,1181773,288,RepeatMasker,LTR,1180619,1184913,288,1.00
ptg005235l,603169,603469,300,RepeatMasker,LTR,603117,603681,300,1.00
ptg005237l,2333055,2333377,322,RepeatMasker,LTR,2333289,2333537,89,0.28
ptg005243l,2050865,2051174,309,RepeatMasker,LTR,2048731,2050893,28,0.09
ptg005243l,2050865,2051174,309,RepeatMasker,LTR,2051087,2051230,88,0.28
ptg005244l,202727,203044,317,RepeatMasker,LTR,202891,202977,87,0.27
ptg005249l,711921,712224,303,RepeatMasker,LTR,709161,712227,303,1.00
ptg005250l,2063642,2063949,307,RepeatMasker,LTR,2063718,2063783,66,0.21
ptg005250l,2084860,2085159,299,RepeatMasker,LTR,2084808,2085239,299,1.00
ptg005255l,29938,30253,315,RepeatMasker,LTR,29750,30564,315,1.00
ptg005255l,643721,644025,304,RepeatMasker,LTR,643682,644390,304,1.00
ptg005255l,2029284,2029578,294,RepeatMasker,LTR,2027091,2029566,282,0.96
ptg005259l,1038898,1039190,292,RepeatMasker,LTR,1036437,1038948,50,0.17
ptg005260l,1585362,1585689,327,RepeatMasker,LTR,1582341,1585387,25,0.08
ptg005260l,1585362,1585689,327,RepeatMasker,LTR,1585582,1585936,108,0.33
ptg005260l,1789022,1789353,331,RepeatMasker,LTR,1788815,1789205,183,0.55
ptg005267l,63949,64232,283,RepeatMasker,LTR,63916,64624,283,1.00
ptg005274l,1659325,1659602,277,RepeatMasker,LTR,1659218,1659642,277,1.00
ptg005274l,1659325,1659602,277,RepeatMasker,LTR,1659335,1659642,268,0.97
ptg005282l,433420,433715,295,RepeatMasker,LTR,433387,433893,295,1.00
ptg005282l,2339306,2339600,294,RepeatMasker,LTR,2338727,2340657,294,1.00
ptg005284l,361054,361335,281,RepeatMasker,LTR,361021,362473,281,1.00
ptg005290l,292822,293116,294,RepeatMasker,LTR,292679,293593,294,1.00
ptg005294l,743633,743932,299,RepeatMasker,LTR,743581,744112,299,1.00
ptg005297l,31501,31782,281,RepeatMasker,LTR,30861,31798,281,1.00
ptg005299l,2188683,2188953,270,RepeatMasker,LTR,2188800,2188891,92,0.34
ptg005306l,1226263,1226562,299,RepeatMasker,LTR,1226211,1226642,299,1.00
ptg005309l,2491829,2492121,292,RepeatMasker,LTR,2490548,2491955,126,0.43
ptg005325l,207607,207915,308,RepeatMasker,LTR,207297,207657,50,0.16
ptg005344l,1536588,1536868,280,RepeatMasker,LTR,1536575,1537498,280,1.00
ptg005351l,1021299,1021604,305,RepeatMasker,LTR,1021073,1021445,146,0.48
ptg005354l,1090299,1090599,300,RepeatMasker,LTR,1090247,1090811,300,1.00
ptg005356l,274502,274798,296,RepeatMasker,LTR,272209,274924,296,1.00
ptg005358l,829790,830095,305,RepeatMasker,LTR,830004,830680,92,0.30
ptg005363l,1300785,1301078,293,RepeatMasker,LTR,1300594,1301061,276,0.94
ptg005367l,978792,979073,281,RepeatMasker,LTR,978779,979462,281,1.00
ptg005376l,60506,60806,300,RepeatMasker,LTR,60454,61022,300,1.00
ptg005380l,571919,572200,281,RepeatMasker,LTR,571906,572587,281,1.00
ptg005381l,766532,766838,306,RepeatMasker,LTR,761799,768768,306,1.00
ptg005381l,1293869,1294165,296,RepeatMasker,LTR,1293225,1294529,296,1.00
ptg005389l,762834,763120,286,RepeatMasker,LTR,761962,764689,286,1.00
ptg005393l,1861258,1861538,280,RepeatMasker,LTR,1860475,1862598,280,1.00
ptg005393l,2048530,2048862,332,RepeatMasker,LTR,2048707,2050730,156,0.47
ptg005400l,2120178,2120477,299,RepeatMasker,LTR,2120126,2120497,299,1.00
ptg005409l,420475,420770,295,RepeatMasker,LTR,420423,420811,295,1.00
ptg005411l,439267,439555,288,RepeatMasker,LTR,438405,444204,288,1.00
ptg005413l,1332159,1332460,301,RepeatMasker,LTR,1331529,1333583,301,1.00
ptg005418l,781859,782157,298,RepeatMasker,LTR,780792,782882,298,1.00
ptg005420l,1799590,1799897,307,RepeatMasker,LTR,1799541,1799894,304,0.99
ptg005421l,1769354,1769662,308,RepeatMasker,LTR,1769321,1770043,308,1.00
ptg005421l,2109402,2109698,296,RepeatMasker,LTR,2106375,2109441,39,0.13
ptg005421l,2109402,2109698,296,RepeatMasker,LTR,2109366,2109452,50,0.17
ptg005422l,1939137,1939456,319,RepeatMasker,LTR,1936847,1939186,49,0.15
ptg005428l,53888,54201,313,RepeatMasker,LTR,49113,53927,39,0.12
ptg005432l,1629018,1629314,296,RepeatMasker,LTR,1628896,1629356,296,1.00
ptg005432l,1629018,1629314,296,RepeatMasker,LTR,1629028,1632709,287,0.97
ptg005432l,1749381,1749678,297,RepeatMasker,LTR,1749329,1749676,295,0.99
ptg005432l,2397398,2397674,276,RepeatMasker,LTR,2397368,2399317,276,1.00
ptg005441l,1709471,1709770,299,RepeatMasker,LTR,1709419,1709948,299,1.00
ptg005441l,3064233,3064375,142,RepeatMasker,LTR,3063203,3064392,142,1.00
ptg005442l,782495,782830,335,RepeatMasker,LTR,782652,787610,179,0.53
ptg005442l,1687046,1687350,304,RepeatMasker,LTR,1686135,1687742,304,1.00
ptg005443l,301298,301597,299,RepeatMasker,LTR,301246,301804,299,1.00
ptg005443l,2394881,2395167,286,RepeatMasker,LTR,2394022,2397142,286,1.00
ptg005446l,405960,406250,290,RepeatMasker,LTR,405832,407136,290,1.00
ptg005446l,1925040,1925325,285,RepeatMasker,LTR,1924181,1926773,285,1.00
ptg005458l,768961,769239,278,RepeatMasker,LTR,768970,769040,71,0.26
ptg005458l,982617,982935,318,RepeatMasker,LTR,982570,982699,82,0.26
ptg005460l,266840,267145,305,RepeatMasker,LTR,266675,269024,305,1.00
ptg005462l,466027,466351,324,RepeatMasker,LTR,465641,466401,324,1.00
ptg005463l,631087,631393,306,RepeatMasker,LTR,628023,631728,306,1.00
ptg005468l,1164709,1165007,298,RepeatMasker,LTR,1162336,1168305,298,1.00
ptg005472l,483359,483673,314,RepeatMasker,LTR,482756,483694,314,1.00
ptg005473l,431775,432051,276,RepeatMasker,LTR,431050,431922,147,0.53
ptg005476l,3239453,3239739,286,RepeatMasker,LTR,3239428,3239478,25,0.09
ptg005476l,3239453,3239739,286,RepeatMasker,LTR,3239442,3239518,65,0.23
ptg005480l,734227,734528,301,RepeatMasker,LTR,734331,734557,198,0.66
ptg005492l,1299319,1299617,298,RepeatMasker,LTR,1292473,1299484,165,0.55
ptg005492l,2094567,2094884,317,RepeatMasker,LTR,2094175,2094623,56,0.18
ptg005492l,2238740,2239037,297,RepeatMasker,LTR,2238688,2239078,297,1.00
ptg005492l,2496669,2496965,296,RepeatMasker,LTR,2496617,2497006,296,1.00
ptg005498l,705102,705382,280,RepeatMasker,LTR,704320,706421,280,1.00
ptg005502l,1248370,1248682,312,RepeatMasker,LTR,1248093,1248876,312,1.00
ptg005504l,252927,253188,261,RepeatMasker,LTR,252902,252952,25,0.10
ptg005504l,252927,253188,261,RepeatMasker,LTR,252916,252982,55,0.21
ptg005508l,3569523,3569801,278,RepeatMasker,LTR,3567598,3571268,278,1.00
ptg005512l,820459,820759,300,RepeatMasker,LTR,820407,820971,300,1.00
ptg005513l,1144214,1144522,308,RepeatMasker,LTR,1141709,1144535,308,1.00
ptg005514l,369013,369309,296,RepeatMasker,LTR,368961,369477,296,1.00
ptg005519l,515874,516185,311,RepeatMasker,LTR,516040,516638,146,0.47
ptg005521l,1671677,1671976,299,RepeatMasker,LTR,1671625,1672056,299,1.00
ptg005527l,26857,27154,297,RepeatMasker,LTR,26094,27520,297,1.00
ptg005529l,3857944,3858225,281,RepeatMasker,LTR,3857141,3858580,281,1.00
ptg005529l,6252033,6252342,309,RepeatMasker,LTR,6251779,6254636,309,1.00
ptg005529l,7600375,7600661,286,RepeatMasker,LTR,7599520,7602668,286,1.00
ptg005530l,2120533,2120831,298,RepeatMasker,LTR,2120481,2121040,298,1.00
ptg005533l,703239,703536,297,RepeatMasker,LTR,697047,703265,26,0.09
ptg005536l,425888,426179,291,RepeatMasker,LTR,426088,426172,85,0.29
ptg005552l,1912128,1912432,304,RepeatMasker,LTR,1911697,1912478,304,1.00
ptg005552l,1912128,1912432,304,RepeatMasker,LTR,1911792,1914384,304,1.00
ptg005554l,2316826,2317138,312,RepeatMasker,LTR,2315708,2318080,312,1.00
ptg005554l,2316826,2317138,312,RepeatMasker,LTR,2316081,2318687,312,1.00
ptg005554l,2614364,2614678,314,RepeatMasker,LTR,2614475,2615250,204,0.65
ptg005554l,10003858,10004154,296,RepeatMasker,LTR,10003806,10004362,296,1.00
ptg005556l,752271,752577,306,RepeatMasker,LTR,751795,754591,306,1.00
ptg005567l,1605912,1606201,289,RepeatMasker,LTR,1606178,1606225,24,0.08
ptg005571l,1483043,1483318,275,RepeatMasker,LTR,1482862,1483150,107,0.39
ptg005579l,556782,557063,281,RepeatMasker,LTR,556137,557457,281,1.00
ptg005579l,827322,827602,280,RepeatMasker,LTR,827310,827993,280,1.00
ptg005579l,1040045,1040342,297,RepeatMasker,LTR,1039406,1040707,297,1.00
ptg005587l,1531752,1532081,329,RepeatMasker,LTR,1531934,1534143,148,0.45
ptg005591l,1516997,1517321,324,RepeatMasker,LTR,1514710,1517512,324,1.00
ptg005591l,1846391,1846704,313,RepeatMasker,LTR,1846340,1846394,3,0.01
ptg005593l,1172980,1173284,304,RepeatMasker,LTR,1172928,1173462,304,1.00
ptg005596l,61076,61367,291,RepeatMasker,LTR,61030,61411,291,1.00
ptg005602l,2801115,2801392,277,RepeatMasker,LTR,2801102,2802409,277,1.00
ptg005607l,413057,413378,321,RepeatMasker,LTR,412912,414149,321,1.00
ptg005607l,413057,413378,321,RepeatMasker,LTR,413312,414149,67,0.21
ptg005611l,736594,736872,278,RepeatMasker,LTR,736290,736595,1,0.00
ptg005611l,736594,736872,278,RepeatMasker,LTR,736624,736798,175,0.63
ptg005614l,1978476,1978771,295,RepeatMasker,LTR,1978430,1978812,295,1.00
ptg005615l,9805241,9805522,281,RepeatMasker,LTR,9804441,9805817,281,1.00
ptg005622l,324066,324400,334,RepeatMasker,LTR,324059,324927,334,1.00
ptg005631l,1407745,1408024,279,RepeatMasker,LTR,1405295,1408489,279,1.00
ptg005635l,39911,40194,283,RepeatMasker,LTR,35786,40238,283,1.00
ptg005636l,2061960,2062271,311,RepeatMasker,LTR,2061744,2062323,311,1.00
ptg005638l,5044320,5044628,308,RepeatMasker,LTR,5043834,5044361,41,0.13
ptg005638l,5044320,5044628,308,RepeatMasker,LTR,5044441,5044477,37,0.12
ptg005639l,159105,159385,280,RepeatMasker,LTR,159072,159767,280,1.00
ptg005640l,1643089,1643389,300,RepeatMasker,LTR,1643037,1643615,300,1.00
ptg005642l,328098,328379,281,RepeatMasker,LTR,328065,328768,281,1.00
ptg005642l,328098,328379,281,RepeatMasker,LTR,327295,328691,281,1.00
ptg005643l,388628,388928,300,RepeatMasker,LTR,388465,388670,42,0.14
ptg005643l,893554,893862,308,RepeatMasker,LTR,893216,893717,163,0.53
ptg005653l,1772378,1772659,281,RepeatMasker,LTR,1772365,1773708,281,1.00
ptg005655l,1035498,1035818,320,RepeatMasker,LTR,1035041,1036077,320,1.00
ptg005655l,1086640,1086920,280,RepeatMasker,LTR,1086005,1087238,280,1.00
ptg005667l,813777,814077,300,RepeatMasker,LTR,813725,814285,300,1.00
ptg005672l,1305809,1306085,276,RepeatMasker,LTR,1305910,1306412,176,0.64
ptg005681l,377097,377377,280,RepeatMasker,LTR,377084,378423,280,1.00
ptg005682l,138141,138418,277,RepeatMasker,LTR,137350,139457,277,1.00
ptg005683l,148572,148852,280,RepeatMasker,LTR,148559,149896,280,1.00
ptg005685l,1474349,1474629,280,RepeatMasker,LTR,1474606,1474650,24,0.09
ptg005700l,1031429,1031751,322,RepeatMasker,LTR,1030930,1031654,225,0.70
ptg005702l,574808,575120,312,RepeatMasker,LTR,571833,574845,37,0.12
ptg005702l,1584841,1585134,293,RepeatMasker,LTR,1584789,1585312,293,1.00
ptg005704l,75945,76252,307,RepeatMasker,LTR,71445,76117,172,0.56
ptg005709l,814779,815088,309,RepeatMasker,LTR,815080,815525,9,0.03
ptg005710l,97021,97315,294,RepeatMasker,LTR,96158,101728,294,1.00
ptg005712l,696008,696305,297,RepeatMasker,LTR,695956,696483,297,1.00
ptg005712l,722738,723032,294,RepeatMasker,LTR,722704,723055,294,1.00
ptg005713l,492519,492799,280,RepeatMasker,LTR,492506,493191,280,1.00
ptg005714l,434220,434507,287,RepeatMasker,LTR,433364,438936,287,1.00
ptg005727l,658836,659117,281,RepeatMasker,LTR,658823,659424,281,1.00
ptg005737l,4412538,4412835,297,RepeatMasker,LTR,4412486,4412876,297,1.00
ptg005737l,4545207,4545514,307,RepeatMasker,LTR,4544390,4545399,192,0.63
ptg005740l,1500333,1500626,293,RepeatMasker,LTR,1500281,1500805,293,1.00
ptg005741l,1494553,1494868,315,RepeatMasker,LTR,1494256,1494610,57,0.18
ptg005741l,1494553,1494868,315,RepeatMasker,LTR,1494256,1494659,106,0.34
ptg005741l,1494553,1494868,315,RepeatMasker,LTR,1494687,1494818,132,0.42
ptg005746l,618167,618450,283,RepeatMasker,LTR,617953,618176,9,0.03
ptg005750l,559718,559978,260,RepeatMasker,LTR,559125,559817,99,0.38
ptg005750l,616721,617009,288,RepeatMasker,LTR,615960,620479,288,1.00
ptg005757l,798561,798842,281,RepeatMasker,LTR,798447,799259,281,1.00
ptg005757l,798561,798842,281,RepeatMasker,LTR,798680,799240,163,0.58
ptg005763l,475836,476130,294,RepeatMasker,LTR,475786,476208,294,1.00
ptg005764l,3132483,3132779,296,RepeatMasker,LTR,3132431,3132960,296,1.00
ptg005764l,3141942,3142241,299,RepeatMasker,LTR,3141890,3142419,299,1.00
ptg005770l,418945,419242,297,RepeatMasker,LTR,418893,419322,297,1.00
ptg005770l,888892,889191,299,RepeatMasker,LTR,888840,889271,299,1.00
ptg005772l,200705,201020,315,RepeatMasker,LTR,200912,201036,109,0.35
ptg005772l,5154537,5154816,279,RepeatMasker,LTR,5153901,5155987,279,1.00
ptg005772l,5168878,5169180,302,RepeatMasker,LTR,5168097,5170234,302,1.00
ptg005772l,5576222,5576535,313,RepeatMasker,LTR,5576229,5577122,307,0.98
ptg005773l,449634,449914,280,RepeatMasker,LTR,449601,450274,280,1.00
ptg005774l,77167,77464,297,RepeatMasker,LTR,77356,77921,109,0.37
ptg005775l,428185,428465,280,RepeatMasker,LTR,427566,428784,280,1.00
ptg005776l,41295,41575,280,RepeatMasker,LTR,40648,41886,280,1.00
ptg005776l,41295,41575,280,RepeatMasker,LTR,41284,41957,280,1.00
ptg005777l,3378730,3379041,311,RepeatMasker,LTR,3378688,3378862,132,0.42
ptg005778l,568643,568913,270,RepeatMasker,LTR,568862,569805,52,0.19
ptg005782l,834456,834756,300,RepeatMasker,LTR,834404,834982,300,1.00
ptg005784l,584222,584526,304,RepeatMasker,LTR,584075,584258,36,0.12
ptg005790l,297932,298218,286,RepeatMasker,LTR,297856,298185,253,0.88
ptg005792l,849499,849792,293,RepeatMasker,LTR,849447,849970,293,1.00
ptg005795l,1690617,1690911,294,RepeatMasker,LTR,1689980,1692028,294,1.00
ptg005800l,11305,11617,312,RepeatMasker,LTR,11483,11745,135,0.43
ptg005800l,43835,44155,320,RepeatMasker,LTR,39418,43885,50,0.16
ptg005803l,557827,558136,309,RepeatMasker,LTR,556958,559405,309,1.00
ptg005804l,1991874,1992155,281,RepeatMasker,LTR,1991563,1992013,139,0.49
ptg005807l,1548857,1549166,309,RepeatMasker,LTR,1548803,1548978,121,0.39
ptg005809l,1000182,1000479,297,RepeatMasker,LTR,1000130,1000658,297,1.00
ptg005809l,2298924,2299230,306,RepeatMasker,LTR,2292061,2299086,162,0.53
ptg005811l,366107,366399,292,RepeatMasker,LTR,366131,366576,269,0.92
ptg005815l,899208,899520,312,RepeatMasker,LTR,899439,899869,82,0.26
ptg005815l,2278536,2278829,293,RepeatMasker,LTR,2278624,2278844,206,0.70
ptg005817l,196952,197233,281,RepeatMasker,LTR,196315,197656,281,1.00
ptg005818l,785927,786182,255,RepeatMasker,LTR,784309,790393,255,1.00
ptg005819l,655915,656223,308,RepeatMasker,LTR,655707,655923,8,0.03
ptg005822l,1065174,1065475,301,RepeatMasker,LTR,1065429,1066039,47,0.16
ptg005822l,1071964,1072265,301,RepeatMasker,LTR,1072219,1072829,47,0.16
ptg005822l,4128122,4128431,309,RepeatMasker,LTR,4127026,4128169,47,0.15
ptg005826l,2574211,2574525,314,RepeatMasker,LTR,2573723,2575411,314,1.00
ptg005828l,242547,242868,321,RepeatMasker,LTR,242519,242572,25,0.08
ptg005828l,242547,242868,321,RepeatMasker,LTR,242536,242620,73,0.23
ptg005834l,1322236,1322526,290,RepeatMasker,LTR,1322276,1322412,137,0.47
ptg005834l,1322236,1322526,290,RepeatMasker,LTR,1322371,1322760,156,0.54
ptg005837l,3418911,3419210,299,RepeatMasker,LTR,3418859,3419290,299,1.00
ptg005839l,742880,743161,281,RepeatMasker,LTR,742867,744199,281,1.00
ptg005842l,1648172,1648483,311,RepeatMasker,LTR,1643147,1648208,36,0.12
ptg005843l,896622,896904,282,RepeatMasker,LTR,896614,896750,128,0.45
ptg005843l,1264980,1265273,293,RepeatMasker,LTR,1264928,1265314,293,1.00
ptg005843l,1303545,1303841,296,RepeatMasker,LTR,1303493,1304015,296,1.00
ptg005855l,1879634,1879933,299,RepeatMasker,LTR,1877534,1880097,299,1.00
ptg005865l,2333044,2333337,293,RepeatMasker,LTR,2333132,2333566,206,0.70
ptg005870l,529174,529466,292,RepeatMasker,LTR,527428,530134,292,1.00
ptg005875l,664914,665247,333,RepeatMasker,LTR,665120,665172,53,0.16
ptg005903l,287337,287629,292,RepeatMasker,LTR,287615,289055,15,0.05
ptg005903l,1099109,1099403,294,RepeatMasker,LTR,1099132,1099208,77,0.26
ptg005903l,1099109,1099403,294,RepeatMasker,LTR,1099132,1099222,91,0.31
ptg005903l,1099109,1099403,294,RepeatMasker,LTR,1099289,1099436,115,0.39
ptg005903l,1099109,1099403,294,RepeatMasker,LTR,1099363,1099891,41,0.14
ptg005908l,962295,962616,321,RepeatMasker,LTR,962425,962612,188,0.59
ptg005914l,1242605,1242902,297,RepeatMasker,LTR,1242553,1243097,297,1.00
ptg005917l,566731,567042,311,RepeatMasker,LTR,562322,566765,34,0.11
ptg005936l,1021681,1021977,296,RepeatMasker,LTR,1021608,1022108,296,1.00
ptg005939l,1391273,1391571,298,RepeatMasker,LTR,1388525,1391310,37,0.12
ptg005939l,1391273,1391571,298,RepeatMasker,LTR,1391249,1391320,47,0.16
ptg005939l,1664286,1664585,299,RepeatMasker,LTR,1664234,1664792,299,1.00
ptg005943l,104231,104536,305,RepeatMasker,LTR,104085,104512,281,0.92
ptg005944l,386236,386567,331,RepeatMasker,LTR,386177,386443,207,0.63
ptg005944l,2670728,2671054,326,RepeatMasker,LTR,2670715,2671027,299,0.92
ptg005944l,3933954,3934253,299,RepeatMasker,LTR,3933907,3934431,299,1.00
ptg005946l,3163065,3163350,285,RepeatMasker,LTR,3163116,3163178,63,0.22
ptg005948l,1111081,1111374,293,RepeatMasker,LTR,1111029,1111552,293,1.00
ptg005950l,367634,367942,308,RepeatMasker,LTR,367447,367844,210,0.68
ptg005954l,1392889,1393166,277,RepeatMasker,LTR,1392768,1392898,9,0.03
ptg005954l,1392889,1393166,277,RepeatMasker,LTR,1392899,1396584,268,0.97
ptg005955l,345731,346022,291,RepeatMasker,LTR,345941,345991,51,0.18
ptg005955l,347574,347873,299,RepeatMasker,LTR,347522,348051,299,1.00
ptg005955l,1061512,1061831,319,RepeatMasker,LTR,1060650,1061628,116,0.36
ptg005955l,1877537,1877836,299,RepeatMasker,LTR,1877485,1877856,299,1.00
ptg005959l,1806459,1806739,280,RepeatMasker,LTR,1806447,1807155,280,1.00
ptg005966l,3661928,3662234,306,RepeatMasker,LTR,3660929,3662063,135,0.44
ptg005966l,3661928,3662234,306,RepeatMasker,LTR,3661082,3662899,306,1.00
ptg005973l,1318884,1319183,299,RepeatMasker,LTR,1318832,1319360,299,1.00
ptg005977l,287345,287636,291,RepeatMasker,LTR,287293,287791,291,1.00
ptg005978l,3098447,3098741,294,RepeatMasker,LTR,3096874,3098491,44,0.15
ptg005978l,3098447,3098741,294,RepeatMasker,LTR,3098495,3098844,247,0.84
ptg005979l,1200436,1200739,303,RepeatMasker,LTR,1197189,1201074,303,1.00
ptg005984l,1321673,1321953,280,RepeatMasker,LTR,1321370,1321996,280,1.00
ptg005990l,919678,919978,300,RepeatMasker,LTR,919644,920187,300,1.00
ptg005990l,950650,950949,299,RepeatMasker,LTR,950598,951130,299,1.00
ptg005990l,1522334,1522633,299,RepeatMasker,LTR,1522282,1522713,299,1.00
ptg005990l,1594790,1595070,280,RepeatMasker,LTR,1594767,1596112,280,1.00
ptg006013l,981687,982013,326,RepeatMasker,LTR,981714,982343,300,0.92
ptg006016l,517297,517622,325,RepeatMasker,LTR,517483,517522,40,0.12
ptg006020l,949178,949475,297,RepeatMasker,LTR,949126,949548,297,1.00
ptg006022l,2572109,2572392,283,RepeatMasker,LTR,2572368,2573313,25,0.09
ptg006026l,1539791,1540087,296,RepeatMasker,LTR,1533901,1539871,80,0.27
ptg006026l,3231711,3232014,303,RepeatMasker,LTR,3230461,3231843,132,0.44
ptg006034l,408311,408670,359,RepeatMasker,LTR,408250,408343,32,0.09
ptg006043l,492319,492550,231,RepeatMasker,LTR,492415,492481,67,0.29
ptg006043l,492319,492550,231,RepeatMasker,LTR,492429,492486,58,0.25
ptg006043l,492319,492550,231,RepeatMasker,LTR,492439,492510,72,0.31
ptg006043l,1188037,1188336,299,RepeatMasker,LTR,1187985,1188514,299,1.00
ptg006047l,1756062,1756343,281,RepeatMasker,LTR,1755419,1756734,281,1.00
ptg006049l,511013,511336,323,RepeatMasker,LTR,510961,511541,323,1.00
ptg006056l,1019392,1019703,311,RepeatMasker,LTR,1016722,1019908,311,1.00
ptg006063l,1101516,1101815,299,RepeatMasker,LTR,1101464,1102023,299,1.00
ptg006065l,538,836,298,RepeatMasker,LTR,486,916,298,1.00
ptg006073l,351208,351507,299,RepeatMasker,LTR,351156,351713,299,1.00
ptg006079l,591086,591334,248,RepeatMasker,LTR,586029,595541,248,1.00
ptg006089l,445431,445736,305,RepeatMasker,LTR,442708,445701,270,0.89
ptg006101l,496565,496866,301,RepeatMasker,LTR,496220,496591,26,0.09
ptg006104l,2072144,2072449,305,RepeatMasker,LTR,2072226,2072408,183,0.60
ptg006104l,3364101,3364382,281,RepeatMasker,LTR,3363458,3365520,281,1.00
ptg006104l,3755938,3756229,291,RepeatMasker,LTR,3754132,3756595,291,1.00
ptg006105l,17216,17509,293,RepeatMasker,LTR,17182,17712,293,1.00
ptg006106l,307519,307834,315,RepeatMasker,LTR,307652,308187,183,0.58
ptg006108l,1551284,1551577,293,RepeatMasker,LTR,1549031,1551553,269,0.92
ptg006114l,1686385,1686682,297,RepeatMasker,LTR,1686198,1686610,225,0.76
ptg006116l,184838,185127,289,RepeatMasker,LTR,185029,185068,40,0.14
ptg006121l,127368,127645,277,RepeatMasker,LTR,127169,127645,277,1.00
ptg006122l,892413,892744,331,RepeatMasker,LTR,891204,892490,77,0.23
ptg006122l,892413,892744,331,RepeatMasker,LTR,892155,892560,147,0.44
ptg006122l,892413,892744,331,RepeatMasker,LTR,892736,893451,9,0.03
ptg006133l,768005,768285,280,RepeatMasker,LTR,767972,769331,280,1.00
ptg006133l,1857567,1857860,293,RepeatMasker,LTR,1853538,1857849,282,0.96
ptg006135l,694488,694781,293,RepeatMasker,LTR,694465,695150,293,1.00
ptg006140l,228992,229272,280,RepeatMasker,LTR,228358,229654,280,1.00
ptg006150l,766869,767181,312,RepeatMasker,LTR,766883,767009,127,0.41
ptg006156l,2263685,2264002,317,RepeatMasker,LTR,2262820,2264186,317,1.00
ptg006161l,1119877,1120192,315,RepeatMasker,LTR,1119530,1123689,315,1.00
ptg006171l,328987,329287,300,RepeatMasker,LTR,328935,329461,300,1.00
ptg006174l,571915,572212,297,RepeatMasker,LTR,571278,572506,297,1.00
ptg006174l,571915,572212,297,RepeatMasker,LTR,571904,572577,297,1.00
ptg006183l,2925744,2926045,301,RepeatMasker,LTR,2925133,2926041,297,0.99
ptg006193l,247412,247705,293,RepeatMasker,LTR,247360,247785,293,1.00
ptg006197l,1985064,1985376,312,RepeatMasker,LTR,1985017,1985148,84,0.27
ptg006197l,2583505,2583805,300,RepeatMasker,LTR,2583772,2583911,34,0.11
ptg006200l,2355178,2355458,280,RepeatMasker,LTR,2355145,2355840,280,1.00
ptg006201l,330119,330405,286,RepeatMasker,LTR,329805,330402,283,0.99
ptg006201l,534473,534753,280,RepeatMasker,LTR,533691,535810,280,1.00
ptg006201l,1034721,1035049,328,RepeatMasker,LTR,1034339,1037178,328,1.00
ptg006211l,1793005,1793293,288,RepeatMasker,LTR,1792370,1794458,288,1.00
ptg006213l,594623,594920,297,RepeatMasker,LTR,594571,595129,297,1.00
ptg006215l,2485790,2486103,313,RepeatMasker,LTR,2485797,2486692,307,0.98
ptg006217l,1620453,1620767,314,RepeatMasker,LTR,1620598,1620665,68,0.22
ptg006219l,5454505,5454786,281,RepeatMasker,LTR,5453867,5455917,281,1.00
ptg006224l,977534,977833,299,RepeatMasker,LTR,977482,978027,299,1.00
ptg006224l,1079578,1079878,300,RepeatMasker,LTR,1079526,1080084,300,1.00
ptg006224l,1826942,1827241,299,RepeatMasker,LTR,1826890,1827423,299,1.00
ptg006224l,1965062,1965361,299,RepeatMasker,LTR,1965010,1965569,299,1.00
ptg006224l,2009930,2010229,299,RepeatMasker,LTR,2009878,2010407,299,1.00
ptg006224l,3493164,3493459,295,RepeatMasker,LTR,3493112,3493651,295,1.00
ptg006224l,4879242,4879522,280,RepeatMasker,LTR,4879102,4879583,280,1.00
ptg006224l,4879242,4879522,280,RepeatMasker,LTR,4879258,4882931,265,0.95
ptg006228l,4535373,4535672,299,RepeatMasker,LTR,4535321,4535837,299,1.00
ptg006233l,3383096,3383431,335,RepeatMasker,LTR,3381453,3383109,13,0.04
ptg006238l,1149871,1150185,314,RepeatMasker,LTR,1147509,1150123,252,0.80
ptg006239l,1002023,1002314,291,RepeatMasker,LTR,1001163,1004968,291,1.00
ptg006249l,1914348,1914628,280,RepeatMasker,LTR,1913714,1915010,280,1.00
ptg006272l,506982,507285,303,RepeatMasker,LTR,506382,507014,32,0.11
ptg006272l,506982,507285,303,RepeatMasker,LTR,507087,507377,199,0.66
ptg006277l,88848,89149,301,RepeatMasker,LTR,89011,89051,41,0.14
ptg006278l,150093,150415,322,RepeatMasker,LTR,150056,150381,288,0.89
ptg006287l,582611,582895,284,RepeatMasker,LTR,580674,583816,284,1.00
ptg006289l,3603401,3603702,301,RepeatMasker,LTR,3602565,3606291,301,1.00
ptg006293l,1074697,1074976,279,RepeatMasker,LTR,1074650,1075662,279,1.00
ptg006298l,5223758,5224039,281,RepeatMasker,LTR,5223112,5224421,281,1.00
ptg006298l,6314173,6314479,306,RepeatMasker,LTR,6314307,6314356,50,0.16
ptg006298l,6314173,6314479,306,RepeatMasker,LTR,6314313,6314365,53,0.17
ptg006299l,642708,643001,293,RepeatMasker,LTR,642060,643379,293,1.00
ptg006300l,979588,979886,298,RepeatMasker,LTR,972690,979750,162,0.54
ptg006302l,114074,114351,277,RepeatMasker,LTR,113272,114735,277,1.00
ptg006309l,732086,732407,321,RepeatMasker,LTR,732061,732111,25,0.08
ptg006309l,732086,732407,321,RepeatMasker,LTR,732075,732162,76,0.24
ptg006314l,2418509,2418812,303,RepeatMasker,LTR,2418079,2418614,105,0.35
ptg006314l,2418509,2418812,303,RepeatMasker,LTR,2418126,2418590,81,0.27
ptg006314l,2418509,2418812,303,RepeatMasker,LTR,2418196,2420387,303,1.00
ptg006314l,2722488,2722783,295,RepeatMasker,LTR,2717560,2722527,39,0.13
ptg006316l,192985,193268,283,RepeatMasker,LTR,192541,193606,283,1.00
ptg006317l,375532,375830,298,RepeatMasker,LTR,375520,376215,298,1.00
ptg006320l,58740,59021,281,RepeatMasker,LTR,56199,58752,12,0.04
ptg006320l,58740,59021,281,RepeatMasker,LTR,56761,58890,150,0.53
ptg006323l,704418,704740,322,RepeatMasker,LTR,704405,705753,322,1.00
ptg006325l,915833,916119,286,RepeatMasker,LTR,911928,918887,286,1.00
ptg006327l,804869,805169,300,RepeatMasker,LTR,804817,805383,300,1.00
ptg006331l,2277591,2277872,281,RepeatMasker,LTR,2277578,2278254,281,1.00
ptg006331l,2478230,2478510,280,RepeatMasker,LTR,2478196,2478906,280,1.00
ptg006337l,1788806,1789085,279,RepeatMasker,LTR,1788170,1790233,279,1.00
ptg006339l,2982845,2983123,278,RepeatMasker,LTR,2982846,2983105,260,0.94
ptg006339l,3633336,3633610,274,RepeatMasker,LTR,3633587,3633631,24,0.09
ptg006347l,127514,127822,308,RepeatMasker,LTR,127501,128964,308,1.00
ptg006347l,140917,141197,280,RepeatMasker,LTR,140905,142226,280,1.00
ptg006348l,127368,127649,281,RepeatMasker,LTR,127336,128037,281,1.00
ptg006363l,768671,768953,282,RepeatMasker,LTR,767870,769361,282,1.00
ptg006369l,70932,71219,287,RepeatMasker,LTR,70096,71317,287,1.00
ptg006372l,3569281,3569601,320,RepeatMasker,LTR,3569106,3569576,295,0.92
ptg006380l,2761560,2761843,283,RepeatMasker,LTR,2760943,2762487,283,1.00
ptg006380l,2761560,2761843,283,RepeatMasker,LTR,2760992,2762754,283,1.00
ptg006380l,6563983,6564270,287,RepeatMasker,LTR,6563128,6565839,287,1.00
ptg006383l,3989692,3990020,328,RepeatMasker,LTR,3989600,3989826,134,0.41
ptg006387l,167753,168033,280,RepeatMasker,LTR,167725,169094,280,1.00
ptg006392l,2000408,2000707,299,RepeatMasker,LTR,2000356,2000727,299,1.00
ptg006401l,458556,458855,299,RepeatMasker,LTR,458504,458896,299,1.00
ptg006407l,1080033,1080319,286,RepeatMasker,LTR,1079175,1085005,286,1.00
ptg006407l,1249237,1249523,286,RepeatMasker,LTR,1248400,1253974,286,1.00
ptg006413l,1814116,1814402,286,RepeatMasker,LTR,1813166,1815292,286,1.00
ptg006413l,1814116,1814402,286,RepeatMasker,LTR,1813395,1816383,286,1.00
ptg006419l,396883,397163,280,RepeatMasker,LTR,396092,397557,280,1.00
ptg006419l,651957,652234,277,RepeatMasker,LTR,651945,652611,277,1.00
ptg006420l,380473,380751,278,RepeatMasker,LTR,380728,380772,24,0.09
ptg006420l,1086841,1087169,328,RepeatMasker,LTR,1086794,1086928,87,0.27
ptg006422l,3540709,3540990,281,RepeatMasker,LTR,3539915,3542043,281,1.00
ptg006426l,2598603,2598902,299,RepeatMasker,LTR,2598569,2598877,274,0.92
ptg006426l,3329681,3329980,299,RepeatMasker,LTR,3329635,3330021,299,1.00
ptg006426l,5029243,5029536,293,RepeatMasker,LTR,5029191,5029744,293,1.00
ptg006427l,1123148,1123445,297,RepeatMasker,LTR,1123338,1123593,108,0.36
ptg006432l,222495,222787,292,RepeatMasker,LTR,221796,223153,292,1.00
ptg006436l,196890,197216,326,RepeatMasker,LTR,196972,197073,102,0.31
ptg006440l,1102540,1102818,278,RepeatMasker,LTR,1101892,1103959,278,1.00
ptg006440l,1102901,1103200,299,RepeatMasker,LTR,1101892,1103959,299,1.00
ptg006440l,1124072,1124353,281,RepeatMasker,LTR,1124059,1125400,281,1.00
ptg006442l,487588,487897,309,RepeatMasker,LTR,487705,487817,113,0.37
ptg006444l,597291,597619,328,RepeatMasker,LTR,597165,597608,317,0.97
ptg006445l,1584379,1584659,280,RepeatMasker,LTR,1583745,1585041,280,1.00
ptg006446l,278316,278604,288,RepeatMasker,LTR,278480,283029,125,0.43
ptg006454l,1139863,1140142,279,RepeatMasker,LTR,1140043,1140273,100,0.36
ptg006454l,1139863,1140142,279,RepeatMasker,LTR,1140096,1140606,47,0.17
ptg006454l,4037526,4037806,280,RepeatMasker,LTR,4037781,4038492,26,0.09
ptg006461l,4761508,4761809,301,RepeatMasker,LTR,4761037,4762242,301,1.00
ptg006461l,4761508,4761809,301,RepeatMasker,LTR,4761600,4768353,210,0.70
ptg006466l,805503,805814,311,RepeatMasker,LTR,805789,806179,26,0.08
ptg006468l,382043,382330,287,RepeatMasker,LTR,381188,386978,287,1.00
ptg006478l,1774726,1775006,280,RepeatMasker,LTR,1774095,1775392,280,1.00
ptg006489l,510314,510613,299,RepeatMasker,LTR,510262,510778,299,1.00
ptg006491l,109872,110153,281,RepeatMasker,LTR,109266,110183,281,1.00
ptg006492l,698442,698736,294,RepeatMasker,LTR,698390,698914,294,1.00
ptg006492l,2229954,2230238,284,RepeatMasker,LTR,2229455,2229967,13,0.05
ptg006492l,2485882,2486112,230,RepeatMasker,LTR,2485856,2485907,25,0.11
ptg006492l,2485882,2486112,230,RepeatMasker,LTR,2485871,2485941,59,0.26
ptg006493l,174118,174398,280,RepeatMasker,LTR,174085,174779,280,1.00
ptg006495l,1853650,1853934,284,RepeatMasker,LTR,1853524,1853819,169,0.60
ptg006496l,1069194,1069503,309,RepeatMasker,LTR,1069256,1069420,165,0.53
ptg006496l,1069194,1069503,309,RepeatMasker,LTR,1069331,1069836,173,0.56
ptg006496l,2570924,2571223,299,RepeatMasker,LTR,2570872,2571417,299,1.00
ptg006500l,522690,522963,273,RepeatMasker,LTR,522771,523657,193,0.71
ptg006506l,1527298,1527574,276,RepeatMasker,LTR,1527440,1527676,135,0.49
ptg006513l,362836,363161,325,RepeatMasker,LTR,362694,363192,325,1.00
ptg006516l,4969836,4970170,334,RepeatMasker,LTR,4969690,4970627,334,1.00
ptg006518l,586923,587235,312,RepeatMasker,LTR,585177,588009,312,1.00
ptg006519l,58551,58845,294,RepeatMasker,LTR,58517,59155,294,1.00
ptg006519l,1277413,1277693,280,RepeatMasker,LTR,1277380,1278075,280,1.00
ptg006524l,1925012,1925326,314,RepeatMasker,LTR,1924403,1925308,296,0.94
ptg006525l,820429,820714,285,RepeatMasker,LTR,819120,820975,285,1.00
ptg006534l,385954,386253,299,RepeatMasker,LTR,385902,386333,299,1.00
ptg006537l,3681072,3681371,299,RepeatMasker,LTR,3681020,3681549,299,1.00
ptg006537l,5888649,5888930,281,RepeatMasker,LTR,5887846,5889314,281,1.00
ptg006537l,9143499,9143778,279,RepeatMasker,LTR,9142879,9148224,279,1.00
ptg006541l,469456,469737,281,RepeatMasker,LTR,465145,471428,281,1.00
ptg006542l,1420905,1421221,316,RepeatMasker,LTR,1418003,1420937,32,0.10
ptg006542l,1420905,1421221,316,RepeatMasker,LTR,1419140,1421402,316,1.00
ptg006549l,15781,16070,289,RepeatMasker,LTR,14990,16367,289,1.00
ptg006551l,4011278,4011560,282,RepeatMasker,LTR,4011362,4011395,34,0.12
ptg006553l,2939474,2939754,280,RepeatMasker,LTR,2939447,2940770,280,1.00
ptg006555l,185190,185469,279,RepeatMasker,LTR,184544,185851,279,1.00
ptg006563l,396065,396346,281,RepeatMasker,LTR,395493,397537,281,1.00
ptg006564l,269135,269472,337,RepeatMasker,LTR,268692,269237,102,0.30
ptg006565l,1581494,1581798,304,RepeatMasker,LTR,1580626,1583731,304,1.00
ptg006565l,1742514,1742824,310,RepeatMasker,LTR,1742310,1742520,6,0.02
ptg006565l,1742514,1742824,310,RepeatMasker,LTR,1742478,1742581,67,0.22
ptg006569l,1873985,1874270,285,RepeatMasker,LTR,1874194,1874682,77,0.27
ptg006570l,1714579,1714865,286,RepeatMasker,LTR,1711780,1715103,286,1.00
ptg006570l,1714579,1714865,286,RepeatMasker,LTR,1713121,1715263,286,1.00
ptg006572l,509455,509757,302,RepeatMasker,LTR,508204,509587,132,0.44
ptg006572l,509455,509757,302,RepeatMasker,LTR,507886,509584,129,0.43
ptg006581l,37517,37808,291,RepeatMasker,LTR,37537,37748,212,0.73
ptg006581l,37517,37808,291,RepeatMasker,LTR,37737,39243,72,0.25
ptg006584l,998289,998589,300,RepeatMasker,LTR,998237,998784,300,1.00
ptg006589l,1517589,1517891,302,RepeatMasker,LTR,1517563,1517842,253,0.84
ptg006592l,1191318,1191617,299,RepeatMasker,LTR,1191266,1191825,299,1.00
ptg006594l,713895,714175,280,RepeatMasker,LTR,713862,714568,280,1.00
ptg006594l,721047,721327,280,RepeatMasker,LTR,721014,721710,280,1.00
ptg006595l,1149275,1149586,311,RepeatMasker,LTR,1148386,1149319,44,0.14
ptg006597l,392221,392536,315,RepeatMasker,LTR,387936,392271,50,0.16
ptg006597l,891138,891428,290,RepeatMasker,LTR,884228,891301,163,0.56
ptg006598l,1404990,1405320,330,RepeatMasker,LTR,1398068,1407567,330,1.00
ptg006600l,61115,61415,300,RepeatMasker,LTR,61063,61643,300,1.00
ptg006601l,561177,561457,280,RepeatMasker,LTR,561146,562871,280,1.00
ptg006602l,111949,112257,308,RepeatMasker,LTR,110557,116346,308,1.00
ptg006609l,942867,943157,290,RepeatMasker,LTR,941106,944716,290,1.00
ptg006610l,528882,529181,299,RepeatMasker,LTR,528832,529378,299,1.00
ptg006612l,261629,261939,310,RepeatMasker,LTR,260872,262192,310,1.00
ptg006613l,421515,421846,331,RepeatMasker,LTR,421511,423167,331,1.00
ptg006614l,2423043,2423326,283,RepeatMasker,LTR,2423166,2423902,161,0.57
ptg006615l,1818463,1818783,320,RepeatMasker,LTR,1818618,1818714,97,0.30
ptg006616l,1086442,1086732,290,RepeatMasker,LTR,1086543,1086642,100,0.34
ptg006619l,991552,991878,326,RepeatMasker,LTR,991829,992032,50,0.15
ptg006620l,2005821,2006124,303,RepeatMasker,LTR,2005121,2005933,112,0.37
ptg006621l,607260,607540,280,RepeatMasker,LTR,606480,607936,280,1.00
ptg006624l,2244285,2244565,280,RepeatMasker,LTR,2243498,2244947,280,1.00
ptg006631l,182652,182920,268,RepeatMasker,LTR,182898,182995,23,0.09
ptg006637l,1766993,1767301,308,RepeatMasker,LTR,1767231,1767283,53,0.17
ptg006638l,4482327,4482631,304,RepeatMasker,LTR,4482402,4483037,230,0.76
ptg006639l,3620236,3620529,293,RepeatMasker,LTR,3620202,3620570,293,1.00
ptg006642l,1288500,1288817,317,RepeatMasker,LTR,1288571,1288624,54,0.17
ptg006642l,1288500,1288817,317,RepeatMasker,LTR,1288580,1289495,238,0.75
ptg006642l,1401083,1401408,325,RepeatMasker,LTR,1401109,1401328,220,0.68
ptg006642l,1401083,1401408,325,RepeatMasker,LTR,1401232,1401284,53,0.16
ptg006645l,1120749,1121044,295,RepeatMasker,LTR,1120697,1121226,295,1.00
ptg006645l,1225541,1225838,297,RepeatMasker,LTR,1225489,1226016,297,1.00
ptg006646l,1867391,1867689,298,RepeatMasker,LTR,1865001,1868161,298,1.00
ptg006658l,68097,68377,280,RepeatMasker,LTR,68085,68759,280,1.00
ptg006669l,1983032,1983349,317,RepeatMasker,LTR,1982593,1983731,317,1.00
ptg006669l,1983032,1983349,317,RepeatMasker,LTR,1982655,1983863,317,1.00
ptg006674l,155255,155569,314,RepeatMasker,LTR,154768,155310,55,0.18
ptg006679l,254566,254847,281,RepeatMasker,LTR,253898,255114,281,1.00
ptg006687l,545362,545658,296,RepeatMasker,LTR,544968,546458,296,1.00
ptg006688l,1718312,1718560,248,RepeatMasker,LTR,1715072,1721020,248,1.00
ptg006688l,2249890,2250188,298,RepeatMasker,LTR,2249244,2250568,298,1.00
ptg006698l,953225,953532,307,RepeatMasker,LTR,952479,953383,158,0.51
ptg006699l,239766,240065,299,RepeatMasker,LTR,236894,239806,40,0.13
ptg006699l,988424,988721,297,RepeatMasker,LTR,988372,988719,295,0.99
ptg006703l,229237,229550,313,RepeatMasker,LTR,226104,233808,313,1.00
ptg006703l,729202,729518,316,RepeatMasker,LTR,728990,730657,316,1.00
ptg006711l,2360393,2360673,280,RepeatMasker,LTR,2359749,2360981,280,1.00
ptg006711l,3212389,3212691,302,RepeatMasker,LTR,3212563,3213622,129,0.43
ptg006711l,4348723,4349004,281,RepeatMasker,LTR,4348690,4349395,281,1.00
ptg006712l,4213285,4213585,300,RepeatMasker,LTR,4213484,4213685,102,0.34
ptg006721l,725758,726058,300,RepeatMasker,LTR,725706,726251,300,1.00
ptg006721l,898396,898710,314,RepeatMasker,LTR,897135,898903,314,1.00
ptg006725l,1629207,1629499,292,RepeatMasker,LTR,1629084,1629530,292,1.00
ptg006734l,839948,840250,302,RepeatMasker,LTR,840150,840364,101,0.33
ptg006735l,124119,124402,283,RepeatMasker,LTR,124328,124462,75,0.27
ptg006742l,3535132,3535429,297,RepeatMasker,LTR,3535119,3536567,297,1.00
ptg006746l,246827,247127,300,RepeatMasker,LTR,246775,247322,300,1.00
ptg006746l,312209,312504,295,RepeatMasker,LTR,312175,312682,295,1.00
ptg006746l,341464,341763,299,RepeatMasker,LTR,341430,341940,299,1.00
ptg006747l,622357,622638,281,RepeatMasker,LTR,621556,623027,281,1.00
ptg006755l,1930523,1930817,294,RepeatMasker,LTR,1930476,1931039,294,1.00
ptg006755l,3463500,3463783,283,RepeatMasker,LTR,3463284,3463715,215,0.76
ptg006758l,690160,690469,309,RepeatMasker,LTR,690133,690180,20,0.06
ptg006758l,690160,690469,309,RepeatMasker,LTR,690149,690220,60,0.19
ptg006758l,1735286,1735577,291,RepeatMasker,LTR,1735542,1736116,36,0.12
ptg006765l,1052901,1053181,280,RepeatMasker,LTR,1052889,1053499,280,1.00
ptg006765l,1052901,1053181,280,RepeatMasker,LTR,1052890,1053571,280,1.00
ptg006767l,865071,865378,307,RepeatMasker,LTR,865064,865122,51,0.17
ptg006775l,1165040,1165325,285,RepeatMasker,LTR,1165121,1165286,166,0.58
ptg006776l,29128,29441,313,RepeatMasker,LTR,28911,29499,313,1.00
ptg006776l,29128,29441,313,RepeatMasker,LTR,28945,29640,313,1.00
ptg006780l,341841,342139,298,RepeatMasker,LTR,341098,342001,160,0.54
ptg006781l,818041,818340,299,RepeatMasker,LTR,817989,818519,299,1.00
ptg006788l,100709,100990,281,RepeatMasker,LTR,100696,102027,281,1.00
ptg006788l,179824,180095,271,RepeatMasker,LTR,179793,179952,128,0.47
ptg006788l,1762088,1762383,295,RepeatMasker,LTR,1762036,1762581,295,1.00
ptg006788l,6018268,6018563,295,RepeatMasker,LTR,6018059,6018276,8,0.03
ptg006796l,210340,210637,297,RepeatMasker,LTR,210294,210678,297,1.00
ptg006796l,1038059,1038355,296,RepeatMasker,LTR,1038019,1038396,296,1.00
ptg006796l,1582681,1582967,286,RepeatMasker,LTR,1582634,1583145,286,1.00
ptg006796l,2613524,2613819,295,RepeatMasker,LTR,2613472,2613999,295,1.00
ptg006797l,1221126,1221440,314,RepeatMasker,LTR,1220120,1221306,180,0.57
ptg006797l,1283890,1284168,278,RepeatMasker,LTR,1280263,1284446,278,1.00
ptg006803l,324139,324454,315,RepeatMasker,LTR,324114,324164,25,0.08
ptg006803l,324139,324454,315,RepeatMasker,LTR,324128,324198,59,0.19
ptg006804l,400238,400534,296,RepeatMasker,LTR,399993,401549,296,1.00
ptg006808l,789732,790029,297,RepeatMasker,LTR,789099,790394,297,1.00
ptg006811l,632386,632685,299,RepeatMasker,LTR,632335,632863,299,1.00
ptg006811l,1808215,1808523,308,RepeatMasker,LTR,1807112,1808380,165,0.54
ptg006814l,190858,191174,316,RepeatMasker,LTR,191142,191422,33,0.10
ptg006820l,874287,874591,304,RepeatMasker,LTR,874322,874753,270,0.89
ptg006820l,874287,874591,304,RepeatMasker,LTR,874524,875158,68,0.22
ptg006822l,1231033,1231333,300,RepeatMasker,LTR,1230981,1231547,300,1.00
ptg006823l,561757,562088,331,RepeatMasker,LTR,560865,561889,132,0.40
ptg006823l,561757,562088,331,RepeatMasker,LTR,562060,562674,29,0.09
ptg006825l,5303763,5304062,299,RepeatMasker,LTR,5303729,5304082,299,1.00
ptg006825l,5351681,5351981,300,RepeatMasker,LTR,5351629,5352209,300,1.00
ptg006825l,5483671,5483958,287,RepeatMasker,LTR,5483619,5484136,287,1.00
ptg006829l,1224710,1225047,337,RepeatMasker,LTR,1224663,1224794,84,0.25
ptg006831l,2315850,2316179,329,RepeatMasker,LTR,2315374,2316427,329,1.00
ptg006837l,1805848,1806131,283,RepeatMasker,LTR,1805645,1805914,66,0.23
ptg006842l,265581,265877,296,RepeatMasker,LTR,265547,265900,296,1.00
ptg006842l,779753,780039,286,RepeatMasker,LTR,778788,779788,35,0.12
ptg006843l,2443431,2443730,299,RepeatMasker,LTR,2443397,2443908,299,1.00
ptg006846l,340404,340685,281,RepeatMasker,LTR,339768,341812,281,1.00
ptg006846l,347571,347852,281,RepeatMasker,LTR,346792,348894,281,1.00
ptg006847l,934901,935182,281,RepeatMasker,LTR,934265,936314,281,1.00
ptg006859l,302507,302778,271,RepeatMasker,LTR,302368,302585,78,0.29
ptg006867l,946655,946919,264,RepeatMasker,LTR,946808,946955,112,0.42
ptg006870l,88590,88901,311,RepeatMasker,LTR,88489,88626,36,0.12
ptg006870l,2216692,2217004,312,RepeatMasker,LTR,2216802,2216951,150,0.48
ptg006873l,3659528,3659810,282,RepeatMasker,LTR,3654005,3660208,282,1.00
ptg006876l,276003,276283,280,RepeatMasker,LTR,275990,276666,280,1.00
ptg006879l,75210,75528,318,RepeatMasker,LTR,73699,75396,186,0.58
ptg006884l,2257400,2257648,248,RepeatMasker,LTR,2252341,2261857,248,1.00
ptg006887l,541788,542092,304,RepeatMasker,LTR,534925,541950,162,0.53
ptg006888l,836932,837238,306,RepeatMasker,LTR,836384,837196,264,0.86
ptg006898l,440386,440698,312,RepeatMasker,LTR,440168,440394,8,0.03
ptg006898l,440386,440698,312,RepeatMasker,LTR,440393,443892,306,0.98
ptg006898l,687272,687561,289,RepeatMasker,LTR,687538,687588,24,0.08
ptg006900l,2923958,2924256,298,RepeatMasker,LTR,2922090,2924146,188,0.63
ptg006900l,5077611,5077926,315,RepeatMasker,LTR,5076842,5081655,315,1.00
ptg006900l,15346441,15346740,299,RepeatMasker,LTR,15346389,15346918,299,1.00
ptg006900l,16523839,16524134,295,RepeatMasker,LTR,16523787,16524214,295,1.00
ptg006906l,397979,398231,252,RepeatMasker,LTR,391125,398141,162,0.64
ptg006906l,584892,585213,321,RepeatMasker,LTR,584745,585202,310,0.97
ptg006908l,624356,624655,299,RepeatMasker,LTR,624105,628220,299,1.00
ptg006908l,1810128,1810442,314,RepeatMasker,LTR,1809309,1810718,314,1.00
ptg006909l,1609936,1610222,286,RepeatMasker,LTR,1610199,1610246,24,0.08
ptg006917l,1219640,1219946,306,RepeatMasker,LTR,1219334,1220734,306,1.00
ptg006921l,1733290,1733622,332,RepeatMasker,LTR,1732172,1733453,163,0.49
ptg006930l,232040,232348,308,RepeatMasker,LTR,232071,232346,276,0.90
ptg006930l,232040,232348,308,RepeatMasker,LTR,232343,232787,6,0.02
ptg006930l,2072575,2072898,323,RepeatMasker,LTR,2072490,2073098,323,1.00
ptg006933l,1015865,1016176,311,RepeatMasker,LTR,1015927,1016827,250,0.80
ptg006933l,3732500,3732815,315,RepeatMasker,LTR,3725835,3732546,46,0.15
ptg006934l,1333405,1333692,287,RepeatMasker,LTR,1333389,1333427,22,0.08
ptg006934l,1333405,1333692,287,RepeatMasker,LTR,1333596,1333708,97,0.34
ptg006934l,1767244,1767547,303,RepeatMasker,LTR,1764509,1771023,303,1.00
ptg006937l,1009513,1009823,310,RepeatMasker,LTR,1008674,1011642,310,1.00
ptg006937l,1324791,1325090,299,RepeatMasker,LTR,1324739,1325298,299,1.00
ptg006939l,2054510,2054788,278,RepeatMasker,LTR,2054485,2054532,22,0.08
ptg006939l,2054510,2054788,278,RepeatMasker,LTR,2054499,2054548,38,0.14
ptg006942l,1056543,1056829,286,RepeatMasker,LTR,1056498,1057011,286,1.00
ptg006945l,2188170,2188472,302,RepeatMasker,LTR,2186596,2189227,302,1.00
ptg006949l,1243697,1243941,244,RepeatMasker,LTR,1239985,1248166,244,1.00
ptg006949l,2485839,2486153,314,RepeatMasker,LTR,2485247,2486176,314,1.00
ptg006952l,3534486,3534758,272,RepeatMasker,LTR,3532749,3535040,272,1.00
ptg006952l,3534486,3534758,272,RepeatMasker,LTR,3532993,3535055,272,1.00
ptg006965l,538879,539160,281,RepeatMasker,LTR,538243,539166,281,1.00
ptg006965l,538879,539160,281,RepeatMasker,LTR,538868,540201,281,1.00
ptg006967l,1066618,1066899,281,RepeatMasker,LTR,1065978,1067958,281,1.00
ptg006969l,912618,912925,307,RepeatMasker,LTR,912485,912656,38,0.12
ptg006971l,647499,647780,281,RepeatMasker,LTR,647466,648091,281,1.00
ptg006971l,647499,647780,281,RepeatMasker,LTR,647492,648162,281,1.00
ptg006980l,109573,109853,280,RepeatMasker,LTR,108924,110164,280,1.00
ptg006980l,155836,156084,248,RepeatMasker,LTR,150806,160270,248,1.00
ptg006986l,755728,756042,314,RepeatMasker,LTR,749737,756787,314,1.00
ptg006991l,1843727,1844033,306,RepeatMasker,LTR,1842474,1846278,306,1.00
ptg006992l,705817,706137,320,RepeatMasker,LTR,705911,706033,123,0.38
ptg006994l,1998111,1998432,321,RepeatMasker,LTR,1997888,1998260,149,0.46
ptg006998l,142253,142539,286,RepeatMasker,LTR,138341,144574,286,1.00
ptg007001l,24761,25006,245,RepeatMasker,LTR,19703,29217,245,1.00
ptg007001l,177306,177634,328,RepeatMasker,LTR,176786,177315,9,0.03
ptg007002l,3037425,3037724,299,RepeatMasker,LTR,3036727,3038394,299,1.00
ptg007004l,3061062,3061354,292,RepeatMasker,LTR,3054417,3061224,162,0.55
ptg007005l,129360,129664,304,RepeatMasker,LTR,126200,129573,213,0.70
ptg007005l,129360,129664,304,RepeatMasker,LTR,129580,130534,85,0.28
ptg007007l,1268639,1268938,299,RepeatMasker,LTR,1268587,1269116,299,1.00
ptg007007l,1735569,1735868,299,RepeatMasker,LTR,1735517,1736046,299,1.00
ptg007009l,316832,317144,312,RepeatMasker,LTR,317120,319396,25,0.08
ptg007015l,214066,214359,293,RepeatMasker,LTR,214314,215254,46,0.16
ptg007017l,3942478,3942754,276,RepeatMasker,LTR,3939309,3942704,226,0.82
ptg007020l,433930,434229,299,RepeatMasker,LTR,433878,434438,299,1.00
ptg007020l,2406412,2406711,299,RepeatMasker,LTR,2406360,2406789,299,1.00
ptg007021l,1740133,1740431,298,RepeatMasker,LTR,1739823,1741277,298,1.00
ptg007021l,4849202,4849501,299,RepeatMasker,LTR,4849150,4849706,299,1.00
ptg007021l,5888809,5889114,305,RepeatMasker,LTR,5888720,5889306,305,1.00
ptg007021l,7659520,7659801,281,RepeatMasker,LTR,7658887,7660197,281,1.00
ptg007024l,1169091,1169398,307,RepeatMasker,LTR,1168004,1169265,174,0.57
ptg007024l,1169091,1169398,307,RepeatMasker,LTR,1169251,1169961,148,0.48
ptg007024l,2392882,2393174,292,RepeatMasker,LTR,2390049,2393516,292,1.00
ptg007034l,513944,514232,288,RepeatMasker,LTR,513545,514015,71,0.25
ptg007036l,956225,956534,309,RepeatMasker,LTR,956304,956758,231,0.75
ptg007036l,956225,956534,309,RepeatMasker,LTR,956363,956758,172,0.56
ptg007036l,1148124,1148437,313,RepeatMasker,LTR,1144912,1149689,313,1.00
ptg007040l,2154793,2155094,301,RepeatMasker,LTR,2154747,2154877,84,0.28
ptg007040l,2154793,2155094,301,RepeatMasker,LTR,2155020,2155089,70,0.23
ptg007044l,493792,494081,289,RepeatMasker,LTR,493156,494298,289,1.00
ptg007053l,3335108,3335395,287,RepeatMasker,LTR,3334196,3335807,287,1.00
ptg007056l,732469,732751,282,RepeatMasker,LTR,729864,732646,177,0.63
ptg007056l,1362623,1362919,296,RepeatMasker,LTR,1362503,1362657,34,0.11
ptg007057l,1448299,1448617,318,RepeatMasker,LTR,1448185,1448939,318,1.00
ptg007057l,1448299,1448617,318,RepeatMasker,LTR,1448418,1448947,200,0.63
ptg007059l,282575,282860,285,RepeatMasker,LTR,275702,282742,167,0.59
ptg007059l,542050,542383,333,RepeatMasker,LTR,541998,542519,333,1.00
ptg007062l,201563,201893,330,RepeatMasker,LTR,200822,202031,330,1.00
ptg007063l,1361002,1361315,313,RepeatMasker,LTR,1360191,1361072,70,0.22
ptg007078l,2983798,2984096,298,RepeatMasker,LTR,2983788,2983837,39,0.13
ptg007078l,2983798,2984096,298,RepeatMasker,LTR,2983795,2984023,225,0.76
ptg007078l,2983798,2984096,298,RepeatMasker,LTR,2983897,2984387,200,0.67
ptg007088l,2432643,2432905,262,RepeatMasker,LTR,2432498,2432645,2,0.01
ptg007088l,2432643,2432905,262,RepeatMasker,LTR,2432822,2432864,43,0.16
ptg007092l,677968,678288,320,RepeatMasker,LTR,677191,678018,50,0.16
ptg007094l,135725,136055,330,RepeatMasker,LTR,134259,135841,116,0.35
ptg007097l,3001694,3001965,271,RepeatMasker,LTR,3001961,3002272,5,0.02
ptg007101l,957921,958220,299,RepeatMasker,LTR,957869,958398,299,1.00
ptg007103l,27554,27852,298,RepeatMasker,LTR,24367,27638,84,0.28
ptg007103l,27554,27852,298,RepeatMasker,LTR,25180,28410,298,1.00
ptg007107l,216932,217227,295,RepeatMasker,LTR,216880,217422,295,1.00
ptg007112l,417978,418281,303,RepeatMasker,LTR,417140,423368,303,1.00
ptg007117l,164655,164936,281,RepeatMasker,LTR,164011,165324,281,1.00
ptg007130l,900688,900978,290,RepeatMasker,LTR,900043,901351,290,1.00
ptg007131l,2420691,2421020,329,RepeatMasker,LTR,2420923,2421072,98,0.30
ptg007132l,340748,341058,310,RepeatMasker,LTR,335078,341014,266,0.86
ptg007143l,721095,721379,284,RepeatMasker,LTR,721356,721400,24,0.08
ptg007143l,5209982,5210258,276,RepeatMasker,LTR,5209970,5210654,276,1.00
ptg007144l,1045390,1045670,280,RepeatMasker,LTR,1044596,1046082,280,1.00
ptg007147l,356047,356335,288,RepeatMasker,LTR,356312,356356,24,0.08
ptg007148l,1942421,1942720,299,RepeatMasker,LTR,1942371,1942928,299,1.00
ptg007156l,409024,409310,286,RepeatMasker,LTR,402880,409710,286,1.00
ptg007169l,475169,475479,310,RepeatMasker,LTR,475308,475367,60,0.19
ptg007169l,475169,475479,310,RepeatMasker,LTR,475334,475370,37,0.12
ptg007169l,475169,475479,310,RepeatMasker,LTR,475364,477696,116,0.37
ptg007171l,2623079,2623359,280,RepeatMasker,LTR,2622440,2624491,280,1.00
ptg007176l,266027,266331,304,RepeatMasker,LTR,263634,268057,304,1.00
ptg007177l,402300,402586,286,RepeatMasker,LTR,401590,402320,20,0.07
ptg007181l,186964,187260,296,RepeatMasker,LTR,186915,187321,296,1.00
ptg007181l,513719,514021,302,RepeatMasker,LTR,512475,513801,82,0.27
ptg007181l,2506900,2507206,306,RepeatMasker,LTR,2506978,2507254,229,0.75
ptg007188l,144460,144740,280,RepeatMasker,LTR,144427,145736,280,1.00
ptg007188l,3453651,3453955,304,RepeatMasker,LTR,3453708,3454203,248,0.82
ptg007190l,1246796,1247116,320,RepeatMasker,LTR,1246697,1247813,320,1.00
ptg007198l,1472937,1473077,140,RepeatMasker,LTR,1473076,1482588,2,0.01
ptg007204l,928216,928508,292,RepeatMasker,LTR,925366,928845,292,1.00
ptg007210l,172804,173090,286,RepeatMasker,LTR,168713,173491,286,1.00
ptg007210l,909514,909820,306,RepeatMasker,LTR,906946,916436,306,1.00
ptg007212l,139580,139905,325,RepeatMasker,LTR,139528,139847,267,0.82
ptg007212l,1100120,1100397,277,RepeatMasker,LTR,1099471,1100782,277,1.00
ptg007215l,254375,254671,296,RepeatMasker,LTR,254231,254600,225,0.76
ptg007218l,2599525,2599829,304,RepeatMasker,LTR,2598886,2600211,304,1.00
ptg007218l,2614298,2614602,304,RepeatMasker,LTR,2614265,2614967,304,1.00
ptg007228l,2412986,2413289,303,RepeatMasker,LTR,2412603,2413000,14,0.05
ptg007242l,2042527,2042814,287,RepeatMasker,LTR,2041676,2047532,287,1.00
ptg007244l,959387,959699,312,RepeatMasker,LTR,958783,959748,312,1.00
ptg007258l,118919,119210,291,RepeatMasker,LTR,118280,120246,291,1.00
ptg007261l,83968,84274,306,RepeatMasker,LTR,83943,84189,221,0.72
ptg007271l,1002633,1002940,307,RepeatMasker,LTR,1001998,1003324,307,1.00
ptg007271l,1011538,1011818,280,RepeatMasker,LTR,1010762,1012200,280,1.00
ptg007273l,5018842,5019147,305,RepeatMasker,LTR,5017168,5019082,240,0.79
ptg007273l,5138496,5138792,296,RepeatMasker,LTR,5138484,5139179,296,1.00
ptg007275l,67491,67768,277,RepeatMasker,LTR,66848,67787,277,1.00
ptg007275l,99007,99287,280,RepeatMasker,LTR,98995,99666,280,1.00
ptg007276l,543183,543463,280,RepeatMasker,LTR,543171,543845,280,1.00
ptg007276l,1804463,1804773,310,RepeatMasker,LTR,1804012,1805356,310,1.00
ptg007277l,1024400,1024695,295,RepeatMasker,LTR,1024348,1024889,295,1.00
ptg007279l,1196496,1196777,281,RepeatMasker,LTR,1195852,1197166,281,1.00
ptg007279l,1203981,1204260,279,RepeatMasker,LTR,1203184,1204642,279,1.00
ptg007285l,668384,668665,281,RepeatMasker,LTR,667739,668745,281,1.00
ptg007285l,707637,707918,281,RepeatMasker,LTR,707604,708976,281,1.00
ptg007285l,3302124,3302418,294,RepeatMasker,LTR,3302072,3302498,294,1.00
ptg007287l,2386618,2386905,287,RepeatMasker,LTR,2385718,2387218,287,1.00
ptg007294l,349009,349327,318,RepeatMasker,LTR,348366,349693,318,1.00
ptg007295l,3351917,3352218,301,RepeatMasker,LTR,3351936,3352151,216,0.72
ptg007295l,3879899,3880192,293,RepeatMasker,LTR,3879847,3880370,293,1.00
ptg007296l,782298,782600,302,RepeatMasker,LTR,781962,782460,162,0.54
ptg007302l,1563688,1563985,297,RepeatMasker,LTR,1563636,1564163,297,1.00
ptg007314l,425839,426133,294,RepeatMasker,LTR,425789,426285,294,1.00
ptg007316l,130200,130487,287,RepeatMasker,LTR,129341,135112,287,1.00
ptg007319l,1363059,1363353,294,RepeatMasker,LTR,1360260,1364193,294,1.00
ptg007331l,706868,707148,280,RepeatMasker,LTR,706855,708210,280,1.00
ptg007332l,2805505,2805825,320,RepeatMasker,LTR,2805567,2805630,64,0.20
ptg007334l,401718,402014,296,RepeatMasker,LTR,401684,402094,296,1.00
ptg007334l,2061358,2061642,284,RepeatMasker,LTR,2059810,2061587,229,0.81
ptg007335l,1168906,1169214,308,RepeatMasker,LTR,1164162,1169109,203,0.66
ptg007342l,2527560,2527859,299,RepeatMasker,LTR,2527513,2528054,299,1.00
ptg007342l,2704999,2705294,295,RepeatMasker,LTR,2704947,2705374,295,1.00
ptg007342l,2827712,2828011,299,RepeatMasker,LTR,2827660,2828189,299,1.00
ptg007342l,3425252,3425552,300,RepeatMasker,LTR,3425200,3425766,300,1.00
ptg007345l,346332,346631,299,RepeatMasker,LTR,346280,346711,299,1.00
ptg007345l,676591,676890,299,RepeatMasker,LTR,676539,677087,299,1.00
ptg007351l,667284,667590,306,RepeatMasker,LTR,666373,668285,306,1.00
ptg007355l,2079996,2080306,310,RepeatMasker,LTR,2079895,2080132,136,0.44
ptg007356l,308522,308821,299,RepeatMasker,LTR,308470,308999,299,1.00
ptg007356l,3086698,3087018,320,RepeatMasker,LTR,3086750,3087063,269,0.84
ptg007356l,3086698,3087018,320,RepeatMasker,LTR,3086912,3087099,107,0.33
ptg007361l,350388,350699,311,RepeatMasker,LTR,350255,350876,311,1.00
ptg007370l,1136643,1136934,291,RepeatMasker,LTR,1135573,1136690,47,0.16
ptg007374l,1663159,1663459,300,RepeatMasker,LTR,1663107,1663668,300,1.00
ptg007374l,1817855,1818154,299,RepeatMasker,LTR,1817803,1818349,299,1.00
ptg007374l,1942788,1943107,319,RepeatMasker,LTR,1942780,1942939,151,0.47
ptg007375l,1607127,1607443,316,RepeatMasker,LTR,1607208,1608237,236,0.75
ptg007375l,5704786,5705067,281,RepeatMasker,LTR,5704143,5705484,281,1.00
ptg007378l,330411,330731,320,RepeatMasker,LTR,330106,330579,168,0.53
ptg007378l,1968279,1968604,325,RepeatMasker,LTR,1964690,1968491,212,0.65
ptg007395l,525607,525890,283,RepeatMasker,LTR,522355,526989,283,1.00
ptg007397l,1411555,1411854,299,RepeatMasker,LTR,1411503,1411934,299,1.00
ptg007397l,2670607,2670906,299,RepeatMasker,LTR,2670555,2671084,299,1.00
ptg007397l,3700137,3700450,313,RepeatMasker,LTR,3700194,3700368,175,0.56
ptg007399l,405850,406130,280,RepeatMasker,LTR,405049,406512,280,1.00
ptg007403l,211405,211688,283,RepeatMasker,LTR,209002,213141,283,1.00
ptg007404l,1066946,1067246,300,RepeatMasker,LTR,1066894,1067454,300,1.00
ptg007413l,260135,260412,277,RepeatMasker,LTR,260392,261238,21,0.08
ptg007421l,5165644,5165935,291,RepeatMasker,LTR,5165027,5168650,291,1.00
ptg007421l,5624461,5624607,146,RepeatMasker,LTR,5624437,5625210,146,1.00
ptg007436l,2341028,2341336,308,RepeatMasker,LTR,2339423,2342221,308,1.00
ptg007439l,658989,659269,280,RepeatMasker,LTR,658227,659581,280,1.00
ptg007439l,9027501,9027816,315,RepeatMasker,LTR,9027701,9028183,116,0.37
ptg007439l,10376541,10376841,300,RepeatMasker,LTR,10374320,10380107,300,1.00
ptg007442l,3066824,3067124,300,RepeatMasker,LTR,3066772,3067347,300,1.00
ptg007442l,3128349,3128649,300,RepeatMasker,LTR,3128297,3128860,300,1.00
ptg007447l,129565,129873,308,RepeatMasker,LTR,129626,129977,248,0.81
ptg007459l,279839,280155,316,RepeatMasker,LTR,278526,280065,226,0.72
ptg007459l,3305512,3305826,314,RepeatMasker,LTR,3304907,3305972,314,1.00
ptg007461l,4132524,4132815,291,RepeatMasker,LTR,4132185,4133236,291,1.00
ptg007462l,540653,540933,280,RepeatMasker,LTR,538046,543977,280,1.00
ptg007469l,1286525,1286826,301,RepeatMasker,LTR,1286491,1287044,301,1.00
ptg007470l,706268,706572,304,RepeatMasker,LTR,706549,706605,24,0.08
ptg007472l,6173857,6174156,299,RepeatMasker,LTR,6173805,6174364,299,1.00
ptg007473l,572858,573156,298,RepeatMasker,LTR,572806,573176,298,1.00
ptg007473l,586435,586734,299,RepeatMasker,LTR,586383,586912,299,1.00
ptg007473l,605316,605606,290,RepeatMasker,LTR,602881,605917,290,1.00
ptg007473l,985901,986200,299,RepeatMasker,LTR,985849,986280,299,1.00
ptg007474l,1237899,1238198,299,RepeatMasker,LTR,1237847,1238376,299,1.00
ptg007485l,337162,337448,286,RepeatMasker,LTR,337130,337825,286,1.00
ptg007493l,1398358,1398660,302,RepeatMasker,LTR,1398574,1398948,87,0.29
ptg007497l,1373162,1373445,283,RepeatMasker,LTR,1373077,1373557,283,1.00
ptg007505l,233485,233784,299,RepeatMasker,LTR,233433,233864,299,1.00
ptg007506l,1063402,1063729,327,RepeatMasker,LTR,1063246,1063496,94,0.29
ptg007506l,1063402,1063729,327,RepeatMasker,LTR,1063524,1063849,206,0.63
ptg007509l,2712961,2713259,298,RepeatMasker,LTR,2711818,2713927,298,1.00
ptg007512l,735445,735715,270,RepeatMasker,LTR,734794,736910,270,1.00
ptg007522l,71610,71909,299,RepeatMasker,LTR,71558,72064,299,1.00
ptg007523l,23539,23820,281,RepeatMasker,LTR,22894,24212,281,1.00
ptg007523l,90467,90748,281,RepeatMasker,LTR,89818,91141,281,1.00
ptg007523l,662387,662668,281,RepeatMasker,LTR,661742,663054,281,1.00
ptg007524l,275165,275441,276,RepeatMasker,LTR,274815,276441,276,1.00
ptg007525l,41573,41853,280,RepeatMasker,LTR,41728,42057,126,0.45
ptg007526l,1631354,1631655,301,RepeatMasker,LTR,1628861,1632141,301,1.00
ptg007530l,70059,70358,299,RepeatMasker,LTR,70007,70523,299,1.00
ptg007536c,1183621,1183936,315,RepeatMasker,LTR,1183285,1183783,162,0.51
ptg007538l,1249597,1249908,311,RepeatMasker,LTR,1249852,1250234,57,0.18
ptg007541l,249443,249746,303,RepeatMasker,LTR,248842,249861,303,1.00
ptg007545l,6735277,6735567,290,RepeatMasker,LTR,6735225,6735732,290,1.00
ptg007547l,1940952,1941246,294,RepeatMasker,LTR,1941166,1941225,60,0.20
ptg007551l,945208,945513,305,RepeatMasker,LTR,943081,945240,32,0.10
ptg007556l,22204,22506,302,RepeatMasker,LTR,21074,22335,131,0.43
ptg007558l,160992,161284,292,RepeatMasker,LTR,158160,161645,292,1.00
ptg007561l,483171,483496,325,RepeatMasker,LTR,483115,483383,212,0.65
ptg007561l,483171,483496,325,RepeatMasker,LTR,483390,483615,107,0.33
ptg007562l,2348979,2349278,299,RepeatMasker,LTR,2348927,2349298,299,1.00
ptg007565l,287402,287696,294,RepeatMasker,LTR,287374,287620,218,0.74
ptg007565l,287402,287696,294,RepeatMasker,LTR,287439,287620,182,0.62
ptg007565l,1534537,1534815,278,RepeatMasker,LTR,1534538,1534777,240,0.86
ptg007566l,3233476,3233736,260,RepeatMasker,LTR,3233504,3233561,58,0.22
ptg007592l,296552,296835,283,RepeatMasker,LTR,295750,297205,283,1.00
ptg007605l,287434,287734,300,RepeatMasker,LTR,287708,288952,27,0.09
ptg007613l,1852152,1852445,293,RepeatMasker,LTR,1849285,1853103,293,1.00
ptg007613l,3289073,3289385,312,RepeatMasker,LTR,3288016,3291210,312,1.00
ptg007613l,3323923,3324230,307,RepeatMasker,LTR,3323342,3323954,31,0.10
ptg007617l,716720,717014,294,RepeatMasker,LTR,716877,716956,80,0.27
ptg007621l,905085,905410,325,RepeatMasker,LTR,905350,905391,42,0.13
ptg007623l,3525445,3525745,300,RepeatMasker,LTR,3525393,3525938,300,1.00
ptg007630l,635466,635747,281,RepeatMasker,LTR,635436,636129,281,1.00
ptg007630l,635466,635747,281,RepeatMasker,LTR,635453,636057,281,1.00
ptg007630l,886681,886962,281,RepeatMasker,LTR,886668,887345,281,1.00
ptg007635l,835419,835698,279,RepeatMasker,LTR,831224,835436,17,0.06
ptg007635l,2122206,2122513,307,RepeatMasker,LTR,2121776,2122574,307,1.00
ptg007635l,2122206,2122513,307,RepeatMasker,LTR,2121776,2122794,307,1.00
ptg007639l,1805452,1805755,303,RepeatMasker,LTR,1804590,1805682,230,0.76
ptg007650l,808380,808667,287,RepeatMasker,LTR,807527,808760,287,1.00
ptg007650l,1324598,1324897,299,RepeatMasker,LTR,1324546,1324977,299,1.00
ptg007661l,1148371,1148662,291,RepeatMasker,LTR,1147728,1149033,291,1.00
ptg007661l,2752046,2752331,285,RepeatMasker,LTR,2752222,2752347,110,0.39
ptg007665l,1018423,1018703,280,RepeatMasker,LTR,1018416,1019012,280,1.00
ptg007668l,359641,359935,294,RepeatMasker,LTR,358862,360621,294,1.00
ptg007668l,1695607,1695894,287,RepeatMasker,LTR,1693177,1696333,287,1.00
ptg007678l,4210451,4210725,274,RepeatMasker,LTR,4210426,4210476,25,0.09
ptg007678l,4210451,4210725,274,RepeatMasker,LTR,4210443,4210494,43,0.16
ptg007678l,4210451,4210725,274,RepeatMasker,LTR,4210443,4210508,57,0.21
ptg007678l,4287785,4288116,331,RepeatMasker,LTR,4285976,4287826,41,0.12
ptg007685l,2007287,2007594,307,RepeatMasker,LTR,2000419,2007449,162,0.53
ptg007687l,24733,25032,299,RepeatMasker,LTR,24681,25112,299,1.00
ptg007687l,45134,45434,300,RepeatMasker,LTR,45082,45612,300,1.00
ptg007687l,2277554,2277853,299,RepeatMasker,LTR,2277303,2281412,299,1.00
ptg007696l,2794179,2794466,287,RepeatMasker,LTR,2794415,2794459,45,0.16
ptg007701l,607931,608223,292,RepeatMasker,LTR,607332,608252,292,1.00
ptg007702l,491840,492121,281,RepeatMasker,LTR,491807,492271,281,1.00
ptg007702l,491840,492121,281,RepeatMasker,LTR,491193,492189,281,1.00
ptg007703l,317210,317490,280,RepeatMasker,LTR,316429,318561,280,1.00
ptg007703l,398548,398828,280,RepeatMasker,LTR,398536,399210,280,1.00
ptg007706l,57730,58010,280,RepeatMasker,LTR,57094,58314,280,1.00
ptg007713l,605044,605358,314,RepeatMasker,LTR,605164,605585,195,0.62
ptg007713l,605044,605358,314,RepeatMasker,LTR,605164,605909,195,0.62
ptg007726l,422546,422864,318,RepeatMasker,LTR,422813,425003,52,0.16
ptg007729l,3336863,3337171,308,RepeatMasker,LTR,3336061,3337553,308,1.00
ptg007732l,2001172,2001440,268,RepeatMasker,LTR,2001147,2001197,25,0.09
ptg007732l,2001172,2001440,268,RepeatMasker,LTR,2001161,2001226,54,0.20
ptg007732l,3385618,3385942,324,RepeatMasker,LTR,3385619,3385948,324,1.00
ptg007736l,256181,256480,299,RepeatMasker,LTR,256147,256500,299,1.00
ptg007742l,1259650,1259983,333,RepeatMasker,LTR,1253476,1259700,50,0.15
ptg007746l,83326,83625,299,RepeatMasker,LTR,83274,83600,274,0.92
ptg007760l,489343,489629,286,RepeatMasker,LTR,489516,492447,114,0.40
ptg007768l,2701329,2701637,308,RepeatMasker,LTR,2701334,2701401,68,0.22
ptg007768l,2701329,2701637,308,RepeatMasker,LTR,2701472,2702353,166,0.54
ptg007768l,2701329,2701637,308,RepeatMasker,LTR,2701579,2702502,59,0.19
ptg007784l,226811,227107,296,RepeatMasker,LTR,226765,227314,296,1.00
ptg007784l,233728,234028,300,RepeatMasker,LTR,233676,234234,300,1.00
ptg007784l,5560992,5561312,320,RepeatMasker,LTR,5561175,5561249,75,0.23
ptg007787l,1265232,1265529,297,RepeatMasker,LTR,1265180,1265684,297,1.00
ptg007791l,1297629,1297935,306,RepeatMasker,LTR,1297390,1298480,306,1.00
ptg007793l,30855,31121,266,RepeatMasker,LTR,30782,30927,72,0.27
ptg007793l,30855,31121,266,RepeatMasker,LTR,30782,30945,90,0.34
ptg007807l,2604691,2604986,295,RepeatMasker,LTR,2604690,2604773,82,0.28
ptg007808l,426962,427257,295,RepeatMasker,LTR,426910,427327,295,1.00
ptg007810l,1285340,1285638,298,RepeatMasker,LTR,1285374,1286029,265,0.89
ptg007814l,411030,411346,316,RepeatMasker,LTR,410341,412241,316,1.00
ptg007826l,2665434,2665733,299,RepeatMasker,LTR,2665382,2665917,299,1.00
ptg007826l,2783696,2783989,293,RepeatMasker,LTR,2783644,2784194,293,1.00
ptg007826l,2911483,2911789,306,RepeatMasker,LTR,2911182,2914769,306,1.00
ptg007840l,2935009,2935296,287,RepeatMasker,LTR,2935281,2935472,16,0.06
ptg007840l,3570058,3570357,299,RepeatMasker,LTR,3570024,3570377,299,1.00
ptg007841l,344790,345092,302,RepeatMasker,LTR,343956,345020,230,0.76
ptg007842l,2071568,2071895,327,RepeatMasker,LTR,2069223,2072251,327,1.00
ptg007842l,2071568,2071895,327,RepeatMasker,LTR,2070263,2072627,327,1.00
ptg007843l,89383,89705,322,RepeatMasker,LTR,89293,90421,322,1.00
ptg007844l,95014,95319,305,RepeatMasker,LTR,95237,95392,83,0.27
ptg007847l,1120855,1121137,282,RepeatMasker,LTR,1120210,1121519,282,1.00
ptg007850l,1119137,1119418,281,RepeatMasker,LTR,1119124,1119801,281,1.00
ptg007850l,1201702,1202004,302,RepeatMasker,LTR,1200267,1201793,91,0.30
ptg007850l,1201702,1202004,302,RepeatMasker,LTR,1200451,1201834,132,0.44
ptg007850l,1441193,1441474,281,RepeatMasker,LTR,1441160,1441857,281,1.00
ptg007850l,3887515,3887796,281,RepeatMasker,LTR,3886713,3888178,281,1.00
ptg007852l,547994,548275,281,RepeatMasker,LTR,547981,548657,281,1.00
ptg007852l,555137,555431,294,RepeatMasker,LTR,555124,555731,294,1.00
ptg007855l,543457,543787,330,RepeatMasker,LTR,543736,544041,52,0.16
ptg007858l,2161636,2161916,280,RepeatMasker,LTR,2157514,2166371,280,1.00
ptg007865l,352804,353136,332,RepeatMasker,LTR,352875,352924,50,0.15
ptg007865l,1488345,1488645,300,RepeatMasker,LTR,1488293,1488854,300,1.00
ptg007879l,1030038,1030319,281,RepeatMasker,LTR,1030006,1030330,281,1.00
ptg007884l,1022583,1022865,282,RepeatMasker,LTR,1021936,1023175,282,1.00
ptg007887l,609825,610118,293,RepeatMasker,LTR,609949,610026,78,0.27
ptg007887l,609825,610118,293,RepeatMasker,LTR,610116,610173,3,0.01
ptg007892l,104423,104705,282,RepeatMasker,LTR,103790,105085,282,1.00
ptg007892l,111570,111851,281,RepeatMasker,LTR,110768,112233,281,1.00
ptg007892l,528256,528549,293,RepeatMasker,LTR,528244,528927,293,1.00
ptg007898l,2410018,2410276,258,RepeatMasker,LTR,2409960,2410159,141,0.55
ptg007898l,2410018,2410276,258,RepeatMasker,LTR,2410197,2410253,57,0.22
ptg007898l,4806955,4807258,303,RepeatMasker,LTR,4806662,4808189,303,1.00
ptg007898l,4806955,4807258,303,RepeatMasker,LTR,4806697,4808151,303,1.00
ptg007903l,868589,868891,302,RepeatMasker,LTR,867019,869657,302,1.00
ptg007903l,868589,868891,302,RepeatMasker,LTR,867341,869627,302,1.00
ptg007903l,868595,868893,298,RepeatMasker,LTR,867019,869657,298,1.00
ptg007903l,868595,868893,298,RepeatMasker,LTR,867341,869627,298,1.00
ptg007904l,373617,373898,281,RepeatMasker,LTR,373604,374287,281,1.00
ptg007906l,85343,85627,284,RepeatMasker,LTR,84971,86120,284,1.00
ptg007906l,1438913,1439212,299,RepeatMasker,LTR,1438861,1439420,299,1.00
ptg007906l,1614338,1614635,297,RepeatMasker,LTR,1614292,1614676,297,1.00
ptg007909l,249452,249720,268,RepeatMasker,LTR,249611,250198,110,0.41
ptg007910l,182328,182627,299,RepeatMasker,LTR,182276,182835,299,1.00
ptg007910l,287089,287388,299,RepeatMasker,LTR,287037,287596,299,1.00
ptg007910l,860334,860635,301,RepeatMasker,LTR,860282,860840,301,1.00
ptg007910l,929476,929782,306,RepeatMasker,LTR,927836,929667,191,0.62
ptg007910l,972276,972577,301,RepeatMasker,LTR,972224,972656,301,1.00
ptg007910l,1211258,1211560,302,RepeatMasker,LTR,1210137,1215943,302,1.00
ptg007924l,28702,28983,281,RepeatMasker,LTR,28669,29388,281,1.00
ptg007924l,480453,480733,280,RepeatMasker,LTR,480420,481868,280,1.00
ptg007924l,487630,487926,296,RepeatMasker,LTR,487597,489004,296,1.00
ptg007924l,531893,532214,321,RepeatMasker,LTR,531861,531918,25,0.08
ptg007924l,531893,532214,321,RepeatMasker,LTR,531883,531946,53,0.17
ptg007925l,1560530,1560840,310,RepeatMasker,LTR,1560619,1560801,183,0.59
ptg007925l,4404417,4404684,267,RepeatMasker,LTR,4404121,4404457,40,0.15
ptg007928l,278938,279237,299,RepeatMasker,LTR,278886,279402,299,1.00
ptg007930l,1181343,1181668,325,RepeatMasker,LTR,1181029,1181481,138,0.42
ptg007934l,3117203,3117498,295,RepeatMasker,LTR,3117157,3117662,295,1.00
ptg007937l,122452,122732,280,RepeatMasker,LTR,122414,123031,280,1.00
ptg007937l,337062,337343,281,RepeatMasker,LTR,337028,338387,281,1.00
ptg007940l,3464783,3465060,277,RepeatMasker,LTR,3464801,3464904,104,0.38
ptg007945l,465117,465396,279,RepeatMasker,LTR,464471,465790,279,1.00
ptg007945l,2426342,2426644,302,RepeatMasker,LTR,2426193,2426620,278,0.92
ptg007954l,478699,478996,297,RepeatMasker,LTR,471842,478861,162,0.55
ptg007956l,1164378,1164660,282,RepeatMasker,LTR,1163577,1165047,282,1.00
ptg007956l,4510305,4510601,296,RepeatMasker,LTR,4505234,4510339,34,0.11
ptg007956l,5535930,5536232,302,RepeatMasker,LTR,5533215,5536072,142,0.47
ptg007963l,1740729,1741042,313,RepeatMasker,LTR,1735198,1741080,313,1.00
ptg007966l,720966,721279,313,RepeatMasker,LTR,720484,723506,313,1.00
ptg007966l,2178167,2178478,311,RepeatMasker,LTR,2178272,2179067,207,0.67
ptg007969l,57099,57416,317,RepeatMasker,LTR,55995,57277,178,0.56
ptg007969l,628545,628843,298,RepeatMasker,LTR,628493,628998,298,1.00
ptg007969l,1703451,1703742,291,RepeatMasker,LTR,1702943,1704825,291,1.00
ptg007979l,1421119,1421391,272,RepeatMasker,LTR,1420364,1421158,39,0.14
ptg007979l,1421119,1421391,272,RepeatMasker,LTR,1420831,1421302,183,0.67
ptg007981l,179981,180280,299,RepeatMasker,LTR,179929,180457,299,1.00
ptg007981l,740886,741185,299,RepeatMasker,LTR,740834,741363,299,1.00
ptg007981l,1308070,1308368,298,RepeatMasker,LTR,1308037,1309389,298,1.00
ptg007983l,403301,403623,322,RepeatMasker,LTR,398879,403618,317,0.98
ptg007989l,3056564,3056857,293,RepeatMasker,LTR,3056120,3056623,59,0.20
ptg007990l,581582,581881,299,RepeatMasker,LTR,581530,582046,299,1.00
ptg007995l,714570,714877,307,RepeatMasker,LTR,711997,721470,307,1.00
ptg007996l,512801,513100,299,RepeatMasker,LTR,512749,513141,299,1.00
ptg008007l,186735,187015,280,RepeatMasker,LTR,185578,189055,280,1.00
ptg008015l,53416,53697,281,RepeatMasker,LTR,52773,54077,281,1.00
ptg008023l,72527,72826,299,RepeatMasker,LTR,72475,73004,299,1.00
ptg008026l,3421838,3422138,300,RepeatMasker,LTR,3416788,3426319,300,1.00
ptg008031l,1059137,1059432,295,RepeatMasker,LTR,1059085,1059597,295,1.00
ptg008031l,1549679,1549978,299,RepeatMasker,LTR,1549627,1550058,299,1.00
ptg008035l,257691,257994,303,RepeatMasker,LTR,255505,259529,303,1.00
ptg008036l,346962,347254,292,RepeatMasker,LTR,346910,347422,292,1.00
ptg008036l,363630,363926,296,RepeatMasker,LTR,363578,364091,296,1.00
ptg008038l,1323539,1323823,284,RepeatMasker,LTR,1323794,1323964,30,0.11
ptg008038l,1520924,1521237,313,RepeatMasker,LTR,1520506,1521096,172,0.55
ptg008039l,218743,219024,281,RepeatMasker,LTR,218109,220140,281,1.00
ptg008048l,1238525,1238806,281,RepeatMasker,LTR,1237889,1239954,281,1.00
ptg008056l,1030845,1031150,305,RepeatMasker,LTR,1030689,1030923,78,0.26
ptg008060l,804401,804689,288,RepeatMasker,LTR,804594,805183,96,0.33
ptg008062l,173327,173630,303,RepeatMasker,LTR,173523,173889,108,0.36
ptg008062l,1091633,1091968,335,RepeatMasker,LTR,1091867,1093384,102,0.30
ptg008062l,2232736,2233023,287,RepeatMasker,LTR,2231877,2233922,287,1.00
ptg008063l,4661291,4661570,279,RepeatMasker,LTR,4661394,4661459,66,0.24
ptg008067l,1655194,1655506,312,RepeatMasker,LTR,1655454,1655503,50,0.16
ptg008067l,1985783,1986087,304,RepeatMasker,LTR,1985854,1988153,234,0.77
ptg008069l,327699,327983,284,RepeatMasker,LTR,323812,330586,284,1.00
ptg008090l,4351139,4351431,292,RepeatMasker,LTR,4348308,4351773,292,1.00
ptg008091l,728693,728977,284,RepeatMasker,LTR,728708,732314,270,0.95
ptg008091l,728693,728977,284,RepeatMasker,LTR,728750,731921,228,0.80
ptg008096l,1199144,1199441,297,RepeatMasker,LTR,1199418,1199462,24,0.08
ptg008104l,161495,161772,277,RepeatMasker,LTR,161273,161833,277,1.00
ptg008104l,161495,161772,277,RepeatMasker,LTR,161505,164045,268,0.97
ptg008107l,4165214,4165510,296,RepeatMasker,LTR,4164010,4165349,135,0.46
ptg008112l,358925,359225,300,RepeatMasker,LTR,358873,359305,300,1.00
ptg008113l,2022793,2023080,287,RepeatMasker,LTR,2015931,2022955,162,0.56
ptg008113l,2123417,2123719,302,RepeatMasker,LTR,2121982,2123508,91,0.30
ptg008113l,2123417,2123719,302,RepeatMasker,LTR,2122166,2123549,132,0.44
ptg008116l,66170,66451,281,RepeatMasker,LTR,65370,67498,281,1.00
ptg008116l,446838,447119,281,RepeatMasker,LTR,446037,447507,281,1.00
ptg008116l,488741,489022,281,RepeatMasker,LTR,488708,489412,281,1.00
ptg008116l,496264,496545,281,RepeatMasker,LTR,495462,496934,281,1.00
ptg008117l,905535,905821,286,RepeatMasker,LTR,904186,906221,286,1.00
ptg008121l,1687755,1688050,295,RepeatMasker,LTR,1687957,1688168,94,0.32
ptg008121l,1687755,1688050,295,RepeatMasker,LTR,1687997,1688127,54,0.18
ptg008121l,1687755,1688050,295,RepeatMasker,LTR,1686894,1687804,49,0.17
ptg008122l,2664395,2664697,302,RepeatMasker,LTR,2664140,2664693,298,0.99
ptg008122l,3327475,3327773,298,RepeatMasker,LTR,3326773,3331654,298,1.00
ptg008126l,972489,972753,264,RepeatMasker,LTR,972534,972631,98,0.37
ptg008126l,1801789,1802081,292,RepeatMasker,LTR,1801090,1802423,292,1.00
ptg008137l,3832496,3832807,311,RepeatMasker,LTR,3832784,3832858,24,0.08
ptg008139l,264926,265212,286,RepeatMasker,LTR,263638,266094,286,1.00
ptg008139l,264926,265212,286,RepeatMasker,LTR,264201,267183,286,1.00
ptg008145l,525416,525735,319,RepeatMasker,LTR,524520,525796,319,1.00
ptg008153l,1215411,1215691,280,RepeatMasker,LTR,1214769,1216831,280,1.00
ptg008159l,464346,464613,267,RepeatMasker,LTR,457440,464512,166,0.62
ptg008163l,462495,462775,280,RepeatMasker,LTR,461693,463183,280,1.00
ptg008165l,763283,763575,292,RepeatMasker,LTR,760461,763940,292,1.00
ptg008172l,337345,337668,323,RepeatMasker,LTR,333254,337584,239,0.74
ptg008176l,981517,981816,299,RepeatMasker,LTR,981465,982020,299,1.00
ptg008190l,641949,642266,317,RepeatMasker,LTR,641075,642156,207,0.65
ptg008190l,641949,642266,317,RepeatMasker,LTR,642151,642723,116,0.37
ptg008198l,1674331,1674613,282,RepeatMasker,LTR,1674319,1674924,282,1.00
ptg008198l,1674331,1674613,282,RepeatMasker,LTR,1674320,1674995,282,1.00
ptg008202l,1784110,1784409,299,RepeatMasker,LTR,1784058,1784574,299,1.00
ptg008204l,710146,710441,295,RepeatMasker,LTR,710094,710619,295,1.00
ptg008207l,98764,99059,295,RepeatMasker,LTR,98712,99227,295,1.00
ptg008207l,112228,112524,296,RepeatMasker,LTR,112176,112706,296,1.00
ptg008213l,193499,193813,314,RepeatMasker,LTR,193548,193576,29,0.09
ptg008213l,982961,983274,313,RepeatMasker,LTR,982734,983767,313,1.00
ptg008216l,606159,606503,344,RepeatMasker,LTR,605989,606517,344,1.00
ptg008216l,669973,670273,300,RepeatMasker,LTR,669921,670485,300,1.00
ptg008217l,1099021,1099302,281,RepeatMasker,LTR,1098618,1099488,281,1.00
ptg008220l,154383,154682,299,RepeatMasker,LTR,154331,154860,299,1.00
ptg008221l,2383497,2383812,315,RepeatMasker,LTR,2383164,2383520,23,0.07
ptg008234l,699038,699348,310,RepeatMasker,LTR,699254,699425,95,0.31
ptg008242l,979417,979713,296,RepeatMasker,LTR,978616,980080,296,1.00
ptg008244l,57730,58026,296,RepeatMasker,LTR,57084,58386,296,1.00
ptg008244l,65128,65408,280,RepeatMasker,LTR,64326,65792,280,1.00
ptg008248l,339199,339478,279,RepeatMasker,LTR,338553,339856,279,1.00
ptg008255l,384821,385120,299,RepeatMasker,LTR,384798,385277,299,1.00
ptg008255l,434149,434439,290,RepeatMasker,LTR,433735,435320,290,1.00
ptg008255l,1927546,1927872,326,RepeatMasker,LTR,1927547,1928206,326,1.00
ptg008255l,1928313,1928626,313,RepeatMasker,LTR,1928318,1928370,53,0.17
ptg008255l,1928313,1928626,313,RepeatMasker,LTR,1928334,1928405,72,0.23
ptg008255l,2182434,2182734,300,RepeatMasker,LTR,2182399,2182954,300,1.00
ptg008255l,2400439,2400738,299,RepeatMasker,LTR,2400387,2400903,299,1.00
ptg008260l,2606250,2606545,295,RepeatMasker,LTR,2606198,2606753,295,1.00
ptg008267l,616566,616885,319,RepeatMasker,LTR,614363,617447,319,1.00
ptg008271l,444895,445221,326,RepeatMasker,LTR,444274,445513,326,1.00
ptg008296l,325046,325345,299,RepeatMasker,LTR,324942,325420,299,1.00
ptg008296l,1878688,1878977,289,RepeatMasker,LTR,1878644,1878714,26,0.09
ptg008296l,1878688,1878977,289,RepeatMasker,LTR,1878657,1878787,99,0.34
ptg008332l,503902,504213,311,RepeatMasker,LTR,504128,504496,86,0.28
ptg008336l,1173673,1173965,292,RepeatMasker,LTR,1168032,1173723,50,0.17
ptg008339l,1881762,1882083,321,RepeatMasker,LTR,1881793,1882033,241,0.75
ptg008339l,1881762,1882083,321,RepeatMasker,LTR,1882076,1883792,8,0.02
ptg008339l,1910025,1910306,281,RepeatMasker,LTR,1910053,1910279,227,0.81
ptg008339l,1910025,1910306,281,RepeatMasker,LTR,1910235,1910288,54,0.19
ptg008339l,2373565,2373845,280,RepeatMasker,LTR,2372927,2374879,280,1.00
ptg008341l,770648,770929,281,RepeatMasker,LTR,770906,770966,24,0.09
ptg008341l,1350658,1350941,283,RepeatMasker,LTR,1349302,1351881,283,1.00
ptg008350l,528933,529213,280,RepeatMasker,LTR,528131,529595,280,1.00
ptg008367l,313445,313730,285,RepeatMasker,LTR,312609,316505,285,1.00
ptg008372l,601746,602027,281,RepeatMasker,LTR,601713,602412,281,1.00
ptg008378l,1996665,1996986,321,RepeatMasker,LTR,1996020,1997365,321,1.00
ptg008385l,282688,282983,295,RepeatMasker,LTR,282659,284022,295,1.00
ptg008387l,889672,889999,327,RepeatMasker,LTR,889482,892568,327,1.00
ptg008387l,889672,889999,327,RepeatMasker,LTR,889917,893353,83,0.25
ptg008389l,654792,655112,320,RepeatMasker,LTR,654159,655475,320,1.00
ptg008389l,1979014,1979333,319,RepeatMasker,LTR,1977574,1979064,50,0.16
ptg008389l,2342959,2343254,295,RepeatMasker,LTR,2342947,2343559,295,1.00
ptg008390l,551962,552268,306,RepeatMasker,LTR,549531,552092,130,0.42
ptg008393l,1813558,1813871,313,RepeatMasker,LTR,1813565,1814173,307,0.98
ptg008395l,1048677,1048976,299,RepeatMasker,LTR,1048625,1049154,299,1.00
ptg008395l,1082550,1082842,292,RepeatMasker,LTR,1080859,1082600,50,0.17
ptg008400l,2382732,2383026,294,RepeatMasker,LTR,2379929,2386080,294,1.00
ptg008404l,2964830,2965110,280,RepeatMasker,LTR,2964817,2965116,280,1.00
ptg008404l,5035116,5035413,297,RepeatMasker,LTR,5034334,5036400,297,1.00
ptg008414l,1233289,1233591,302,RepeatMasker,LTR,1231720,1234345,302,1.00
ptg008414l,1233289,1233591,302,RepeatMasker,LTR,1232038,1233421,132,0.44
ptg008425l,1406897,1407201,304,RepeatMasker,LTR,1406855,1407738,304,1.00
ptg008428l,1370269,1370577,308,RepeatMasker,LTR,1369534,1370401,132,0.43
ptg008435l,1616133,1616432,299,RepeatMasker,LTR,1616081,1616610,299,1.00
ptg008439l,100568,100843,275,RepeatMasker,LTR,100732,103630,112,0.41
ptg008439l,100568,100843,275,RepeatMasker,LTR,99577,100731,163,0.59
ptg008442l,1412883,1413163,280,RepeatMasker,LTR,1412236,1413546,280,1.00
ptg008446l,116878,117194,316,RepeatMasker,LTR,116692,116884,6,0.02
ptg008446l,116878,117194,316,RepeatMasker,LTR,116881,117535,314,0.99
ptg008446l,2015202,2015522,320,RepeatMasker,LTR,2015474,2015549,49,0.15
ptg008446l,2015202,2015522,320,RepeatMasker,LTR,2015498,2016139,25,0.08
ptg008449l,189795,190120,325,RepeatMasker,LTR,189776,189822,27,0.08
ptg008455l,454175,454478,303,RepeatMasker,LTR,453958,454219,44,0.15
ptg008455l,454175,454478,303,RepeatMasker,LTR,454373,454489,106,0.35
ptg008459l,19097,19420,323,RepeatMasker,LTR,17651,20627,323,1.00
ptg008461l,2803274,2803575,301,RepeatMasker,LTR,2803222,2803794,301,1.00
ptg008467l,2255495,2255782,287,RepeatMasker,LTR,2255519,2257026,264,0.92
ptg008468l,279275,279588,313,RepeatMasker,LTR,278419,281130,313,1.00
ptg008472l,958844,959130,286,RepeatMasker,LTR,958493,958853,9,0.03
ptg008473l,530909,531211,302,RepeatMasker,LTR,529341,531038,129,0.43
ptg008473l,530909,531211,302,RepeatMasker,LTR,529660,531041,132,0.44
ptg008482l,1156126,1156417,291,RepeatMasker,LTR,1155504,1156129,3,0.01
ptg008484l,3117497,3117802,305,RepeatMasker,LTR,3117500,3117570,71,0.23
ptg008491l,999462,999741,279,RepeatMasker,LTR,999618,999832,124,0.44
ptg008492l,1551277,1551574,297,RepeatMasker,LTR,1551243,1551546,269,0.91
ptg008492l,1641716,1642013,297,RepeatMasker,LTR,1641664,1642217,297,1.00
ptg008492l,1942975,1943273,298,RepeatMasker,LTR,1942941,1943479,298,1.00
ptg008492l,1949364,1949639,275,RepeatMasker,LTR,1949584,1949706,56,0.20
ptg008493l,559467,559748,281,RepeatMasker,LTR,558822,560152,281,1.00
ptg008493l,566640,566921,281,RepeatMasker,LTR,566608,567310,281,1.00
ptg008498l,12027,12329,302,RepeatMasker,LTR,11206,12334,302,1.00
ptg008498l,247146,247442,296,RepeatMasker,LTR,246342,250674,296,1.00
ptg008507l,961339,961616,277,RepeatMasker,LTR,961308,963069,277,1.00
ptg008507l,3333065,3333378,313,RepeatMasker,LTR,3332796,3336867,313,1.00
ptg008512l,162025,162317,292,RepeatMasker,LTR,159192,162683,292,1.00
ptg008521l,85799,86113,314,RepeatMasker,LTR,78917,85961,162,0.52
ptg008521l,1007363,1007611,248,RepeatMasker,LTR,1002307,1011819,248,1.00
ptg008528l,119486,119783,297,RepeatMasker,LTR,119453,119993,297,1.00
ptg008530l,968279,968595,316,RepeatMasker,LTR,967762,968311,32,0.10
ptg008530l,968279,968595,316,RepeatMasker,LTR,967762,969044,316,1.00
ptg008530l,968279,968595,316,RepeatMasker,LTR,968353,969408,243,0.77
ptg008531l,656690,657007,317,RepeatMasker,LTR,657004,657447,4,0.01
ptg008531l,656690,657007,317,RepeatMasker,LTR,655024,656873,183,0.58
ptg008534l,1467658,1467963,305,RepeatMasker,LTR,1467776,1468135,188,0.62
ptg008534l,1467658,1467963,305,RepeatMasker,LTR,1467817,1468124,147,0.48
ptg008542l,724006,724303,297,RepeatMasker,LTR,722239,724371,297,1.00
ptg008543l,3582142,3582428,286,RepeatMasker,LTR,3581281,3587071,286,1.00
ptg008544l,1807567,1807869,302,RepeatMasker,LTR,1807797,1808056,73,0.24
ptg008547l,2504878,2505149,271,RepeatMasker,LTR,2502917,2505048,170,0.63
ptg008552l,242937,243246,309,RepeatMasker,LTR,241996,242963,26,0.08
ptg008552l,676657,676940,283,RepeatMasker,LTR,676449,676671,14,0.05
ptg008553l,363791,364077,286,RepeatMasker,LTR,360235,364476,286,1.00
ptg008556l,1262738,1263043,305,RepeatMasker,LTR,1261929,1263400,305,1.00
ptg008559l,6556618,6556913,295,RepeatMasker,LTR,6556566,6556993,295,1.00
ptg008565l,359739,360040,301,RepeatMasker,LTR,359531,359745,6,0.02
ptg008565l,359739,360040,301,RepeatMasker,LTR,359703,359755,16,0.05
ptg008582l,9801,10097,296,RepeatMasker,LTR,9774,9824,23,0.08
ptg008584l,977822,978073,251,RepeatMasker,LTR,978002,978040,39,0.16
ptg008587l,390092,390391,299,RepeatMasker,LTR,389916,390137,45,0.15
ptg008588l,1139734,1140042,308,RepeatMasker,LTR,1139200,1140075,308,1.00
ptg008590l,1445850,1446169,319,RepeatMasker,LTR,1446110,1446145,36,0.11
ptg008592l,583696,584002,306,RepeatMasker,LTR,582969,583908,212,0.69
ptg008597l,1521763,1522093,330,RepeatMasker,LTR,1514839,1524338,330,1.00
ptg008610l,3987769,3988068,299,RepeatMasker,LTR,3987735,3988088,299,1.00
ptg008612l,432748,433029,281,RepeatMasker,LTR,431946,433429,281,1.00
ptg008615l,152118,152413,295,RepeatMasker,LTR,152066,152620,295,1.00
ptg008615l,256524,256820,296,RepeatMasker,LTR,256490,256843,296,1.00
ptg008618l,190134,190433,299,RepeatMasker,LTR,190082,190641,299,1.00
ptg008618l,298696,298973,277,RepeatMasker,LTR,298706,302394,268,0.97
ptg008621l,66363,66662,299,RepeatMasker,LTR,66311,66834,299,1.00
ptg008621l,275673,275967,294,RepeatMasker,LTR,275621,276143,294,1.00
ptg008621l,346246,346542,296,RepeatMasker,LTR,346212,346562,296,1.00
ptg008621l,788989,789315,326,RepeatMasker,LTR,789119,790792,197,0.60
ptg008624l,240125,240415,290,RepeatMasker,LTR,239859,240175,50,0.17
ptg008627l,195424,195715,291,RepeatMasker,LTR,195389,196086,291,1.00
ptg008632l,631922,632216,294,RepeatMasker,LTR,630328,632551,294,1.00
ptg008634l,444339,444622,283,RepeatMasker,LTR,443719,445449,283,1.00
ptg008634l,724582,724882,300,RepeatMasker,LTR,724530,725091,300,1.00
ptg008638l,527828,528148,320,RepeatMasker,LTR,527009,527987,159,0.50
ptg008638l,1058212,1058504,292,RepeatMasker,LTR,1057803,1058846,292,1.00
ptg008639l,205809,206089,280,RepeatMasker,LTR,205475,206460,280,1.00
ptg008640l,698336,698635,299,RepeatMasker,LTR,698269,698843,299,1.00
ptg008645l,63363,63674,311,RepeatMasker,LTR,56592,63525,162,0.52
ptg008649l,667301,667581,280,RepeatMasker,LTR,666663,667963,280,1.00
ptg008652l,1614957,1615238,281,RepeatMasker,LTR,1614164,1616285,281,1.00
ptg008655l,489724,490050,326,RepeatMasker,LTR,489953,490537,98,0.30
ptg008661l,589738,590037,299,RepeatMasker,LTR,589686,590117,299,1.00
ptg008666l,244748,245028,280,RepeatMasker,LTR,244736,245032,280,1.00
ptg008666l,252233,252513,280,RepeatMasker,LTR,252221,252817,280,1.00
ptg008666l,259752,260032,280,RepeatMasker,LTR,258960,260336,280,1.00
ptg008666l,1568646,1568934,288,RepeatMasker,LTR,1568878,1573353,57,0.20
ptg008668l,664702,664982,280,RepeatMasker,LTR,664690,665364,280,1.00
ptg008672l,522045,522326,281,RepeatMasker,LTR,522012,523377,281,1.00
ptg008673l,416188,416499,311,RepeatMasker,LTR,415597,419212,311,1.00
ptg008681l,877403,877669,266,RepeatMasker,LTR,876840,877535,132,0.50
ptg008681l,877403,877669,266,RepeatMasker,LTR,876923,879312,266,1.00
ptg008681l,2617597,2617906,309,RepeatMasker,LTR,2617758,2617800,43,0.14
ptg008682l,605409,605709,300,RepeatMasker,LTR,605357,605921,300,1.00
ptg008682l,872988,873287,299,RepeatMasker,LTR,872936,873328,299,1.00
ptg008682l,927633,927932,299,RepeatMasker,LTR,927581,928012,299,1.00
ptg008682l,1007272,1007567,295,RepeatMasker,LTR,1007220,1007775,295,1.00
ptg008688l,1447771,1448074,303,RepeatMasker,LTR,1448057,1448488,18,0.06
ptg008691l,659541,659851,310,RepeatMasker,LTR,658435,661420,310,1.00
ptg008696l,1227499,1227798,299,RepeatMasker,LTR,1227447,1227878,299,1.00
ptg008700l,5613689,5613975,286,RepeatMasker,LTR,5612830,5618608,286,1.00
ptg008707l,1319102,1319399,297,RepeatMasker,LTR,1316965,1319128,26,0.09
ptg008708l,1134415,1134704,289,RepeatMasker,LTR,1131913,1137273,289,1.00
ptg008711l,860752,861062,310,RepeatMasker,LTR,860705,860839,87,0.28
ptg008717l,400413,400733,320,RepeatMasker,LTR,395914,400449,36,0.11
ptg008721l,436632,436949,317,RepeatMasker,LTR,435872,436671,39,0.12
ptg008723l,740712,740992,280,RepeatMasker,LTR,739920,741373,280,1.00
ptg008724l,1266960,1267241,281,RepeatMasker,LTR,1266321,1268261,281,1.00
ptg008724l,1274143,1274423,280,RepeatMasker,LTR,1273348,1275424,280,1.00
ptg008726l,232424,232744,320,RepeatMasker,LTR,232224,232474,50,0.16
ptg008729l,250196,250477,281,RepeatMasker,LTR,250183,250553,281,1.00
ptg008731l,524978,525273,295,RepeatMasker,LTR,524926,525435,295,1.00
ptg008731l,589844,590143,299,RepeatMasker,LTR,589793,590321,299,1.00
ptg008734l,3534,3814,280,RepeatMasker,LTR,2888,4201,280,1.00
ptg008734l,10093,10373,280,RepeatMasker,LTR,9290,10692,280,1.00
ptg008736l,467823,468110,287,RepeatMasker,LTR,466967,469680,287,1.00
ptg008738l,416494,416794,300,RepeatMasker,LTR,414924,417549,300,1.00
ptg008741l,2150920,2151197,277,RepeatMasker,LTR,2150625,2151267,277,1.00
ptg008741l,3784587,3784892,305,RepeatMasker,LTR,3784695,3784887,193,0.63
ptg008749l,2368319,2368606,287,RepeatMasker,LTR,2368098,2368329,10,0.03
ptg008749l,2368319,2368606,287,RepeatMasker,LTR,2368321,2368366,46,0.16
ptg008749l,2368319,2368606,287,RepeatMasker,LTR,2368367,2374317,240,0.84
ptg008755l,1458765,1459066,301,RepeatMasker,LTR,1458434,1460221,301,1.00
ptg008755l,1514285,1514562,277,RepeatMasker,LTR,1514375,1514756,188,0.68
ptg008758l,49841,50137,296,RepeatMasker,LTR,49194,50503,296,1.00
ptg008758l,64843,65123,280,RepeatMasker,LTR,64040,65507,280,1.00
ptg008760l,552706,552998,292,RepeatMasker,LTR,552654,553153,292,1.00
ptg008760l,1062533,1062837,304,RepeatMasker,LTR,1062141,1063127,304,1.00
ptg008760l,1210509,1210808,299,RepeatMasker,LTR,1210457,1210985,299,1.00
ptg008760l,2038319,2038618,299,RepeatMasker,LTR,2038267,2038811,299,1.00
ptg008762l,210079,210396,317,RepeatMasker,LTR,207746,210095,16,0.05
ptg008762l,210079,210396,317,RepeatMasker,LTR,210044,210115,36,0.11
ptg008772l,402858,403175,317,RepeatMasker,LTR,401806,403106,248,0.78
ptg008775l,441197,441477,280,RepeatMasker,LTR,440413,442553,280,1.00
ptg008778l,2338471,2338766,295,RepeatMasker,LTR,2337668,2339133,295,1.00
ptg008783l,31614,31918,304,RepeatMasker,LTR,31739,31863,125,0.41
ptg008783l,793379,793691,312,RepeatMasker,LTR,791199,794409,312,1.00
ptg008787l,796778,797065,287,RepeatMasker,LTR,795922,801779,287,1.00
ptg008787l,2231225,2231541,316,RepeatMasker,LTR,2231490,2235123,52,0.16
ptg008789l,3661001,3661282,281,RepeatMasker,LTR,3660988,3662344,281,1.00
ptg008789l,3700886,3701187,301,RepeatMasker,LTR,3698648,3701836,301,1.00
ptg008805l,396517,396797,280,RepeatMasker,LTR,395884,397100,280,1.00
ptg008818l,615562,615843,281,RepeatMasker,LTR,614916,616224,281,1.00
ptg008818l,622704,622985,281,RepeatMasker,LTR,621901,623367,281,1.00
ptg008835l,2093143,2093452,309,RepeatMasker,LTR,2093400,2093996,53,0.17
ptg008849l,1282632,1282914,282,RepeatMasker,LTR,1281964,1282787,155,0.55
ptg008850l,665045,665347,302,RepeatMasker,LTR,662350,665326,281,0.93
ptg008850l,665045,665347,302,RepeatMasker,LTR,665323,665367,25,0.08
ptg008860l,341093,341373,280,RepeatMasker,LTR,340306,341763,280,1.00
ptg008862l,1099596,1099894,298,RepeatMasker,LTR,1099544,1100123,298,1.00
ptg008869l,447247,447541,294,RepeatMasker,LTR,446606,447922,294,1.00
ptg008877l,542735,542988,253,RepeatMasker,LTR,535857,542897,162,0.64
ptg008877l,1801001,1801288,287,RepeatMasker,LTR,1801199,1801299,90,0.31
ptg008896l,191991,192288,297,RepeatMasker,LTR,191246,193786,297,1.00
ptg008896l,191991,192288,297,RepeatMasker,LTR,191852,199599,297,1.00
ptg008906l,2145953,2146247,294,RepeatMasker,LTR,2145901,2146423,294,1.00
ptg008907l,195514,195796,282,RepeatMasker,LTR,194962,197222,282,1.00
ptg008907l,503293,503592,299,RepeatMasker,LTR,503390,503418,29,0.10
ptg008907l,503293,503592,299,RepeatMasker,LTR,503586,503620,7,0.02
ptg008910l,507762,508061,299,RepeatMasker,LTR,507716,508270,299,1.00
ptg008911l,206393,206691,298,RepeatMasker,LTR,206527,206722,165,0.55
ptg008916l,72194,72493,299,RepeatMasker,LTR,72142,72671,299,1.00
ptg008917l,924759,925072,313,RepeatMasker,LTR,924613,924981,222,0.71
ptg008918l,34210,34522,312,RepeatMasker,LTR,34433,34605,90,0.29
ptg008926l,1171377,1171656,279,RepeatMasker,LTR,1170830,1173601,279,1.00
ptg008927l,52192,52451,259,RepeatMasker,LTR,51804,52574,259,1.00
ptg008928l,1011549,1011829,280,RepeatMasker,LTR,1010906,1012211,280,1.00
ptg008929l,395670,395964,294,RepeatMasker,LTR,395618,395962,292,0.99
ptg008931l,2101867,2102180,313,RepeatMasker,LTR,2101993,2105387,188,0.60
ptg008933l,630487,630782,295,RepeatMasker,LTR,630435,630990,295,1.00
ptg008954l,252661,252945,284,RepeatMasker,LTR,252377,252961,284,1.00
ptg008958l,886660,886957,297,RepeatMasker,LTR,886608,886981,297,1.00
ptg008969l,3421155,3421425,270,RepeatMasker,LTR,3420635,3424544,270,1.00
ptg008973l,956221,956550,329,RepeatMasker,LTR,954886,957465,329,1.00
ptg008973l,956221,956550,329,RepeatMasker,LTR,954890,956839,329,1.00
ptg008973l,1385707,1385987,280,RepeatMasker,LTR,1385695,1386369,280,1.00
ptg008984l,717267,717554,287,RepeatMasker,LTR,716455,722233,287,1.00
ptg008984l,1188920,1189232,312,RepeatMasker,LTR,1188444,1189657,312,1.00
ptg008984l,2009421,2009717,296,RepeatMasker,LTR,2009439,2009728,279,0.94
ptg008986l,227670,227984,314,RepeatMasker,LTR,226784,230360,314,1.00
ptg008990l,1314301,1314600,299,RepeatMasker,LTR,1314392,1314755,209,0.70
ptg008991l,2063089,2063424,335,RepeatMasker,LTR,2060232,2063126,37,0.11
ptg008991l,2063089,2063424,335,RepeatMasker,LTR,2061218,2063128,39,0.12
ptg008998l,153694,153993,299,RepeatMasker,LTR,153642,154121,299,1.00
ptg008998l,1918989,1919257,268,RepeatMasker,LTR,1918633,1919034,45,0.17
ptg008998l,1918989,1919257,268,RepeatMasker,LTR,1918685,1919088,99,0.37
ptg009001l,1322268,1322587,319,RepeatMasker,LTR,1319847,1322411,143,0.45
ptg009001l,2188909,2189215,306,RepeatMasker,LTR,2188871,2189704,306,1.00
ptg009006l,161291,161588,297,RepeatMasker,LTR,160824,161293,2,0.01
ptg009033l,116609,116910,301,RepeatMasker,LTR,115735,116837,228,0.76
ptg009038l,886660,886980,320,RepeatMasker,LTR,884496,886710,50,0.16
ptg009043l,1486424,1486729,305,RepeatMasker,LTR,1486308,1487657,305,1.00
ptg009051l,1466562,1466842,280,RepeatMasker,LTR,1465924,1467153,280,1.00
ptg009052l,108094,108390,296,RepeatMasker,LTR,101895,108120,26,0.09
ptg009053l,606557,606903,346,RepeatMasker,LTR,606891,607284,13,0.04
ptg009053l,606557,606903,346,RepeatMasker,LTR,605889,606861,304,0.88
ptg009054l,839176,839457,281,RepeatMasker,LTR,838533,840595,281,1.00
ptg009055l,306574,306852,278,RepeatMasker,LTR,305774,307903,278,1.00
ptg009077l,646783,647118,335,RepeatMasker,LTR,642794,646925,142,0.42
ptg009077l,1993604,1993914,310,RepeatMasker,LTR,1993807,1993931,108,0.35
ptg009077l,4136166,4136462,296,RepeatMasker,LTR,4135532,4136828,296,1.00
ptg009079l,321099,321423,324,RepeatMasker,LTR,320927,321451,324,1.00
ptg009082l,1428120,1428390,270,RepeatMasker,LTR,1428302,1428341,40,0.15
ptg009084l,163891,164171,280,RepeatMasker,LTR,163097,164554,280,1.00
ptg009084l,1181025,1181314,289,RepeatMasker,LTR,1180996,1181687,289,1.00
ptg009084l,1187964,1188244,280,RepeatMasker,LTR,1187935,1188627,280,1.00
ptg009093l,862652,862951,299,RepeatMasker,LTR,862468,862839,187,0.63
ptg009103l,429160,429467,307,RepeatMasker,LTR,428151,429190,30,0.10
ptg009104l,2526237,2526538,301,RepeatMasker,LTR,2526203,2526930,301,1.00
ptg009107l,1919179,1919464,285,RepeatMasker,LTR,1919441,1919492,24,0.08
ptg009120l,764099,764405,306,RepeatMasker,LTR,764092,766275,306,1.00
ptg009129l,187473,187780,307,RepeatMasker,LTR,186804,188187,307,1.00
ptg009133l,1142385,1142697,312,RepeatMasker,LTR,1142175,1145245,312,1.00
ptg009141l,895522,895830,308,RepeatMasker,LTR,895635,895921,196,0.64
ptg009142l,444171,444502,331,RepeatMasker,LTR,444357,444403,47,0.14
ptg009147l,675702,676008,306,RepeatMasker,LTR,673194,675924,222,0.73
ptg009147l,675702,676008,306,RepeatMasker,LTR,675835,676329,174,0.57
ptg009149l,166327,166626,299,RepeatMasker,LTR,166275,166804,299,1.00
ptg009150l,222904,223203,299,RepeatMasker,LTR,222852,223223,299,1.00
ptg009151l,1078696,1078998,302,RepeatMasker,LTR,1078975,1079019,24,0.08
ptg009171l,709110,709405,295,RepeatMasker,LTR,709204,709425,202,0.68
ptg009171l,729149,729449,300,RepeatMasker,LTR,729097,729626,300,1.00
ptg009178l,1569724,1570027,303,RepeatMasker,LTR,1569688,1569761,37,0.12
ptg009178l,1569724,1570027,303,RepeatMasker,LTR,1569761,1571428,267,0.88
ptg009179l,3997566,3997873,307,RepeatMasker,LTR,3996814,3998976,307,1.00
ptg009182l,814299,814586,287,RepeatMasker,LTR,813444,819231,287,1.00
ptg009182l,1021581,1021868,287,RepeatMasker,LTR,1020726,1026572,287,1.00
ptg009187l,804930,805227,297,RepeatMasker,LTR,804878,805406,297,1.00
ptg009188l,37058,37366,308,RepeatMasker,LTR,36994,37059,1,0.00
ptg009188l,37058,37366,308,RepeatMasker,LTR,37046,41315,308,1.00
ptg009188l,1155951,1156247,296,RepeatMasker,LTR,1155904,1156409,296,1.00
ptg009190l,1157578,1157865,287,RepeatMasker,LTR,1156677,1162510,287,1.00
ptg009190l,2605288,2605611,323,RepeatMasker,LTR,2598424,2605450,162,0.50
ptg009195l,257833,258140,307,RepeatMasker,LTR,257341,258535,307,1.00
ptg009206l,2619972,2620266,294,RepeatMasker,LTR,2620258,2622346,9,0.03
ptg009207l,179676,179977,301,RepeatMasker,LTR,179629,180176,301,1.00
ptg009207l,186701,187028,327,RepeatMasker,LTR,186667,187221,327,1.00
ptg009219l,2110668,2110961,293,RepeatMasker,LTR,2110904,2110948,45,0.15
ptg009227l,1388077,1388359,282,RepeatMasker,LTR,1387462,1389137,282,1.00
ptg009229l,519560,519859,299,RepeatMasker,LTR,519508,519900,299,1.00
ptg009231l,467550,467836,286,RepeatMasker,LTR,466699,472554,286,1.00
ptg009234l,132517,132814,297,RepeatMasker,LTR,132465,133007,297,1.00
ptg009235l,118456,118755,299,RepeatMasker,LTR,118404,118835,299,1.00
ptg009247l,36228,36509,281,RepeatMasker,LTR,35583,36891,281,1.00
ptg009247l,505116,505396,280,RepeatMasker,LTR,504482,506499,280,1.00
ptg009250l,1826829,1827114,285,RepeatMasker,LTR,1827091,1827136,24,0.08
ptg009256l,790715,791013,298,RepeatMasker,LTR,788349,791522,298,1.00
ptg009262l,1248842,1249141,299,RepeatMasker,LTR,1248790,1249349,299,1.00
ptg009262l,1278173,1278460,287,RepeatMasker,LTR,1277332,1280461,287,1.00
ptg009262l,1679388,1679687,299,RepeatMasker,LTR,1679336,1679865,299,1.00
ptg009262l,2551497,2551796,299,RepeatMasker,LTR,2551445,2551876,299,1.00
ptg009265l,907366,907646,280,RepeatMasker,LTR,907336,908700,280,1.00
ptg009267l,430744,431064,320,RepeatMasker,LTR,431019,431089,46,0.14
ptg009267l,1135896,1136177,281,RepeatMasker,LTR,1135098,1136596,281,1.00
ptg009271l,265359,265686,327,RepeatMasker,LTR,265332,265382,23,0.07
ptg009271l,265359,265686,327,RepeatMasker,LTR,265369,265427,59,0.18
ptg009271l,3364251,3364544,293,RepeatMasker,LTR,3364204,3364564,293,1.00
ptg009273l,2382237,2382556,319,RepeatMasker,LTR,2382508,2385693,49,0.15
ptg009285l,298251,298563,312,RepeatMasker,LTR,298180,298335,84,0.27
ptg009288l,139203,139523,320,RepeatMasker,LTR,138739,141242,320,1.00
ptg009288l,139203,139523,320,RepeatMasker,LTR,139164,141237,320,1.00
ptg009298l,1575026,1575321,295,RepeatMasker,LTR,1574974,1575499,295,1.00
ptg009298l,1595677,1595980,303,RepeatMasker,LTR,1595041,1597024,303,1.00
ptg009298l,2082587,2082867,280,RepeatMasker,LTR,2081948,2084006,280,1.00
ptg009298l,2480152,2480454,302,RepeatMasker,LTR,2480100,2480662,302,1.00
ptg009298l,2687357,2687638,281,RepeatMasker,LTR,2686566,2688689,281,1.00
ptg009298l,3107681,3107980,299,RepeatMasker,LTR,3107629,3108000,299,1.00
ptg009298l,3213326,3213621,295,RepeatMasker,LTR,3213274,3213800,295,1.00
ptg009300l,1628920,1629206,286,RepeatMasker,LTR,1622791,1629605,286,1.00
ptg009303l,146407,146688,281,RepeatMasker,LTR,146375,147086,281,1.00
ptg009311l,372831,373158,327,RepeatMasker,LTR,369617,372897,66,0.20
ptg009311l,372831,373158,327,RepeatMasker,LTR,372856,372993,138,0.42
ptg009311l,372831,373158,327,RepeatMasker,LTR,373047,373257,112,0.34
ptg009316l,1349276,1349555,279,RepeatMasker,LTR,1349292,1349867,264,0.95
ptg009316l,1867437,1867761,324,RepeatMasker,LTR,1867485,1867544,60,0.19
ptg009320l,1126990,1127277,287,RepeatMasker,LTR,1126154,1131989,287,1.00
ptg009331l,2529792,2530094,302,RepeatMasker,LTR,2529647,2530019,227,0.75
ptg009342l,218915,219214,299,RepeatMasker,LTR,218863,219389,299,1.00
ptg009344l,1059684,1059964,280,RepeatMasker,LTR,1059047,1061105,280,1.00
ptg009347l,600949,601241,292,RepeatMasker,LTR,598117,601578,292,1.00
ptg009352l,1497503,1497789,286,RepeatMasker,LTR,1497257,1497887,286,1.00
ptg009352l,1497503,1497789,286,RepeatMasker,LTR,1497364,1497887,286,1.00
ptg009357l,1425349,1425642,293,RepeatMasker,LTR,1425193,1425610,261,0.89
ptg009367l,374075,374378,303,RepeatMasker,LTR,373892,374428,303,1.00
ptg009367l,374075,374378,303,RepeatMasker,LTR,374124,374481,255,0.84
ptg009367l,890101,890400,299,RepeatMasker,LTR,890049,890608,299,1.00
ptg009367l,906791,907098,307,RepeatMasker,LTR,906764,906842,51,0.17
ptg009373l,288812,289119,307,RepeatMasker,LTR,286441,291934,307,1.00
ptg009373l,1975537,1975816,279,RepeatMasker,LTR,1975636,1975689,54,0.19
ptg009375l,1362678,1362977,299,RepeatMasker,LTR,1362626,1363154,299,1.00
ptg009378l,2187395,2187708,313,RepeatMasker,LTR,2187359,2187495,100,0.32
ptg009378l,2188303,2188616,313,RepeatMasker,LTR,2188170,2188482,179,0.57
ptg009384l,22663,22975,312,RepeatMasker,LTR,22616,22750,87,0.28
ptg009385l,542768,543051,283,RepeatMasker,LTR,541968,544107,283,1.00
ptg009385l,559827,560108,281,RepeatMasker,LTR,559182,561252,281,1.00
ptg009385l,1351117,1351433,316,RepeatMasker,LTR,1350493,1351822,316,1.00
ptg009387l,4544266,4544565,299,RepeatMasker,LTR,4544214,4544739,299,1.00
ptg009387l,4550349,4550641,292,RepeatMasker,LTR,4549125,4550983,292,1.00
ptg009389l,442466,442761,295,RepeatMasker,LTR,442466,443509,295,1.00
ptg009389l,442466,442761,295,RepeatMasker,LTR,442247,442474,8,0.03
ptg009391l,244554,244846,292,RepeatMasker,LTR,243854,245212,292,1.00
ptg009391l,767112,767411,299,RepeatMasker,LTR,767060,767604,299,1.00
ptg009396l,47595,47892,297,RepeatMasker,LTR,46948,48258,297,1.00
ptg009399l,272304,272595,291,RepeatMasker,LTR,272373,272635,223,0.77
ptg009399l,272304,272595,291,RepeatMasker,LTR,272516,272645,80,0.27
ptg009413l,310733,311041,308,RepeatMasker,LTR,311004,311566,38,0.12
ptg009413l,1414362,1414643,281,RepeatMasker,LTR,1413625,1415264,281,1.00
ptg009414l,302759,303039,280,RepeatMasker,LTR,301958,303421,280,1.00
ptg009414l,325424,325705,281,RepeatMasker,LTR,324778,326086,281,1.00
ptg009420l,904206,904454,248,RepeatMasker,LTR,899155,906150,248,1.00
ptg009421l,812727,813045,318,RepeatMasker,LTR,812925,813251,121,0.38
ptg009421l,1208102,1208379,277,RepeatMasker,LTR,1207310,1208768,277,1.00
ptg009423l,260557,260834,277,RepeatMasker,LTR,260811,260855,24,0.09
ptg009423l,269568,269879,311,RepeatMasker,LTR,269733,269912,147,0.47
ptg009430l,129827,130119,292,RepeatMasker,LTR,130061,130727,59,0.20
ptg009433l,3113287,3113601,314,RepeatMasker,LTR,3112167,3113451,164,0.52
ptg009439l,759991,760301,310,RepeatMasker,LTR,759771,760082,91,0.29
ptg009440l,818148,818468,320,RepeatMasker,LTR,817007,820197,320,1.00
ptg009440l,876586,876873,287,RepeatMasker,LTR,875686,878443,287,1.00
ptg009441l,672100,672376,276,RepeatMasker,LTR,672353,672413,24,0.09
ptg009443l,208599,208897,298,RepeatMasker,LTR,207393,208631,32,0.11
ptg009449l,1096878,1097183,305,RepeatMasker,LTR,1095782,1097041,163,0.53
ptg009449l,1096878,1097183,305,RepeatMasker,LTR,1097111,1097186,73,0.24
ptg009452l,99694,99993,299,RepeatMasker,LTR,99650,99968,274,0.92
ptg009452l,268166,268459,293,RepeatMasker,LTR,268114,268623,293,1.00
ptg009452l,572233,572513,280,RepeatMasker,LTR,572220,572529,280,1.00
ptg009465l,246851,247149,298,RepeatMasker,LTR,246799,247327,298,1.00
ptg009465l,1035820,1036113,293,RepeatMasker,LTR,1035768,1036291,293,1.00
ptg009477l,553322,553597,275,RepeatMasker,LTR,552422,554339,275,1.00
ptg009480l,54955,55239,284,RepeatMasker,LTR,55161,55299,79,0.28
ptg009481l,594979,595278,299,RepeatMasker,LTR,594945,595298,299,1.00
ptg009492l,1105800,1106091,291,RepeatMasker,LTR,1105748,1106269,291,1.00
ptg009492l,1117133,1117432,299,RepeatMasker,LTR,1117081,1117610,299,1.00
ptg009501l,63757,64039,282,RepeatMasker,LTR,63942,64519,98,0.35
ptg009501l,195825,196129,304,RepeatMasker,LTR,195107,196596,304,1.00
ptg009504l,1177135,1177447,312,RepeatMasker,LTR,1172691,1177241,106,0.34
ptg009513l,323170,323488,318,RepeatMasker,LTR,322709,323219,49,0.15
ptg009516l,3365906,3366195,289,RepeatMasker,LTR,3365854,3366398,289,1.00
ptg009516l,3695271,3695570,299,RepeatMasker,LTR,3695219,3695611,299,1.00
ptg009516l,4157357,4157656,299,RepeatMasker,LTR,4157305,4157834,299,1.00
ptg009516l,4502072,4502367,295,RepeatMasker,LTR,4502020,4502447,295,1.00
ptg009516l,5412675,5412974,299,RepeatMasker,LTR,5412641,5413054,299,1.00
ptg009516l,6033905,6034204,299,RepeatMasker,LTR,6033853,6034284,299,1.00
ptg009516l,6389718,6390017,299,RepeatMasker,LTR,6389666,6390221,299,1.00
ptg009527l,1569159,1569457,298,RepeatMasker,LTR,1568939,1569166,7,0.02
ptg009528l,1186341,1186640,299,RepeatMasker,LTR,1186307,1186720,299,1.00
ptg009533l,1172444,1172755,311,RepeatMasker,LTR,1171666,1173762,311,1.00
ptg009535l,2656919,2657245,326,RepeatMasker,LTR,2656834,2656921,2,0.01
ptg009535l,2656919,2657245,326,RepeatMasker,LTR,2657097,2657135,39,0.12
ptg009542l,1555817,1556097,280,RepeatMasker,LTR,1555167,1556479,280,1.00
ptg009544l,274776,275074,298,RepeatMasker,LTR,274743,276195,298,1.00
ptg009544l,281962,282244,282,RepeatMasker,LTR,281162,283326,282,1.00
ptg009546l,1383228,1383525,297,RepeatMasker,LTR,1383176,1383704,297,1.00
ptg009546l,1392259,1392556,297,RepeatMasker,LTR,1392207,1392734,297,1.00
ptg009546l,1723732,1724033,301,RepeatMasker,LTR,1723680,1724241,301,1.00
ptg009546l,1947641,1947919,278,RepeatMasker,LTR,1947530,1947783,142,0.51
ptg009546l,2021569,2021867,298,RepeatMasker,LTR,2021517,2022088,298,1.00
ptg009552l,67223,67503,280,RepeatMasker,LTR,66423,67885,280,1.00
ptg009552l,674036,674321,285,RepeatMasker,LTR,672178,674890,285,1.00
ptg009555l,188589,188893,304,RepeatMasker,LTR,188555,188611,22,0.07
ptg009559l,28313,28603,290,RepeatMasker,LTR,27994,29333,290,1.00
ptg009559l,315468,315767,299,RepeatMasker,LTR,315434,315787,299,1.00
ptg009561l,237006,237297,291,RepeatMasker,LTR,236357,237056,50,0.17
ptg009568l,1655200,1655474,274,RepeatMasker,LTR,1655101,1655221,21,0.08
ptg009568l,1655200,1655474,274,RepeatMasker,LTR,1655197,1655383,183,0.67
ptg009568l,1655200,1655474,274,RepeatMasker,LTR,1655459,1656835,16,0.06
ptg009568l,2448353,2448666,313,RepeatMasker,LTR,2448265,2450348,313,1.00
ptg009570l,11025,11306,281,RepeatMasker,LTR,11012,11318,281,1.00
ptg009570l,21024,21305,281,RepeatMasker,LTR,21011,21615,281,1.00
ptg009573l,1024849,1025129,280,RepeatMasker,LTR,1024836,1026187,280,1.00
ptg009582l,1209974,1210298,324,RepeatMasker,LTR,1209631,1210590,324,1.00
ptg009586l,1356457,1356744,287,RepeatMasker,LTR,1355557,1358315,287,1.00
ptg009586l,2154652,2154922,270,RepeatMasker,LTR,2148310,2154814,162,0.60
ptg009588l,1703287,1703604,317,RepeatMasker,LTR,1702664,1703834,317,1.00
ptg009590l,362661,362961,300,RepeatMasker,LTR,359346,362689,28,0.09
ptg009591l,2276944,2277224,280,RepeatMasker,LTR,2276307,2277613,280,1.00
ptg009591l,2284347,2284627,280,RepeatMasker,LTR,2283555,2285009,280,1.00
ptg009599l,199536,199825,289,RepeatMasker,LTR,199801,200719,25,0.09
ptg009621l,622652,622946,294,RepeatMasker,LTR,622005,624067,294,1.00
ptg009621l,629838,630119,281,RepeatMasker,LTR,629038,631143,281,1.00
ptg009622l,288206,288529,323,RepeatMasker,LTR,288378,288411,34,0.11
ptg009631l,60715,61021,306,RepeatMasker,LTR,60997,61041,25,0.08
ptg009632l,769546,769811,265,RepeatMasker,LTR,769026,769873,265,1.00
ptg009632l,1156624,1156925,301,RepeatMasker,LTR,1155752,1157843,301,1.00
ptg009638l,670140,670444,304,RepeatMasker,LTR,670045,670384,244,0.80
ptg009643l,2705370,2705670,300,RepeatMasker,LTR,2705318,2705880,300,1.00
ptg009646l,785319,785618,299,RepeatMasker,LTR,785267,785813,299,1.00
ptg009652l,2146690,2146988,298,RepeatMasker,LTR,2146638,2147183,298,1.00
ptg009660l,164007,164336,329,RepeatMasker,LTR,163555,166100,329,1.00
ptg009660l,1635930,1636217,287,RepeatMasker,LTR,1635494,1640821,287,1.00
ptg009662l,178469,178795,326,RepeatMasker,LTR,178518,178602,85,0.26
ptg009664l,3687138,3687441,303,RepeatMasker,LTR,3686944,3687438,300,0.99
ptg009665l,1157617,1157934,317,RepeatMasker,LTR,1157854,1158448,81,0.26
ptg009671l,1771773,1772054,281,RepeatMasker,LTR,1770972,1772450,281,1.00
ptg009674l,668040,668351,311,RepeatMasker,LTR,668303,668494,49,0.16
ptg009674l,671767,672083,316,RepeatMasker,LTR,670156,672039,272,0.86
ptg009675l,1232985,1233246,261,RepeatMasker,LTR,1227935,1237459,261,1.00
ptg009675l,1281509,1281796,287,RepeatMasker,LTR,1280608,1283366,287,1.00
ptg009681l,268573,268879,306,RepeatMasker,LTR,265989,275497,306,1.00
ptg009682l,1018646,1018952,306,RepeatMasker,LTR,1018002,1019321,306,1.00
ptg009692l,750263,750565,302,RepeatMasker,LTR,748693,751320,302,1.00
ptg009693l,641285,641582,297,RepeatMasker,LTR,641233,641790,297,1.00
ptg009693l,806162,806449,287,RepeatMasker,LTR,806110,806630,287,1.00
ptg009693l,1862265,1862562,297,RepeatMasker,LTR,1862213,1862642,297,1.00
ptg009700l,1228078,1228358,280,RepeatMasker,LTR,1227439,1229492,280,1.00
ptg009700l,1256754,1257036,282,RepeatMasker,LTR,1255970,1258094,282,1.00
ptg009700l,1257085,1257383,298,RepeatMasker,LTR,1255970,1258094,298,1.00
ptg009701l,1214305,1214586,281,RepeatMasker,LTR,1213502,1214978,281,1.00
ptg009719l,1510078,1510359,281,RepeatMasker,LTR,1509434,1510763,281,1.00
ptg009720l,735363,735644,281,RepeatMasker,LTR,735350,735955,281,1.00
ptg009732l,215072,215367,295,RepeatMasker,LTR,215020,215560,295,1.00
ptg009732l,572538,572821,283,RepeatMasker,LTR,571126,574758,283,1.00
ptg009732l,617068,617397,329,RepeatMasker,LTR,616859,617075,7,0.02
ptg009735l,10311,10635,324,RepeatMasker,LTR,10368,10411,44,0.14
ptg009744l,1037486,1037766,280,RepeatMasker,LTR,1037473,1038816,280,1.00
ptg009754l,525351,525643,292,RepeatMasker,LTR,523013,526043,292,1.00
ptg009758l,185960,186255,295,RepeatMasker,LTR,185908,186432,295,1.00
ptg009758l,239984,240283,299,RepeatMasker,LTR,239932,240459,299,1.00
ptg009758l,2104089,2104388,299,RepeatMasker,LTR,2104037,2104566,299,1.00
ptg009758l,2120042,2120342,300,RepeatMasker,LTR,2119990,2120542,300,1.00
ptg009758l,2146007,2146306,299,RepeatMasker,LTR,2145955,2146461,299,1.00
ptg009761l,209330,209610,280,RepeatMasker,LTR,208684,210001,280,1.00
ptg009761l,216953,217233,280,RepeatMasker,LTR,216152,217652,280,1.00
ptg009762l,1420662,1420959,297,RepeatMasker,LTR,1420367,1422100,297,1.00
ptg009766l,1086043,1086343,300,RepeatMasker,LTR,1085991,1086572,300,1.00
ptg009772l,1804132,1804415,283,RepeatMasker,LTR,1804120,1804795,283,1.00
ptg009774l,1255047,1255339,292,RepeatMasker,LTR,1252214,1255705,292,1.00
ptg009774l,1635805,1636089,284,RepeatMasker,LTR,1635893,1636991,197,0.69
ptg009779l,1065481,1065786,305,RepeatMasker,LTR,1064321,1065692,211,0.69
ptg009782l,1042179,1042459,280,RepeatMasker,LTR,1042147,1042841,280,1.00
ptg009785l,368554,368851,297,RepeatMasker,LTR,368541,369240,297,1.00
ptg009785l,851327,851614,287,RepeatMasker,LTR,851343,851939,272,0.95
ptg009785l,851327,851614,287,RepeatMasker,LTR,851348,852644,267,0.93
ptg009791l,1013617,1013907,290,RepeatMasker,LTR,1011184,1014822,290,1.00
ptg009798l,110815,111100,285,RepeatMasker,LTR,109850,110835,20,0.07
ptg009801l,107650,107936,286,RepeatMasker,LTR,106793,110817,286,1.00
ptg009804l,1355836,1356121,285,RepeatMasker,LTR,1356061,1356111,51,0.18
ptg009816l,797114,797397,283,RepeatMasker,LTR,797374,797418,24,0.08
ptg009818l,317401,317681,280,RepeatMasker,LTR,317389,317762,280,1.00
ptg009818l,317401,317681,280,RepeatMasker,LTR,317390,317842,280,1.00
ptg009837l,1359447,1359768,321,RepeatMasker,LTR,1359365,1359820,321,1.00
ptg009839l,2301193,2301479,286,RepeatMasker,LTR,2295062,2301878,286,1.00
ptg009840l,808098,808371,273,RepeatMasker,LTR,807542,808526,273,1.00
ptg009854l,570874,571173,299,RepeatMasker,LTR,570822,571197,299,1.00
ptg009854l,2840767,2841044,277,RepeatMasker,LTR,2840645,2841105,277,1.00
ptg009854l,2840767,2841044,277,RepeatMasker,LTR,2840777,2844474,268,0.97
ptg009855l,3510891,3511193,302,RepeatMasker,LTR,3509321,3511946,302,1.00
ptg009863l,108447,108742,295,RepeatMasker,LTR,108109,108520,73,0.25
ptg009863l,108447,108742,295,RepeatMasker,LTR,108163,108524,77,0.26
ptg009873l,655938,656237,299,RepeatMasker,LTR,655886,656278,299,1.00
ptg009873l,709049,709348,299,RepeatMasker,LTR,708997,709556,299,1.00
ptg009881l,1174834,1175140,306,RepeatMasker,LTR,1175021,1176159,120,0.39
ptg009883l,449257,449537,280,RepeatMasker,LTR,448456,449605,280,1.00
ptg009886l,703835,704134,299,RepeatMasker,LTR,703780,704342,299,1.00
ptg009887l,217625,217945,320,RepeatMasker,LTR,212823,217675,50,0.16
ptg009889l,1409943,1410264,321,RepeatMasker,LTR,1409634,1410105,162,0.50
ptg009898l,651852,652181,329,RepeatMasker,LTR,652074,652108,35,0.11
ptg009899l,232191,232493,302,RepeatMasker,LTR,230621,233242,302,1.00
ptg009899l,232191,232493,302,RepeatMasker,LTR,230940,232272,81,0.27
ptg009907l,1351423,1351709,286,RepeatMasker,LTR,1350923,1356345,286,1.00
ptg009913l,98037,98316,279,RepeatMasker,LTR,97388,98706,279,1.00
ptg009915l,1067871,1068170,299,RepeatMasker,LTR,1067819,1068211,299,1.00
ptg009919l,1217654,1217954,300,RepeatMasker,LTR,1217712,1219015,243,0.81
ptg009920l,196290,196538,248,RepeatMasker,LTR,192618,196868,248,1.00
ptg009928l,689254,689562,308,RepeatMasker,LTR,689056,689779,308,1.00
ptg009929l,439159,439465,306,RepeatMasker,LTR,437901,440480,306,1.00
ptg009941l,124018,124313,295,RepeatMasker,LTR,123966,124478,295,1.00
ptg009945l,1835743,1836056,313,RepeatMasker,LTR,1834244,1837367,313,1.00
ptg009946l,1252350,1252680,330,RepeatMasker,LTR,1248662,1254928,330,1.00
ptg009948l,303690,303973,283,RepeatMasker,LTR,303677,305033,283,1.00
ptg009948l,741388,741720,332,RepeatMasker,LTR,740606,741670,282,0.85
ptg009948l,2005358,2005680,322,RepeatMasker,LTR,2004819,2006075,322,1.00
ptg009948l,2005358,2005680,322,RepeatMasker,LTR,2004819,2006306,322,1.00
ptg009952l,163378,163673,295,RepeatMasker,LTR,163326,163838,295,1.00
ptg009959l,1005593,1005902,309,RepeatMasker,LTR,1004497,1005756,163,0.53
ptg009961l,674805,675107,302,RepeatMasker,LTR,674818,675263,290,0.96
ptg009961l,1961343,1961635,292,RepeatMasker,LTR,1961291,1961718,292,1.00
ptg009961l,2438665,2438964,299,RepeatMasker,LTR,2438613,2438984,299,1.00
ptg009984l,293072,293374,302,RepeatMasker,LTR,291499,293204,132,0.44
ptg009984l,293072,293374,302,RepeatMasker,LTR,291821,293204,132,0.44
ptg009988l,1010914,1011198,284,RepeatMasker,LTR,1008086,1011566,284,1.00
ptg009993l,436752,437039,287,RepeatMasker,LTR,436869,436957,89,0.31
ptg010002l,1293091,1293390,299,RepeatMasker,LTR,1292718,1293643,299,1.00
ptg010010l,988459,988773,314,RepeatMasker,LTR,987812,988508,49,0.16
ptg010010l,988459,988773,314,RepeatMasker,LTR,988609,989406,165,0.53
ptg010010l,988459,988773,314,RepeatMasker,LTR,988643,989056,131,0.42
ptg010012l,91614,91895,281,RepeatMasker,LTR,91581,92270,281,1.00
ptg010012l,142242,142523,281,RepeatMasker,LTR,142229,142930,281,1.00
ptg010028l,886460,886757,297,RepeatMasker,LTR,886643,886947,115,0.39
ptg010035l,37047,37356,309,RepeatMasker,LTR,37071,37423,286,0.93
ptg010035l,37047,37356,309,RepeatMasker,LTR,37071,37744,286,0.93
ptg010036l,97643,97924,281,RepeatMasker,LTR,93326,99607,281,1.00
ptg010036l,208522,208816,294,RepeatMasker,LTR,207698,209220,294,1.00
ptg010043l,550129,550441,312,RepeatMasker,LTR,550392,550429,38,0.12
ptg010046l,1130841,1131150,309,RepeatMasker,LTR,1128187,1130871,30,0.10
ptg010049l,546278,546575,297,RepeatMasker,LTR,546266,546956,297,1.00
ptg010050l,85558,85877,319,RepeatMasker,LTR,84950,86284,319,1.00
ptg010050l,85558,85877,319,RepeatMasker,LTR,85474,86494,319,1.00
ptg010063l,2932662,2932961,299,RepeatMasker,LTR,2932610,2933041,299,1.00
ptg010063l,3129704,3130024,320,RepeatMasker,LTR,3129908,3129982,75,0.23
ptg010063l,3129704,3130024,320,RepeatMasker,LTR,3129978,3130907,47,0.15
ptg010065l,715051,715341,290,RepeatMasker,LTR,715090,716212,252,0.87
ptg010067l,403214,403529,315,RepeatMasker,LTR,402283,405031,315,1.00
ptg010068l,681072,681371,299,RepeatMasker,LTR,681020,681451,299,1.00
ptg010072l,698859,699145,286,RepeatMasker,LTR,698977,701465,169,0.59
ptg010075l,1314939,1315231,292,RepeatMasker,LTR,1312112,1315573,292,1.00
ptg010080l,488103,488388,285,RepeatMasker,LTR,487765,488265,162,0.57
ptg010084l,831835,832119,284,RepeatMasker,LTR,831327,832920,284,1.00
ptg010086l,687483,687796,313,RepeatMasker,LTR,687314,687537,54,0.17
ptg010088l,306848,307146,298,RepeatMasker,LTR,306815,307543,298,1.00
ptg010088l,506958,507270,312,RepeatMasker,LTR,506837,506970,12,0.04
ptg010088l,506958,507270,312,RepeatMasker,LTR,506976,507050,75,0.24
ptg010088l,5282132,5282427,295,RepeatMasker,LTR,5282012,5282194,62,0.21
ptg010091l,845517,845788,271,RepeatMasker,LTR,839594,845860,271,1.00
ptg010091l,845517,845788,271,RepeatMasker,LTR,845679,846691,110,0.41
ptg010091l,984989,985284,295,RepeatMasker,LTR,984976,986350,295,1.00
ptg010091l,1172905,1173186,281,RepeatMasker,LTR,1172892,1173568,281,1.00
ptg010095l,214122,214431,309,RepeatMasker,LTR,214373,215558,59,0.19
ptg010116l,31071,31401,330,RepeatMasker,LTR,29942,31235,164,0.50
ptg010129l,1254801,1255087,286,RepeatMasker,LTR,1253950,1259449,286,1.00
ptg010129l,4309905,4310210,305,RepeatMasker,LTR,4309299,4309937,32,0.10
ptg010130l,1210004,1210328,324,RepeatMasker,LTR,1210152,1210196,45,0.14
ptg010138l,1204636,1204930,294,RepeatMasker,LTR,1204244,1204646,10,0.03
ptg010140l,648944,649266,322,RepeatMasker,LTR,649078,649333,189,0.59
ptg010141l,1732436,1732729,293,RepeatMasker,LTR,1732413,1733098,293,1.00
ptg010141l,1732436,1732729,293,RepeatMasker,LTR,1732423,1733027,293,1.00
ptg010145l,874600,874896,296,RepeatMasker,LTR,874279,874858,258,0.87
ptg010172l,438440,438746,306,RepeatMasker,LTR,437143,442254,306,1.00
ptg010182l,763257,763554,297,RepeatMasker,LTR,763205,763732,297,1.00
ptg010191l,1829633,1829932,299,RepeatMasker,LTR,1829581,1830110,299,1.00
ptg010194l,1631109,1631404,295,RepeatMasker,LTR,1631075,1631424,295,1.00
ptg010201l,2382325,2382604,279,RepeatMasker,LTR,2382041,2382493,168,0.60
ptg010201l,2382325,2382604,279,RepeatMasker,LTR,2382490,2382659,115,0.41
ptg010201l,2598093,2598375,282,RepeatMasker,LTR,2598352,2598396,24,0.09
ptg010213l,1484239,1484533,294,RepeatMasker,LTR,1484461,1485332,73,0.25
ptg010231l,3515875,3516189,314,RepeatMasker,LTR,3513539,3516135,260,0.83
ptg010234l,315588,315886,298,RepeatMasker,LTR,314787,316207,298,1.00
ptg010239l,125176,125475,299,RepeatMasker,LTR,125124,125652,299,1.00
ptg010240l,1081629,1081935,306,RepeatMasker,LTR,1081596,1082321,306,1.00
ptg010244l,182332,182619,287,RepeatMasker,LTR,181484,182828,287,1.00
ptg010249l,649674,649980,306,RepeatMasker,LTR,648492,652051,306,1.00
ptg010251l,1358674,1358966,292,RepeatMasker,LTR,1355843,1359308,292,1.00
ptg010251l,4257485,4257798,313,RepeatMasker,LTR,4256997,4258680,313,1.00
ptg010252l,27715,28003,288,RepeatMasker,LTR,27802,28611,202,0.70
ptg010256l,253875,254185,310,RepeatMasker,LTR,254093,254643,93,0.30
ptg010261l,682008,682318,310,RepeatMasker,LTR,679706,682080,72,0.23
ptg010261l,682008,682318,310,RepeatMasker,LTR,682188,683516,131,0.42
ptg010262l,23669,23965,296,RepeatMasker,LTR,22863,24331,296,1.00
ptg010266l,87105,87385,280,RepeatMasker,LTR,87092,88515,280,1.00
ptg010266l,94299,94580,281,RepeatMasker,LTR,94286,95713,281,1.00
ptg010266l,101422,101703,281,RepeatMasker,LTR,100782,102828,281,1.00
ptg010266l,104932,105213,281,RepeatMasker,LTR,104919,106345,281,1.00
ptg010289l,712780,713066,286,RepeatMasker,LTR,709809,715115,286,1.00
ptg010290l,94711,94962,251,RepeatMasker,LTR,94645,94776,65,0.26
ptg010291l,110770,111079,309,RepeatMasker,LTR,110561,110776,6,0.02
ptg010297l,509306,509609,303,RepeatMasker,LTR,509524,509640,86,0.28
ptg010297l,1788697,1788976,279,RepeatMasker,LTR,1786076,1789695,279,1.00
ptg010297l,1788697,1788976,279,RepeatMasker,LTR,1787740,1795433,279,1.00
ptg010299l,150324,150617,293,RepeatMasker,LTR,150272,150795,293,1.00
ptg010304l,580074,580354,280,RepeatMasker,LTR,579271,580736,280,1.00
ptg010311l,361683,361996,313,RepeatMasker,LTR,360881,362346,313,1.00
ptg010311l,724577,724880,303,RepeatMasker,LTR,724705,724795,91,0.30
ptg010325l,1340930,1341229,299,RepeatMasker,LTR,1340883,1341309,299,1.00
ptg010325l,3629807,3630104,297,RepeatMasker,LTR,3629755,3630313,297,1.00
ptg010330l,519296,519618,322,RepeatMasker,LTR,519594,520087,25,0.08
ptg010336l,744016,744289,273,RepeatMasker,LTR,742901,744180,164,0.60
ptg010336l,1550912,1551201,289,RepeatMasker,LTR,1550958,1551327,244,0.84
ptg010340l,1026823,1027104,281,RepeatMasker,LTR,1026023,1027190,281,1.00
ptg010340l,1026823,1027104,281,RepeatMasker,LTR,1026023,1027424,281,1.00
ptg010340l,1724287,1724567,280,RepeatMasker,LTR,1724274,1725199,280,1.00
ptg010354l,561979,562260,281,RepeatMasker,LTR,562157,562392,104,0.37
ptg010363l,992585,992881,296,RepeatMasker,LTR,992533,993059,296,1.00
ptg010363l,1018101,1018349,248,RepeatMasker,LTR,1014895,1022549,248,1.00
ptg010364l,52726,53025,299,RepeatMasker,LTR,52674,53105,299,1.00
ptg010380l,3875903,3876198,295,RepeatMasker,LTR,3875257,3876586,295,1.00
ptg010382l,29165,29465,300,RepeatMasker,LTR,28370,29240,75,0.25
ptg010382l,1086469,1086768,299,RepeatMasker,LTR,1086419,1086848,299,1.00
ptg010382l,1699576,1699875,299,RepeatMasker,LTR,1699524,1699955,299,1.00
ptg010382l,3948954,3949252,298,RepeatMasker,LTR,3948902,3949250,296,0.99
ptg010384l,53791,54071,280,RepeatMasker,LTR,53752,54453,280,1.00
ptg010388l,841086,841385,299,RepeatMasker,LTR,841034,841582,299,1.00
ptg010395l,11254,11534,280,RepeatMasker,LTR,11488,13190,47,0.17
ptg010398l,1987214,1987509,295,RepeatMasker,LTR,1987162,1987589,295,1.00
ptg010398l,1996647,1996946,299,RepeatMasker,LTR,1996595,1997141,299,1.00
ptg010398l,2041776,2042071,295,RepeatMasker,LTR,2041724,2042266,295,1.00
ptg010404l,126706,126992,286,RepeatMasker,LTR,125844,130076,286,1.00
ptg010406l,322542,322827,285,RepeatMasker,LTR,322325,322550,8,0.03
ptg010408l,199887,200168,281,RepeatMasker,LTR,199086,200550,281,1.00
ptg010419l,90568,90865,297,RepeatMasker,LTR,90516,91060,297,1.00
ptg010421l,851642,851941,299,RepeatMasker,LTR,851599,853367,299,1.00
ptg010426l,412797,413078,281,RepeatMasker,LTR,412133,413093,281,1.00
ptg010426l,419983,420266,283,RepeatMasker,LTR,419184,420639,283,1.00
ptg010427l,1682594,1682899,305,RepeatMasker,LTR,1679395,1682695,101,0.33
ptg010427l,1682594,1682899,305,RepeatMasker,LTR,1680696,1688141,305,1.00
ptg010435l,97472,97768,296,RepeatMasker,LTR,97390,97506,34,0.11
ptg010435l,97472,97768,296,RepeatMasker,LTR,97437,97533,61,0.21
ptg010438l,2514503,2514783,280,RepeatMasker,LTR,2513867,2515847,280,1.00
ptg010460l,325635,325932,297,RepeatMasker,LTR,325299,325801,166,0.56
ptg010460l,2937776,2938043,267,RepeatMasker,LTR,2937898,2938851,146,0.55
ptg010460l,4890141,4890441,300,RepeatMasker,LTR,4889739,4890706,300,1.00
ptg010464l,3080073,3080372,299,RepeatMasker,LTR,3080021,3080565,299,1.00
ptg010464l,4754293,4754613,320,RepeatMasker,LTR,4754414,4754699,200,0.63
ptg010466l,543393,543697,304,RepeatMasker,LTR,543270,543500,107,0.35
ptg010469l,683461,683760,299,RepeatMasker,LTR,683409,683954,299,1.00
ptg010473l,1232459,1232763,304,RepeatMasker,LTR,1232011,1233086,304,1.00
ptg010478l,619667,619954,287,RepeatMasker,LTR,619422,624683,287,1.00
ptg010478l,1215674,1215947,273,RepeatMasker,LTR,1215886,1216042,62,0.23
ptg010478l,2387101,2387388,287,RepeatMasker,LTR,2387135,2387230,96,0.33
ptg010484l,564496,564795,299,RepeatMasker,LTR,564444,564815,299,1.00
ptg010484l,1980836,1981135,299,RepeatMasker,LTR,1980784,1981313,299,1.00
ptg010493l,1146888,1147169,281,RepeatMasker,LTR,1146243,1147551,281,1.00
ptg010504l,284422,284703,281,RepeatMasker,LTR,284389,285761,281,1.00
ptg010512l,705515,705788,273,RepeatMasker,LTR,705746,705790,43,0.16
ptg010513l,400927,401207,280,RepeatMasker,LTR,400283,402345,280,1.00
ptg010518l,1911572,1911872,300,RepeatMasker,LTR,1911042,1912949,300,1.00
ptg010519l,260060,260331,271,RepeatMasker,LTR,259722,260222,162,0.60
ptg010523l,56347,56489,142,RepeatMasker,LTR,53584,56502,142,1.00
ptg010523l,56347,56489,142,RepeatMasker,LTR,56487,58109,3,0.02
ptg010530l,250313,250600,287,RepeatMasker,LTR,249471,252170,287,1.00
ptg010545l,150421,150701,280,RepeatMasker,LTR,149800,150909,280,1.00
ptg010545l,164244,164524,280,RepeatMasker,LTR,163699,164879,280,1.00
ptg010545l,504608,504940,332,RepeatMasker,LTR,504843,506308,98,0.30
ptg010545l,943734,944035,301,RepeatMasker,LTR,943483,944067,301,1.00
ptg010552l,970420,970701,281,RepeatMasker,LTR,970362,970517,97,0.35
ptg010563l,538172,538474,302,RepeatMasker,LTR,538215,538295,81,0.27
ptg010563l,538172,538474,302,RepeatMasker,LTR,538242,538308,67,0.22
ptg010573l,2506041,2506336,295,RepeatMasker,LTR,2505989,2506063,22,0.07
ptg010573l,2506041,2506336,295,RepeatMasker,LTR,2506084,2506469,253,0.86
ptg010574l,2290214,2290493,279,RepeatMasker,LTR,2289919,2290730,279,1.00
ptg010585l,1523551,1523842,291,RepeatMasker,LTR,1523499,1524020,291,1.00
ptg010594l,557347,557628,281,RepeatMasker,LTR,556703,558014,281,1.00
ptg010594l,1815145,1815443,298,RepeatMasker,LTR,1814743,1816111,298,1.00
ptg010597l,543479,543759,280,RepeatMasker,LTR,543460,544141,280,1.00
ptg010613l,2809376,2809697,321,RepeatMasker,LTR,2809383,2809452,70,0.22
ptg010619l,1428621,1428901,280,RepeatMasker,LTR,1427864,1429370,280,1.00
ptg010619l,1428621,1428901,280,RepeatMasker,LTR,1428582,1430162,280,1.00
ptg010620l,507041,507323,282,RepeatMasker,LTR,506410,508370,282,1.00
ptg010625l,2571014,2571313,299,RepeatMasker,LTR,2570962,2571491,299,1.00
ptg010627l,2409006,2409313,307,RepeatMasker,LTR,2408979,2409031,25,0.08
ptg010627l,2409006,2409313,307,RepeatMasker,LTR,2408995,2409060,54,0.18
ptg010628l,158967,159266,299,RepeatMasker,LTR,158915,159307,299,1.00
ptg010630l,841532,841807,275,RepeatMasker,LTR,841729,841892,79,0.29
ptg010630l,906536,906836,300,RepeatMasker,LTR,906484,907048,300,1.00
ptg010646l,627494,627774,280,RepeatMasker,LTR,626848,628166,280,1.00
ptg010647l,1319849,1320177,328,RepeatMasker,LTR,1319760,1319895,46,0.14
ptg010648l,1273247,1273528,281,RepeatMasker,LTR,1272446,1273910,281,1.00
ptg010651l,205238,205558,320,RepeatMasker,LTR,204401,205288,50,0.16
ptg010651l,245786,246085,299,RepeatMasker,LTR,245734,246165,299,1.00
ptg010655l,633292,633590,298,RepeatMasker,LTR,633590,633698,1,0.00
ptg010659l,2226539,2226820,281,RepeatMasker,LTR,2225894,2227201,281,1.00
ptg010660l,223733,224038,305,RepeatMasker,LTR,222336,224008,275,0.90
ptg010665l,3036681,3036979,298,RepeatMasker,LTR,3036629,3037175,298,1.00
ptg010672l,223345,223626,281,RepeatMasker,LTR,222707,224671,281,1.00
ptg010674l,343928,344237,309,RepeatMasker,LTR,343453,343968,40,0.13
ptg010674l,343928,344237,309,RepeatMasker,LTR,344174,344697,64,0.21
ptg010675l,388859,389159,300,RepeatMasker,LTR,388807,389361,300,1.00
ptg010676l,1088667,1088944,277,RepeatMasker,LTR,1088644,1090076,277,1.00
ptg010676l,1103609,1103890,281,RepeatMasker,LTR,1103586,1104938,281,1.00
ptg010681l,671908,672201,293,RepeatMasker,LTR,671856,672378,293,1.00
ptg010681l,739520,739816,296,RepeatMasker,LTR,739468,739896,296,1.00
ptg010681l,1234686,1234967,281,RepeatMasker,LTR,1232103,1238021,281,1.00
ptg010684l,691065,691368,303,RepeatMasker,LTR,691237,691810,132,0.44
ptg010686l,560352,560646,294,RepeatMasker,LTR,557638,560382,30,0.10
ptg010687l,1218860,1219151,291,RepeatMasker,LTR,1218847,1219156,291,1.00
ptg010692l,134276,134572,296,RepeatMasker,LTR,133642,134938,296,1.00
ptg010697l,496515,496798,283,RepeatMasker,LTR,495857,498277,283,1.00
ptg010699l,2761227,2761506,279,RepeatMasker,LTR,2761389,2761475,87,0.31
ptg010706l,231218,231545,327,RepeatMasker,LTR,228189,231832,327,1.00
ptg010710l,41020,41315,295,RepeatMasker,LTR,40968,41395,295,1.00
ptg010712l,35597,35880,283,RepeatMasker,LTR,35487,35617,20,0.07
ptg010720l,3108821,3109102,281,RepeatMasker,LTR,3108187,3110237,281,1.00
ptg010728l,435053,435348,295,RepeatMasker,LTR,435006,435555,295,1.00
ptg010731l,565107,565416,309,RepeatMasker,LTR,562382,565137,30,0.10
ptg010733l,181602,181905,303,RepeatMasker,LTR,181517,182005,303,1.00
ptg010741l,3780733,3781031,298,RepeatMasker,LTR,3780918,3784145,114,0.38
ptg010749l,395789,396101,312,RepeatMasker,LTR,395327,399522,312,1.00
ptg010749l,633750,634071,321,RepeatMasker,LTR,633689,633753,3,0.01
ptg010751l,540097,540391,294,RepeatMasker,LTR,540045,540556,294,1.00
ptg010752l,393681,393976,295,RepeatMasker,LTR,393629,394184,295,1.00
ptg010752l,1184442,1184731,289,RepeatMasker,LTR,1184390,1184930,289,1.00
ptg010757l,38070,38367,297,RepeatMasker,LTR,38018,38559,297,1.00
ptg010757l,541881,542166,285,RepeatMasker,LTR,542165,542279,2,0.01
ptg010759l,944843,945168,325,RepeatMasker,LTR,944610,947682,325,1.00
ptg010764l,78457,78738,281,RepeatMasker,LTR,77812,79117,281,1.00
ptg010765l,590597,590894,297,RepeatMasker,LTR,590545,591072,297,1.00
ptg010769l,692142,692423,281,RepeatMasker,LTR,691497,692841,281,1.00
ptg010769l,699327,699625,298,RepeatMasker,LTR,698525,699990,298,1.00
ptg010771l,340571,340858,287,RepeatMasker,LTR,339735,345194,287,1.00
ptg010773l,1744132,1744437,305,RepeatMasker,LTR,1744233,1744655,205,0.67
ptg010773l,5067210,5067521,311,RepeatMasker,LTR,5067436,5067467,32,0.10
ptg010785l,537886,538134,248,RepeatMasker,LTR,532831,540327,248,1.00
ptg010819l,1683538,1683851,313,RepeatMasker,LTR,1683460,1683569,31,0.10
ptg010819l,1683538,1683851,313,RepeatMasker,LTR,1683811,1683875,41,0.13
ptg010822l,191243,191534,291,RepeatMasker,LTR,191191,191614,291,1.00
ptg010823l,977164,977483,319,RepeatMasker,LTR,977132,979358,319,1.00
ptg010826l,582265,582551,286,RepeatMasker,LTR,576115,582950,286,1.00
ptg010826l,2081254,2081550,296,RepeatMasker,LTR,2081109,2081519,265,0.90
ptg010830l,127019,127300,281,RepeatMasker,LTR,126243,127681,281,1.00
ptg010832l,1333758,1334042,284,RepeatMasker,LTR,1333813,1334308,230,0.81
ptg010832l,1333758,1334042,284,RepeatMasker,LTR,1333824,1334592,219,0.77
ptg010834l,587883,588164,281,RepeatMasker,LTR,587850,588557,281,1.00
ptg010837l,1584748,1585066,318,RepeatMasker,LTR,1585019,1585093,48,0.15
ptg010847l,1296235,1296516,281,RepeatMasker,LTR,1295433,1296898,281,1.00
ptg010851l,355255,355536,281,RepeatMasker,LTR,354617,356672,281,1.00
ptg010851l,426523,426854,331,RepeatMasker,LTR,425876,426823,300,0.91
ptg010861l,223334,223639,305,RepeatMasker,LTR,223603,224532,37,0.12
ptg010870l,465670,465986,316,RepeatMasker,LTR,463609,465832,162,0.51
ptg010876l,1157780,1158087,307,RepeatMasker,LTR,1156247,1157817,37,0.12
ptg010876l,1157780,1158087,307,RepeatMasker,LTR,1157745,1157826,46,0.15
ptg010876l,1157780,1158087,307,RepeatMasker,LTR,1157757,1157846,66,0.21
ptg010884l,1353727,1354012,285,RepeatMasker,LTR,1353389,1353889,162,0.57
ptg010899l,2349300,2349589,289,RepeatMasker,LTR,2349463,2349850,127,0.44
ptg010899l,2349300,2349589,289,RepeatMasker,LTR,2342434,2349488,188,0.65
ptg010899l,2364583,2364881,298,RepeatMasker,LTR,2364531,2364961,298,1.00
ptg010910l,1020109,1020389,280,RepeatMasker,LTR,1020097,1020771,280,1.00
ptg010910l,1027473,1027769,296,RepeatMasker,LTR,1027461,1028136,296,1.00
ptg010915l,528061,528342,281,RepeatMasker,LTR,528029,528735,281,1.00
ptg010915l,583962,584242,280,RepeatMasker,LTR,583327,584633,280,1.00
ptg010921l,80061,80361,300,RepeatMasker,LTR,79096,80096,35,0.12
ptg010922l,489938,490247,309,RepeatMasker,LTR,489622,490103,165,0.53
ptg010922l,489938,490247,309,RepeatMasker,LTR,489677,490104,166,0.54
ptg010923l,53207,53506,299,RepeatMasker,LTR,53160,53684,299,1.00
ptg010923l,126775,127073,298,RepeatMasker,LTR,126723,127115,298,1.00
ptg010929l,1114488,1114781,293,RepeatMasker,LTR,1113850,1115150,293,1.00
ptg010931l,1058173,1058466,293,RepeatMasker,LTR,1057536,1058470,293,1.00
ptg010931l,1058173,1058466,293,RepeatMasker,LTR,1058160,1059542,293,1.00
ptg010931l,1066738,1067042,304,RepeatMasker,LTR,1066725,1068094,304,1.00
ptg010934l,203276,203589,313,RepeatMasker,LTR,203259,203907,313,1.00
ptg010938l,3922145,3922424,279,RepeatMasker,LTR,3922093,3922350,205,0.73
ptg010938l,3922145,3922424,279,RepeatMasker,LTR,3922175,3922405,231,0.83
ptg010945l,489241,489534,293,RepeatMasker,LTR,489103,489670,293,1.00
ptg010945l,1117406,1117682,276,RepeatMasker,LTR,1117636,1118595,47,0.17
ptg010956l,2059403,2059698,295,RepeatMasker,LTR,2058800,2061734,295,1.00
ptg010962l,1869557,1869890,333,RepeatMasker,LTR,1868962,1869673,116,0.35
ptg010962l,1869557,1869890,333,RepeatMasker,LTR,1869223,1869673,116,0.35
ptg010968l,53160,53446,286,RepeatMasker,LTR,52304,55019,286,1.00
ptg010971l,247468,247749,281,RepeatMasker,LTR,246831,248925,281,1.00
ptg010980l,379467,379747,280,RepeatMasker,LTR,379454,380129,280,1.00
ptg010997l,586794,587100,306,RepeatMasker,LTR,586151,588155,306,1.00
ptg011010l,656008,656301,293,RepeatMasker,LTR,656076,656247,172,0.59
ptg011015l,1755960,1756261,301,RepeatMasker,LTR,1755948,1756641,301,1.00
ptg011028l,568257,568537,280,RepeatMasker,LTR,567619,569685,280,1.00
ptg011040l,1747424,1747729,305,RepeatMasker,LTR,1746316,1747589,165,0.54
ptg011042l,454720,455007,287,RepeatMasker,LTR,454717,454942,222,0.77
ptg011042l,454720,455007,287,RepeatMasker,LTR,454816,455506,192,0.67
ptg011053l,333829,334142,313,RepeatMasker,LTR,333836,334727,307,0.98
ptg011058l,467499,467811,312,RepeatMasker,LTR,466819,472243,312,1.00
ptg011068l,2428778,2429107,329,RepeatMasker,LTR,2426183,2428821,43,0.13
ptg011072l,1146693,1146998,305,RepeatMasker,LTR,1146089,1147027,305,1.00
ptg011080l,106227,106513,286,RepeatMasker,LTR,101403,106912,286,1.00
ptg011084l,311500,311780,280,RepeatMasker,LTR,311487,312953,280,1.00
ptg011085l,484461,484760,299,RepeatMasker,LTR,484736,485498,25,0.08
ptg011085l,484461,484760,299,RepeatMasker,LTR,484736,485871,25,0.08
ptg011089l,368587,368881,294,RepeatMasker,LTR,368535,369076,294,1.00
ptg011089l,507273,507571,298,RepeatMasker,LTR,507239,507651,298,1.00
ptg011092l,833221,833504,283,RepeatMasker,LTR,832932,833223,2,0.01
ptg011092l,833221,833504,283,RepeatMasker,LTR,832984,834925,283,1.00
ptg011092l,2238685,2238994,309,RepeatMasker,LTR,2238947,2238993,47,0.15
ptg011108l,455232,455552,320,RepeatMasker,LTR,454523,455282,50,0.16
ptg011109l,338527,338808,281,RepeatMasker,LTR,337731,339863,281,1.00
ptg011112l,1442312,1442611,299,RepeatMasker,LTR,1442260,1442793,299,1.00
ptg011136l,1312846,1313144,298,RepeatMasker,LTR,1310937,1313319,298,1.00
ptg011140l,482282,482563,281,RepeatMasker,LTR,482249,482954,281,1.00
ptg011145l,351881,352200,319,RepeatMasker,LTR,352101,352140,40,0.13
ptg011156l,730830,731105,275,RepeatMasker,LTR,730219,731490,275,1.00
ptg011156l,738221,738501,280,RepeatMasker,LTR,737429,738795,280,1.00
ptg011163l,2554018,2554316,298,RepeatMasker,LTR,2553985,2554520,298,1.00
ptg011178l,117287,117566,279,RepeatMasker,LTR,116656,117876,279,1.00
ptg011181l,301553,301802,249,RepeatMasker,LTR,301367,301626,73,0.29
ptg011183l,125071,125352,281,RepeatMasker,LTR,124434,125755,281,1.00
ptg011187l,299781,300071,290,RepeatMasker,LTR,294997,299815,34,0.12
ptg011205l,441688,441987,299,RepeatMasker,LTR,441636,442151,299,1.00
ptg011206l,120984,121283,299,RepeatMasker,LTR,120932,121363,299,1.00
ptg011211l,688562,688839,277,RepeatMasker,LTR,688022,689337,277,1.00
ptg011211l,726423,726752,329,RepeatMasker,LTR,726715,727624,38,0.12
ptg011222l,1566532,1566831,299,RepeatMasker,LTR,1566480,1566872,299,1.00
ptg011224l,388316,388606,290,RepeatMasker,LTR,387714,388639,290,1.00
ptg011231l,383777,384092,315,RepeatMasker,LTR,383541,383812,35,0.11
ptg011231l,383777,384092,315,RepeatMasker,LTR,383821,384588,272,0.86
ptg011231l,1084601,1084900,299,RepeatMasker,LTR,1084549,1085108,299,1.00
ptg011231l,1117832,1118137,305,RepeatMasker,LTR,1117937,1118229,201,0.66
ptg011235l,1645202,1645518,316,RepeatMasker,LTR,1644190,1646773,316,1.00
ptg011239l,34965,35245,280,RepeatMasker,LTR,34952,36322,280,1.00
ptg011247l,1505858,1506145,287,RepeatMasker,LTR,1505522,1506028,170,0.59
ptg011252l,1507804,1508107,303,RepeatMasker,LTR,1508097,1508654,11,0.04
ptg011255l,631122,631426,304,RepeatMasker,LTR,630487,631793,304,1.00
ptg011256l,691906,692220,314,RepeatMasker,LTR,689588,693670,314,1.00
ptg011259l,115419,115699,280,RepeatMasker,LTR,115407,116010,280,1.00
ptg011263l,1282489,1282773,284,RepeatMasker,LTR,1281256,1282636,147,0.52
ptg011270l,2795286,2795589,303,RepeatMasker,LTR,2794679,2795623,303,1.00
ptg011272l,2033693,2033973,280,RepeatMasker,LTR,2032159,2037041,280,1.00
ptg011279l,3022766,3023054,288,RepeatMasker,LTR,3021598,3023552,288,1.00
ptg011282l,1641159,1641474,315,RepeatMasker,LTR,1640622,1643520,315,1.00
ptg011282l,1772890,1773138,248,RepeatMasker,LTR,1767837,1777333,248,1.00
ptg011290l,1158675,1158999,324,RepeatMasker,LTR,1157009,1158837,162,0.50
ptg011304l,1071178,1071482,304,RepeatMasker,LTR,1071145,1071793,304,1.00
ptg011308l,617110,617390,280,RepeatMasker,LTR,617085,617770,280,1.00
ptg011308l,631300,631580,280,RepeatMasker,LTR,630523,631987,280,1.00
ptg011331l,2410799,2411078,279,RepeatMasker,LTR,2410786,2412251,279,1.00
ptg011331l,2417951,2418231,280,RepeatMasker,LTR,2417168,2419415,280,1.00
ptg011331l,2447435,2447715,280,RepeatMasker,LTR,2447422,2448763,280,1.00
ptg011334l,169777,170100,323,RepeatMasker,LTR,169103,170391,323,1.00
ptg011337l,320919,321200,281,RepeatMasker,LTR,320907,321580,281,1.00
ptg011337l,1202720,1203025,305,RepeatMasker,LTR,1202865,1203523,161,0.53
ptg011342l,1014308,1014600,292,RepeatMasker,LTR,1014206,1014366,58,0.20
ptg011342l,1587939,1588219,280,RepeatMasker,LTR,1587293,1588597,280,1.00
ptg011345l,36522,36808,286,RepeatMasker,LTR,30389,37208,286,1.00
ptg011348l,228357,228637,280,RepeatMasker,LTR,228350,229022,280,1.00
ptg011351l,194963,195290,327,RepeatMasker,LTR,194135,195001,38,0.12
ptg011353l,360220,360545,325,RepeatMasker,LTR,358884,361473,325,1.00
ptg011358l,524201,524517,316,RepeatMasker,LTR,524236,525393,282,0.89
ptg011366l,71413,71693,280,RepeatMasker,LTR,71474,71556,83,0.30
ptg011369l,658523,658821,298,RepeatMasker,LTR,658471,659051,298,1.00
ptg011375l,32034,32316,282,RepeatMasker,LTR,31535,32702,282,1.00
ptg011375l,60284,60566,282,RepeatMasker,LTR,59517,60957,282,1.00
ptg011389l,241090,241382,292,RepeatMasker,LTR,240665,241140,50,0.17
ptg011397l,2570621,2570956,335,RepeatMasker,LTR,2570569,2570998,335,1.00
ptg011397l,2594393,2594692,299,RepeatMasker,LTR,2594341,2594843,299,1.00
ptg011405l,2020439,2020758,319,RepeatMasker,LTR,2020645,2020796,114,0.36
ptg011406l,90653,90955,302,RepeatMasker,LTR,90745,90998,211,0.70
ptg011409l,66634,66918,284,RepeatMasker,LTR,65677,66669,35,0.12
ptg011411l,1218115,1218411,296,RepeatMasker,LTR,1218063,1218589,296,1.00
ptg011416l,11594,11875,281,RepeatMasker,LTR,10948,12162,281,1.00
ptg011416l,250078,250358,280,RepeatMasker,LTR,249276,250667,280,1.00
ptg011420l,625115,625432,317,RepeatMasker,LTR,623702,627130,317,1.00
ptg011428l,59174,59468,294,RepeatMasker,LTR,59128,59512,294,1.00
ptg011431l,1560603,1560884,281,RepeatMasker,LTR,1559800,1561266,281,1.00
ptg011442l,633140,633462,322,RepeatMasker,LTR,631002,633182,42,0.13
ptg011442l,633140,633462,322,RepeatMasker,LTR,633181,635468,282,0.88
ptg011442l,2059490,2059800,310,RepeatMasker,LTR,2059099,2059811,310,1.00
ptg011451l,455832,456113,281,RepeatMasker,LTR,455811,457167,281,1.00
ptg011451l,1539548,1539832,284,RepeatMasker,LTR,1539518,1539923,284,1.00
ptg011459l,267151,267464,313,RepeatMasker,LTR,267158,268051,307,0.98
ptg011465l,1845573,1845885,312,RepeatMasker,LTR,1845579,1845766,188,0.60
ptg011466l,457519,457799,280,RepeatMasker,LTR,457506,458189,280,1.00
ptg011468l,46031,46330,299,RepeatMasker,LTR,45979,46538,299,1.00
ptg011468l,113463,113762,299,RepeatMasker,LTR,113429,113940,299,1.00
ptg011470l,956335,956646,311,RepeatMasker,LTR,956603,957544,44,0.14
ptg011474l,2147770,2148049,279,RepeatMasker,LTR,2147663,2148237,279,1.00
ptg011477l,670166,670464,298,RepeatMasker,LTR,669887,670338,172,0.58
ptg011479l,178058,178336,278,RepeatMasker,LTR,178036,178728,278,1.00
ptg011479l,178058,178336,278,RepeatMasker,LTR,178045,178657,278,1.00
ptg011479l,2781744,2782038,294,RepeatMasker,LTR,2781600,2781963,219,0.74
ptg011482l,1214965,1215249,284,RepeatMasker,LTR,1214321,1216389,284,1.00
ptg011497l,272928,273228,300,RepeatMasker,LTR,272645,272930,2,0.01
ptg011497l,272928,273228,300,RepeatMasker,LTR,272690,273049,121,0.40
ptg011497l,272928,273228,300,RepeatMasker,LTR,273076,273137,62,0.21
ptg011498l,171652,171945,293,RepeatMasker,LTR,170851,172234,293,1.00
ptg011499l,551370,551668,298,RepeatMasker,LTR,551337,552032,298,1.00
ptg011499l,1409239,1409545,306,RepeatMasker,LTR,1407364,1410604,306,1.00
ptg011500l,211758,212021,263,RepeatMasker,LTR,210645,211921,163,0.62
ptg011501l,245809,246108,299,RepeatMasker,LTR,245757,246078,269,0.90
ptg011509l,76167,76482,315,RepeatMasker,LTR,76115,76678,315,1.00
ptg011509l,577396,577694,298,RepeatMasker,LTR,577344,577873,298,1.00
ptg011511l,834876,835158,282,RepeatMasker,LTR,834075,835548,282,1.00
ptg011511l,981894,982193,299,RepeatMasker,LTR,981842,982273,299,1.00
ptg011513l,25299,25546,247,RepeatMasker,LTR,20247,29750,247,1.00
ptg011543l,2884278,2884559,281,RepeatMasker,LTR,2883632,2884870,281,1.00
ptg011543l,2917110,2917391,281,RepeatMasker,LTR,2917077,2917781,281,1.00
ptg011544l,243714,244033,319,RepeatMasker,LTR,243974,244082,60,0.19
ptg011549l,232531,232837,306,RepeatMasker,LTR,232542,232823,282,0.92
ptg011557l,784663,784978,315,RepeatMasker,LTR,784727,785611,252,0.80
ptg011558l,778017,778302,285,RepeatMasker,LTR,778279,778323,24,0.08
ptg011560l,1576535,1576816,281,RepeatMasker,LTR,1576502,1577861,281,1.00
ptg011562l,1819269,1819584,315,RepeatMasker,LTR,1819294,1819594,291,0.92
ptg011565l,149222,149552,330,RepeatMasker,LTR,149161,151793,330,1.00
ptg011565l,366819,367120,301,RepeatMasker,LTR,366033,367481,301,1.00
ptg011568l,1731276,1731557,281,RepeatMasker,LTR,1730475,1731939,281,1.00
ptg011568l,2854840,2855120,280,RepeatMasker,LTR,2854827,2856256,280,1.00
ptg011576l,197477,197780,303,RepeatMasker,LTR,197445,198140,303,1.00
ptg011576l,588198,588493,295,RepeatMasker,LTR,588146,588671,295,1.00
ptg011576l,628701,629000,299,RepeatMasker,LTR,628649,629178,299,1.00
ptg011578l,213282,213546,264,RepeatMasker,LTR,213200,213310,28,0.11
ptg011578l,532219,532512,293,RepeatMasker,LTR,532465,536634,48,0.16
ptg011580l,139971,140300,329,RepeatMasker,LTR,140024,140912,277,0.84
ptg011581l,523686,523966,280,RepeatMasker,LTR,523674,524346,280,1.00
ptg011594l,203671,203952,281,RepeatMasker,LTR,203030,204335,281,1.00
ptg011596l,876718,876995,277,RepeatMasker,LTR,874296,877312,277,1.00
ptg011598l,1088179,1088458,279,RepeatMasker,LTR,1087406,1088722,279,1.00
ptg011600l,1427628,1427911,283,RepeatMasker,LTR,1427827,1431001,85,0.30
ptg011600l,1584820,1585108,288,RepeatMasker,LTR,1585085,1585129,24,0.08
ptg011611l,1549545,1549866,321,RepeatMasker,LTR,1549538,1549591,46,0.14
ptg011617l,251704,251984,280,RepeatMasker,LTR,251053,252396,280,1.00
ptg011619l,1008752,1009039,287,RepeatMasker,LTR,1008568,1011295,287,1.00
ptg011619l,1063913,1064221,308,RepeatMasker,LTR,1063268,1064575,308,1.00
ptg011621l,693788,694091,303,RepeatMasker,LTR,693197,694132,303,1.00
ptg011635l,1608046,1608357,311,RepeatMasker,LTR,1608084,1609605,274,0.88
ptg011646l,2905043,2905360,317,RepeatMasker,LTR,2904964,2905046,3,0.01
ptg011675l,535111,535403,292,RepeatMasker,LTR,532278,535745,292,1.00
ptg011684l,405479,405800,321,RepeatMasker,LTR,405701,405820,100,0.31
ptg011686l,301550,301830,280,RepeatMasker,LTR,300748,302232,280,1.00
ptg011686l,1833427,1833707,280,RepeatMasker,LTR,1832806,1834886,280,1.00
ptg011697l,623709,624014,305,RepeatMasker,LTR,623683,626082,305,1.00
ptg011712l,1392237,1392563,326,RepeatMasker,LTR,1392539,1392641,25,0.08
ptg011713l,634925,635173,248,RepeatMasker,LTR,634891,639301,248,1.00
ptg011729l,236305,236597,292,RepeatMasker,LTR,236539,237173,59,0.20
ptg011733l,224438,224736,298,RepeatMasker,LTR,222515,226936,298,1.00
ptg011739l,996729,997047,318,RepeatMasker,LTR,996194,997562,318,1.00
ptg011742l,882153,882451,298,RepeatMasker,LTR,882101,882531,298,1.00
ptg011742l,948951,949273,322,RepeatMasker,LTR,944995,949096,145,0.45
ptg011748l,1121336,1121616,280,RepeatMasker,LTR,1120700,1122004,280,1.00
ptg011758l,217617,217898,281,RepeatMasker,LTR,216815,218280,281,1.00
ptg011761l,585405,585547,142,RepeatMasker,LTR,585353,585900,142,1.00
ptg011768l,215559,215872,313,RepeatMasker,LTR,215354,216363,313,1.00
ptg011768l,481571,481856,285,RepeatMasker,LTR,480740,486590,285,1.00
ptg011772l,520849,521156,307,RepeatMasker,LTR,521136,522587,21,0.07
ptg011781l,1589986,1590305,319,RepeatMasker,LTR,1589225,1594336,319,1.00
ptg011787l,452540,452869,329,RepeatMasker,LTR,451216,453702,329,1.00
ptg011799l,1032639,1032964,325,RepeatMasker,LTR,1032393,1035107,325,1.00
ptg011800l,44029,44328,299,RepeatMasker,LTR,43977,44511,299,1.00
ptg011800l,336548,336847,299,RepeatMasker,LTR,336514,336867,299,1.00
ptg011803l,1772094,1772393,299,RepeatMasker,LTR,1772042,1772434,299,1.00
ptg011806l,543143,543451,308,RepeatMasker,LTR,542342,543434,291,0.94
ptg011813l,83436,83741,305,RepeatMasker,LTR,83098,84482,305,1.00
ptg011818l,736642,736928,286,RepeatMasker,LTR,730568,737328,286,1.00
ptg011836l,64989,65269,280,RepeatMasker,LTR,64976,66427,280,1.00
ptg011860l,750881,751162,281,RepeatMasker,LTR,751139,751183,24,0.09
ptg011860l,884339,884618,279,RepeatMasker,LTR,883705,885762,279,1.00
ptg011869l,122786,123063,277,RepeatMasker,LTR,119478,122907,121,0.44
ptg011869l,122786,123063,277,RepeatMasker,LTR,123036,123691,28,0.10
ptg011895l,38105,38386,281,RepeatMasker,LTR,37460,38777,281,1.00
ptg011903l,2723688,2723991,303,RepeatMasker,LTR,2723954,2727055,38,0.13
ptg011905l,68854,69153,299,RepeatMasker,LTR,68802,69331,299,1.00
ptg011911l,210798,211092,294,RepeatMasker,LTR,210751,211305,294,1.00
ptg011924l,606560,606839,279,RepeatMasker,LTR,606548,607229,279,1.00
ptg011925l,1311346,1311644,298,RepeatMasker,LTR,1311301,1311685,298,1.00
ptg011926l,640858,641137,279,RepeatMasker,LTR,637453,642003,279,1.00
ptg011929l,864097,864380,283,RepeatMasker,LTR,863234,865950,283,1.00
ptg011929l,1048422,1048715,293,RepeatMasker,LTR,1048512,1048941,204,0.70
ptg011955l,313045,313345,300,RepeatMasker,LTR,312993,313553,300,1.00
ptg011959l,1458142,1458465,323,RepeatMasker,LTR,1458260,1458297,38,0.12
ptg011967l,299645,299930,285,RepeatMasker,LTR,294924,301848,285,1.00
ptg011977l,4655304,4655604,300,RepeatMasker,LTR,4654738,4655349,45,0.15
ptg011977l,4655304,4655604,300,RepeatMasker,LTR,4655349,4656585,256,0.85
ptg011978l,4776567,4776888,321,RepeatMasker,LTR,4776845,4777117,44,0.14
ptg011978l,5606444,5606769,325,RepeatMasker,LTR,5606288,5606475,31,0.10
ptg011978l,8044368,8044651,283,RepeatMasker,LTR,8044522,8044554,33,0.12
ptg011996l,1674764,1675063,299,RepeatMasker,LTR,1674120,1675435,299,1.00
ptg011999l,409491,409819,328,RepeatMasker,LTR,409009,410996,328,1.00
ptg012002l,350999,351286,287,RepeatMasker,LTR,350120,355971,287,1.00
ptg012008l,73257,73536,279,RepeatMasker,LTR,73268,73349,82,0.29
ptg012014l,9734,10046,312,RepeatMasker,LTR,9456,11115,312,1.00
ptg012017l,103354,103665,311,RepeatMasker,LTR,100309,103469,115,0.37
ptg012034l,691028,691315,287,RepeatMasker,LTR,690169,692174,287,1.00
ptg012034l,691028,691315,287,RepeatMasker,LTR,690194,692876,287,1.00
ptg012035l,218214,218521,307,RepeatMasker,LTR,218458,219126,64,0.21
ptg012041l,1142853,1143130,277,RepeatMasker,LTR,1142732,1143191,277,1.00
ptg012041l,1142853,1143130,277,RepeatMasker,LTR,1142863,1146559,268,0.97
ptg012042l,293315,293622,307,RepeatMasker,LTR,293048,293544,229,0.75
ptg012042l,293315,293622,307,RepeatMasker,LTR,293528,293906,95,0.31
ptg012046l,252906,253187,281,RepeatMasker,LTR,252626,253569,281,1.00
ptg012048l,1049071,1049369,298,RepeatMasker,LTR,1049237,1049331,95,0.32
ptg012058l,1628247,1628528,281,RepeatMasker,LTR,1627602,1628925,281,1.00
ptg012058l,1933497,1933792,295,RepeatMasker,LTR,1933482,1934166,295,1.00
ptg012061l,316910,317228,318,RepeatMasker,LTR,317227,317370,2,0.01
ptg012062l,133375,133669,294,RepeatMasker,LTR,133208,133595,220,0.75
ptg012090l,549342,549629,287,RepeatMasker,LTR,548487,551558,287,1.00
ptg012090l,1104484,1104811,327,RepeatMasker,LTR,1104236,1105101,327,1.00
ptg012133l,269907,270194,287,RepeatMasker,LTR,269052,271775,287,1.00
ptg012146l,740666,740950,284,RepeatMasker,LTR,739175,740918,252,0.89
ptg012154l,586411,586730,319,RepeatMasker,LTR,586379,586711,300,0.94
ptg012154l,586411,586730,319,RepeatMasker,LTR,586718,587149,13,0.04
ptg012159l,16249,16530,281,RepeatMasker,LTR,15688,16290,41,0.15
ptg012159l,16249,16530,281,RepeatMasker,LTR,16216,16303,54,0.19
ptg012160l,57172,57481,309,RepeatMasker,LTR,56348,57202,30,0.10
ptg012160l,167061,167375,314,RepeatMasker,LTR,167063,167103,41,0.13
ptg012164l,383397,383717,320,RepeatMasker,LTR,383581,384282,137,0.43
ptg012167l,35269,35563,294,RepeatMasker,LTR,32688,35319,50,0.17
ptg012171l,1901494,1901805,311,RepeatMasker,LTR,1899873,1901528,34,0.11
ptg012175l,556593,556931,338,RepeatMasker,LTR,556756,556823,68,0.20
ptg012191l,1312885,1313164,279,RepeatMasker,LTR,1312667,1313053,168,0.60
ptg012197l,1470520,1470803,283,RepeatMasker,LTR,1470700,1470918,104,0.37
ptg012198l,1132030,1132342,312,RepeatMasker,LTR,1127820,1132072,42,0.13
ptg012211l,172943,173224,281,RepeatMasker,LTR,172930,173512,281,1.00
ptg012214l,573070,573354,284,RepeatMasker,LTR,572280,573665,284,1.00
ptg012217l,252158,252445,287,RepeatMasker,LTR,251672,253001,287,1.00
ptg012239l,23814,24128,314,RepeatMasker,LTR,20973,23842,28,0.09
ptg012239l,23814,24128,314,RepeatMasker,LTR,24041,24308,88,0.28
ptg012242l,991425,991723,298,RepeatMasker,LTR,991682,991739,42,0.14
ptg012242l,991425,991723,298,RepeatMasker,LTR,991691,992255,33,0.11
ptg012244l,45055,45348,293,RepeatMasker,LTR,45003,45505,293,1.00
ptg012244l,79670,79963,293,RepeatMasker,LTR,79618,80004,293,1.00
ptg012245l,1410261,1410548,287,RepeatMasker,LTR,1409406,1414250,287,1.00
ptg012249l,788974,789270,296,RepeatMasker,LTR,788829,789201,227,0.77
ptg012249l,2360512,2360821,309,RepeatMasker,LTR,2360773,2360817,45,0.15
ptg012250l,618466,618766,300,RepeatMasker,LTR,615973,619096,300,1.00
ptg012251l,827701,828021,320,RepeatMasker,LTR,822886,827751,50,0.16
ptg012252l,1022339,1022633,294,RepeatMasker,LTR,1021692,1023009,294,1.00
ptg012252l,1124444,1124725,281,RepeatMasker,LTR,1124431,1125107,281,1.00
ptg012281l,65440,65735,295,RepeatMasker,LTR,65388,65815,295,1.00
ptg012294l,293084,293362,278,RepeatMasker,LTR,292752,294863,278,1.00
ptg012294l,309413,309710,297,RepeatMasker,LTR,309361,309907,297,1.00
ptg012294l,581561,581856,295,RepeatMasker,LTR,581509,582034,295,1.00
ptg012294l,695717,696016,299,RepeatMasker,LTR,695683,696036,299,1.00
ptg012294l,1750269,1750579,310,RepeatMasker,LTR,1750487,1751061,93,0.30
ptg012297l,244484,244796,312,RepeatMasker,LTR,243703,249964,312,1.00
ptg012299l,5134547,5134866,319,RepeatMasker,LTR,5133703,5134597,50,0.16
ptg012306l,67190,67488,298,RepeatMasker,LTR,67143,67666,298,1.00
ptg012306l,2558420,2558714,294,RepeatMasker,LTR,2557784,2559739,294,1.00
ptg012315l,2293224,2293504,280,RepeatMasker,LTR,2292416,2293890,280,1.00
ptg012341l,1049643,1049941,298,RepeatMasker,LTR,1048586,1049999,298,1.00
ptg012356l,1217467,1217769,302,RepeatMasker,LTR,1217322,1217745,278,0.92
ptg012367l,542023,542310,287,RepeatMasker,LTR,542231,544083,80,0.28
ptg012384l,301096,301376,280,RepeatMasker,LTR,300458,301758,280,1.00
ptg012389l,135647,135977,330,RepeatMasker,LTR,134848,136903,330,1.00
ptg012397l,202501,202787,286,RepeatMasker,LTR,202764,202808,24,0.08
ptg012403l,1500376,1500682,306,RepeatMasker,LTR,1500070,1501470,306,1.00
ptg012404l,15545,15846,301,RepeatMasker,LTR,14751,16207,301,1.00
ptg012406l,513219,513518,299,RepeatMasker,LTR,513207,513901,299,1.00
ptg012412l,767240,767553,313,RepeatMasker,LTR,767247,767896,307,0.98
ptg012414l,1024727,1025024,297,RepeatMasker,LTR,1024446,1024874,147,0.49
ptg012420l,2233651,2233945,294,RepeatMasker,LTR,2233836,2234402,110,0.37
ptg012424l,279906,280228,322,RepeatMasker,LTR,279106,280192,286,0.89
ptg012428l,620160,620456,296,RepeatMasker,LTR,620108,620536,296,1.00
ptg012429l,263005,263286,281,RepeatMasker,LTR,262974,264926,281,1.00
ptg012434l,2301882,2302163,281,RepeatMasker,LTR,2301387,2303579,281,1.00
ptg012439l,1298384,1298666,282,RepeatMasker,LTR,1297732,1300149,282,1.00
ptg012446l,38587,38887,300,RepeatMasker,LTR,38535,39066,300,1.00
ptg012456l,1054183,1054475,292,RepeatMasker,LTR,1051371,1054817,292,1.00
ptg012456l,3235897,3236225,328,RepeatMasker,LTR,3233665,3235934,37,0.11
ptg012456l,3235897,3236225,328,RepeatMasker,LTR,3236050,3236294,176,0.54
ptg012458l,197449,197755,306,RepeatMasker,LTR,195066,204372,306,1.00
ptg012461l,331975,332274,299,RepeatMasker,LTR,331923,332354,299,1.00
ptg012466l,876522,876795,273,RepeatMasker,LTR,876679,876890,117,0.43
ptg012475l,180795,181076,281,RepeatMasker,LTR,180011,182148,281,1.00
ptg012479l,794843,795149,306,RepeatMasker,LTR,795042,795278,108,0.35
ptg012503l,1515770,1516084,314,RepeatMasker,LTR,1515149,1516016,246,0.78
ptg012503l,1552396,1552712,316,RepeatMasker,LTR,1552474,1552620,147,0.47
ptg012509l,608659,608940,281,RepeatMasker,LTR,608015,610089,281,1.00
ptg012513l,601583,601876,293,RepeatMasker,LTR,600793,602246,293,1.00
ptg012517l,3751,4066,315,RepeatMasker,LTR,3593,3779,28,0.09
ptg012517l,3751,4066,315,RepeatMasker,LTR,3672,4125,315,1.00
ptg012520l,1756051,1756355,304,RepeatMasker,LTR,1755980,1756167,116,0.38
ptg012523l,330851,331150,299,RepeatMasker,LTR,330799,331329,299,1.00
ptg012523l,830252,830544,292,RepeatMasker,LTR,830218,830564,292,1.00
ptg012523l,1406707,1407002,295,RepeatMasker,LTR,1406655,1407177,295,1.00
ptg012525l,55454,55734,280,RepeatMasker,LTR,54815,56116,280,1.00
ptg012525l,62587,62888,301,RepeatMasker,LTR,61802,62886,299,0.99
ptg012530l,103414,103706,292,RepeatMasker,LTR,103261,103682,268,0.92
ptg012534l,650074,650355,281,RepeatMasker,LTR,649438,651497,281,1.00
ptg012534l,657250,657530,280,RepeatMasker,LTR,656457,658579,280,1.00
ptg012537l,1306793,1307081,288,RepeatMasker,LTR,1307049,1307078,30,0.10
ptg012547l,964043,964333,290,RepeatMasker,LTR,963991,964534,290,1.00
ptg012554l,744743,745039,296,RepeatMasker,LTR,743381,746003,296,1.00
ptg012554l,792557,792839,282,RepeatMasker,LTR,791772,793228,282,1.00
ptg012556l,61540,61839,299,RepeatMasker,LTR,61488,62045,299,1.00
ptg012558l,560293,560574,281,RepeatMasker,LTR,557716,563636,281,1.00
ptg012571l,195513,195803,290,RepeatMasker,LTR,194867,196176,290,1.00
ptg012571l,265063,265347,284,RepeatMasker,LTR,265072,265291,220,0.77
ptg012574l,1053848,1054134,286,RepeatMasker,LTR,1053815,1054526,286,1.00
ptg012576l,683241,683536,295,RepeatMasker,LTR,679885,683936,295,1.00
ptg012578l,529106,529386,280,RepeatMasker,LTR,529093,530434,280,1.00
ptg012579l,2060419,2060719,300,RepeatMasker,LTR,2060367,2060943,300,1.00
ptg012582l,810358,810638,280,RepeatMasker,LTR,809713,811020,280,1.00
ptg012592l,702881,703176,295,RepeatMasker,LTR,702834,703400,295,1.00
ptg012592l,3629572,3629865,293,RepeatMasker,LTR,3629560,3630243,293,1.00
ptg012594l,2073568,2073867,299,RepeatMasker,LTR,2073516,2073947,299,1.00
ptg012595l,322412,322726,314,RepeatMasker,LTR,322247,326095,314,1.00
ptg012606l,299693,299989,296,RepeatMasker,LTR,299641,300020,296,1.00
ptg012606l,384342,384635,293,RepeatMasker,LTR,384290,384843,293,1.00
ptg012609l,1042201,1042504,303,RepeatMasker,LTR,1041484,1042396,195,0.64
ptg012609l,1042201,1042504,303,RepeatMasker,LTR,1042388,1042982,117,0.39
ptg012610l,673973,674272,299,RepeatMasker,LTR,673921,674270,297,0.99
ptg012612l,482717,483016,299,RepeatMasker,LTR,482665,483223,299,1.00
ptg012612l,1399734,1400011,277,RepeatMasker,LTR,1399612,1400072,277,1.00
ptg012612l,1399734,1400011,277,RepeatMasker,LTR,1399744,1403436,268,0.97
ptg012615l,1039280,1039573,293,RepeatMasker,LTR,1039228,1039754,293,1.00
ptg012616l,1512649,1512955,306,RepeatMasker,LTR,1512836,1513524,120,0.39
ptg012617l,1322499,1322779,280,RepeatMasker,LTR,1322466,1323169,280,1.00
ptg012617l,1329643,1329924,281,RepeatMasker,LTR,1328842,1330307,281,1.00
ptg012625l,1200877,1201179,302,RepeatMasker,LTR,1200136,1200957,80,0.26
ptg012632l,75021,75319,298,RepeatMasker,LTR,74969,75527,298,1.00
ptg012645l,124118,124401,283,RepeatMasker,LTR,119011,126498,283,1.00
ptg012646l,2848186,2848488,302,RepeatMasker,LTR,2846935,2848318,132,0.44
ptg012648l,213950,214240,290,RepeatMasker,LTR,213898,214447,290,1.00
ptg012650l,413137,413449,312,RepeatMasker,LTR,412477,413436,299,0.96
ptg012650l,413137,413449,312,RepeatMasker,LTR,413105,413844,312,1.00
ptg012653l,29279,29577,298,RepeatMasker,LTR,29227,29785,298,1.00
ptg012658l,87637,87923,286,RepeatMasker,LTR,86783,88893,286,1.00
ptg012664l,379035,379326,291,RepeatMasker,LTR,378389,379626,291,1.00
ptg012664l,386173,386453,280,RepeatMasker,LTR,385370,386764,280,1.00
ptg012677l,19990,20304,314,RepeatMasker,LTR,19027,20952,314,1.00
ptg012698l,1624806,1625085,279,RepeatMasker,LTR,1625062,1625106,24,0.09
ptg012718l,64162,64467,305,RepeatMasker,LTR,64345,71379,123,0.40
ptg012723l,1064860,1065185,325,RepeatMasker,LTR,1064886,1065105,220,0.68
ptg012725l,260834,261129,295,RepeatMasker,LTR,260920,261068,149,0.51
ptg012752l,83365,83646,281,RepeatMasker,LTR,82711,84028,281,1.00
ptg012752l,209816,210107,291,RepeatMasker,LTR,209783,210101,285,0.98
ptg012752l,941651,941915,264,RepeatMasker,LTR,941351,941916,264,1.00
ptg012752l,941651,941915,264,RepeatMasker,LTR,941360,942090,264,1.00
ptg012752l,2142205,2142497,292,RepeatMasker,LTR,2141570,2142526,292,1.00
ptg012758l,1608237,1608526,289,RepeatMasker,LTR,1602139,1608284,47,0.16
ptg012759l,329130,329410,280,RepeatMasker,LTR,328496,329792,280,1.00
ptg012761l,391540,391788,248,RepeatMasker,LTR,386485,395995,248,1.00
ptg012763l,450611,450936,325,RepeatMasker,LTR,450167,451843,325,1.00
ptg012768l,382278,382577,299,RepeatMasker,LTR,382226,382785,299,1.00
ptg012772l,485744,486041,297,RepeatMasker,LTR,485692,486121,297,1.00
ptg012773l,545208,545507,299,RepeatMasker,LTR,545156,545687,299,1.00
ptg012773l,550529,550828,299,RepeatMasker,LTR,550496,550908,299,1.00
ptg012773l,649403,649697,294,RepeatMasker,LTR,649351,649852,294,1.00
ptg012773l,687131,687427,296,RepeatMasker,LTR,687079,687605,296,1.00
ptg012773l,975262,975559,297,RepeatMasker,LTR,974625,975932,297,1.00
ptg012773l,1916604,1916903,299,RepeatMasker,LTR,1916552,1917083,299,1.00
ptg012773l,2351761,2352058,297,RepeatMasker,LTR,2351715,2352099,297,1.00
ptg012783l,1370924,1371205,281,RepeatMasker,LTR,1370891,1372376,281,1.00
ptg012783l,1481694,1481975,281,RepeatMasker,LTR,1481060,1482366,281,1.00
ptg012785l,940808,941107,299,RepeatMasker,LTR,940756,941285,299,1.00
ptg012788l,1804248,1804547,299,RepeatMasker,LTR,1804193,1804768,299,1.00
ptg012789l,1211173,1211472,299,RepeatMasker,LTR,1211441,1211578,32,0.11
ptg012796l,1051272,1051559,287,RepeatMasker,LTR,1050414,1053116,287,1.00
ptg012797l,73691,73999,308,RepeatMasker,LTR,73204,74877,308,1.00
ptg012806l,515211,515531,320,RepeatMasker,LTR,514291,515266,55,0.17
ptg012807l,584880,585204,324,RepeatMasker,LTR,585172,585384,33,0.10
ptg012824l,292863,293160,297,RepeatMasker,LTR,292811,293337,297,1.00
ptg012826l,204707,205006,299,RepeatMasker,LTR,204655,205214,299,1.00
ptg012826l,631437,631720,283,RepeatMasker,LTR,631241,633123,283,1.00
ptg012835l,1165248,1165539,291,RepeatMasker,LTR,1164929,1166763,291,1.00
ptg012836l,495654,495953,299,RepeatMasker,LTR,495602,496033,299,1.00
ptg012836l,696008,696307,299,RepeatMasker,LTR,695956,696305,297,0.99
ptg012836l,696008,696307,299,RepeatMasker,LTR,696307,696405,1,0.00
ptg012836l,748660,748959,299,RepeatMasker,LTR,748608,749154,299,1.00
ptg012839l,331691,331971,280,RepeatMasker,LTR,331050,332353,280,1.00
ptg012839l,357930,358251,321,RepeatMasker,LTR,357144,358623,321,1.00
ptg012843l,475002,475283,281,RepeatMasker,LTR,474989,475680,281,1.00
ptg012843l,501679,501958,279,RepeatMasker,LTR,500346,507119,279,1.00
ptg012851l,966197,966467,270,RepeatMasker,LTR,966226,966344,119,0.44
ptg012852l,138418,138742,324,RepeatMasker,LTR,138674,138943,69,0.21
ptg012858l,1440306,1440636,330,RepeatMasker,LTR,1440468,1440502,35,0.11
ptg012864l,3409402,3409718,316,RepeatMasker,LTR,3409613,3410806,106,0.34
ptg012866l,1218063,1218355,292,RepeatMasker,LTR,1215231,1218697,292,1.00
ptg012870l,1731105,1731404,299,RepeatMasker,LTR,1731053,1731484,299,1.00
ptg012870l,1992956,1993255,299,RepeatMasker,LTR,1992904,1993335,299,1.00
ptg012870l,2079575,2079875,300,RepeatMasker,LTR,2079523,2079955,300,1.00
ptg012871l,386005,386292,287,RepeatMasker,LTR,385145,390922,287,1.00
ptg012873l,1245100,1245386,286,RepeatMasker,LTR,1244377,1247940,286,1.00
ptg012883l,647311,647626,315,RepeatMasker,LTR,645367,647731,315,1.00
ptg012884l,67714,68031,317,RepeatMasker,LTR,67570,68012,298,0.94
ptg012889l,92991,93268,277,RepeatMasker,LTR,92746,93233,242,0.87
ptg012891l,496017,496297,280,RepeatMasker,LTR,495225,496689,280,1.00
ptg012893l,737717,738032,315,RepeatMasker,LTR,736494,739723,315,1.00
ptg012893l,1033708,1034007,299,RepeatMasker,LTR,1033656,1034215,299,1.00
ptg012898l,870198,870496,298,RepeatMasker,LTR,869181,871257,298,1.00
ptg012898l,1464915,1465205,290,RepeatMasker,LTR,1465097,1465141,45,0.16
ptg012905l,430808,431110,302,RepeatMasker,LTR,429238,430899,91,0.30
ptg012905l,430808,431110,302,RepeatMasker,LTR,429557,430889,81,0.27
ptg012913l,1648639,1648929,290,RepeatMasker,LTR,1648587,1649140,290,1.00
ptg012919l,587858,588163,305,RepeatMasker,LTR,585648,588075,217,0.71
ptg012922l,256009,256289,280,RepeatMasker,LTR,255217,256671,280,1.00
ptg012938l,887841,888165,324,RepeatMasker,LTR,888084,888120,37,0.11
ptg012943l,191751,191999,248,RepeatMasker,LTR,186696,196205,248,1.00
ptg012946l,1369345,1369655,310,RepeatMasker,LTR,1369293,1369850,310,1.00
ptg012947l,3290017,3290341,324,RepeatMasker,LTR,3290317,3290538,25,0.08
ptg012961l,216992,217275,283,RepeatMasker,LTR,217252,217296,24,0.08
ptg012972l,481199,481481,282,RepeatMasker,LTR,481167,481863,282,1.00
ptg012972l,488339,488647,308,RepeatMasker,LTR,488307,488957,308,1.00
ptg012973l,831947,832246,299,RepeatMasker,LTR,831895,832411,299,1.00
ptg012979l,263876,264175,299,RepeatMasker,LTR,263824,264353,299,1.00
ptg012980l,1066466,1066747,281,RepeatMasker,LTR,1065672,1067128,281,1.00
ptg012980l,1299391,1299668,277,RepeatMasker,LTR,1298746,1300053,277,1.00
ptg012981l,1138967,1139265,298,RepeatMasker,LTR,1137840,1139014,47,0.16
ptg012982l,1725341,1725622,281,RepeatMasker,LTR,1724704,1726672,281,1.00
ptg012993l,320528,320827,299,RepeatMasker,LTR,320476,320975,299,1.00
ptg012995l,170730,171011,281,RepeatMasker,LTR,170083,171399,281,1.00
ptg013007l,379745,380059,314,RepeatMasker,LTR,378016,379855,110,0.35
ptg013016l,180532,180830,298,RepeatMasker,LTR,180480,181008,298,1.00
ptg013016l,1086905,1087205,300,RepeatMasker,LTR,1086853,1087414,300,1.00
ptg013020l,1916897,1917216,319,RepeatMasker,LTR,1914613,1917193,296,0.93
ptg013024l,541918,542222,304,RepeatMasker,LTR,539540,543942,304,1.00
ptg013035l,1213932,1214263,331,RepeatMasker,LTR,1213041,1213978,46,0.14
ptg013035l,1613048,1613335,287,RepeatMasker,LTR,1612189,1615265,287,1.00
ptg013042l,814970,815260,290,RepeatMasker,LTR,814918,815400,290,1.00
ptg013045l,1897576,1897872,296,RepeatMasker,LTR,1896960,1897597,21,0.07
ptg013047l,183428,183715,287,RepeatMasker,LTR,182567,187761,287,1.00
ptg013047l,218606,218905,299,RepeatMasker,LTR,218554,219083,299,1.00
ptg013050l,153932,154180,248,RepeatMasker,LTR,149643,158382,248,1.00
ptg013062l,1438712,1438988,276,RepeatMasker,LTR,1438504,1438727,15,0.05
ptg013067l,350165,350459,294,RepeatMasker,LTR,349252,350568,294,1.00
ptg013068l,1888556,1888842,286,RepeatMasker,LTR,1888819,1888865,24,0.08
ptg013080l,195824,196105,281,RepeatMasker,LTR,195430,197243,281,1.00
ptg013085l,929231,929512,281,RepeatMasker,LTR,929218,930653,281,1.00
ptg013106l,437670,437962,292,RepeatMasker,LTR,436970,438304,292,1.00
ptg013106l,452913,453205,292,RepeatMasker,LTR,450377,453561,292,1.00
ptg013107l,1247659,1247939,280,RepeatMasker,LTR,1247015,1248337,280,1.00
ptg013113l,327209,327505,296,RepeatMasker,LTR,326019,327563,296,1.00
ptg013121l,116302,116589,287,RepeatMasker,LTR,115401,121224,287,1.00
ptg013137l,16810,17101,291,RepeatMasker,LTR,16797,18112,291,1.00
ptg013139l,116279,116559,280,RepeatMasker,LTR,116247,116949,280,1.00
ptg013142l,783171,783452,281,RepeatMasker,LTR,782381,783856,281,1.00
ptg013146l,735768,736070,302,RepeatMasker,LTR,735623,736046,278,0.92
ptg013148l,94076,94375,299,RepeatMasker,LTR,94024,94553,299,1.00
ptg013148l,217068,217367,299,RepeatMasker,LTR,217020,217575,299,1.00
ptg013148l,363631,363927,296,RepeatMasker,LTR,363579,364126,296,1.00
ptg013148l,384621,384921,300,RepeatMasker,LTR,384569,385121,300,1.00
ptg013149l,350459,350758,299,RepeatMasker,LTR,350409,350966,299,1.00
ptg013152l,596311,596646,335,RepeatMasker,LTR,595789,596851,335,1.00
ptg013155l,1190989,1191300,311,RepeatMasker,LTR,1191152,1191431,149,0.48
ptg013159l,517786,518078,292,RepeatMasker,LTR,517975,518185,104,0.36
ptg013171l,231183,231431,248,RepeatMasker,LTR,229936,234436,248,1.00
ptg013173l,437668,437955,287,RepeatMasker,LTR,437932,437976,24,0.08
ptg013193l,1646438,1646730,292,RepeatMasker,LTR,1646587,1646764,144,0.49
ptg013193l,2148856,2149163,307,RepeatMasker,LTR,2148212,2149943,307,1.00
ptg013199l,648458,648740,282,RepeatMasker,LTR,645889,651762,282,1.00
ptg013221l,4133633,4133938,305,RepeatMasker,LTR,4132771,4138609,305,1.00
ptg013231l,502959,503283,324,RepeatMasker,LTR,502859,503085,126,0.39
ptg013236l,211017,211298,281,RepeatMasker,LTR,210232,212341,281,1.00
ptg013242l,93323,93609,286,RepeatMasker,LTR,87198,94009,286,1.00
ptg013251l,903189,903503,314,RepeatMasker,LTR,903417,903449,33,0.11
ptg013252l,1091862,1092148,286,RepeatMasker,LTR,1090988,1096853,286,1.00
ptg013259l,102181,102478,297,RepeatMasker,LTR,99472,102307,126,0.42
ptg013263l,104308,104605,297,RepeatMasker,LTR,104256,104813,297,1.00
ptg013272l,199239,199528,289,RepeatMasker,LTR,197928,201747,289,1.00
ptg013272l,213538,213824,286,RepeatMasker,LTR,211535,214223,286,1.00
ptg013276l,587293,587607,314,RepeatMasker,LTR,587556,591190,52,0.17
ptg013278l,149392,149723,331,RepeatMasker,LTR,149462,149604,143,0.43
ptg013281l,269535,269816,281,RepeatMasker,LTR,269502,270198,281,1.00
ptg013282l,1393042,1393363,321,RepeatMasker,LTR,1393037,1393642,321,1.00
ptg013291l,20562,20866,304,RepeatMasker,LTR,20448,23620,304,1.00
ptg013298l,42465,42745,280,RepeatMasker,LTR,41663,43127,280,1.00
ptg013330l,482202,482507,305,RepeatMasker,LTR,481569,482865,305,1.00
ptg013330l,1219672,1219974,302,RepeatMasker,LTR,1218134,1220974,302,1.00
ptg013331l,786399,786680,281,RepeatMasker,LTR,785599,787819,281,1.00
ptg013331l,834847,835110,263,RepeatMasker,LTR,832393,836561,263,1.00
ptg013332l,2377213,2377505,292,RepeatMasker,LTR,2376621,2378022,292,1.00
ptg013334l,4424,4723,299,RepeatMasker,LTR,4372,4721,297,0.99
ptg013343l,118252,118537,285,RepeatMasker,LTR,118253,118377,125,0.44
ptg013349l,2538700,2538981,281,RepeatMasker,LTR,2534799,2541022,281,1.00
ptg013353l,1897598,1897896,298,RepeatMasker,LTR,1897884,1898163,13,0.04
ptg013369l,1058992,1059289,297,RepeatMasker,LTR,1055378,1059126,134,0.45
ptg013387l,1850522,1850802,280,RepeatMasker,LTR,1849725,1851110,280,1.00
ptg013387l,1850522,1850802,280,RepeatMasker,LTR,1850510,1851184,280,1.00
ptg013387l,3055666,3055946,280,RepeatMasker,LTR,3055654,3056342,280,1.00
ptg013389l,877189,877488,299,RepeatMasker,LTR,877137,877568,299,1.00
ptg013393l,1661281,1661580,299,RepeatMasker,LTR,1661229,1661660,299,1.00
ptg013395l,274771,275063,292,RepeatMasker,LTR,271940,275428,292,1.00
ptg013397l,615019,615342,323,RepeatMasker,LTR,614870,615096,77,0.24
ptg013401l,994585,994870,285,RepeatMasker,LTR,991526,995455,285,1.00
ptg013401l,1570916,1571232,316,RepeatMasker,LTR,1570857,1571333,316,1.00
ptg013417l,208283,208590,307,RepeatMasker,LTR,208489,208620,102,0.33
ptg013427l,1726237,1726536,299,RepeatMasker,LTR,1726185,1726717,299,1.00
ptg013431l,1297130,1297441,311,RepeatMasker,LTR,1296371,1300851,311,1.00
ptg013438l,1290571,1290851,280,RepeatMasker,LTR,1289937,1291233,280,1.00
ptg013440l,42111,42391,280,RepeatMasker,LTR,41753,44288,280,1.00
ptg013463l,266095,266376,281,RepeatMasker,LTR,266082,267507,281,1.00
ptg013463l,2235602,2235879,277,RepeatMasker,LTR,2235257,2235765,163,0.59
ptg013466l,997067,997345,278,RepeatMasker,LTR,997068,997307,240,0.86
ptg013473l,4667872,4668166,294,RepeatMasker,LTR,4667069,4668035,163,0.55
ptg013476l,746447,746758,311,RepeatMasker,LTR,746395,746891,311,1.00
ptg013478l,51708,52009,301,RepeatMasker,LTR,50594,51873,165,0.55
ptg013478l,51708,52009,301,RepeatMasker,LTR,51869,59089,141,0.47
ptg013487l,754808,755114,306,RepeatMasker,LTR,754831,755078,248,0.81
ptg013488l,129615,129921,306,RepeatMasker,LTR,127062,136520,306,1.00
ptg013491l,843825,844106,281,RepeatMasker,LTR,843064,845111,281,1.00
ptg013491l,3648675,3648992,317,RepeatMasker,LTR,3648555,3649040,317,1.00
ptg013491l,4104692,4104994,302,RepeatMasker,LTR,4103125,4105748,302,1.00
ptg013492l,444559,444880,321,RepeatMasker,LTR,438356,444608,49,0.15
ptg013497l,592081,592376,295,RepeatMasker,LTR,592029,592551,295,1.00
ptg013502l,4147433,4147734,301,RepeatMasker,LTR,4147303,4147445,12,0.04
ptg013502l,4213362,4213661,299,RepeatMasker,LTR,4213344,4213416,54,0.18
ptg013502l,4213362,4213661,299,RepeatMasker,LTR,4213638,4214442,24,0.08
ptg013502l,4213362,4213661,299,RepeatMasker,LTR,4213638,4214772,24,0.08
ptg013502l,4354044,4354344,300,RepeatMasker,LTR,4353992,4354424,300,1.00
ptg013502l,4696726,4697006,280,RepeatMasker,LTR,4696089,4697689,280,1.00
ptg013505l,101497,101819,322,RepeatMasker,LTR,101445,101658,161,0.50
ptg013505l,101497,101819,322,RepeatMasker,LTR,101655,101912,165,0.51
ptg013505l,819845,820144,299,RepeatMasker,LTR,819793,820164,299,1.00
ptg013506l,542223,542553,330,RepeatMasker,LTR,541388,543404,330,1.00
ptg013513l,1626276,1626570,294,RepeatMasker,LTR,1626258,1626382,106,0.36
ptg013521l,1334259,1334546,287,RepeatMasker,LTR,1333984,1334407,148,0.52
ptg013527l,463965,464252,287,RepeatMasker,LTR,463107,464867,287,1.00
ptg013529l,1227622,1227920,298,RepeatMasker,LTR,1225401,1232812,298,1.00
ptg013537l,517290,517572,282,RepeatMasker,LTR,517278,518617,282,1.00
ptg013541l,445622,445921,299,RepeatMasker,LTR,445570,446001,299,1.00
ptg013541l,942027,942327,300,RepeatMasker,LTR,941975,942538,300,1.00
ptg013541l,1070866,1071162,296,RepeatMasker,LTR,1070814,1071373,296,1.00
ptg013541l,1353822,1354131,309,RepeatMasker,LTR,1352820,1354898,309,1.00
ptg013542l,601704,602023,319,RepeatMasker,LTR,601079,602657,319,1.00
ptg013572l,909509,909834,325,RepeatMasker,LTR,909551,909631,81,0.25
ptg013578l,1475621,1475936,315,RepeatMasker,LTR,1475843,1476417,94,0.30
ptg013578l,1475621,1475936,315,RepeatMasker,LTR,1474193,1475827,206,0.65
ptg013582l,1191620,1191902,282,RepeatMasker,LTR,1191608,1192213,282,1.00
ptg013589l,670698,670993,295,RepeatMasker,LTR,670646,671171,295,1.00
ptg013589l,672057,672356,299,RepeatMasker,LTR,672005,672534,299,1.00
ptg013597l,100682,100982,300,RepeatMasker,LTR,100630,101202,300,1.00
ptg013599l,941873,942191,318,RepeatMasker,LTR,940790,941923,50,0.16
ptg013603l,376537,376828,291,RepeatMasker,LTR,376392,376764,227,0.78
ptg013604l,1130176,1130488,312,RepeatMasker,LTR,1130105,1130484,308,0.99
ptg013607l,615758,616068,310,RepeatMasker,LTR,613555,615808,50,0.16
ptg013610l,1755687,1755978,291,RepeatMasker,LTR,1752851,1756344,291,1.00
ptg013613l,859648,859927,279,RepeatMasker,LTR,859834,860395,94,0.34
ptg013626l,75121,75403,282,RepeatMasker,LTR,74340,75778,282,1.00
ptg013629l,802968,803267,299,RepeatMasker,LTR,802916,803432,299,1.00
ptg013639l,75051,75350,299,RepeatMasker,LTR,74999,75557,299,1.00
ptg013641l,748721,749001,280,RepeatMasker,LTR,748688,749383,280,1.00
ptg013641l,1701606,1701886,280,RepeatMasker,LTR,1700795,1702266,280,1.00
ptg013653l,157265,157587,322,RepeatMasker,LTR,151284,158332,322,1.00
ptg013659l,339916,340221,305,RepeatMasker,LTR,338758,339945,29,0.10
ptg013660l,1403439,1403726,287,RepeatMasker,LTR,1402729,1405297,287,1.00
ptg013670l,21163,21444,281,RepeatMasker,LTR,20522,21836,281,1.00
ptg013670l,620104,620411,307,RepeatMasker,LTR,619804,621994,307,1.00
ptg013678l,334464,334773,309,RepeatMasker,LTR,333948,335554,309,1.00
ptg013678l,1058279,1058616,337,RepeatMasker,LTR,1058541,1058572,32,0.09
ptg013712l,125327,125641,314,RepeatMasker,LTR,124775,125660,314,1.00
ptg013721l,539860,540159,299,RepeatMasker,LTR,539808,540241,299,1.00
ptg013728l,585143,585442,299,RepeatMasker,LTR,585091,585607,299,1.00
ptg013737l,268054,268335,281,RepeatMasker,LTR,268041,268710,281,1.00
ptg013738l,193037,193359,322,RepeatMasker,LTR,192989,193915,322,1.00
ptg013739l,102247,102523,276,RepeatMasker,LTR,99762,102284,37,0.13
ptg013744l,3538439,3538744,305,RepeatMasker,LTR,3534840,3540691,305,1.00
ptg013744l,3545427,3545731,304,RepeatMasker,LTR,3541851,3547679,304,1.00
ptg013744l,4513006,4513306,300,RepeatMasker,LTR,4512954,4513488,300,1.00
ptg013773l,229356,229640,284,RepeatMasker,LTR,229554,231015,87,0.31
ptg013778l,624170,624469,299,RepeatMasker,LTR,624118,624664,299,1.00
ptg013780l,74544,74859,315,RepeatMasker,LTR,72364,74727,183,0.58
ptg013794l,161558,161838,280,RepeatMasker,LTR,161546,162222,280,1.00
ptg013802l,228248,228566,318,RepeatMasker,LTR,228267,228772,300,0.94
ptg013804l,228587,228885,298,RepeatMasker,LTR,227300,228806,219,0.73
ptg013804l,228587,228885,298,RepeatMasker,LTR,227300,229307,298,1.00
ptg013804l,228587,228885,298,RepeatMasker,LTR,228793,233284,93,0.31
ptg013806l,791189,791479,290,RepeatMasker,LTR,790694,792049,290,1.00
ptg013809l,2680158,2680457,299,RepeatMasker,LTR,2679612,2682129,299,1.00
ptg013812l,997061,997358,297,RepeatMasker,LTR,997009,997399,297,1.00
ptg013824l,375418,375713,295,RepeatMasker,LTR,375114,375794,295,1.00
ptg013828l,339647,339927,280,RepeatMasker,LTR,339615,340232,280,1.00
ptg013848l,657835,658142,307,RepeatMasker,LTR,657362,658004,169,0.55
ptg013848l,657835,658142,307,RepeatMasker,LTR,658004,658039,36,0.12
ptg013848l,845640,845926,286,RepeatMasker,LTR,843407,848523,286,1.00
ptg013848l,1014989,1015291,302,RepeatMasker,LTR,1013054,1017830,302,1.00
ptg013869l,524956,525244,288,RepeatMasker,LTR,524904,525446,288,1.00
ptg013871l,1054494,1054775,281,RepeatMasker,LTR,1053814,1054843,281,1.00
ptg013879l,1351016,1351302,286,RepeatMasker,LTR,1349942,1351699,286,1.00
ptg013879l,1565057,1565370,313,RepeatMasker,LTR,1564728,1566108,313,1.00
ptg013879l,1664455,1664768,313,RepeatMasker,LTR,1663616,1665500,313,1.00
ptg013882l,1143325,1143633,308,RepeatMasker,LTR,1143222,1143500,175,0.57
ptg013894l,3175755,3176036,281,RepeatMasker,LTR,3175124,3177187,281,1.00
ptg013894l,3190024,3190322,298,RepeatMasker,LTR,3189270,3190877,298,1.00
ptg013895l,762338,762632,294,RepeatMasker,LTR,762231,762840,294,1.00
ptg013895l,1361615,1361915,300,RepeatMasker,LTR,1361140,1362469,300,1.00
ptg013895l,1361615,1361915,300,RepeatMasker,LTR,1361281,1363403,300,1.00
ptg013895l,1774253,1774535,282,RepeatMasker,LTR,1773472,1774951,282,1.00
ptg013896l,1054375,1054667,292,RepeatMasker,LTR,1051544,1055009,292,1.00
ptg013902l,481939,482220,281,RepeatMasker,LTR,481294,482610,281,1.00
ptg013902l,489082,489364,282,RepeatMasker,LTR,488279,489745,282,1.00
ptg013914l,1371609,1371908,299,RepeatMasker,LTR,1371557,1372116,299,1.00
ptg013915l,928110,928396,286,RepeatMasker,LTR,926833,929286,286,1.00
ptg013915l,928110,928396,286,RepeatMasker,LTR,927397,930351,286,1.00
ptg013926l,838485,838765,280,RepeatMasker,LTR,837694,839171,280,1.00
ptg013937l,346096,346395,299,RepeatMasker,LTR,346044,346436,299,1.00
ptg013937l,542654,542953,299,RepeatMasker,LTR,542602,542994,299,1.00
ptg013943l,129329,129621,292,RepeatMasker,LTR,129316,129992,292,1.00
ptg013948l,1785192,1785462,270,RepeatMasker,LTR,1784778,1785205,13,0.05
ptg013951l,163318,163613,295,RepeatMasker,LTR,163285,163988,295,1.00
ptg013966l,551761,552076,315,RepeatMasker,LTR,551915,552255,162,0.51
ptg013966l,551761,552076,315,RepeatMasker,LTR,552012,552393,65,0.21
ptg013971l,221340,221645,305,RepeatMasker,LTR,221288,221686,305,1.00
ptg013980l,158417,158716,299,RepeatMasker,LTR,158323,158894,299,1.00
ptg013980l,760441,760742,301,RepeatMasker,LTR,760327,760490,49,0.16
ptg013995l,37412,37704,292,RepeatMasker,LTR,37360,37784,292,1.00
ptg014024l,446029,446361,332,RepeatMasker,LTR,446084,446124,41,0.12
ptg014026l,103389,103708,319,RepeatMasker,LTR,103233,103423,34,0.11
ptg014029l,203939,204248,309,RepeatMasker,LTR,200862,204054,115,0.37
ptg014029l,203939,204248,309,RepeatMasker,LTR,201592,204435,309,1.00
ptg014048l,684157,684455,298,RepeatMasker,LTR,684105,684535,298,1.00
ptg014048l,1155255,1155562,307,RepeatMasker,LTR,1155229,1155807,307,1.00
ptg014053l,809544,809837,293,RepeatMasker,LTR,807103,811242,293,1.00
ptg014053l,809544,809837,293,RepeatMasker,LTR,809245,812063,293,1.00
ptg014055l,42781,43108,327,RepeatMasker,LTR,38451,43092,311,0.95
ptg014057l,571257,571552,295,RepeatMasker,LTR,570140,571420,163,0.55
ptg014058l,261808,262089,281,RepeatMasker,LTR,261163,262471,281,1.00
ptg014062l,835725,836007,282,RepeatMasker,LTR,835872,835937,66,0.23
ptg014062l,835725,836007,282,RepeatMasker,LTR,835945,838834,63,0.22
ptg014062l,835725,836007,282,RepeatMasker,LTR,835521,835900,175,0.62
ptg014062l,835725,836007,282,RepeatMasker,LTR,835564,835880,155,0.55
ptg014066l,647591,647874,283,RepeatMasker,LTR,645407,649298,283,1.00
ptg014068l,698680,698975,295,RepeatMasker,LTR,698628,699016,295,1.00
ptg014069l,297243,297555,312,RepeatMasker,LTR,297250,297320,71,0.23
ptg014069l,297243,297555,312,RepeatMasker,LTR,297264,297336,73,0.23
ptg014069l,297243,297555,312,RepeatMasker,LTR,297327,298215,229,0.73
ptg014076l,2449450,2449739,289,RepeatMasker,LTR,2448762,2453124,289,1.00
ptg014078l,1011831,1012152,321,RepeatMasker,LTR,1010540,1011881,50,0.16
ptg014085l,1491450,1491736,286,RepeatMasker,LTR,1490615,1493269,286,1.00
ptg014086l,835622,835910,288,RepeatMasker,LTR,835128,839460,288,1.00
ptg014086l,853178,853495,317,RepeatMasker,LTR,851782,853981,317,1.00
ptg014101l,687451,687749,298,RepeatMasker,LTR,682401,687499,48,0.16
ptg014107l,206170,206470,300,RepeatMasker,LTR,206118,206682,300,1.00
ptg014107l,839012,839335,323,RepeatMasker,LTR,838899,839159,147,0.46
ptg014112l,29579,29827,248,RepeatMasker,LTR,24531,30523,248,1.00
ptg014112l,110897,111212,315,RepeatMasker,LTR,103988,111059,162,0.51
ptg014112l,110897,111212,315,RepeatMasker,LTR,111134,111272,79,0.25
ptg014113l,123441,123765,324,RepeatMasker,LTR,121439,124910,324,1.00
ptg014114l,514774,515055,281,RepeatMasker,LTR,513973,515443,281,1.00
ptg014122l,324917,325206,289,RepeatMasker,LTR,323329,325562,289,1.00
ptg014123l,419644,419924,280,RepeatMasker,LTR,419870,422989,55,0.20
ptg014129l,1394828,1395109,281,RepeatMasker,LTR,1394190,1396248,281,1.00
ptg014153l,842925,843208,283,RepeatMasker,LTR,842325,845144,283,1.00
ptg014157l,196861,197142,281,RepeatMasker,LTR,196059,197524,281,1.00
ptg014159l,333177,333460,283,RepeatMasker,LTR,329967,334844,283,1.00
ptg014162l,263756,264042,286,RepeatMasker,LTR,263889,264256,154,0.54
ptg014165l,802092,802375,283,RepeatMasker,LTR,801478,802456,283,1.00
ptg014172l,3204162,3204442,280,RepeatMasker,LTR,3203865,3204309,147,0.53
ptg014174l,785564,785854,290,RepeatMasker,LTR,785344,785572,8,0.03
ptg014174l,785564,785854,290,RepeatMasker,LTR,785621,786335,234,0.81
ptg014174l,4367558,4367838,280,RepeatMasker,LTR,4366913,4368221,280,1.00
ptg014178l,235969,236283,314,RepeatMasker,LTR,235825,236183,214,0.68
ptg014178l,1505484,1505786,302,RepeatMasker,LTR,1504560,1509150,302,1.00
ptg014184l,231745,232680,935,RepeatMasker,LTR,232430,232486,57,0.06
ptg014194l,798628,798934,306,RepeatMasker,LTR,798835,798902,68,0.22
ptg014194l,798628,798934,306,RepeatMasker,LTR,798847,798955,88,0.29
ptg014195l,303740,304040,300,RepeatMasker,LTR,303931,304495,110,0.37
ptg014208l,321418,321712,294,RepeatMasker,LTR,320783,322080,294,1.00
ptg014214l,419523,419806,283,RepeatMasker,LTR,418797,420438,283,1.00
ptg014216l,1789244,1789548,304,RepeatMasker,LTR,1787507,1791927,304,1.00
ptg014221l,193135,193433,298,RepeatMasker,LTR,192866,193158,23,0.08
ptg014228l,394618,394932,314,RepeatMasker,LTR,394313,400027,314,1.00
ptg014246l,500263,500573,310,RepeatMasker,LTR,500270,501156,304,0.98
ptg014250l,439315,439620,305,RepeatMasker,LTR,438883,440150,305,1.00
ptg014252l,629649,629956,307,RepeatMasker,LTR,629636,630328,307,1.00
ptg014252l,637180,637460,280,RepeatMasker,LTR,636377,637771,280,1.00
ptg014253l,164406,164687,281,RepeatMasker,LTR,163604,164703,281,1.00
ptg014267l,830618,830923,305,RepeatMasker,LTR,830464,830646,28,0.09
ptg014267l,830618,830923,305,RepeatMasker,LTR,830856,831396,68,0.22
ptg014275l,3815816,3816096,280,RepeatMasker,LTR,3815016,3816485,280,1.00
ptg014284l,74985,75266,281,RepeatMasker,LTR,74349,76324,281,1.00
ptg014291l,135644,135922,278,RepeatMasker,LTR,135631,137057,278,1.00
ptg014291l,142830,143110,280,RepeatMasker,LTR,142817,144157,280,1.00
ptg014291l,452100,452392,292,RepeatMasker,LTR,449270,452734,292,1.00
ptg014324l,65283,65591,308,RepeatMasker,LTR,64488,66639,308,1.00
ptg014327l,862671,862981,310,RepeatMasker,LTR,862746,862827,82,0.26
ptg014331l,42160,42430,270,RepeatMasker,LTR,41983,42583,270,1.00
ptg014335l,361511,361790,279,RepeatMasker,LTR,361371,363379,279,1.00
ptg014346l,238192,238471,279,RepeatMasker,LTR,238180,238865,279,1.00
ptg014346l,274223,274542,319,RepeatMasker,LTR,273246,274237,14,0.04
ptg014346l,1432656,1432937,281,RepeatMasker,LTR,1432623,1433984,281,1.00
ptg014355l,223319,223614,295,RepeatMasker,LTR,223246,223443,124,0.42
ptg014364l,466479,466786,307,RepeatMasker,LTR,466684,466929,103,0.34
ptg014367l,961172,961464,292,RepeatMasker,LTR,959265,962189,292,1.00
ptg014369l,598191,598478,287,RepeatMasker,LTR,597340,602489,287,1.00
ptg014381l,3076319,3076618,299,RepeatMasker,LTR,3076267,3076812,299,1.00
ptg014398l,366025,366345,320,RepeatMasker,LTR,366294,366369,52,0.16
ptg014405l,326017,326290,273,RepeatMasker,LTR,326253,326629,38,0.14
ptg014406l,205320,205641,321,RepeatMasker,LTR,205468,205551,84,0.26
ptg014410l,930280,930618,338,RepeatMasker,LTR,929635,930576,296,0.88
ptg014410l,930280,930618,338,RepeatMasker,LTR,930598,931000,21,0.06
ptg014415l,694098,694416,318,RepeatMasker,LTR,694086,694766,318,1.00
ptg014415l,718901,719182,281,RepeatMasker,LTR,718869,719564,281,1.00
ptg014421l,637636,637916,280,RepeatMasker,LTR,636990,638298,280,1.00
ptg014421l,1834495,1834793,298,RepeatMasker,LTR,1834244,1834666,171,0.57
ptg014428l,125059,125340,281,RepeatMasker,LTR,125031,125729,281,1.00
ptg014429l,400664,400985,321,RepeatMasker,LTR,400661,400871,207,0.64
ptg014429l,400664,400985,321,RepeatMasker,LTR,400840,400898,59,0.18
ptg014456l,473970,474257,287,RepeatMasker,LTR,473967,474193,223,0.78
ptg014456l,473970,474257,287,RepeatMasker,LTR,474067,474864,191,0.67
ptg014458l,2283100,2283400,300,RepeatMasker,LTR,2282455,2283770,300,1.00
ptg014465l,112043,112334,291,RepeatMasker,LTR,109573,112216,173,0.59
ptg014469l,47147,47448,301,RepeatMasker,LTR,46357,47829,301,1.00
ptg014469l,111756,112037,281,RepeatMasker,LTR,110958,112411,281,1.00
ptg014484l,586726,587024,298,RepeatMasker,LTR,586086,588136,298,1.00
ptg014489l,1033933,1034265,332,RepeatMasker,LTR,1032628,1034207,274,0.83
ptg014489l,1033933,1034265,332,RepeatMasker,LTR,1034205,1034378,61,0.18
ptg014491l,173731,174042,311,RepeatMasker,LTR,173931,173988,58,0.19
ptg014491l,173731,174042,311,RepeatMasker,LTR,173945,174059,98,0.32
ptg014529l,999831,1000168,337,RepeatMasker,LTR,1000055,1001048,114,0.34
ptg014542l,939201,939503,302,RepeatMasker,LTR,937950,939333,132,0.44
ptg014542l,939201,939503,302,RepeatMasker,LTR,938991,940257,302,1.00
ptg014555l,376314,376592,278,RepeatMasker,LTR,376301,377729,278,1.00
ptg014557l,1544948,1545245,297,RepeatMasker,LTR,1544896,1545453,297,1.00
ptg014559l,416060,416355,295,RepeatMasker,LTR,416008,416533,295,1.00
ptg014562l,246859,247157,298,RepeatMasker,LTR,244936,248133,298,1.00
ptg014568l,129658,129938,280,RepeatMasker,LTR,129011,131127,280,1.00
ptg014568l,130027,130323,296,RepeatMasker,LTR,129011,131127,296,1.00
ptg014568l,136828,137108,280,RepeatMasker,LTR,136042,138145,280,1.00
ptg014569l,92356,92664,308,RepeatMasker,LTR,90614,92386,30,0.10
ptg014592l,1042964,1043263,299,RepeatMasker,LTR,1042912,1043438,299,1.00
ptg014599l,154782,155084,302,RepeatMasker,LTR,153532,154911,129,0.43
ptg014599l,154782,155084,302,RepeatMasker,LTR,154572,155839,302,1.00
ptg014599l,2224059,2224365,306,RepeatMasker,LTR,2223523,2224590,306,1.00
ptg014636l,218619,218919,300,RepeatMasker,LTR,216173,218743,124,0.41
ptg014636l,1109245,1109549,304,RepeatMasker,LTR,1108611,1110601,304,1.00
ptg014638l,1224472,1224781,309,RepeatMasker,LTR,1224246,1225530,309,1.00
ptg014638l,1533336,1533617,281,RepeatMasker,LTR,1532709,1533999,281,1.00
ptg014638l,1654215,1654512,297,RepeatMasker,LTR,1653426,1655543,297,1.00
ptg014650l,1079903,1080185,282,RepeatMasker,LTR,1079787,1080044,141,0.50
ptg014650l,1125264,1125563,299,RepeatMasker,LTR,1125212,1125741,299,1.00
ptg014663l,395926,396225,299,RepeatMasker,LTR,395874,396394,299,1.00
ptg014677l,615420,615701,281,RepeatMasker,LTR,615407,616758,281,1.00
ptg014678l,267635,267921,286,RepeatMasker,LTR,266772,272570,286,1.00
ptg014678l,832385,832712,327,RepeatMasker,LTR,831139,832767,327,1.00
ptg014687l,892943,893240,297,RepeatMasker,LTR,892909,893626,297,1.00
ptg014693l,74829,75124,295,RepeatMasker,LTR,74777,75301,295,1.00
ptg014698l,472791,473071,280,RepeatMasker,LTR,472163,474209,280,1.00
ptg014703l,1219131,1219427,296,RepeatMasker,LTR,1219097,1219450,296,1.00
ptg014703l,3614074,3614360,286,RepeatMasker,LTR,3614053,3616278,286,1.00
ptg014706l,382742,383029,287,RepeatMasker,LTR,381889,387672,287,1.00
ptg014707l,343436,343718,282,RepeatMasker,LTR,342525,344659,282,1.00
ptg014717l,1282489,1282773,284,RepeatMasker,LTR,1282157,1282656,167,0.59
ptg014717l,1282489,1282773,284,RepeatMasker,LTR,1282193,1282623,134,0.47
ptg014723l,71039,71312,273,RepeatMasker,LTR,70890,71457,273,1.00
ptg014733l,740793,741086,293,RepeatMasker,LTR,740355,741477,293,1.00
ptg014736l,211924,212209,285,RepeatMasker,LTR,212162,212520,48,0.17
ptg014758l,624090,624370,280,RepeatMasker,LTR,623289,624752,280,1.00
ptg014760l,284776,285073,297,RepeatMasker,LTR,284555,284782,6,0.02
ptg014768l,261437,261692,255,RepeatMasker,LTR,261240,262242,255,1.00
ptg014768l,261437,261692,255,RepeatMasker,LTR,261401,262470,255,1.00
ptg014770l,384732,385031,299,RepeatMasker,LTR,384680,385209,299,1.00
ptg014784l,1436112,1436399,287,RepeatMasker,LTR,1436087,1436478,287,1.00
ptg014793l,3563314,3563573,259,RepeatMasker,LTR,3561939,3563433,119,0.46
ptg014803l,271403,271722,319,RepeatMasker,LTR,271419,271635,217,0.68
ptg014808l,370822,371099,277,RepeatMasker,LTR,370600,371160,277,1.00
ptg014808l,370822,371099,277,RepeatMasker,LTR,370835,374527,265,0.96
ptg014813l,1543491,1543802,311,RepeatMasker,LTR,1543604,1543893,199,0.64
ptg014817l,478887,479182,295,RepeatMasker,LTR,477992,479100,213,0.72
ptg014817l,478887,479182,295,RepeatMasker,LTR,477992,479304,295,1.00
ptg014817l,478887,479182,295,RepeatMasker,LTR,478355,479513,295,1.00
ptg014819l,41617,41947,330,RepeatMasker,LTR,41872,41961,76,0.23
ptg014822l,361507,361800,293,RepeatMasker,LTR,361460,361880,293,1.00
ptg014828l,42009,42291,282,RepeatMasker,LTR,42181,42609,111,0.39
ptg014828l,1119408,1119684,276,RepeatMasker,LTR,1119396,1120107,276,1.00
ptg014833l,897125,897411,286,RepeatMasker,LTR,896749,898353,286,1.00
ptg014833l,1511749,1512031,282,RepeatMasker,LTR,1511736,1512345,282,1.00
ptg014833l,1511749,1512031,282,RepeatMasker,LTR,1511738,1512423,282,1.00
ptg014836l,715613,715878,265,RepeatMasker,LTR,714857,715758,145,0.55
ptg014847l,374943,375254,311,RepeatMasker,LTR,373158,375003,60,0.19
ptg014851l,1816140,1816451,311,RepeatMasker,LTR,1816251,1816342,92,0.30
ptg014854l,528790,529095,305,RepeatMasker,LTR,528941,530835,155,0.51
ptg014859l,385205,385535,330,RepeatMasker,LTR,384006,386242,330,1.00
ptg014859l,385205,385535,330,RepeatMasker,LTR,384375,386293,330,1.00
ptg014859l,584759,585041,282,RepeatMasker,LTR,584121,586175,282,1.00
ptg014859l,609790,610084,294,RepeatMasker,LTR,609777,611117,294,1.00
ptg014859l,2572003,2572300,297,RepeatMasker,LTR,2569069,2572687,297,1.00
ptg014871l,844112,844399,287,RepeatMasker,LTR,844070,844204,92,0.32
ptg014902l,483885,484152,267,RepeatMasker,LTR,483465,483968,83,0.31
ptg014913l,2659648,2659952,304,RepeatMasker,LTR,2659451,2661978,304,1.00
ptg014918l,229810,230095,285,RepeatMasker,LTR,230072,230116,24,0.08
ptg014924l,2915963,2916258,295,RepeatMasker,LTR,2916148,2916199,52,0.18
ptg014934l,79172,79482,310,RepeatMasker,LTR,79478,82502,5,0.02
ptg014951l,507797,508088,291,RepeatMasker,LTR,507784,509129,291,1.00
ptg014962l,977352,977632,280,RepeatMasker,LTR,976710,977950,280,1.00
ptg014968l,913151,913478,327,RepeatMasker,LTR,912829,913445,294,0.90
ptg014970l,681927,682229,302,RepeatMasker,LTR,682162,683851,68,0.23
ptg014971l,1245741,1246034,293,RepeatMasker,LTR,1245710,1245834,93,0.32
ptg014973l,108381,108678,297,RepeatMasker,LTR,108329,108872,297,1.00
ptg014973l,264980,265275,295,RepeatMasker,LTR,264928,265453,295,1.00
ptg014973l,546660,546959,299,RepeatMasker,LTR,546608,547124,299,1.00
ptg014993l,815523,815803,280,RepeatMasker,LTR,814877,816866,280,1.00
ptg015003l,770348,770627,279,RepeatMasker,LTR,769546,771009,279,1.00
ptg015003l,1197545,1197853,308,RepeatMasker,LTR,1197534,1198130,308,1.00
ptg015005l,119684,119972,288,RepeatMasker,LTR,119858,121948,115,0.40
ptg015044l,783914,784213,299,RepeatMasker,LTR,783862,784378,299,1.00
ptg015048l,597735,598053,318,RepeatMasker,LTR,596956,597772,37,0.12
ptg015050l,388132,388432,300,RepeatMasker,LTR,388098,388625,300,1.00
ptg015051l,721120,721415,295,RepeatMasker,LTR,721068,721593,295,1.00
ptg015051l,1656623,1656922,299,RepeatMasker,LTR,1656571,1657117,299,1.00
ptg015068l,577961,578239,278,RepeatMasker,LTR,577327,578557,278,1.00
ptg015069l,305650,305949,299,RepeatMasker,LTR,305598,306157,299,1.00
ptg015071l,1468928,1469214,286,RepeatMasker,LTR,1468079,1472014,286,1.00
ptg015073l,599149,599441,292,RepeatMasker,LTR,599116,599485,292,1.00
ptg015082l,251732,252011,279,RepeatMasker,LTR,251291,252008,276,0.99
ptg015082l,564578,564880,302,RepeatMasker,LTR,563777,565273,302,1.00
ptg015084l,829229,829539,310,RepeatMasker,LTR,828746,830564,310,1.00
ptg015102l,309381,309662,281,RepeatMasker,LTR,309639,309684,24,0.09
ptg015121l,478393,478710,317,RepeatMasker,LTR,477918,478541,148,0.47
ptg015124l,612702,613011,309,RepeatMasker,LTR,611897,613399,309,1.00
ptg015131l,257536,257861,325,RepeatMasker,LTR,257686,258825,176,0.54
ptg015131l,391820,392109,289,RepeatMasker,LTR,391768,392285,289,1.00
ptg015133l,336807,337087,280,RepeatMasker,LTR,335998,337469,280,1.00
ptg015133l,357987,358267,280,RepeatMasker,LTR,357975,358649,280,1.00
ptg015152l,24134,24464,330,RepeatMasker,LTR,21569,24748,330,1.00
ptg015154l,1230177,1230458,281,RepeatMasker,LTR,1230144,1230474,281,1.00
ptg015159l,336664,336956,292,RepeatMasker,LTR,333831,337298,292,1.00
ptg015159l,622513,622807,294,RepeatMasker,LTR,622705,623271,103,0.35
ptg015168l,501746,502080,334,RepeatMasker,LTR,500495,505256,334,1.00
ptg015172l,253023,253303,280,RepeatMasker,LTR,252375,253697,280,1.00
ptg015173l,111717,112016,299,RepeatMasker,LTR,111665,112224,299,1.00
ptg015173l,214471,214770,299,RepeatMasker,LTR,214419,214850,299,1.00
ptg015173l,641105,641410,305,RepeatMasker,LTR,641071,641653,305,1.00
ptg015178l,700147,700428,281,RepeatMasker,LTR,700114,700739,281,1.00
ptg015182l,309469,309766,297,RepeatMasker,LTR,309498,309616,119,0.40
ptg015186l,514787,515082,295,RepeatMasker,LTR,514735,515282,295,1.00
ptg015189l,1045337,1045628,291,RepeatMasker,LTR,1044543,1046002,291,1.00
ptg015216l,216179,216459,280,RepeatMasker,LTR,216145,216770,280,1.00
ptg015222l,353224,353486,262,RepeatMasker,LTR,347906,353386,162,0.62
ptg015225l,2265458,2265755,297,RepeatMasker,LTR,2265424,2265746,288,0.97
ptg015226l,64277,64571,294,RepeatMasker,LTR,64485,64527,43,0.15
ptg015229l,225116,225399,283,RepeatMasker,LTR,224939,225192,76,0.27
ptg015229l,225116,225399,283,RepeatMasker,LTR,224943,225159,43,0.15
ptg015229l,319196,319473,277,RepeatMasker,LTR,319091,321643,277,1.00
ptg015230l,1606040,1606320,280,RepeatMasker,LTR,1606007,1606709,280,1.00
ptg015231l,1054799,1055110,311,RepeatMasker,LTR,1054968,1055239,143,0.46
ptg015235l,523682,523983,301,RepeatMasker,LTR,523670,524343,301,1.00
ptg015236l,352825,353106,281,RepeatMasker,LTR,350255,356156,281,1.00
ptg015237l,1436896,1437216,320,RepeatMasker,LTR,1431050,1436946,50,0.16
ptg015245l,658474,658765,291,RepeatMasker,LTR,655242,662934,291,1.00
ptg015245l,767892,768219,327,RepeatMasker,LTR,767952,768046,95,0.29
ptg015248l,530750,531035,285,RepeatMasker,LTR,531012,531056,24,0.08
ptg015250l,426576,426895,319,RepeatMasker,LTR,426771,426822,52,0.16
ptg015253l,148617,148911,294,RepeatMasker,LTR,148409,148631,14,0.05
ptg015256l,1351349,1351677,328,RepeatMasker,LTR,1351193,1351417,68,0.21
ptg015293l,1780069,1780366,297,RepeatMasker,LTR,1780017,1780544,297,1.00
ptg015293l,2150380,2150678,298,RepeatMasker,LTR,2150328,2150857,298,1.00
ptg015295l,435423,435709,286,RepeatMasker,LTR,432570,435599,176,0.62
ptg015297l,2125826,2126126,300,RepeatMasker,LTR,2125774,2126260,300,1.00
ptg015297l,2461666,2461947,281,RepeatMasker,LTR,2459081,2465019,281,1.00
ptg015298l,519456,519781,325,RepeatMasker,LTR,516906,520584,325,1.00
ptg015312l,556427,556675,248,RepeatMasker,LTR,551371,560880,248,1.00
ptg015324l,986213,986525,312,RepeatMasker,LTR,986050,987469,312,1.00
ptg015328l,654033,654314,281,RepeatMasker,LTR,653237,654694,281,1.00
ptg015334l,892127,892446,319,RepeatMasker,LTR,888805,892177,50,0.16
ptg015335l,641973,642270,297,RepeatMasker,LTR,642218,643258,53,0.18
ptg015338l,379922,380230,308,RepeatMasker,LTR,377630,380034,112,0.36
ptg015347l,1233871,1234184,313,RepeatMasker,LTR,1234175,1239597,10,0.03
ptg015349l,332403,332729,326,RepeatMasker,LTR,330217,334233,326,1.00
ptg015350l,1985907,1986215,308,RepeatMasker,LTR,1986128,1986744,88,0.29
ptg015350l,1985907,1986215,308,RepeatMasker,LTR,1982356,1985935,28,0.09
ptg015372l,213442,213722,280,RepeatMasker,LTR,212661,214043,280,1.00
ptg015381l,98858,99138,280,RepeatMasker,LTR,98825,99550,280,1.00
ptg015382l,210632,210945,313,RepeatMasker,LTR,209259,212375,313,1.00
ptg015388l,407048,407329,281,RepeatMasker,LTR,407021,408376,281,1.00
ptg015398l,678734,679015,281,RepeatMasker,LTR,677932,679396,281,1.00
ptg015405l,123019,123323,304,RepeatMasker,LTR,123049,123127,79,0.26
ptg015410l,37120,37428,308,RepeatMasker,LTR,30257,37282,162,0.53
ptg015418l,262800,263081,281,RepeatMasker,LTR,262156,263475,281,1.00
ptg015426l,568873,569154,281,RepeatMasker,LTR,568860,570209,281,1.00
ptg015446l,22893,23179,286,RepeatMasker,LTR,23156,23200,24,0.08
ptg015454l,1923766,1924058,292,RepeatMasker,LTR,1923912,1924111,147,0.50
ptg015464l,569262,569561,299,RepeatMasker,LTR,569210,569641,299,1.00
ptg015464l,2199340,2199631,291,RepeatMasker,LTR,2196762,2199433,93,0.32
ptg015465l,321214,321495,281,RepeatMasker,LTR,318809,322289,281,1.00
ptg015479l,200439,200716,277,RepeatMasker,LTR,200317,200777,277,1.00
ptg015479l,200439,200716,277,RepeatMasker,LTR,200449,202036,268,0.97
ptg015494l,841339,841631,292,RepeatMasker,LTR,841305,841654,292,1.00
ptg015504l,2742559,2742853,294,RepeatMasker,LTR,2742331,2743579,294,1.00
ptg015506l,3005854,3006185,331,RepeatMasker,LTR,3006020,3006565,166,0.50
ptg015506l,3249632,3249968,336,RepeatMasker,LTR,3249182,3249773,141,0.42
ptg015514l,718263,718557,294,RepeatMasker,LTR,718254,718474,211,0.72
ptg015514l,718263,718557,294,RepeatMasker,LTR,718406,718883,152,0.52
ptg015521l,149061,149348,287,RepeatMasker,LTR,148205,151307,287,1.00
ptg015522l,513526,513809,283,RepeatMasker,LTR,513469,514054,283,1.00
ptg015527l,574578,574870,292,RepeatMasker,LTR,573878,575212,292,1.00
ptg015535l,168282,168558,276,RepeatMasker,LTR,168075,168288,6,0.02
ptg015546l,665659,665940,281,RepeatMasker,LTR,665014,666330,281,1.00
ptg015546l,787854,788152,298,RepeatMasker,LTR,787821,788517,298,1.00
ptg015548l,37932,38212,280,RepeatMasker,LTR,37131,38457,280,1.00
ptg015556l,2410777,2411054,277,RepeatMasker,LTR,2410365,2411073,277,1.00
ptg015556l,2410777,2411054,277,RepeatMasker,LTR,2410521,2411074,277,1.00
ptg015560l,547790,548090,300,RepeatMasker,LTR,546923,548052,262,0.87
ptg015580l,565792,566091,299,RepeatMasker,LTR,565541,569182,299,1.00
ptg015585l,45327,45624,297,RepeatMasker,LTR,45410,45670,215,0.72
ptg015585l,269868,270188,320,RepeatMasker,LTR,268074,269918,50,0.16
ptg015611l,533742,534041,299,RepeatMasker,LTR,533690,534121,299,1.00
ptg015615l,353286,353566,280,RepeatMasker,LTR,353253,354223,280,1.00
ptg015621l,387529,387833,304,RepeatMasker,LTR,387719,387944,115,0.38
ptg015624l,562307,562600,293,RepeatMasker,LTR,562139,562348,41,0.14
ptg015624l,562307,562600,293,RepeatMasker,LTR,562527,562669,74,0.25
ptg015640l,452712,453011,299,RepeatMasker,LTR,452660,453206,299,1.00
ptg015640l,513218,513508,290,RepeatMasker,LTR,513166,513673,290,1.00
ptg015646l,86908,87189,281,RepeatMasker,LTR,86263,87486,281,1.00
ptg015656l,1242260,1242549,289,RepeatMasker,LTR,1242343,1242871,207,0.72
ptg015659l,221258,221551,293,RepeatMasker,LTR,221206,221759,293,1.00
ptg015659l,292405,292702,297,RepeatMasker,LTR,292353,292910,297,1.00
ptg015666l,265329,265653,324,RepeatMasker,LTR,265297,265625,296,0.91
ptg015666l,669927,670246,319,RepeatMasker,LTR,669003,669967,40,0.13
ptg015666l,1279181,1279460,279,RepeatMasker,LTR,1279220,1279518,241,0.86
ptg015666l,2320133,2320420,287,RepeatMasker,LTR,2319309,2320697,287,1.00
ptg015682l,92929,93210,281,RepeatMasker,LTR,92128,93591,281,1.00
ptg015686l,151426,151745,319,RepeatMasker,LTR,149750,151475,49,0.15
ptg015696l,37234,37536,302,RepeatMasker,LTR,36440,37517,283,0.94
ptg015696l,37234,37536,302,RepeatMasker,LTR,37223,37939,302,1.00
ptg015696l,461835,462116,281,RepeatMasker,LTR,461804,463157,281,1.00
ptg015704l,461927,462235,308,RepeatMasker,LTR,462094,463287,142,0.46
ptg015705l,271103,271395,292,RepeatMasker,LTR,264900,271153,50,0.17
ptg015705l,274889,275176,287,RepeatMasker,LTR,274032,279890,287,1.00
ptg015709l,189472,189762,290,RepeatMasker,LTR,189316,189689,217,0.75
ptg015714l,591992,592284,292,RepeatMasker,LTR,591335,592042,50,0.17
ptg015714l,1159645,1159926,281,RepeatMasker,LTR,1159633,1160314,281,1.00
ptg015715l,637459,637735,276,RepeatMasker,LTR,637712,637756,24,0.09
ptg015720l,47803,48098,295,RepeatMasker,LTR,47751,48263,295,1.00
ptg015720l,241349,241646,297,RepeatMasker,LTR,241297,241823,297,1.00
ptg015722l,627549,627829,280,RepeatMasker,LTR,626754,628233,280,1.00
ptg015748l,525375,525683,308,RepeatMasker,LTR,525043,525954,308,1.00
ptg015749l,33478,33798,320,RepeatMasker,LTR,32713,38855,320,1.00
ptg015759l,182482,182762,280,RepeatMasker,LTR,181846,183149,280,1.00
ptg015762l,309578,309877,299,RepeatMasker,LTR,309526,310058,299,1.00
ptg015766l,726101,726382,281,RepeatMasker,LTR,725456,726771,281,1.00
ptg015768l,6140350,6140649,299,RepeatMasker,LTR,6140298,6140729,299,1.00
ptg015768l,6232015,6232325,310,RepeatMasker,LTR,6231738,6232259,244,0.79
ptg015768l,7070574,7070885,311,RepeatMasker,LTR,7070399,7072634,311,1.00
ptg015778l,630009,630290,281,RepeatMasker,LTR,629216,631293,281,1.00
ptg015803l,69100,69399,299,RepeatMasker,LTR,69048,69577,299,1.00
ptg015806l,233143,233451,308,RepeatMasker,LTR,233096,233174,31,0.10
ptg015806l,233143,233451,308,RepeatMasker,LTR,233185,233587,267,0.87
ptg015813l,1320425,1320670,245,RepeatMasker,LTR,1315381,1323813,245,1.00
ptg015824l,32463,32761,298,RepeatMasker,LTR,31820,33053,298,1.00
ptg015825l,758338,758636,298,RepeatMasker,LTR,758286,758812,298,1.00
ptg015834l,252396,252718,322,RepeatMasker,LTR,252609,252771,110,0.34
ptg015841l,920776,921043,267,RepeatMasker,LTR,917069,920801,25,0.09
ptg015845l,3012227,3012554,327,RepeatMasker,LTR,3009750,3012849,327,1.00
ptg015852l,17960,18242,282,RepeatMasker,LTR,17948,18626,282,1.00
ptg015869l,495326,495628,302,RepeatMasker,LTR,494075,495458,132,0.44
ptg015880l,713999,714301,302,RepeatMasker,LTR,710572,714036,37,0.12
ptg015880l,2534781,2535079,298,RepeatMasker,LTR,2534735,2535272,298,1.00
ptg015880l,2541457,2541751,294,RepeatMasker,LTR,2541405,2541816,294,1.00
ptg015881l,634237,634541,304,RepeatMasker,LTR,634484,636099,58,0.19
ptg015891l,90451,90771,320,RepeatMasker,LTR,84321,90501,50,0.16
ptg015894l,22471,22756,285,RepeatMasker,LTR,22616,22920,141,0.49
ptg015895l,245840,246132,292,RepeatMasker,LTR,243433,247709,292,1.00
ptg015902l,328135,328448,313,RepeatMasker,LTR,328330,329345,119,0.38
ptg015902l,328135,328448,313,RepeatMasker,LTR,328348,329233,101,0.32
ptg015919l,2987237,2987536,299,RepeatMasker,LTR,2987185,2987744,299,1.00
ptg015927l,710258,710540,282,RepeatMasker,LTR,710225,710898,282,1.00
ptg015927l,1449318,1449599,281,RepeatMasker,LTR,1449285,1449906,281,1.00
ptg015937l,146155,146448,293,RepeatMasker,LTR,146103,146623,293,1.00
ptg015947l,523292,523588,296,RepeatMasker,LTR,523240,523767,296,1.00
ptg015973l,296941,297258,317,RepeatMasker,LTR,296896,297233,292,0.92
ptg015973l,296941,297258,317,RepeatMasker,LTR,296936,298697,317,1.00
ptg015980l,162827,163150,323,RepeatMasker,LTR,163041,163180,110,0.34
ptg015985l,831788,832074,286,RepeatMasker,LTR,825671,832459,286,1.00
ptg015989l,26908,27207,299,RepeatMasker,LTR,26654,30724,299,1.00
ptg015993l,343808,344094,286,RepeatMasker,LTR,343418,344101,286,1.00
ptg015993l,343808,344094,286,RepeatMasker,LTR,343922,344146,173,0.60
ptg016009l,49013,49333,320,RepeatMasker,LTR,48111,49063,50,0.16
ptg016011l,1105849,1106130,281,RepeatMasker,LTR,1105149,1107142,281,1.00
ptg016014l,644228,644535,307,RepeatMasker,LTR,644207,644415,187,0.61
ptg016021l,198817,199134,317,RepeatMasker,LTR,192907,198847,30,0.09
ptg016028l,126880,127174,294,RepeatMasker,LTR,126828,127380,294,1.00
ptg016033l,557654,557937,283,RepeatMasker,LTR,557622,559078,283,1.00
ptg016033l,564644,564925,281,RepeatMasker,LTR,564301,565876,281,1.00
ptg016041l,391456,391737,281,RepeatMasker,LTR,389877,391603,147,0.52
ptg016046l,369443,369743,300,RepeatMasker,LTR,369400,369759,300,1.00
ptg016046l,369443,369743,300,RepeatMasker,LTR,369410,369832,300,1.00
ptg016046l,897217,897523,306,RepeatMasker,LTR,897309,897558,215,0.70
ptg016053l,1981579,1981860,281,RepeatMasker,LTR,1981560,1982992,281,1.00
ptg016062l,79119,79401,282,RepeatMasker,LTR,78931,79190,71,0.25
ptg016067l,199177,199458,281,RepeatMasker,LTR,198377,199840,281,1.00
ptg016097l,166982,167264,282,RepeatMasker,LTR,166348,168397,282,1.00
ptg016098l,150854,151141,287,RepeatMasker,LTR,149997,155636,287,1.00
ptg016103l,558127,558431,304,RepeatMasker,LTR,557584,560435,304,1.00
ptg016106l,678156,678472,316,RepeatMasker,LTR,678051,678411,255,0.81
ptg016112l,1283289,1283604,315,RepeatMasker,LTR,1283585,1284802,20,0.06
ptg016114l,161390,161687,297,RepeatMasker,LTR,161344,161728,297,1.00
ptg016126l,337293,337579,286,RepeatMasker,LTR,336447,342230,286,1.00
ptg016143l,72167,72464,297,RepeatMasker,LTR,72366,72649,99,0.33
ptg016143l,335874,336153,279,RepeatMasker,LTR,335212,336564,279,1.00
ptg016176l,167173,167501,328,RepeatMasker,LTR,167071,167810,328,1.00
ptg016177l,14672,14957,285,RepeatMasker,LTR,14934,14983,24,0.08
ptg016189l,108677,108982,305,RepeatMasker,LTR,108368,108678,1,0.00
ptg016189l,108677,108982,305,RepeatMasker,LTR,108795,109504,188,0.62
ptg016189l,108677,108982,305,RepeatMasker,LTR,108795,109865,188,0.62
ptg016190l,452686,453009,323,RepeatMasker,LTR,452976,453448,34,0.11
ptg016196l,826224,826504,280,RepeatMasker,LTR,825589,826887,280,1.00
ptg016196l,849162,849441,279,RepeatMasker,LTR,848382,849757,279,1.00
ptg016200l,247132,247451,319,RepeatMasker,LTR,246677,247369,237,0.74
ptg016216l,193628,193941,313,RepeatMasker,LTR,191733,193636,8,0.03
ptg016216l,193628,193941,313,RepeatMasker,LTR,193863,194633,79,0.25
ptg016239l,354801,355106,305,RepeatMasker,LTR,354832,355061,230,0.75
ptg016239l,565231,565528,297,RepeatMasker,LTR,563239,565279,48,0.16
ptg016239l,1616009,1616323,314,RepeatMasker,LTR,1615388,1616037,28,0.09
ptg016239l,1616009,1616323,314,RepeatMasker,LTR,1616236,1616805,88,0.28
ptg016248l,304033,304314,281,RepeatMasker,LTR,304000,304330,281,1.00
ptg016248l,2081704,2082024,320,RepeatMasker,LTR,2081052,2081754,50,0.16
ptg016250l,464373,464662,289,RepeatMasker,LTR,464364,464598,225,0.78
ptg016250l,464373,464662,289,RepeatMasker,LTR,464472,464827,191,0.66
ptg016263l,280779,281111,332,RepeatMasker,LTR,280654,280807,28,0.08
ptg016288l,1372893,1373212,319,RepeatMasker,LTR,1373150,1373852,63,0.20
ptg016313l,273996,274302,306,RepeatMasker,LTR,269388,274187,191,0.62
ptg016321l,320536,320817,281,RepeatMasker,LTR,319734,321180,281,1.00
ptg016324l,846515,846801,286,RepeatMasker,LTR,840384,847200,286,1.00
ptg016335l,363335,363616,281,RepeatMasker,LTR,363322,364682,281,1.00
ptg016339l,236699,236947,248,RepeatMasker,LTR,231644,241145,248,1.00
ptg016343l,645839,646154,315,RepeatMasker,LTR,645874,646020,147,0.47
ptg016378l,532076,532375,299,RepeatMasker,LTR,532024,532556,299,1.00
ptg016386l,885329,885608,279,RepeatMasker,LTR,884673,886013,279,1.00
ptg016389l,286223,286547,324,RepeatMasker,LTR,283408,286355,132,0.41
ptg016395l,116866,117163,297,RepeatMasker,LTR,116570,117022,156,0.53
ptg016410l,42164,42474,310,RepeatMasker,LTR,39632,42795,310,1.00
ptg016437l,311294,311599,305,RepeatMasker,LTR,310501,311991,305,1.00
ptg016445l,407890,408187,297,RepeatMasker,LTR,407760,408101,211,0.71
ptg016446l,27045,27356,311,RepeatMasker,LTR,26828,28235,311,1.00
ptg016450l,692217,692544,327,RepeatMasker,LTR,692008,692223,6,0.02
ptg016454l,454449,454749,300,RepeatMasker,LTR,454520,456345,230,0.77
ptg016457l,637341,637630,289,RepeatMasker,LTR,637295,637671,289,1.00
ptg016462l,2460832,2461131,299,RepeatMasker,LTR,2460780,2461211,299,1.00
ptg016483l,357945,358216,271,RepeatMasker,LTR,353691,358107,162,0.60
ptg016489l,420292,420571,279,RepeatMasker,LTR,420054,420357,65,0.23
ptg016489l,420292,420571,279,RepeatMasker,LTR,420362,420560,199,0.71
ptg016491l,911216,911515,299,RepeatMasker,LTR,911164,911708,299,1.00
ptg016492l,176582,176877,295,RepeatMasker,LTR,176530,177085,295,1.00
ptg016501l,177805,178084,279,RepeatMasker,LTR,176997,178466,279,1.00
ptg016517l,437126,437444,318,RepeatMasker,LTR,437393,437437,45,0.14
ptg016533l,354492,354808,316,RepeatMasker,LTR,354422,357613,316,1.00
ptg016545l,235222,235521,299,RepeatMasker,LTR,235170,235601,299,1.00
ptg016558l,266589,266888,299,RepeatMasker,LTR,266537,267066,299,1.00
ptg016586l,1011116,1011413,297,RepeatMasker,LTR,1009758,1011168,52,0.18
ptg016596l,1057408,1057701,293,RepeatMasker,LTR,1057395,1058839,293,1.00
ptg016598l,188920,189219,299,RepeatMasker,LTR,188868,189299,299,1.00
ptg016609l,453492,453776,284,RepeatMasker,LTR,452637,455350,284,1.00
ptg016611l,15164,15444,280,RepeatMasker,LTR,14539,15310,146,0.52
ptg016616l,521028,521340,312,RepeatMasker,LTR,514197,521200,172,0.55
ptg016629l,1227818,1228137,319,RepeatMasker,LTR,1227731,1228309,319,1.00
ptg016644l,869387,869688,301,RepeatMasker,LTR,868574,870687,301,1.00
ptg016648l,387716,387996,280,RepeatMasker,LTR,387576,388057,280,1.00
ptg016648l,387716,387996,280,RepeatMasker,LTR,387729,391427,268,0.96
ptg016662l,20117,20414,297,RepeatMasker,LTR,20083,20494,297,1.00
ptg016662l,884291,884586,295,RepeatMasker,LTR,884239,884751,295,1.00
ptg016669l,513295,513587,292,RepeatMasker,LTR,512227,513742,292,1.00
ptg016672l,32956,33253,297,RepeatMasker,LTR,32904,33333,297,1.00
ptg016674l,218191,218471,280,RepeatMasker,LTR,218178,219525,280,1.00
ptg016684l,197984,198264,280,RepeatMasker,LTR,197340,198652,280,1.00
ptg016684l,220871,221152,281,RepeatMasker,LTR,220068,221545,281,1.00
ptg016684l,220871,221152,281,RepeatMasker,LTR,220837,221474,281,1.00
ptg016684l,543609,543902,293,RepeatMasker,LTR,543596,544200,293,1.00
ptg016716l,272840,273137,297,RepeatMasker,LTR,272188,273502,297,1.00
ptg016723l,595078,595409,331,RepeatMasker,LTR,595372,597292,38,0.11
ptg016727l,334891,335171,280,RepeatMasker,LTR,334246,335552,280,1.00
ptg016727l,1301245,1301524,279,RepeatMasker,LTR,1300454,1301540,279,1.00
ptg016731l,5286,5637,351,RepeatMasker,LTR,4944,5606,320,0.91
ptg016741l,129012,129301,289,RepeatMasker,LTR,128960,129503,289,1.00
ptg016741l,1236527,1236826,299,RepeatMasker,LTR,1236475,1236991,299,1.00
ptg016751l,882387,882700,313,RepeatMasker,LTR,882680,882942,21,0.07
ptg016753l,771761,772041,280,RepeatMasker,LTR,771735,772307,280,1.00
ptg016753l,771761,772041,280,RepeatMasker,LTR,771741,772133,280,1.00
ptg016767l,1835212,1835493,281,RepeatMasker,LTR,1835179,1835882,281,1.00
ptg016769l,1170634,1170963,329,RepeatMasker,LTR,1170644,1171097,320,0.97
ptg016770l,518236,518556,320,RepeatMasker,LTR,515705,518286,50,0.16
ptg016795l,746927,747244,317,RepeatMasker,LTR,746567,747040,113,0.36
ptg016814l,719866,720146,280,RepeatMasker,LTR,719230,720538,280,1.00
ptg016816l,557305,557602,297,RepeatMasker,LTR,553992,558114,297,1.00
ptg016824l,895407,895700,293,RepeatMasker,LTR,895342,895521,114,0.39
ptg016831l,29737,30017,280,RepeatMasker,LTR,29101,31004,280,1.00
ptg016831l,53412,53693,281,RepeatMasker,LTR,52629,54669,281,1.00
ptg016863l,65127,65408,281,RepeatMasker,LTR,64476,65737,281,1.00
ptg016870l,1472741,1473022,281,RepeatMasker,LTR,1472113,1473840,281,1.00
ptg016870l,1665390,1665709,319,RepeatMasker,LTR,1659203,1665440,50,0.16
ptg016871l,187455,187735,280,RepeatMasker,LTR,186819,188790,280,1.00
ptg016874l,507887,508199,312,RepeatMasker,LTR,507717,507993,106,0.34
ptg016876l,136903,137184,281,RepeatMasker,LTR,136254,137566,281,1.00
ptg016876l,197537,197818,281,RepeatMasker,LTR,197504,198228,281,1.00
ptg016879l,54684,55004,320,RepeatMasker,LTR,53237,54734,50,0.16
ptg016890l,2019542,2019862,320,RepeatMasker,LTR,2019344,2019613,71,0.22
ptg016895l,535777,536056,279,RepeatMasker,LTR,535641,535912,135,0.48
ptg016898l,135797,136045,248,RepeatMasker,LTR,130740,136467,248,1.00
ptg016901l,1336904,1337185,281,RepeatMasker,LTR,1336285,1337601,281,1.00
ptg016904l,335452,335741,289,RepeatMasker,LTR,334590,335874,289,1.00
ptg016905l,1142955,1143253,298,RepeatMasker,LTR,1142903,1143462,298,1.00
ptg016905l,1570022,1570351,329,RepeatMasker,LTR,1569218,1570537,329,1.00
ptg016905l,1920989,1921288,299,RepeatMasker,LTR,1920937,1921485,299,1.00
ptg016908l,288894,289191,297,RepeatMasker,LTR,288092,289555,297,1.00
ptg016908l,306799,307079,280,RepeatMasker,LTR,305997,307499,280,1.00
ptg016915l,96262,96552,290,RepeatMasker,LTR,95790,97091,290,1.00
ptg016923l,672444,672725,281,RepeatMasker,LTR,671799,673101,281,1.00
ptg016930l,698438,698718,280,RepeatMasker,LTR,697634,699100,280,1.00
ptg016930l,943488,943736,248,RepeatMasker,LTR,938423,947946,248,1.00
ptg016934l,1970240,1970526,286,RepeatMasker,LTR,1969379,1972101,286,1.00
ptg016938l,719817,720123,306,RepeatMasker,LTR,718970,719895,78,0.25
ptg016941l,305111,305396,285,RepeatMasker,LTR,304482,306499,285,1.00
ptg016942l,700176,700471,295,RepeatMasker,LTR,700124,700551,295,1.00
ptg016943l,311159,311439,280,RepeatMasker,LTR,310522,311821,280,1.00
ptg016944l,171352,171650,298,RepeatMasker,LTR,171339,172781,298,1.00
ptg016946l,80163,80471,308,RepeatMasker,LTR,80062,82416,308,1.00
ptg016949l,108172,108452,280,RepeatMasker,LTR,107535,109498,280,1.00
ptg016952l,834523,834803,280,RepeatMasker,LTR,833878,835185,280,1.00
ptg016970l,444909,445190,281,RepeatMasker,LTR,444263,445504,281,1.00
ptg016992l,2194974,2195273,299,RepeatMasker,LTR,2194922,2195451,299,1.00
ptg017000l,298361,298641,280,RepeatMasker,LTR,298348,299770,280,1.00
ptg017003l,127754,128044,290,RepeatMasker,LTR,127702,128252,290,1.00
ptg017014l,269684,269969,285,RepeatMasker,LTR,269396,270612,285,1.00
ptg017017l,252508,252807,299,RepeatMasker,LTR,252456,253001,299,1.00
ptg017017l,485850,486177,327,RepeatMasker,LTR,485450,486197,327,1.00
ptg017021l,936623,936943,320,RepeatMasker,LTR,933526,936672,49,0.15
ptg017033l,109121,109446,325,RepeatMasker,LTR,109163,109400,238,0.73
ptg017045l,903742,904041,299,RepeatMasker,LTR,903695,904219,299,1.00
ptg017046l,136888,137196,308,RepeatMasker,LTR,136917,137035,119,0.39
ptg017046l,136888,137196,308,RepeatMasker,LTR,137038,137668,159,0.52
ptg017055l,325265,325545,280,RepeatMasker,LTR,324630,326676,280,1.00
ptg017064l,1006301,1006582,281,RepeatMasker,LTR,1005664,1007641,281,1.00
ptg017073l,1515983,1516274,291,RepeatMasker,LTR,1516220,1516281,55,0.19
ptg017073l,1515983,1516274,291,RepeatMasker,LTR,1516228,1517156,47,0.16
ptg017079l,1151253,1151536,283,RepeatMasker,LTR,1150595,1151954,283,1.00
ptg017082l,288824,289128,304,RepeatMasker,LTR,285832,288858,34,0.11
ptg017092l,145179,145472,293,RepeatMasker,LTR,145157,145669,293,1.00
ptg017092l,202167,202464,297,RepeatMasker,LTR,202116,202643,297,1.00
ptg017102l,19267,19564,297,RepeatMasker,LTR,19233,19587,297,1.00
ptg017102l,146613,146908,295,RepeatMasker,LTR,146561,147084,295,1.00
ptg017102l,305492,305789,297,RepeatMasker,LTR,305440,305966,297,1.00
ptg017102l,310782,311077,295,RepeatMasker,LTR,310730,311097,295,1.00
ptg017102l,506313,506633,320,RepeatMasker,LTR,505396,507869,320,1.00
ptg017102l,749747,750046,299,RepeatMasker,LTR,749695,750240,299,1.00
ptg017102l,1252920,1253235,315,RepeatMasker,LTR,1253047,1253482,189,0.60
ptg017102l,1252920,1253235,315,RepeatMasker,LTR,1253098,1253482,138,0.44
ptg017102l,1428624,1428917,293,RepeatMasker,LTR,1428572,1429082,293,1.00
ptg017106l,72345,72638,293,RepeatMasker,LTR,72036,73922,293,1.00
ptg017115l,219824,220113,289,RepeatMasker,LTR,219811,220640,289,1.00
ptg017134l,217213,217510,297,RepeatMasker,LTR,217167,217508,295,0.99
ptg017135l,317169,317450,281,RepeatMasker,LTR,316376,318511,281,1.00
ptg017150l,83464,83745,281,RepeatMasker,LTR,83431,84876,281,1.00
ptg017150l,90693,90974,281,RepeatMasker,LTR,90660,92031,281,1.00
ptg017152l,327812,328147,335,RepeatMasker,LTR,323074,329213,335,1.00
ptg017164l,3812,4111,299,RepeatMasker,LTR,3760,4306,299,1.00
ptg017164l,1856828,1857125,297,RepeatMasker,LTR,1856776,1857287,297,1.00
ptg017184l,468367,468615,248,RepeatMasker,LTR,463307,472819,248,1.00
ptg017187l,441265,441563,298,RepeatMasker,LTR,440484,442500,298,1.00
ptg017187l,441265,441563,298,RepeatMasker,LTR,440505,442601,298,1.00
ptg017196l,263059,263368,309,RepeatMasker,LTR,263100,263719,269,0.87
ptg017200l,247453,247775,322,RepeatMasker,LTR,247724,251346,52,0.16
ptg017221l,1312132,1312425,293,RepeatMasker,LTR,1312080,1312602,293,1.00
ptg017230l,927867,928152,285,RepeatMasker,LTR,926902,927902,35,0.12
ptg017233l,349848,350129,281,RepeatMasker,LTR,349055,350524,281,1.00
ptg017233l,429931,430211,280,RepeatMasker,LTR,429918,431260,280,1.00
ptg017234l,1334162,1334465,303,RepeatMasker,LTR,1334043,1335314,303,1.00
ptg017258l,1255539,1255819,280,RepeatMasker,LTR,1254737,1256209,280,1.00
ptg017267l,1621403,1621706,303,RepeatMasker,LTR,1620149,1621606,203,0.67
ptg017270l,1219020,1219310,290,RepeatMasker,LTR,1218968,1219488,290,1.00
ptg017272l,447753,448033,280,RepeatMasker,LTR,447741,448426,280,1.00
ptg017283l,415414,415730,316,RepeatMasker,LTR,412395,415577,163,0.52
ptg017283l,415414,415730,316,RepeatMasker,LTR,415571,421749,160,0.51
ptg017285l,1096177,1096457,280,RepeatMasker,LTR,1096165,1096839,280,1.00
ptg017285l,1103285,1103567,282,RepeatMasker,LTR,1102483,1103972,282,1.00
ptg017300l,2614233,2614513,280,RepeatMasker,LTR,2613450,2614777,280,1.00
ptg017300l,2745666,2745936,270,RepeatMasker,LTR,2744848,2745694,28,0.10
ptg017300l,2935913,2936197,284,RepeatMasker,LTR,2935052,2936866,284,1.00
ptg017301l,520226,520532,306,RepeatMasker,LTR,517676,520491,265,0.87
ptg017301l,656502,656805,303,RepeatMasker,LTR,655907,656836,303,1.00
ptg017303l,1043516,1043815,299,RepeatMasker,LTR,1043160,1046726,299,1.00
ptg017305l,524829,525109,280,RepeatMasker,LTR,524182,525492,280,1.00
ptg017313l,150528,150808,280,RepeatMasker,LTR,147787,155235,280,1.00
ptg017323l,907685,907971,286,RepeatMasker,LTR,906824,912680,286,1.00
ptg017325l,3782432,3782768,336,RepeatMasker,LTR,3782715,3783294,54,0.16
ptg017341l,510016,510334,318,RepeatMasker,LTR,509797,510028,12,0.04
ptg017342l,74007,74339,332,RepeatMasker,LTR,74332,75674,8,0.02
ptg017358l,232696,233006,310,RepeatMasker,LTR,232661,232739,43,0.14
ptg017358l,232696,233006,310,RepeatMasker,LTR,232672,232745,49,0.16
ptg017358l,232696,233006,310,RepeatMasker,LTR,229291,232730,34,0.11
ptg017364l,691086,691393,307,RepeatMasker,LTR,690226,695028,307,1.00
ptg017401l,965106,965386,280,RepeatMasker,LTR,964461,965790,280,1.00
ptg017406l,443232,443512,280,RepeatMasker,LTR,442586,443902,280,1.00
ptg017410l,313422,313730,308,RepeatMasker,LTR,313355,313450,28,0.09
ptg017410l,313422,313730,308,RepeatMasker,LTR,313668,314206,63,0.20
ptg017412l,139856,140155,299,RepeatMasker,LTR,139804,140235,299,1.00
ptg017432l,558730,559018,288,RepeatMasker,LTR,558981,559261,38,0.13
ptg017442l,811457,811756,299,RepeatMasker,LTR,811405,811963,299,1.00
ptg017457l,1032626,1032943,317,RepeatMasker,LTR,1032834,1032902,69,0.22
ptg017457l,1032626,1032943,317,RepeatMasker,LTR,1032847,1032973,97,0.31
ptg017459l,1008009,1008293,284,RepeatMasker,LTR,1007672,1008171,162,0.57
ptg017466l,390140,390448,308,RepeatMasker,LTR,390127,390830,308,1.00
ptg017469l,218922,219235,313,RepeatMasker,LTR,218555,219280,313,1.00
ptg017471l,155151,155410,259,RepeatMasker,LTR,150098,159614,259,1.00
ptg017471l,597898,598178,280,RepeatMasker,LTR,595851,599221,280,1.00
ptg017492l,494484,494775,291,RepeatMasker,LTR,494443,494707,223,0.77
ptg017492l,527176,527467,291,RepeatMasker,LTR,527117,527399,223,0.77
ptg017494l,64885,65218,333,RepeatMasker,LTR,64029,65502,333,1.00
ptg017499l,246367,246666,299,RepeatMasker,LTR,246315,246861,299,1.00
ptg017522l,72009,72306,297,RepeatMasker,LTR,71957,72386,297,1.00
ptg017526l,404271,404585,314,RepeatMasker,LTR,404323,404603,263,0.84
ptg017527l,19750,20069,319,RepeatMasker,LTR,19543,21941,319,1.00
ptg017585l,108169,108471,302,RepeatMasker,LTR,106599,108315,146,0.48
ptg017585l,108169,108471,302,RepeatMasker,LTR,106918,108301,132,0.44
ptg017585l,820142,820438,296,RepeatMasker,LTR,819499,821559,296,1.00
ptg017588l,122439,122716,277,RepeatMasker,LTR,122317,122448,9,0.03
ptg017588l,122439,122716,277,RepeatMasker,LTR,122449,126112,268,0.97
ptg017596l,137435,137722,287,RepeatMasker,LTR,137423,138028,287,1.00
ptg017601l,383125,383449,324,RepeatMasker,LTR,378930,384024,324,1.00
ptg017603l,497133,497436,303,RepeatMasker,LTR,496126,497231,98,0.32
ptg017603l,497133,497436,303,RepeatMasker,LTR,497158,497256,99,0.33
ptg017613l,1031454,1031743,289,RepeatMasker,LTR,1031234,1031740,286,0.99
ptg017618l,145230,145537,307,RepeatMasker,LTR,144577,145520,290,0.94
ptg017620l,523086,523380,294,RepeatMasker,LTR,519871,523725,294,1.00
ptg017620l,791859,792143,284,RepeatMasker,LTR,786453,791870,11,0.04
ptg017632l,386907,387203,296,RepeatMasker,LTR,381056,386941,34,0.11
ptg017632l,386907,387203,296,RepeatMasker,LTR,386884,386948,41,0.14
ptg017634l,387922,388217,295,RepeatMasker,LTR,387870,388382,295,1.00
ptg017645l,43775,44071,296,RepeatMasker,LTR,43131,44434,296,1.00
ptg017658l,1046319,1046599,280,RepeatMasker,LTR,1045677,1047789,280,1.00
ptg017665l,191786,192072,286,RepeatMasker,LTR,190917,194064,286,1.00
ptg017665l,1635604,1635913,309,RepeatMasker,LTR,1635581,1636213,309,1.00
ptg017701l,110216,110514,298,RepeatMasker,LTR,110184,110708,298,1.00
ptg017721l,230790,231104,314,RepeatMasker,LTR,231098,231812,7,0.02
ptg017724l,82687,83001,314,RepeatMasker,LTR,79631,82726,39,0.12
ptg017727l,29181,29468,287,RepeatMasker,LTR,28996,29313,132,0.46
ptg017729l,400306,400645,339,RepeatMasker,LTR,400273,400591,285,0.84
ptg017729l,400306,400645,339,RepeatMasker,LTR,400626,400958,20,0.06
ptg017771l,1120010,1120303,293,RepeatMasker,LTR,1119373,1121429,293,1.00
ptg017771l,1908213,1908523,310,RepeatMasker,LTR,1907432,1908515,302,0.97
ptg017771l,1908213,1908523,310,RepeatMasker,LTR,1908200,1908915,310,1.00
ptg017771l,2485774,2486088,314,RepeatMasker,LTR,2485414,2486121,314,1.00
ptg017782l,77949,78236,287,RepeatMasker,LTR,77093,80095,287,1.00
ptg017782l,88750,89037,287,RepeatMasker,LTR,88084,93723,287,1.00
ptg017804l,361142,361448,306,RepeatMasker,LTR,359824,361189,47,0.15
ptg017815l,1226755,1227036,281,RepeatMasker,LTR,1226742,1228077,281,1.00
ptg017816l,268374,268683,309,RepeatMasker,LTR,268553,268769,131,0.42
ptg017816l,290313,290630,317,RepeatMasker,LTR,290264,290660,317,1.00
ptg017828l,548063,548372,309,RepeatMasker,LTR,548086,548155,70,0.23
ptg017828l,1109157,1109470,313,RepeatMasker,LTR,1109164,1110033,307,0.98
ptg017848l,280831,281110,279,RepeatMasker,LTR,279335,281541,279,1.00
ptg017848l,280831,281110,279,RepeatMasker,LTR,279631,282135,279,1.00
ptg017848l,280831,281110,279,RepeatMasker,LTR,280136,282136,279,1.00
ptg017865l,195675,195958,283,RepeatMasker,LTR,195053,197686,283,1.00
ptg017870l,888327,888608,281,RepeatMasker,LTR,888314,888990,281,1.00
ptg017872l,785814,786140,326,RepeatMasker,LTR,785801,787174,326,1.00
ptg017879l,1354523,1354839,316,RepeatMasker,LTR,1354435,1355301,316,1.00
ptg017879l,1367423,1367739,316,RepeatMasker,LTR,1367335,1368201,316,1.00
ptg017883l,814888,815168,280,RepeatMasker,LTR,814081,815551,280,1.00
ptg017889l,5203393,5203718,325,RepeatMasker,LTR,5203614,5204605,105,0.32
ptg017898l,1003352,1003651,299,RepeatMasker,LTR,1003300,1003859,299,1.00
ptg017898l,5984731,5985032,301,RepeatMasker,LTR,5984534,5985597,301,1.00
ptg017908l,361314,361610,296,RepeatMasker,LTR,360802,362330,296,1.00
ptg017908l,557871,558166,295,RepeatMasker,LTR,557819,558359,295,1.00
ptg017911l,842533,842818,285,RepeatMasker,LTR,842271,844194,285,1.00
ptg017912l,505738,506035,297,RepeatMasker,LTR,505969,506046,67,0.23
ptg017917l,25974,26267,293,RepeatMasker,LTR,25922,26445,293,1.00
ptg017926l,122644,122954,310,RepeatMasker,LTR,122392,124907,310,1.00
ptg017931l,442557,442837,280,RepeatMasker,LTR,441765,443894,280,1.00
ptg017931l,950121,950401,280,RepeatMasker,LTR,949484,950796,280,1.00
ptg017931l,1622094,1622374,280,RepeatMasker,LTR,1622061,1623511,280,1.00
ptg017931l,1641774,1642072,298,RepeatMasker,LTR,1641741,1642442,298,1.00
ptg017935l,561688,561969,281,RepeatMasker,LTR,561044,562360,281,1.00
ptg017935l,569216,569510,294,RepeatMasker,LTR,569184,569886,294,1.00
ptg017936l,417677,417957,280,RepeatMasker,LTR,417040,418037,280,1.00
ptg017939l,2448743,2449040,297,RepeatMasker,LTR,2448730,2450072,297,1.00
ptg017948l,564383,564680,297,RepeatMasker,LTR,564331,564888,297,1.00
ptg017959l,27774,28073,299,RepeatMasker,LTR,27722,28153,299,1.00
ptg017969l,66271,66552,281,RepeatMasker,LTR,65471,67599,281,1.00
ptg017977l,258842,259134,292,RepeatMasker,LTR,259033,259073,41,0.14
ptg017985l,3381,3661,280,RepeatMasker,LTR,2579,4043,280,1.00
ptg017985l,229451,229732,281,RepeatMasker,LTR,228660,230112,281,1.00
ptg018010l,167522,167807,285,RepeatMasker,LTR,167155,167629,107,0.38
ptg018066l,174137,174425,288,RepeatMasker,LTR,174131,174360,223,0.77
ptg018066l,174137,174425,288,RepeatMasker,LTR,174234,174923,192,0.67
ptg018091l,1354860,1355152,292,RepeatMasker,LTR,1352028,1355494,292,1.00
ptg018109l,279467,279769,302,RepeatMasker,LTR,279734,283459,36,0.12
ptg018115l,288624,288935,311,RepeatMasker,LTR,288612,289292,311,1.00
ptg018122l,1004123,1004419,296,RepeatMasker,LTR,999327,1004302,179,0.60
ptg018153l,3312804,3313117,313,RepeatMasker,LTR,3312814,3313704,304,0.97
ptg018153l,3841447,3841735,288,RepeatMasker,LTR,3841388,3841767,288,1.00
ptg018185l,694145,694424,279,RepeatMasker,LTR,693501,694822,279,1.00
ptg018187l,803811,804121,310,RepeatMasker,LTR,803551,803934,123,0.40
ptg018188l,607384,607684,300,RepeatMasker,LTR,607332,607899,300,1.00
ptg018189l,18800,19099,299,RepeatMasker,LTR,18766,19140,299,1.00
ptg018199l,313157,313458,301,RepeatMasker,LTR,313105,313680,301,1.00
ptg018201l,452025,452322,297,RepeatMasker,LTR,451974,452496,297,1.00
ptg018243l,1471787,1472068,281,RepeatMasker,LTR,1471775,1472456,281,1.00
ptg018245l,833925,834216,291,RepeatMasker,LTR,833280,834595,291,1.00
ptg018247l,46086,46366,280,RepeatMasker,LTR,45304,47414,280,1.00
ptg018257l,857748,858029,281,RepeatMasker,LTR,857105,858409,281,1.00
ptg018266l,350022,350314,292,RepeatMasker,LTR,349900,350083,61,0.21
ptg018277l,287523,287822,299,RepeatMasker,LTR,287449,288490,299,1.00
ptg018285l,344164,344493,329,RepeatMasker,LTR,344465,346277,29,0.09
ptg018319l,284266,284568,302,RepeatMasker,LTR,283462,284956,302,1.00
ptg018324l,385293,385603,310,RepeatMasker,LTR,384791,386385,310,1.00
ptg018324l,1545052,1545333,281,RepeatMasker,LTR,1544269,1546356,281,1.00
ptg018333l,519279,519527,248,RepeatMasker,LTR,514224,523730,248,1.00
ptg018333l,595002,595283,281,RepeatMasker,LTR,594969,595665,281,1.00
ptg018350l,200872,201174,302,RepeatMasker,LTR,200149,201055,183,0.61
ptg018356l,957441,957734,293,RepeatMasker,LTR,957389,957732,291,0.99
ptg018362l,345409,345728,319,RepeatMasker,LTR,345159,345605,196,0.61
ptg018367l,44139,44437,298,RepeatMasker,LTR,44087,44644,298,1.00
ptg018380l,233443,233753,310,RepeatMasker,LTR,233306,233465,22,0.07
ptg018389l,978300,978599,299,RepeatMasker,LTR,977663,979648,299,1.00
ptg018398l,648291,648628,337,RepeatMasker,LTR,648320,648380,61,0.18
ptg018411l,130611,130906,295,RepeatMasker,LTR,130559,131082,295,1.00
ptg018413l,2071,2384,313,RepeatMasker,LTR,2276,2333,58,0.19
ptg018416l,1452637,1452940,303,RepeatMasker,LTR,1452717,1455470,224,0.74
ptg018418l,260211,260492,281,RepeatMasker,LTR,259410,260795,281,1.00
ptg018426l,147112,147440,328,RepeatMasker,LTR,147060,147614,328,1.00
ptg018431l,837751,838043,292,RepeatMasker,LTR,837779,838795,265,0.91
ptg018436l,1117098,1117413,315,RepeatMasker,LTR,1117261,1117331,71,0.23
ptg018436l,1229277,1229582,305,RepeatMasker,LTR,1228779,1229963,305,1.00
ptg018438l,185133,185435,302,RepeatMasker,LTR,185121,185805,302,1.00
ptg018438l,416914,417210,296,RepeatMasker,LTR,417168,418096,43,0.15
ptg018442l,383994,384291,297,RepeatMasker,LTR,383199,384312,297,1.00
ptg018445l,912632,912914,282,RepeatMasker,LTR,912599,913315,282,1.00
ptg018458l,251221,251518,297,RepeatMasker,LTR,251195,251881,297,1.00
ptg018461l,726526,726813,287,RepeatMasker,LTR,726164,727195,287,1.00
ptg018478l,485065,485375,310,RepeatMasker,LTR,484142,485371,306,0.99
ptg018481l,177280,177582,302,RepeatMasker,LTR,175845,178335,302,1.00
ptg018520l,869746,870054,308,RepeatMasker,LTR,869172,869997,251,0.81
ptg018522l,12970,13291,321,RepeatMasker,LTR,13278,15365,14,0.04
ptg018525l,716170,716497,327,RepeatMasker,LTR,716436,716578,62,0.19
ptg018527l,205249,205548,299,RepeatMasker,LTR,205197,205726,299,1.00
ptg018527l,375126,375425,299,RepeatMasker,LTR,375074,375590,299,1.00
ptg018527l,426637,426921,284,RepeatMasker,LTR,426585,427099,284,1.00
ptg018527l,497746,498046,300,RepeatMasker,LTR,497694,498255,300,1.00
ptg018527l,1077270,1077574,304,RepeatMasker,LTR,1077026,1077325,55,0.18
ptg018527l,1077270,1077574,304,RepeatMasker,LTR,1077555,1079615,20,0.07
ptg018565l,806235,806512,277,RepeatMasker,LTR,806489,806533,24,0.09
ptg018568l,160407,160708,301,RepeatMasker,LTR,159624,161743,301,1.00
ptg018575l,7032,7318,286,RepeatMasker,LTR,6193,11966,286,1.00
ptg018578l,1252170,1252451,281,RepeatMasker,LTR,1251367,1252825,281,1.00
ptg018580l,1766780,1767062,282,RepeatMasker,LTR,1766004,1768104,282,1.00
ptg018583l,616271,616548,277,RepeatMasker,LTR,615547,617157,277,1.00
ptg018590l,931511,931852,341,RepeatMasker,LTR,930877,931782,271,0.79
ptg018595l,633069,633350,281,RepeatMasker,LTR,632264,633655,281,1.00
ptg018602l,1288682,1288986,304,RepeatMasker,LTR,1288380,1288706,24,0.08
ptg018607l,71353,71634,281,RepeatMasker,LTR,71320,72014,281,1.00
ptg018623l,839251,839575,324,RepeatMasker,LTR,838447,839405,154,0.48
ptg018625l,235804,236084,280,RepeatMasker,LTR,235021,237132,280,1.00
ptg018648l,1033832,1034125,293,RepeatMasker,LTR,1033798,1034148,293,1.00
ptg018663l,756710,756994,284,RepeatMasker,LTR,756460,756775,65,0.23
ptg018669l,516060,516336,276,RepeatMasker,LTR,515838,516411,276,1.00
ptg018669l,516060,516336,276,RepeatMasker,LTR,516067,516502,270,0.98
ptg018672l,502970,503257,287,RepeatMasker,LTR,503149,503734,109,0.38
ptg018676l,140359,140657,298,RepeatMasker,LTR,140307,140866,298,1.00
ptg018676l,1764213,1764515,302,RepeatMasker,LTR,1762962,1764345,132,0.44
ptg018676l,1764213,1764515,302,RepeatMasker,LTR,1764003,1765271,302,1.00
ptg018680l,566225,566510,285,RepeatMasker,LTR,565784,567153,285,1.00
ptg018689l,77301,77603,302,RepeatMasker,LTR,76051,77430,129,0.43
ptg018689l,77301,77603,302,RepeatMasker,LTR,76959,78327,302,1.00
ptg018689l,77307,77603,296,RepeatMasker,LTR,76051,77430,123,0.42
ptg018689l,77307,77603,296,RepeatMasker,LTR,76959,78327,296,1.00
ptg018689l,102921,103202,281,RepeatMasker,LTR,102284,104344,281,1.00
ptg018691l,729967,730247,280,RepeatMasker,LTR,729954,730629,280,1.00
ptg018692l,294032,294334,302,RepeatMasker,LTR,294020,294621,302,1.00
ptg018692l,294032,294334,302,RepeatMasker,LTR,294021,294694,302,1.00
ptg018705l,275840,276141,301,RepeatMasker,LTR,275788,276368,301,1.00
ptg018711l,474475,474763,288,RepeatMasker,LTR,474719,475032,45,0.16
ptg018726l,183036,183348,312,RepeatMasker,LTR,183088,183297,210,0.67
ptg018769l,173388,173668,280,RepeatMasker,LTR,172753,174050,280,1.00
ptg018806l,858592,858881,289,RepeatMasker,LTR,857957,859254,289,1.00
ptg018819l,51883,52164,281,RepeatMasker,LTR,51238,52544,281,1.00
ptg018819l,59022,59304,282,RepeatMasker,LTR,58221,59686,282,1.00
ptg018821l,596124,596439,315,RepeatMasker,LTR,595873,598793,315,1.00
ptg018845l,90,373,283,RepeatMasker,LTR,350,398,24,0.08
ptg018850l,557865,558159,294,RepeatMasker,LTR,555093,561215,294,1.00
ptg018851l,687076,687383,307,RepeatMasker,LTR,686469,689479,307,1.00
ptg018853l,1742111,1742392,281,RepeatMasker,LTR,1741466,1742774,281,1.00
ptg018866l,168643,168935,292,RepeatMasker,LTR,166668,168693,50,0.17
ptg018879l,137804,138084,280,RepeatMasker,LTR,137792,138487,280,1.00
ptg018889l,21228,21508,280,RepeatMasker,LTR,20581,21890,280,1.00
ptg018889l,619360,619659,299,RepeatMasker,LTR,618714,620024,299,1.00
ptg018910l,384057,384337,280,RepeatMasker,LTR,383668,384718,280,1.00
ptg018919l,119660,119965,305,RepeatMasker,LTR,119948,120112,18,0.06
ptg018946l,589905,590185,280,RepeatMasker,LTR,589259,590567,280,1.00
ptg018949l,182298,182601,303,RepeatMasker,LTR,181705,182625,303,1.00
ptg018964l,163832,164138,306,RepeatMasker,LTR,162677,166197,306,1.00
ptg018995l,157462,157776,314,RepeatMasker,LTR,154258,157489,27,0.09
ptg018995l,157462,157776,314,RepeatMasker,LTR,157689,158252,88,0.28
ptg019008l,279509,279814,305,RepeatMasker,LTR,279305,279603,94,0.31
ptg019013l,279259,279539,280,RepeatMasker,LTR,279244,279915,280,1.00
ptg019037l,163139,163438,299,RepeatMasker,LTR,163092,163479,299,1.00
ptg019042l,36837,37136,299,RepeatMasker,LTR,36785,37156,299,1.00
ptg019042l,781784,782085,301,RepeatMasker,LTR,781732,782263,301,1.00
ptg019043l,140605,140905,300,RepeatMasker,LTR,140553,141113,300,1.00
ptg019050l,842329,842628,299,RepeatMasker,LTR,842277,842793,299,1.00
ptg019066l,251257,251552,295,RepeatMasker,LTR,249061,251296,39,0.13
ptg019125l,112986,113288,302,RepeatMasker,LTR,113160,113264,105,0.35
ptg019136l,961890,962216,326,RepeatMasker,LTR,961154,962523,326,1.00
ptg019138l,495527,495846,319,RepeatMasker,LTR,495065,495576,49,0.15
ptg019139l,53063,53362,299,RepeatMasker,LTR,53016,53570,299,1.00
ptg019142l,271927,272217,290,RepeatMasker,LTR,268883,276745,290,1.00
ptg019150l,959502,959802,300,RepeatMasker,LTR,958722,960130,300,1.00
ptg019157l,13765,14067,302,RepeatMasker,LTR,13713,14245,302,1.00
ptg019157l,357320,357619,299,RepeatMasker,LTR,357268,357797,299,1.00
ptg019161l,280890,281170,280,RepeatMasker,LTR,280254,282229,280,1.00
ptg019231l,565191,565490,299,RepeatMasker,LTR,565139,565570,299,1.00
ptg019243l,564033,564346,313,RepeatMasker,LTR,563863,564391,313,1.00
ptg019251l,247038,247337,299,RepeatMasker,LTR,246986,247545,299,1.00
ptg019251l,252708,253006,298,RepeatMasker,LTR,252656,253212,298,1.00
ptg019255l,220763,221044,281,RepeatMasker,LTR,220175,221426,281,1.00
ptg019263l,1332780,1333068,288,RepeatMasker,LTR,1332037,1333160,288,1.00
ptg019271l,829857,830153,296,RepeatMasker,LTR,829850,829949,92,0.31
ptg019272l,193308,193615,307,RepeatMasker,LTR,192029,194645,307,1.00
ptg019274l,383842,384166,324,RepeatMasker,LTR,383319,386276,324,1.00
ptg019274l,537794,538074,280,RepeatMasker,LTR,537781,538541,280,1.00
ptg019274l,545353,545648,295,RepeatMasker,LTR,545340,546680,295,1.00
ptg019283l,801574,801899,325,RepeatMasker,LTR,801578,801868,291,0.90
ptg019283l,801574,801899,325,RepeatMasker,LTR,801866,802792,34,0.10
ptg019283l,953136,953416,280,RepeatMasker,LTR,952354,953497,280,1.00
ptg019283l,986678,986955,277,RepeatMasker,LTR,986645,987512,277,1.00
ptg019283l,997288,997568,280,RepeatMasker,LTR,997255,998616,280,1.00
ptg019288l,1692667,1692966,299,RepeatMasker,LTR,1691885,1693283,299,1.00
ptg019290l,429851,430146,295,RepeatMasker,LTR,429000,431229,295,1.00
ptg019294l,685265,685544,279,RepeatMasker,LTR,682323,689595,279,1.00
ptg019299l,33585,33815,230,RepeatMasker,LTR,33157,33673,88,0.38
ptg019305l,90346,90626,280,RepeatMasker,LTR,89551,90998,280,1.00
ptg019305l,1351236,1351516,280,RepeatMasker,LTR,1350441,1351898,280,1.00
ptg019332l,826708,827007,299,RepeatMasker,LTR,826072,828126,299,1.00
ptg019339l,299159,299464,305,RepeatMasker,LTR,292296,299321,162,0.53
ptg019344l,67018,67300,282,RepeatMasker,LTR,65796,67535,282,1.00
ptg019354l,763676,763961,285,RepeatMasker,LTR,763938,763982,24,0.08
ptg019372l,881183,881463,280,RepeatMasker,LTR,880535,881845,280,1.00
ptg019372l,951650,951967,317,RepeatMasker,LTR,951638,952349,317,1.00
ptg019388l,415789,416086,297,RepeatMasker,LTR,415737,416106,297,1.00
ptg019392l,79768,80068,300,RepeatMasker,LTR,79755,81187,300,1.00
ptg019421l,79846,80157,311,RepeatMasker,LTR,78030,79883,37,0.12
ptg019428l,391316,391616,300,RepeatMasker,LTR,391264,391809,300,1.00
ptg019430l,1484393,1484705,312,RepeatMasker,LTR,1482956,1484499,106,0.34
ptg019433l,207007,207287,280,RepeatMasker,LTR,206975,207669,280,1.00
ptg019433l,221554,221835,281,RepeatMasker,LTR,221522,222222,281,1.00
ptg019437l,67034,67314,280,RepeatMasker,LTR,66244,67712,280,1.00
ptg019444l,256828,257138,310,RepeatMasker,LTR,255242,256848,20,0.06
ptg019473l,144825,145113,288,RepeatMasker,LTR,145099,145610,15,0.05
ptg019474l,21148,21460,312,RepeatMasker,LTR,20921,21893,312,1.00
ptg019492l,501975,502254,279,RepeatMasker,LTR,500597,507661,279,1.00
ptg019501l,609734,610033,299,RepeatMasker,LTR,609682,610113,299,1.00
ptg019513l,353042,353372,330,RepeatMasker,LTR,351721,353517,330,1.00
ptg019574l,497830,498163,333,RepeatMasker,LTR,495442,499869,333,1.00
ptg019574l,1182968,1183296,328,RepeatMasker,LTR,1178518,1185544,328,1.00
ptg019581l,763881,764161,280,RepeatMasker,LTR,763868,765338,280,1.00
ptg019581l,2290362,2290671,309,RepeatMasker,LTR,2289875,2290836,309,1.00
ptg019581l,2290362,2290671,309,RepeatMasker,LTR,2290120,2292472,309,1.00
ptg019599l,117595,117894,299,RepeatMasker,LTR,117543,118072,299,1.00
ptg019599l,159656,159949,293,RepeatMasker,LTR,159604,160127,293,1.00
ptg019599l,251942,252237,295,RepeatMasker,LTR,251890,252431,295,1.00
ptg019640l,617803,618083,280,RepeatMasker,LTR,617010,618407,280,1.00
ptg019646l,292338,292616,278,RepeatMasker,LTR,292339,292578,240,0.86
ptg019646l,298362,298640,278,RepeatMasker,LTR,298363,298602,240,0.86
ptg019670l,116160,116445,285,RepeatMasker,LTR,115824,116324,164,0.58
ptg019670l,116160,116445,285,RepeatMasker,LTR,116435,117232,11,0.04
ptg019680l,384943,385225,282,RepeatMasker,LTR,384910,385616,282,1.00
ptg019683l,635510,635801,291,RepeatMasker,LTR,635458,635978,291,1.00
ptg019693l,596766,597013,247,RepeatMasker,LTR,591716,601218,247,1.00
ptg019699l,212415,212734,319,RepeatMasker,LTR,212697,214298,38,0.12
ptg019727l,473949,474235,286,RepeatMasker,LTR,473720,474633,286,1.00
ptg019737l,291269,291549,280,RepeatMasker,LTR,291244,291930,280,1.00
ptg019738l,703407,703695,288,RepeatMasker,LTR,703394,703996,288,1.00
ptg019760l,126526,126823,297,RepeatMasker,LTR,126480,126854,297,1.00
ptg019760l,407064,407357,293,RepeatMasker,LTR,407012,407437,293,1.00
ptg019760l,537889,538199,310,RepeatMasker,LTR,537837,538240,310,1.00
ptg019781l,391343,391638,295,RepeatMasker,LTR,391530,392083,109,0.37
ptg019791l,235250,235492,242,RepeatMasker,LTR,230195,239699,242,1.00
ptg019793l,703773,704062,289,RepeatMasker,LTR,702603,703912,139,0.48
ptg019794l,142651,142945,294,RepeatMasker,LTR,142794,142831,38,0.13
ptg019802l,313864,314126,262,RepeatMasker,LTR,313584,313972,108,0.41
ptg019805l,239340,239640,300,RepeatMasker,LTR,239288,239863,300,1.00
ptg019816l,512626,512933,307,RepeatMasker,LTR,511985,513289,307,1.00
ptg019818l,87879,88148,269,RepeatMasker,LTR,87174,87908,29,0.11
ptg019841l,840298,840624,326,RepeatMasker,LTR,839045,841637,326,1.00
ptg019854l,283784,284098,314,RepeatMasker,LTR,280191,283812,28,0.09
ptg019854l,283784,284098,314,RepeatMasker,LTR,284011,284571,88,0.28
ptg019854l,341077,341358,281,RepeatMasker,LTR,341044,341747,281,1.00
ptg019854l,729923,730243,320,RepeatMasker,LTR,729356,730270,320,1.00
ptg019860l,477663,477944,281,RepeatMasker,LTR,477630,478347,281,1.00
ptg019885l,514772,515042,270,RepeatMasker,LTR,514135,516187,270,1.00
ptg019890l,41120,41401,281,RepeatMasker,LTR,40317,41783,281,1.00
ptg019891l,241387,241698,311,RepeatMasker,LTR,241483,241574,92,0.30
ptg019899l,2999704,2999988,284,RepeatMasker,LTR,2998741,3001029,284,1.00
ptg019936l,12895,13192,297,RepeatMasker,LTR,12843,13272,297,1.00
ptg019936l,301418,301717,299,RepeatMasker,LTR,301384,301737,299,1.00
ptg019956l,1231360,1231666,306,RepeatMasker,LTR,1231118,1231731,306,1.00
ptg019960l,750621,750952,331,RepeatMasker,LTR,750346,750824,203,0.61
ptg019971l,635373,635621,248,RepeatMasker,LTR,630308,639824,248,1.00
ptg019973l,246931,247238,307,RepeatMasker,LTR,246746,247168,237,0.77
ptg019974l,49000,49297,297,RepeatMasker,LTR,48359,49663,297,1.00
ptg019976l,113873,114159,286,RepeatMasker,LTR,113014,115470,286,1.00
ptg020010l,187730,188005,275,RepeatMasker,LTR,186150,187862,132,0.48
ptg020010l,187730,188005,275,RepeatMasker,LTR,187492,187936,206,0.75
ptg020013l,315755,316010,255,RepeatMasker,LTR,310701,320216,255,1.00
ptg020015l,504482,504797,315,RepeatMasker,LTR,504470,505163,315,1.00
ptg020021l,110036,110319,283,RepeatMasker,LTR,109051,110187,151,0.53
ptg020021l,110036,110319,283,RepeatMasker,LTR,109194,110820,283,1.00
ptg020025l,582437,582716,279,RepeatMasker,LTR,581802,583098,279,1.00
ptg020026l,530481,530800,319,RepeatMasker,LTR,530790,531233,11,0.03
ptg020032l,199911,200220,309,RepeatMasker,LTR,199859,200427,309,1.00
ptg020049l,448943,449178,235,RepeatMasker,LTR,448682,449722,235,1.00
ptg020049l,979387,979685,298,RepeatMasker,LTR,979335,979765,298,1.00
ptg020049l,1092895,1093195,300,RepeatMasker,LTR,1092843,1093407,300,1.00
ptg020059l,181946,182248,302,RepeatMasker,LTR,181910,182096,150,0.50
ptg020059l,181946,182248,302,RepeatMasker,LTR,182099,184985,150,0.50
ptg020064l,120050,120322,272,RepeatMasker,LTR,119611,120336,272,1.00
ptg020080l,178568,178848,280,RepeatMasker,LTR,177947,179173,280,1.00
ptg020099l,83610,83890,280,RepeatMasker,LTR,82807,84284,280,1.00
ptg020122l,46853,47152,299,RepeatMasker,LTR,47043,47164,110,0.37
ptg020141l,1761831,1762162,331,RepeatMasker,LTR,1760151,1761946,115,0.35
ptg020141l,1761831,1762162,331,RepeatMasker,LTR,1761948,1762268,215,0.65
ptg020141l,1784761,1785058,297,RepeatMasker,LTR,1784709,1785221,297,1.00
ptg020141l,1794386,1794685,299,RepeatMasker,LTR,1794334,1794863,299,1.00
ptg020157l,944239,944530,291,RepeatMasker,LTR,943901,944401,162,0.56
ptg020163l,718953,719288,335,RepeatMasker,LTR,716853,720389,335,1.00
ptg020175l,59940,60254,314,RepeatMasker,LTR,59452,61136,314,1.00
ptg020185l,315867,316179,312,RepeatMasker,LTR,315362,316608,312,1.00
ptg020207l,1427553,1427850,297,RepeatMasker,LTR,1427507,1427891,297,1.00
ptg020219l,1166157,1166443,286,RepeatMasker,LTR,1164624,1166317,160,0.56
ptg020224l,618597,618877,280,RepeatMasker,LTR,614736,618791,194,0.69
ptg020225l,796515,796822,307,RepeatMasker,LTR,796204,796922,307,1.00
ptg020225l,1125194,1125474,280,RepeatMasker,LTR,1125182,1125784,280,1.00
ptg020250l,44448,44738,290,RepeatMasker,LTR,44000,44464,16,0.06
ptg020250l,245971,246288,317,RepeatMasker,LTR,246199,246241,43,0.14
ptg020250l,245971,246288,317,RepeatMasker,LTR,246237,249880,52,0.16
ptg020261l,292412,292690,278,RepeatMasker,LTR,292290,292733,278,1.00
ptg020261l,292412,292690,278,RepeatMasker,LTR,292422,296091,269,0.97
ptg020302l,420756,421035,279,RepeatMasker,LTR,420744,421347,279,1.00
ptg020323l,977648,977930,282,RepeatMasker,LTR,976849,978312,282,1.00
ptg020342l,732926,733205,279,RepeatMasker,LTR,733025,733050,26,0.09
ptg020350l,58572,58894,322,RepeatMasker,LTR,57408,58646,74,0.23
ptg020350l,149223,149504,281,RepeatMasker,LTR,147901,150001,281,1.00
ptg020350l,149223,149504,281,RepeatMasker,LTR,148374,150002,281,1.00
ptg020350l,149223,149504,281,RepeatMasker,LTR,147308,149384,161,0.57
ptg020364l,362100,362410,310,RepeatMasker,LTR,361936,362292,192,0.62
ptg020367l,342918,343199,281,RepeatMasker,LTR,342273,343592,281,1.00
ptg020367l,1938808,1939083,275,RepeatMasker,LTR,1938752,1939305,275,1.00
ptg020370l,328541,328877,336,RepeatMasker,LTR,328331,328774,233,0.69
ptg020378l,501726,502006,280,RepeatMasker,LTR,500820,502057,280,1.00
ptg020401l,74021,74319,298,RepeatMasker,LTR,73969,74495,298,1.00
ptg020404l,99001,99302,301,RepeatMasker,LTR,98196,99031,30,0.10
ptg020404l,422429,422747,318,RepeatMasker,LTR,422027,423578,318,1.00
ptg020419l,279212,279509,297,RepeatMasker,LTR,279199,280618,297,1.00
ptg020428l,114666,114947,281,RepeatMasker,LTR,114653,116081,281,1.00
ptg020435l,563951,564250,299,RepeatMasker,LTR,563899,564330,299,1.00
ptg020435l,1760813,1761109,296,RepeatMasker,LTR,1760761,1761253,296,1.00
ptg020435l,3168628,3168917,289,RepeatMasker,LTR,3168576,3169119,289,1.00
ptg020441l,2657776,2658082,306,RepeatMasker,LTR,2655197,2659933,306,1.00
ptg020451l,308875,309161,286,RepeatMasker,LTR,308009,312770,286,1.00
ptg020471l,2493650,2493935,285,RepeatMasker,LTR,2490913,2493681,31,0.11
ptg020471l,2493650,2493935,285,RepeatMasker,LTR,2493626,2493698,48,0.17
ptg020472l,374560,374859,299,RepeatMasker,LTR,374508,374900,299,1.00
ptg020480l,641062,641347,285,RepeatMasker,LTR,641305,641472,43,0.15
ptg020485l,448404,448703,299,RepeatMasker,LTR,448352,448866,299,1.00
ptg020486l,392119,392399,280,RepeatMasker,LTR,391315,392778,280,1.00
ptg020488l,190289,190570,281,RepeatMasker,LTR,190276,191624,281,1.00
ptg020490l,431811,432137,326,RepeatMasker,LTR,430932,436805,326,1.00
ptg020508l,63827,64157,330,RepeatMasker,LTR,58457,66408,330,1.00
ptg020512l,788381,788680,299,RepeatMasker,LTR,788329,788888,299,1.00
ptg020513l,691559,691859,300,RepeatMasker,LTR,691414,691835,276,0.92
ptg020535l,429317,429626,309,RepeatMasker,LTR,427166,429347,30,0.10
ptg020565l,408991,409272,281,RepeatMasker,LTR,408211,410321,281,1.00
ptg020568l,145410,145721,311,RepeatMasker,LTR,145403,146399,311,1.00
ptg020569l,484455,484735,280,RepeatMasker,LTR,483822,485117,280,1.00
ptg020569l,1367033,1367319,286,RepeatMasker,LTR,1366171,1372028,286,1.00
ptg020576l,653908,654194,286,RepeatMasker,LTR,650570,653951,43,0.15
ptg020616l,856204,856490,286,RepeatMasker,LTR,856191,857287,286,1.00
ptg020618l,151082,151381,299,RepeatMasker,LTR,151048,151401,299,1.00
ptg020618l,230430,230729,299,RepeatMasker,LTR,230378,230809,299,1.00
ptg020618l,990094,990390,296,RepeatMasker,LTR,990042,990432,296,1.00
ptg020620l,206426,206713,287,RepeatMasker,LTR,204031,207590,287,1.00
ptg020629l,449477,449758,281,RepeatMasker,LTR,449444,450154,281,1.00
ptg020659l,137471,137790,319,RepeatMasker,LTR,135912,137521,50,0.16
ptg020661l,27418,27718,300,RepeatMasker,LTR,27366,27927,300,1.00
ptg020730l,522902,523180,278,RepeatMasker,LTR,523179,523252,2,0.01
ptg020730l,602453,602769,316,RepeatMasker,LTR,601792,604855,316,1.00
ptg020733l,17318,17628,310,RepeatMasker,LTR,16171,17497,179,0.58
ptg020753l,20700,20981,281,RepeatMasker,LTR,19918,22110,281,1.00
ptg020770l,739229,739531,302,RepeatMasker,LTR,739356,739547,176,0.58
ptg020770l,739229,739531,302,RepeatMasker,LTR,739356,739604,176,0.58
ptg020797l,47176,47473,297,RepeatMasker,LTR,46173,47957,297,1.00
ptg020797l,969737,970060,323,RepeatMasker,LTR,967000,969799,62,0.19
ptg020810l,81442,81732,290,RepeatMasker,LTR,80642,82586,290,1.00
ptg020842l,523165,523464,299,RepeatMasker,LTR,523113,523484,299,1.00
ptg020842l,946937,947236,299,RepeatMasker,LTR,946885,947316,299,1.00
ptg020853l,126307,126606,299,RepeatMasker,LTR,126255,126784,299,1.00
ptg020853l,372143,372439,296,RepeatMasker,LTR,372091,372621,296,1.00
ptg020853l,522090,522389,299,RepeatMasker,LTR,522044,522432,299,1.00
ptg020864l,345818,346115,297,RepeatMasker,LTR,345766,346293,297,1.00
ptg020868l,139464,139712,248,RepeatMasker,LTR,134443,143920,248,1.00
ptg020870l,795508,795788,280,RepeatMasker,LTR,794237,796452,280,1.00
ptg020898l,6655,6903,248,RepeatMasker,LTR,1004,10491,248,1.00
ptg020899l,576462,576743,281,RepeatMasker,LTR,573900,579815,281,1.00
ptg020925l,334861,335142,281,RepeatMasker,LTR,333838,334884,23,0.08
ptg020934l,55912,56183,271,RepeatMasker,LTR,55958,56099,142,0.52
ptg020940l,33464,33744,280,RepeatMasker,LTR,32825,34800,280,1.00
ptg020940l,428137,428440,303,RepeatMasker,LTR,422507,428302,165,0.54
ptg020941l,301900,302181,281,RepeatMasker,LTR,301255,302562,281,1.00
ptg020946l,574110,574412,302,RepeatMasker,LTR,572555,574200,90,0.30
ptg020946l,574110,574412,302,RepeatMasker,LTR,572862,574199,89,0.29
ptg020953l,439426,439728,302,RepeatMasker,LTR,439432,439958,297,0.98
ptg020957l,27149,27441,292,RepeatMasker,LTR,27136,28591,292,1.00
ptg020966l,62957,63239,282,RepeatMasker,LTR,57901,62991,34,0.12
ptg020991l,459221,459518,297,RepeatMasker,LTR,459466,459664,53,0.18
ptg020997l,145054,145360,306,RepeatMasker,LTR,144780,145545,306,1.00
ptg020999l,60501,60814,313,RepeatMasker,LTR,60508,61398,307,0.98
ptg021044l,179867,180148,281,RepeatMasker,LTR,179222,180530,281,1.00
ptg021064l,862139,862435,296,RepeatMasker,LTR,862087,862643,296,1.00
ptg021064l,1142878,1143201,323,RepeatMasker,LTR,1140746,1144366,323,1.00
ptg021096l,567973,568277,304,RepeatMasker,LTR,568262,568903,16,0.05
ptg021097l,519640,519913,273,RepeatMasker,LTR,519623,519679,39,0.14
ptg021097l,519640,519913,273,RepeatMasker,LTR,519637,519783,143,0.52
ptg021116l,683555,683835,280,RepeatMasker,LTR,683542,684894,280,1.00
ptg021118l,182112,182414,302,RepeatMasker,LTR,182100,182703,302,1.00
ptg021118l,189640,189920,280,RepeatMasker,LTR,189628,190309,280,1.00
ptg021118l,509106,509392,286,RepeatMasker,LTR,506721,512165,286,1.00
ptg021124l,33601,33896,295,RepeatMasker,LTR,33549,34061,295,1.00
ptg021124l,116477,116770,293,RepeatMasker,LTR,116425,116945,293,1.00
ptg021124l,287123,287422,299,RepeatMasker,LTR,287076,287600,299,1.00
ptg021126l,71310,71591,281,RepeatMasker,LTR,71277,72658,281,1.00
ptg021126l,185514,185793,279,RepeatMasker,LTR,184729,186178,279,1.00
ptg021147l,69001,69281,280,RepeatMasker,LTR,68199,69670,280,1.00
ptg021156l,145927,146252,325,RepeatMasker,LTR,143420,146613,325,1.00
ptg021167l,382921,383234,313,RepeatMasker,LTR,382928,383339,307,0.98
ptg021176l,188116,188436,320,RepeatMasker,LTR,181930,188166,50,0.16
ptg021183l,510486,510780,294,RepeatMasker,LTR,510496,510882,285,0.97
ptg021187l,699898,700213,315,RepeatMasker,LTR,698904,702361,315,1.00
ptg021197l,581604,581886,282,RepeatMasker,LTR,581704,585494,183,0.65
ptg021198l,266838,267137,299,RepeatMasker,LTR,266786,267178,299,1.00
ptg021209l,815333,815644,311,RepeatMasker,LTR,815446,815735,199,0.64
ptg021219l,508330,508624,294,RepeatMasker,LTR,508332,509020,293,1.00
ptg021230l,980141,980440,299,RepeatMasker,LTR,980089,980618,299,1.00
ptg021233l,455589,455892,303,RepeatMasker,LTR,455385,458010,303,1.00
ptg021242l,142888,143215,327,RepeatMasker,LTR,142980,143580,236,0.72
ptg021281l,650717,651032,315,RepeatMasker,LTR,649374,650874,157,0.50
ptg021281l,650717,651032,315,RepeatMasker,LTR,650772,650935,164,0.52
ptg021285l,961615,961896,281,RepeatMasker,LTR,960970,962278,281,1.00
ptg021285l,961615,961896,281,RepeatMasker,LTR,961589,962207,281,1.00
ptg021289l,390533,390828,295,RepeatMasker,LTR,390705,391983,124,0.42
ptg021299l,526290,526570,280,RepeatMasker,LTR,525653,526981,280,1.00
ptg021301l,264400,264704,304,RepeatMasker,LTR,262214,264981,304,1.00
ptg021303l,459961,460270,309,RepeatMasker,LTR,459571,460479,309,1.00
ptg021311l,447430,447717,287,RepeatMasker,LTR,444828,447862,287,1.00
ptg021327l,123185,123488,303,RepeatMasker,LTR,122723,123219,34,0.11
ptg021327l,123185,123488,303,RepeatMasker,LTR,123222,123300,79,0.26
ptg021335l,26452,26765,313,RepeatMasker,LTR,26726,26866,40,0.13
ptg021337l,765071,765342,271,RepeatMasker,LTR,765240,765374,103,0.38
ptg021359l,1167980,1168287,307,RepeatMasker,LTR,1166143,1169439,307,1.00
ptg021359l,1167980,1168287,307,RepeatMasker,LTR,1167588,1169996,307,1.00
ptg021372l,148909,149190,281,RepeatMasker,LTR,148271,150328,281,1.00
ptg021372l,611874,612178,304,RepeatMasker,LTR,610724,613971,304,1.00
ptg021412l,298175,298496,321,RepeatMasker,LTR,298432,298483,52,0.16
ptg021416l,497989,498269,280,RepeatMasker,LTR,497966,499340,280,1.00
ptg021436l,501206,501529,323,RepeatMasker,LTR,500193,501370,164,0.51
ptg021436l,501206,501529,323,RepeatMasker,LTR,500702,501370,164,0.51
ptg021442l,2283314,2283633,319,RepeatMasker,LTR,2282538,2283491,177,0.55
ptg021460l,258929,259221,292,RepeatMasker,LTR,257864,259152,223,0.76
ptg021460l,258929,259221,292,RepeatMasker,LTR,259144,259483,78,0.27
ptg021465l,1091866,1092159,293,RepeatMasker,LTR,1092108,1092623,52,0.18
ptg021477l,683373,683693,320,RepeatMasker,LTR,681514,684176,320,1.00
ptg021494l,119109,119425,316,RepeatMasker,LTR,116198,119148,39,0.12
ptg021496l,419878,420164,286,RepeatMasker,LTR,419025,424790,286,1.00
ptg021498l,16936,17252,316,RepeatMasker,LTR,16790,17164,228,0.72
ptg021517l,549011,549291,280,RepeatMasker,LTR,547732,554276,280,1.00
ptg021527l,647089,647399,310,RepeatMasker,LTR,646483,647439,310,1.00
ptg021527l,820719,821033,314,RepeatMasker,LTR,820233,822818,314,1.00
ptg021530l,173258,173566,308,RepeatMasker,LTR,172837,173382,124,0.40
ptg021530l,173258,173566,308,RepeatMasker,LTR,172837,173461,203,0.66
ptg021530l,793671,793971,300,RepeatMasker,LTR,793619,794196,300,1.00
ptg021539l,37901,38196,295,RepeatMasker,LTR,37100,38564,295,1.00
ptg021540l,201658,201990,332,RepeatMasker,LTR,200188,201834,176,0.53
ptg021582l,286070,286382,312,RepeatMasker,LTR,285318,286322,252,0.81
ptg021588l,250072,250369,297,RepeatMasker,LTR,250038,250440,297,1.00
ptg021588l,627718,628006,288,RepeatMasker,LTR,627713,627941,223,0.77
ptg021588l,627718,628006,288,RepeatMasker,LTR,627815,628509,192,0.67
ptg021588l,838063,838362,299,RepeatMasker,LTR,838011,838529,299,1.00
ptg021593l,95964,96263,299,RepeatMasker,LTR,95912,96440,299,1.00
ptg021595l,485601,485895,294,RepeatMasker,LTR,484965,486275,294,1.00
ptg021595l,553902,554182,280,RepeatMasker,LTR,553102,554554,280,1.00
ptg021614l,1310895,1311182,287,RepeatMasker,LTR,1310040,1315858,287,1.00
ptg021636l,140421,140712,291,RepeatMasker,LTR,139614,141091,291,1.00
ptg021637l,155156,155442,286,RepeatMasker,LTR,150011,155840,286,1.00
ptg021637l,796505,796802,297,RepeatMasker,LTR,796453,797009,297,1.00
ptg021668l,15391,15688,297,RepeatMasker,LTR,15345,15732,297,1.00
ptg021668l,529170,529462,292,RepeatMasker,LTR,528066,529333,163,0.56
ptg021679l,574185,574484,299,RepeatMasker,LTR,574133,574564,299,1.00
ptg021691l,13219,13505,286,RepeatMasker,LTR,13139,13590,286,1.00
ptg021724l,1008793,1009074,281,RepeatMasker,LTR,1008780,1009452,281,1.00
ptg021729l,76689,76988,299,RepeatMasker,LTR,76637,76960,271,0.91
ptg021729l,173226,173524,298,RepeatMasker,LTR,173174,173700,298,1.00
ptg021734l,395839,396119,280,RepeatMasker,LTR,393263,398743,280,1.00
ptg021755l,242640,242888,248,RepeatMasker,LTR,237581,243836,248,1.00
ptg021767l,102278,102568,290,RepeatMasker,LTR,102348,102484,137,0.47
ptg021811l,1378193,1378520,327,RepeatMasker,LTR,1376818,1383218,327,1.00
ptg021815l,165063,165343,280,RepeatMasker,LTR,165051,165721,280,1.00
ptg021839l,368377,368693,316,RepeatMasker,LTR,368244,368488,111,0.35
ptg021839l,422145,422428,283,RepeatMasker,LTR,418768,422545,283,1.00
ptg021885l,645515,645807,292,RepeatMasker,LTR,644887,645705,190,0.65
ptg021885l,879681,880009,328,RepeatMasker,LTR,879461,879695,14,0.04
ptg021896l,71202,71498,296,RepeatMasker,LTR,71024,71654,296,1.00
ptg021922l,597304,597613,309,RepeatMasker,LTR,594579,597334,30,0.10
ptg021939l,449322,449613,291,RepeatMasker,LTR,448543,449866,291,1.00
ptg021939l,632259,632572,313,RepeatMasker,LTR,631273,632291,32,0.10
ptg021939l,632259,632572,313,RepeatMasker,LTR,632334,632924,239,0.76
ptg021947l,354840,355154,314,RepeatMasker,LTR,354330,355089,249,0.79
ptg021996l,97713,98024,311,RepeatMasker,LTR,91807,97739,26,0.08
ptg021996l,101111,101388,277,RepeatMasker,LTR,100991,101449,277,1.00
ptg021996l,101111,101388,277,RepeatMasker,LTR,101121,104794,268,0.97
ptg022003l,24463,24785,322,RepeatMasker,LTR,24676,25263,110,0.34
ptg022023l,1478940,1479264,324,RepeatMasker,LTR,1478284,1478955,15,0.05
ptg022023l,1478940,1479264,324,RepeatMasker,LTR,1479170,1479452,95,0.29
ptg022051l,673746,674040,294,RepeatMasker,LTR,674017,674061,24,0.08
ptg022051l,1393522,1393796,274,RepeatMasker,LTR,1393498,1393557,35,0.13
ptg022077l,183799,184080,281,RepeatMasker,LTR,183156,185209,281,1.00
ptg022079l,10406,10687,281,RepeatMasker,LTR,9770,11069,281,1.00
ptg022084l,492520,492836,316,RepeatMasker,LTR,492503,493153,316,1.00
ptg022085l,332570,332857,287,RepeatMasker,LTR,331708,334424,287,1.00
ptg022097l,426348,426647,299,RepeatMasker,LTR,426296,426727,299,1.00
ptg022119l,342986,343286,300,RepeatMasker,LTR,342934,343451,300,1.00
ptg022158l,255186,255483,297,RepeatMasker,LTR,255134,255561,297,1.00
ptg022158l,286923,287210,287,RepeatMasker,LTR,284502,288071,287,1.00
ptg022158l,810732,811031,299,RepeatMasker,LTR,810680,811003,271,0.91
ptg022158l,890750,891043,293,RepeatMasker,LTR,890698,891221,293,1.00
ptg022183l,180383,180690,307,RepeatMasker,LTR,179891,181637,307,1.00
ptg022183l,1083395,1083675,280,RepeatMasker,LTR,1076499,1083557,162,0.58
ptg022193l,48721,49002,281,RepeatMasker,LTR,48084,49378,281,1.00
ptg022197l,256833,257114,281,RepeatMasker,LTR,254226,260150,281,1.00
ptg022201l,442583,442861,278,RepeatMasker,LTR,442570,443973,278,1.00
ptg022201l,449743,450026,283,RepeatMasker,LTR,449730,451070,283,1.00
ptg022216l,930181,930508,327,RepeatMasker,LTR,929642,932173,327,1.00
ptg022216l,939571,939898,327,RepeatMasker,LTR,939032,940129,327,1.00
ptg022216l,976385,976712,327,RepeatMasker,LTR,975846,978419,327,1.00
ptg022223l,298103,298383,280,RepeatMasker,LTR,297466,299520,280,1.00
ptg022232l,502821,503150,329,RepeatMasker,LTR,502342,502855,34,0.10
ptg022234l,256924,257230,306,RepeatMasker,LTR,255143,257521,306,1.00
ptg022264l,534689,534969,280,RepeatMasker,LTR,534045,535358,280,1.00
ptg022307l,400617,400928,311,RepeatMasker,LTR,400380,400801,184,0.59
ptg022343l,95431,95727,296,RepeatMasker,LTR,95397,95768,296,1.00
ptg022343l,243150,243449,299,RepeatMasker,LTR,243098,243617,299,1.00
ptg022372l,512936,513217,281,RepeatMasker,LTR,512903,513623,281,1.00
ptg022420l,20957,21237,280,RepeatMasker,LTR,20166,21560,280,1.00
ptg022438l,487402,487712,310,RepeatMasker,LTR,487385,487864,310,1.00
ptg022450l,433967,434272,305,RepeatMasker,LTR,433915,434313,305,1.00
ptg022464l,463733,464030,297,RepeatMasker,LTR,463374,463941,208,0.70
ptg022479l,336693,336952,259,RepeatMasker,LTR,336560,339330,259,1.00
ptg022479l,864934,865264,330,RepeatMasker,LTR,864106,866191,330,1.00
ptg022511l,437918,438188,270,RepeatMasker,LTR,437920,437960,41,0.15
ptg022548l,276284,276577,293,RepeatMasker,LTR,276232,276657,293,1.00
ptg022551l,316560,316880,320,RepeatMasker,LTR,312787,316610,50,0.16
ptg022570l,369786,370067,281,RepeatMasker,LTR,369750,371120,281,1.00
ptg022571l,636499,636792,293,RepeatMasker,LTR,635565,636870,293,1.00
ptg022592l,74714,75040,326,RepeatMasker,LTR,74352,75475,326,1.00
ptg022603l,376487,376768,281,RepeatMasker,LTR,375687,377821,281,1.00
ptg022606l,403721,404001,280,RepeatMasker,LTR,402919,404383,280,1.00
ptg022607l,90664,90978,314,RepeatMasker,LTR,90380,90703,39,0.12
ptg022620l,294790,295092,302,RepeatMasker,LTR,293274,295318,302,1.00
ptg022676l,138191,138490,299,RepeatMasker,LTR,138144,138668,299,1.00
ptg022686l,190317,190598,281,RepeatMasker,LTR,189681,191041,281,1.00
ptg022687l,316228,316506,278,RepeatMasker,LTR,315438,316891,278,1.00
ptg022700l,169579,169884,305,RepeatMasker,LTR,169375,169638,59,0.19
ptg022703l,90017,90299,282,RepeatMasker,LTR,90004,91358,282,1.00
ptg022718l,403353,403652,299,RepeatMasker,LTR,403301,403877,299,1.00
ptg022718l,581029,581335,306,RepeatMasker,LTR,580039,581120,91,0.30
ptg022719l,569767,570051,284,RepeatMasker,LTR,569220,571030,284,1.00
ptg022749l,548834,549150,316,RepeatMasker,LTR,548841,548942,102,0.32
ptg022786l,386969,387266,297,RepeatMasker,LTR,386917,387431,297,1.00
ptg022799l,370800,371097,297,RepeatMasker,LTR,370748,371274,297,1.00
ptg022805l,11527,11844,317,RepeatMasker,LTR,9069,11565,38,0.12
ptg022817l,1230221,1230531,310,RepeatMasker,LTR,1230320,1230799,212,0.68
ptg022829l,2933811,2934131,320,RepeatMasker,LTR,2933383,2934791,320,1.00
ptg022846l,434435,434683,248,RepeatMasker,LTR,429914,438792,248,1.00
ptg022871l,342839,343119,280,RepeatMasker,LTR,342200,343501,280,1.00
ptg022873l,901674,901993,319,RepeatMasker,LTR,901969,902013,25,0.08
ptg022885l,544046,544326,280,RepeatMasker,LTR,543435,545218,280,1.00
ptg022886l,305319,305600,281,RepeatMasker,LTR,304678,306737,281,1.00
ptg022926l,242596,242873,277,RepeatMasker,LTR,241992,243370,277,1.00
ptg022946l,29697,29994,297,RepeatMasker,LTR,28913,31022,297,1.00
ptg022960l,432925,433225,300,RepeatMasker,LTR,432061,433152,227,0.76
ptg022979l,851769,852050,281,RepeatMasker,LTR,851736,852124,281,1.00
ptg022979l,851769,852050,281,RepeatMasker,LTR,851736,852204,281,1.00
ptg022981l,2715838,2716118,280,RepeatMasker,LTR,2715806,2716500,280,1.00
ptg022985l,48912,49226,314,RepeatMasker,LTR,48111,49204,292,0.93
ptg022988l,424218,424498,280,RepeatMasker,LTR,424184,425557,280,1.00
ptg022996l,311403,311719,316,RepeatMasker,LTR,311390,311501,98,0.31
ptg023022l,372816,373102,286,RepeatMasker,LTR,371962,374672,286,1.00
ptg023038l,161741,162027,286,RepeatMasker,LTR,161814,161854,41,0.14
ptg023039l,277792,278071,279,RepeatMasker,LTR,276992,278457,279,1.00
ptg023050l,305082,305399,317,RepeatMasker,LTR,305050,305765,317,1.00
ptg023062l,135424,135714,290,RepeatMasker,LTR,133579,136294,290,1.00
ptg023079l,456111,456417,306,RepeatMasker,LTR,456415,456978,3,0.01
ptg023091l,205215,205520,305,RepeatMasker,LTR,204918,205363,148,0.49
ptg023118l,94627,94920,293,RepeatMasker,LTR,94614,96047,293,1.00
ptg023141l,64783,65095,312,RepeatMasker,LTR,65006,65048,43,0.14
ptg023141l,64783,65095,312,RepeatMasker,LTR,65044,68678,52,0.17
ptg023149l,482041,482327,286,RepeatMasker,LTR,481186,485927,286,1.00
ptg023168l,183102,183418,316,RepeatMasker,LTR,182103,185880,316,1.00
ptg023173l,876688,876987,299,RepeatMasker,LTR,876636,877197,299,1.00
ptg023184l,209672,209992,320,RepeatMasker,LTR,208839,209868,196,0.61
ptg023188l,59578,59890,312,RepeatMasker,LTR,58622,59770,192,0.62
ptg023188l,59578,59890,312,RepeatMasker,LTR,59795,60258,96,0.31
ptg023190l,192298,192598,300,RepeatMasker,LTR,192246,192618,300,1.00
ptg023215l,585452,585780,328,RepeatMasker,LTR,584822,585588,136,0.41
ptg023224l,130400,130702,302,RepeatMasker,LTR,130679,131425,24,0.08
ptg023224l,130400,130702,302,RepeatMasker,LTR,130679,131810,24,0.08
ptg023229l,63934,64226,292,RepeatMasker,LTR,61102,64568,292,1.00
ptg023288l,255864,256143,279,RepeatMasker,LTR,255221,257269,279,1.00
ptg023288l,263028,263327,299,RepeatMasker,LTR,262229,264322,299,1.00
ptg023366l,174205,174502,297,RepeatMasker,LTR,173568,175440,297,1.00
ptg023376l,799806,800106,300,RepeatMasker,LTR,799960,800081,122,0.41
ptg023403l,91927,92207,280,RepeatMasker,LTR,91126,92511,280,1.00
ptg023411l,145711,145992,281,RepeatMasker,LTR,145264,147371,281,1.00
ptg023418l,167635,167927,292,RepeatMasker,LTR,167700,167785,86,0.29
ptg023423l,66027,66363,336,RepeatMasker,LTR,66319,70861,45,0.13
ptg023435l,267958,268261,303,RepeatMasker,LTR,268049,273530,213,0.70
ptg023452l,1390334,1390641,307,RepeatMasker,LTR,1389542,1391000,307,1.00
ptg023453l,82640,82926,286,RepeatMasker,LTR,81994,83300,286,1.00
ptg023472l,492551,492821,270,RepeatMasker,LTR,491916,493885,270,1.00
ptg023472l,1372904,1373190,286,RepeatMasker,LTR,1366765,1373592,286,1.00
ptg023472l,1413742,1414061,319,RepeatMasker,LTR,1413465,1413792,50,0.16
ptg023476l,235149,235452,303,RepeatMasker,LTR,234850,238379,303,1.00
ptg023502l,101718,102044,326,RepeatMasker,LTR,101206,101766,48,0.15
ptg023531l,379146,379394,248,RepeatMasker,LTR,375726,383581,248,1.00
ptg023555l,215315,215621,306,RepeatMasker,LTR,215276,215316,1,0.00
ptg023555l,215315,215621,306,RepeatMasker,LTR,215347,215394,48,0.16
ptg023563l,372956,373273,317,RepeatMasker,LTR,372321,374318,317,1.00
ptg023563l,378340,378619,279,RepeatMasker,LTR,377701,379001,279,1.00
ptg023564l,469845,470148,303,RepeatMasker,LTR,470001,470058,58,0.19
ptg023564l,469845,470148,303,RepeatMasker,LTR,470008,470516,141,0.47
ptg023567l,731436,731755,319,RepeatMasker,LTR,731223,731529,93,0.29
ptg023582l,249974,250302,328,RepeatMasker,LTR,244973,251045,328,1.00
ptg023595l,55349,55666,317,RepeatMasker,LTR,53116,55459,110,0.35
ptg023602l,176365,176665,300,RepeatMasker,LTR,176313,176882,300,1.00
ptg023607l,353413,353694,281,RepeatMasker,LTR,352618,354005,281,1.00
ptg023609l,648320,648633,313,RepeatMasker,LTR,641444,648482,162,0.52
ptg023609l,648320,648633,313,RepeatMasker,LTR,648479,648988,155,0.50
ptg023618l,81614,81896,282,RepeatMasker,LTR,81581,82277,282,1.00
ptg023618l,89118,89400,282,RepeatMasker,LTR,89085,89782,282,1.00
ptg023618l,331403,331683,280,RepeatMasker,LTR,330760,332081,280,1.00
ptg023641l,471949,472248,299,RepeatMasker,LTR,471897,472411,299,1.00
ptg023664l,724693,724971,278,RepeatMasker,LTR,724043,725361,278,1.00
ptg023682l,351748,352029,281,RepeatMasker,LTR,351715,352409,281,1.00
ptg023685l,629366,629675,309,RepeatMasker,LTR,622468,629528,162,0.52
ptg023690l,6527,6824,297,RepeatMasker,LTR,3901,10056,297,1.00
ptg023699l,235464,235781,317,RepeatMasker,LTR,233677,237154,317,1.00
ptg023742l,88574,88854,280,RepeatMasker,LTR,88519,89261,280,1.00
ptg023779l,86715,86995,280,RepeatMasker,LTR,86071,87017,280,1.00
ptg023784l,797476,797756,280,RepeatMasker,LTR,797444,798142,280,1.00
ptg023786l,111184,111483,299,RepeatMasker,LTR,111132,111563,299,1.00
ptg023786l,1109688,1110001,313,RepeatMasker,LTR,1109661,1110135,313,1.00
ptg023788l,125632,125918,286,RepeatMasker,LTR,119499,126293,286,1.00
ptg023816l,105995,106288,293,RepeatMasker,LTR,105133,107286,293,1.00
ptg023821l,268297,268602,305,RepeatMasker,LTR,267652,268959,305,1.00
ptg023865l,927211,927510,299,RepeatMasker,LTR,926960,929875,299,1.00
ptg023882l,529004,529303,299,RepeatMasker,LTR,528952,529511,299,1.00
ptg023889l,311401,311688,287,RepeatMasker,LTR,310538,316383,287,1.00
ptg023896l,242091,242372,281,RepeatMasker,LTR,237768,244059,281,1.00
ptg023898l,103148,103457,309,RepeatMasker,LTR,102929,104269,309,1.00
ptg023904l,258618,258890,272,RepeatMasker,LTR,257861,258676,58,0.21
ptg023919l,21888,22194,306,RepeatMasker,LTR,20472,24114,306,1.00
ptg023952l,1091542,1091805,263,RepeatMasker,LTR,1091609,1091676,68,0.26
ptg023952l,1345306,1345595,289,RepeatMasker,LTR,1343507,1345319,13,0.04
ptg024015l,137727,138007,280,RepeatMasker,LTR,137714,138735,280,1.00
ptg024026l,158010,158314,304,RepeatMasker,LTR,155745,158377,304,1.00
ptg024042l,107369,107690,321,RepeatMasker,LTR,107532,107675,144,0.45
ptg024058l,640044,640325,281,RepeatMasker,LTR,639393,640719,281,1.00
ptg024085l,174588,174869,281,RepeatMasker,LTR,174556,175258,281,1.00
ptg024090l,1133493,1133792,299,RepeatMasker,LTR,1133447,1133833,299,1.00
ptg024091l,262385,262679,294,RepeatMasker,LTR,262492,262750,188,0.64
ptg024091l,262385,262679,294,RepeatMasker,LTR,260153,262417,32,0.11
ptg024108l,294931,295209,278,RepeatMasker,LTR,294029,295284,278,1.00
ptg024109l,708768,709085,317,RepeatMasker,LTR,708623,708992,224,0.71
ptg024169l,16748,17047,299,RepeatMasker,LTR,16696,17273,299,1.00
ptg024182l,59151,59452,301,RepeatMasker,LTR,59104,59659,301,1.00
ptg024189l,325210,325488,278,RepeatMasker,LTR,324417,326533,278,1.00
ptg024210l,439108,439389,281,RepeatMasker,LTR,438469,440534,281,1.00
ptg024211l,183685,183980,295,RepeatMasker,LTR,183651,184158,295,1.00
ptg024238l,333393,333684,291,RepeatMasker,LTR,332934,333731,291,1.00
ptg024257l,265331,265610,279,RepeatMasker,LTR,264708,265990,279,1.00
ptg024257l,585401,585686,285,RepeatMasker,LTR,584960,587058,285,1.00
ptg024265l,1053,1334,281,RepeatMasker,LTR,419,2380,281,1.00
ptg024269l,1022996,1023280,284,RepeatMasker,LTR,1023184,1024297,97,0.34
ptg024288l,169833,170120,287,RepeatMasker,LTR,168972,173048,287,1.00
ptg024306l,44295,44586,291,RepeatMasker,LTR,42078,44509,214,0.74
ptg024328l,430366,430667,301,RepeatMasker,LTR,429135,430472,106,0.35
ptg024338l,381187,381524,337,RepeatMasker,LTR,381164,381274,87,0.26
ptg024342l,747559,747869,310,RepeatMasker,LTR,741575,747672,113,0.36
ptg024342l,747559,747869,310,RepeatMasker,LTR,747671,748614,199,0.64
ptg024342l,752583,752894,311,RepeatMasker,LTR,751289,752697,114,0.37
ptg024342l,752583,752894,311,RepeatMasker,LTR,752696,753639,199,0.64
ptg024342l,757613,757923,310,RepeatMasker,LTR,756318,757726,113,0.36
ptg024342l,757613,757923,310,RepeatMasker,LTR,757725,758668,199,0.64
ptg024360l,108016,108296,280,RepeatMasker,LTR,107216,108686,280,1.00
ptg024404l,531563,531890,327,RepeatMasker,LTR,528622,531797,234,0.72
ptg024411l,193778,194068,290,RepeatMasker,LTR,193765,194441,290,1.00
ptg024418l,28615,28929,314,RepeatMasker,LTR,27346,28645,30,0.10
ptg024437l,327771,328052,281,RepeatMasker,LTR,327136,329195,281,1.00
ptg024437l,334958,335248,290,RepeatMasker,LTR,334177,336285,290,1.00
ptg024464l,344800,345121,321,RepeatMasker,LTR,342040,344850,50,0.16
ptg024468l,177262,177542,280,RepeatMasker,LTR,177249,178599,280,1.00
ptg024555l,696740,697048,308,RepeatMasker,LTR,696727,697433,308,1.00
ptg024604l,812691,813004,313,RepeatMasker,LTR,812698,813591,307,0.98
ptg024604l,892475,892770,295,RepeatMasker,LTR,891883,892525,50,0.17
ptg024604l,1163037,1163325,288,RepeatMasker,LTR,1162178,1164752,288,1.00
ptg024608l,135751,136057,306,RepeatMasker,LTR,134577,135783,32,0.10
ptg024608l,135751,136057,306,RepeatMasker,LTR,135859,136166,199,0.65
ptg024633l,119116,119431,315,RepeatMasker,LTR,116971,119632,315,1.00
ptg024673l,59768,60031,263,RepeatMasker,LTR,60010,60068,22,0.08
ptg024673l,449909,450207,298,RepeatMasker,LTR,449857,450423,298,1.00
ptg024706l,2004400,2004685,285,RepeatMasker,LTR,2003993,2004511,111,0.39
ptg024706l,2004400,2004685,285,RepeatMasker,LTR,2004006,2004597,197,0.69
ptg024753l,86532,86813,281,RepeatMasker,LTR,85739,87201,281,1.00
ptg024764l,915787,916068,281,RepeatMasker,LTR,915142,916450,281,1.00
ptg024862l,23657,23950,293,RepeatMasker,LTR,23605,24030,293,1.00
ptg024902l,194932,195212,280,RepeatMasker,LTR,194132,196260,280,1.00
ptg024909l,26296,26576,280,RepeatMasker,LTR,25640,26958,280,1.00
ptg024909l,151898,152214,316,RepeatMasker,LTR,151828,151919,21,0.07
ptg024909l,710341,710656,315,RepeatMasker,LTR,705642,713139,315,1.00
ptg024909l,786428,786709,281,RepeatMasker,LTR,786405,787771,281,1.00
ptg024929l,424835,425115,280,RepeatMasker,LTR,424053,426163,280,1.00
ptg024949l,489900,490183,283,RepeatMasker,LTR,490161,490423,23,0.08
ptg024974l,459771,460063,292,RepeatMasker,LTR,457219,459821,50,0.17
ptg025005l,190045,190338,293,RepeatMasker,LTR,183846,190096,51,0.17
ptg025033l,239715,239995,280,RepeatMasker,LTR,238924,241176,280,1.00
ptg025033l,256619,256915,296,RepeatMasker,LTR,256095,257980,296,1.00
ptg025040l,601239,601544,305,RepeatMasker,LTR,596207,601407,168,0.55
ptg025040l,601239,601544,305,RepeatMasker,LTR,601406,605005,139,0.46
ptg025074l,695535,695822,287,RepeatMasker,LTR,695230,696397,287,1.00
ptg025093l,176450,176736,286,RepeatMasker,LTR,176385,177483,286,1.00
ptg025093l,510038,510338,300,RepeatMasker,LTR,509795,510271,233,0.78
ptg025093l,956874,957162,288,RepeatMasker,LTR,956914,957229,249,0.86
ptg025093l,1476505,1476802,297,RepeatMasker,LTR,1476455,1476843,297,1.00
ptg025095l,129930,130210,280,RepeatMasker,LTR,129917,131254,280,1.00
ptg025109l,506402,506701,299,RepeatMasker,LTR,506350,506866,299,1.00
ptg025125l,738447,738727,280,RepeatMasker,LTR,737812,739118,280,1.00
ptg025135l,19550,19830,280,RepeatMasker,LTR,18901,20204,280,1.00
ptg025181l,164370,164690,320,RepeatMasker,LTR,164304,164406,36,0.11
ptg025181l,164370,164690,320,RepeatMasker,LTR,164391,166593,300,0.94
ptg025181l,294769,295085,316,RepeatMasker,LTR,294792,295151,294,0.93
ptg025201l,225909,226226,317,RepeatMasker,LTR,224632,227099,317,1.00
ptg025234l,90802,91099,297,RepeatMasker,LTR,90769,91465,297,1.00
ptg025253l,84381,84680,299,RepeatMasker,LTR,84335,84721,299,1.00
ptg025296l,74166,74462,296,RepeatMasker,LTR,74113,74542,296,1.00
ptg025311l,675165,675464,299,RepeatMasker,LTR,675113,675672,299,1.00
ptg025330l,458880,459185,305,RepeatMasker,LTR,459084,459299,102,0.33
ptg025355l,187674,187955,281,RepeatMasker,LTR,187662,188266,281,1.00
ptg025355l,187674,187955,281,RepeatMasker,LTR,187663,188337,281,1.00
ptg025355l,198381,198661,280,RepeatMasker,LTR,198368,199811,280,1.00
ptg025389l,296675,296962,287,RepeatMasker,LTR,296291,297675,287,1.00
ptg025402l,112081,112362,281,RepeatMasker,LTR,112063,112751,281,1.00
ptg025422l,120701,121009,308,RepeatMasker,LTR,118224,121471,308,1.00
ptg025422l,586382,586692,310,RepeatMasker,LTR,583413,588359,310,1.00
ptg025451l,270654,270933,279,RepeatMasker,LTR,270008,271310,279,1.00
ptg025462l,68068,68382,314,RepeatMasker,LTR,67510,68093,25,0.08
ptg025462l,68068,68382,314,RepeatMasker,LTR,68092,69953,291,0.93
ptg025471l,112479,112773,294,RepeatMasker,LTR,112335,113087,294,1.00
ptg025474l,643992,644294,302,RepeatMasker,LTR,642434,645049,302,1.00
ptg025514l,71834,72115,281,RepeatMasker,LTR,71801,72496,281,1.00
ptg025514l,372717,372998,281,RepeatMasker,LTR,372078,373380,281,1.00
ptg025520l,633311,633592,281,RepeatMasker,LTR,632668,633906,281,1.00
ptg025554l,876859,877158,299,RepeatMasker,LTR,876813,877199,299,1.00
ptg025557l,206772,207077,305,RepeatMasker,LTR,206656,207217,305,1.00
ptg025568l,268186,268493,307,RepeatMasker,LTR,268361,273252,133,0.43
ptg025598l,22331,22630,299,RepeatMasker,LTR,22279,22650,299,1.00
ptg025631l,1041726,1042038,312,RepeatMasker,LTR,1040639,1045618,312,1.00
ptg025641l,308736,309062,326,RepeatMasker,LTR,308724,309038,302,0.93
ptg025641l,317435,317715,280,RepeatMasker,LTR,317423,318087,280,1.00
ptg025648l,176062,176370,308,RepeatMasker,LTR,176175,176461,196,0.64
ptg025686l,23176,23461,285,RepeatMasker,LTR,23052,26209,285,1.00
ptg025690l,434135,434421,286,RepeatMasker,LTR,434010,435653,286,1.00
ptg025695l,536118,536379,261,RepeatMasker,LTR,536140,536508,240,0.92
ptg025699l,22587,22866,279,RepeatMasker,LTR,21943,23253,279,1.00
ptg025699l,34154,34434,280,RepeatMasker,LTR,34142,34831,280,1.00
ptg025710c,53601,53882,281,RepeatMasker,LTR,53793,53864,72,0.26
ptg025735l,143784,144071,287,RepeatMasker,LTR,143773,143823,39,0.14
ptg025735l,143784,144071,287,RepeatMasker,LTR,143779,144006,222,0.77
ptg025735l,143784,144071,287,RepeatMasker,LTR,143880,144576,192,0.67
ptg025735l,420087,420370,283,RepeatMasker,LTR,413208,420257,170,0.60
ptg025769l,315124,315410,286,RepeatMasker,LTR,309027,315807,286,1.00
ptg025798l,366458,366778,320,RepeatMasker,LTR,363055,366508,50,0.16
ptg025840l,77453,77734,281,RepeatMasker,LTR,77420,78055,281,1.00
ptg025864l,33809,34105,296,RepeatMasker,LTR,33757,34326,296,1.00
ptg025870l,173461,173775,314,RepeatMasker,LTR,169873,173489,28,0.09
ptg025870l,173461,173775,314,RepeatMasker,LTR,173688,174167,88,0.28
ptg025903l,913605,913898,293,RepeatMasker,LTR,911070,913655,50,0.17
ptg025908l,350737,351007,270,RepeatMasker,LTR,350725,351389,270,1.00
ptg025930l,147888,148183,295,RepeatMasker,LTR,147091,148551,295,1.00
ptg025935l,394422,394709,287,RepeatMasker,LTR,393589,395854,287,1.00
ptg025935l,394422,394709,287,RepeatMasker,LTR,393858,398380,287,1.00
ptg025956l,511245,511543,298,RepeatMasker,LTR,511198,511708,298,1.00
ptg025988l,191493,191795,302,RepeatMasker,LTR,189926,192549,302,1.00
ptg026059l,1531342,1531652,310,RepeatMasker,LTR,1529813,1531504,162,0.52
ptg026059l,1531342,1531652,310,RepeatMasker,LTR,1530237,1531504,162,0.52
ptg026060l,103451,103749,298,RepeatMasker,LTR,103399,103940,298,1.00
ptg026082l,215176,215463,287,RepeatMasker,LTR,214429,215220,44,0.15
ptg026090l,152932,153211,279,RepeatMasker,LTR,152290,154212,279,1.00
ptg026100l,41017,41316,299,RepeatMasker,LTR,40118,41278,261,0.87
ptg026148l,37724,38039,315,RepeatMasker,LTR,37596,38475,315,1.00
ptg026160l,98892,99197,305,RepeatMasker,LTR,99068,99109,42,0.14
ptg026164l,153329,153627,298,RepeatMasker,LTR,153546,153835,82,0.28
ptg026165l,1017171,1017473,302,RepeatMasker,LTR,1016371,1017834,302,1.00
ptg026201l,229471,229751,280,RepeatMasker,LTR,229459,230133,280,1.00
ptg026201l,272562,272842,280,RepeatMasker,LTR,271865,273223,280,1.00
ptg026218l,258345,258626,281,RepeatMasker,LTR,258329,259014,281,1.00
ptg026218l,265489,265770,281,RepeatMasker,LTR,265457,266081,281,1.00
ptg026220l,264956,265255,299,RepeatMasker,LTR,264904,265436,299,1.00
ptg026224l,430160,430492,332,RepeatMasker,LTR,430113,430242,82,0.25
ptg026247l,341467,341747,280,RepeatMasker,LTR,340833,342161,280,1.00
ptg026264l,1004772,1005052,280,RepeatMasker,LTR,1003966,1005433,280,1.00
ptg026264l,1037030,1037311,281,RepeatMasker,LTR,1036461,1038360,281,1.00
ptg026286l,123875,124156,281,RepeatMasker,LTR,123078,124553,281,1.00
ptg026293l,14231,14528,297,RepeatMasker,LTR,14197,14548,297,1.00
ptg026297l,621273,621594,321,RepeatMasker,LTR,619827,621398,125,0.39
ptg026317l,286725,287028,303,RepeatMasker,LTR,286583,287802,303,1.00
ptg026328l,147376,147691,315,RepeatMasker,LTR,147169,151239,315,1.00
ptg026354l,27743,28023,280,RepeatMasker,LTR,26946,28087,280,1.00
ptg026354l,27743,28023,280,RepeatMasker,LTR,27732,28167,280,1.00
ptg026354l,154237,154502,265,RepeatMasker,LTR,151009,154267,30,0.11
ptg026354l,154237,154502,265,RepeatMasker,LTR,154262,159509,241,0.91
ptg026378l,294185,294488,303,RepeatMasker,LTR,293700,294201,16,0.05
ptg026378l,294185,294488,303,RepeatMasker,LTR,294301,294337,37,0.12
ptg026441l,357414,357700,286,RepeatMasker,LTR,351288,358100,286,1.00
ptg026508l,184918,185204,286,RepeatMasker,LTR,184278,186253,286,1.00
ptg026560l,386208,386499,291,RepeatMasker,LTR,380815,386258,50,0.17
ptg026580l,492338,492658,320,RepeatMasker,LTR,488587,492388,50,0.16
ptg026585l,344592,344902,310,RepeatMasker,LTR,344864,345475,39,0.13
ptg026585l,344592,344902,310,RepeatMasker,LTR,341915,344861,269,0.87
ptg026594l,507341,507622,281,RepeatMasker,LTR,507308,508004,281,1.00
ptg026594l,519111,519392,281,RepeatMasker,LTR,518309,519774,281,1.00
ptg026605l,405521,405798,277,RepeatMasker,LTR,404720,406195,277,1.00
ptg026635l,18760,19072,312,RepeatMasker,LTR,17518,18863,103,0.33
ptg026643l,648170,648451,281,RepeatMasker,LTR,648157,649583,281,1.00
ptg026643l,655323,655604,281,RepeatMasker,LTR,654769,656689,281,1.00
ptg026684l,63626,63922,296,RepeatMasker,LTR,63614,64251,296,1.00
ptg026692l,102218,102499,281,RepeatMasker,LTR,101581,102888,281,1.00
ptg026709l,327096,327420,324,RepeatMasker,LTR,325567,327407,311,0.96
ptg026709l,327096,327420,324,RepeatMasker,LTR,327322,327452,99,0.31
ptg026735l,158461,158742,281,RepeatMasker,LTR,157823,159801,281,1.00
ptg026741l,817021,817307,286,RepeatMasker,LTR,817009,817683,286,1.00
ptg026741l,824168,824448,280,RepeatMasker,LTR,823361,824830,280,1.00
ptg026773l,101472,101748,276,RepeatMasker,LTR,100827,102142,276,1.00
ptg026773l,108627,108908,281,RepeatMasker,LTR,107825,109309,281,1.00
ptg026781l,41446,41745,299,RepeatMasker,LTR,41394,41950,299,1.00
ptg026799l,211578,211871,293,RepeatMasker,LTR,211526,212063,293,1.00
ptg026803l,318997,319277,280,RepeatMasker,LTR,318207,319671,280,1.00
ptg026824l,161302,161580,278,RepeatMasker,LTR,160664,161891,278,1.00
ptg026826l,428669,428971,302,RepeatMasker,LTR,428448,428675,6,0.02
ptg026848l,48423,48703,280,RepeatMasker,LTR,48389,49760,280,1.00
ptg026855l,851173,851460,287,RepeatMasker,LTR,850311,853626,287,1.00
ptg026855l,3986496,3986791,295,RepeatMasker,LTR,3986444,3986811,295,1.00
ptg026855l,4861535,4861829,294,RepeatMasker,LTR,4861483,4862007,294,1.00
ptg026869l,101801,102088,287,RepeatMasker,LTR,101731,102320,287,1.00
ptg026935l,153835,154119,284,RepeatMasker,LTR,153201,154131,284,1.00
ptg026936l,151530,151836,306,RepeatMasker,LTR,150892,152870,306,1.00
ptg027009l,31897,32194,297,RepeatMasker,LTR,31845,32358,297,1.00
ptg027071l,88762,89068,306,RepeatMasker,LTR,89017,89981,52,0.17
ptg027072l,787851,788134,283,RepeatMasker,LTR,785990,790482,283,1.00
ptg027085l,353184,353488,304,RepeatMasker,LTR,352960,353330,146,0.48
ptg027149l,206966,207271,305,RepeatMasker,LTR,206817,207512,305,1.00
ptg027224l,432471,432771,300,RepeatMasker,LTR,432419,432851,300,1.00
ptg027224l,1856629,1856926,297,RepeatMasker,LTR,1856577,1857091,297,1.00
ptg027224l,2013126,2013425,299,RepeatMasker,LTR,2013074,2013466,299,1.00
ptg027233l,24465,24766,301,RepeatMasker,LTR,19219,24626,161,0.53
ptg027237l,32226,32506,280,RepeatMasker,LTR,31577,32826,280,1.00
ptg027289l,555669,555991,322,RepeatMasker,LTR,548778,555831,162,0.50
ptg027307l,219865,220146,281,RepeatMasker,LTR,219103,221205,281,1.00
ptg027350l,47576,47896,320,RepeatMasker,LTR,41428,47626,50,0.16
ptg027354l,35146,35442,296,RepeatMasker,LTR,35107,35147,1,0.00
ptg027354l,35146,35442,296,RepeatMasker,LTR,35178,35225,48,0.16
ptg027429l,4161929,4162223,294,RepeatMasker,LTR,4161283,4162601,294,1.00
ptg027439l,2397659,2397940,281,RepeatMasker,LTR,2397298,2397857,198,0.70
ptg027439l,2397659,2397940,281,RepeatMasker,LTR,2397802,2397952,139,0.49
ptg027443l,85503,85802,299,RepeatMasker,LTR,85469,85980,299,1.00
ptg027450l,418326,418644,318,RepeatMasker,LTR,417616,418375,49,0.15
ptg027477l,2426,2706,280,RepeatMasker,LTR,2414,3100,280,1.00
ptg027572l,287757,288037,280,RepeatMasker,LTR,286978,289080,280,1.00
ptg027572l,325701,325982,281,RepeatMasker,LTR,325898,327256,85,0.30
ptg027593l,205216,205526,310,RepeatMasker,LTR,205461,205525,65,0.21
ptg027620l,347844,348163,319,RepeatMasker,LTR,347695,348144,300,0.94
ptg027633l,155855,156141,286,RepeatMasker,LTR,155018,157711,286,1.00
ptg027633l,1341076,1341374,298,RepeatMasker,LTR,1339956,1341239,163,0.55
ptg027634l,61829,62141,312,RepeatMasker,LTR,61028,62128,299,0.96
ptg027634l,61829,62141,312,RepeatMasker,LTR,61818,62543,312,1.00
ptg027665l,6450,6730,280,RepeatMasker,LTR,5648,7041,280,1.00
ptg027667l,94897,95183,286,RepeatMasker,LTR,90689,95582,286,1.00
ptg027681l,171006,171277,271,RepeatMasker,LTR,169274,171168,162,0.60
ptg027688l,326113,326420,307,RepeatMasker,LTR,325657,326606,307,1.00
ptg027697l,195693,196005,312,RepeatMasker,LTR,195161,195721,28,0.09
ptg027697l,195693,196005,312,RepeatMasker,LTR,195357,195765,72,0.23
ptg027705l,139669,139982,313,RepeatMasker,LTR,136745,143749,313,1.00
ptg027733l,123210,123508,298,RepeatMasker,LTR,122575,123872,298,1.00
ptg027788l,39584,39897,313,RepeatMasker,LTR,39766,40000,132,0.42
ptg027793l,312427,312726,299,RepeatMasker,LTR,312375,312933,299,1.00
ptg027820l,765121,765401,280,RepeatMasker,LTR,764404,766961,280,1.00
ptg027838l,422067,422348,281,RepeatMasker,LTR,421422,422730,281,1.00
ptg027839l,66011,66312,301,RepeatMasker,LTR,65863,66305,294,0.98
ptg027864l,53108,53406,298,RepeatMasker,LTR,53075,53771,298,1.00
ptg027864l,60251,60534,283,RepeatMasker,LTR,60218,60850,283,1.00
ptg027865l,103581,103892,311,RepeatMasker,LTR,103769,103839,71,0.23
ptg027892l,133605,133853,248,RepeatMasker,LTR,127927,138051,248,1.00
ptg027909l,330942,331230,288,RepeatMasker,LTR,331102,331187,86,0.30
ptg027936l,273293,273576,283,RepeatMasker,LTR,273280,273975,283,1.00
ptg027997l,447938,448251,313,RepeatMasker,LTR,447110,453317,313,1.00
ptg027999l,245963,246264,301,RepeatMasker,LTR,246087,246136,50,0.17
ptg028007l,393725,394018,293,RepeatMasker,LTR,393673,394098,293,1.00
ptg028014l,789855,790142,287,RepeatMasker,LTR,789005,789885,30,0.10
ptg028020l,14800,15083,283,RepeatMasker,LTR,8669,15486,283,1.00
ptg028041l,497084,497365,281,RepeatMasker,LTR,496437,497434,281,1.00
ptg028079l,198361,198656,295,RepeatMasker,LTR,198309,198867,295,1.00
ptg028084l,2008,2289,281,RepeatMasker,LTR,1995,2671,281,1.00
ptg028101l,269803,270093,290,RepeatMasker,LTR,269622,271768,290,1.00
ptg028102l,309056,309375,319,RepeatMasker,LTR,308692,309219,163,0.51
ptg028146l,67292,67587,295,RepeatMasker,LTR,66657,68621,295,1.00
ptg028171l,303958,304239,281,RepeatMasker,LTR,303192,304626,281,1.00
ptg028183l,165520,165783,263,RepeatMasker,LTR,159279,165683,163,0.62
ptg028215l,147476,147761,285,RepeatMasker,LTR,147486,151187,276,0.97
ptg028215l,147476,147761,285,RepeatMasker,LTR,147354,147485,9,0.03
ptg028369l,234483,234779,296,RepeatMasker,LTR,234449,234799,296,1.00
ptg028373l,733821,734109,288,RepeatMasker,LTR,733786,735266,288,1.00
ptg028411l,589081,589405,324,RepeatMasker,LTR,589164,591695,242,0.75
ptg028473l,160418,160728,310,RepeatMasker,LTR,160405,161866,310,1.00
ptg028473l,174639,174918,279,RepeatMasker,LTR,174626,175966,279,1.00
ptg028483l,618474,618772,298,RepeatMasker,LTR,616364,623648,298,1.00
ptg028502l,120596,120916,320,RepeatMasker,LTR,119321,120646,50,0.16
ptg028508l,91411,91691,280,RepeatMasker,LTR,90774,92075,280,1.00
ptg028530l,74929,75209,280,RepeatMasker,LTR,74284,75520,280,1.00
ptg028530l,74929,75209,280,RepeatMasker,LTR,74918,75591,280,1.00
ptg028550l,591949,592240,291,RepeatMasker,LTR,591923,592612,291,1.00
ptg028554l,63147,63434,287,RepeatMasker,LTR,62287,68073,287,1.00
ptg028570l,216420,216721,301,RepeatMasker,LTR,216368,216953,301,1.00
ptg028571l,290004,290285,281,RepeatMasker,LTR,289351,290677,281,1.00
ptg028599l,1194737,1195049,312,RepeatMasker,LTR,1194704,1195035,298,0.96
ptg028657l,114728,115059,331,RepeatMasker,LTR,111891,115494,331,1.00
ptg028661l,6334,6636,302,RepeatMasker,LTR,5532,7027,302,1.00
ptg028666l,421145,421426,281,RepeatMasker,LTR,421113,421432,281,1.00
ptg028675l,19171,19461,290,RepeatMasker,LTR,18884,19183,12,0.04
ptg028702l,192703,193007,304,RepeatMasker,LTR,192039,192725,22,0.07
ptg028702l,209741,210025,284,RepeatMasker,LTR,208961,211160,284,1.00
ptg028702l,213838,214122,284,RepeatMasker,LTR,213825,215168,284,1.00
ptg028756l,215529,215822,293,RepeatMasker,LTR,209420,215579,50,0.17
ptg028764l,536948,537235,287,RepeatMasker,LTR,536090,537730,287,1.00
ptg028777l,47469,47750,281,RepeatMasker,LTR,46816,48059,281,1.00
ptg028789l,1490,1790,300,RepeatMasker,LTR,1438,2002,300,1.00
ptg028801l,379466,379746,280,RepeatMasker,LTR,378825,380128,280,1.00
ptg028814l,61716,61996,280,RepeatMasker,LTR,60926,62380,280,1.00
ptg028936l,733859,734158,299,RepeatMasker,LTR,733807,734199,299,1.00
ptg028936l,984760,985059,299,RepeatMasker,LTR,984708,985237,299,1.00
ptg028970l,62888,63184,296,RepeatMasker,LTR,60367,63080,192,0.65
ptg028970l,62888,63184,296,RepeatMasker,LTR,63089,63389,96,0.32
ptg028975l,224783,225082,299,RepeatMasker,LTR,224731,225277,299,1.00
ptg029006l,94771,95052,281,RepeatMasker,LTR,94121,95433,281,1.00
ptg029091l,354861,355141,280,RepeatMasker,LTR,354075,355539,280,1.00
ptg029100l,2222824,2223145,321,RepeatMasker,LTR,2216627,2222875,51,0.16
ptg029101l,86561,86841,280,RepeatMasker,LTR,85928,87259,280,1.00
ptg029145l,104469,104755,286,RepeatMasker,LTR,103218,105304,286,1.00
ptg029155l,523954,524233,279,RepeatMasker,LTR,523306,525388,279,1.00
ptg029181l,25808,26072,264,RepeatMasker,LTR,25968,26132,105,0.40
ptg029249l,2854755,2855045,290,RepeatMasker,LTR,2854138,2854824,69,0.24
ptg029266l,206321,206610,289,RepeatMasker,LTR,205217,206484,163,0.56
ptg029302l,282712,283041,329,RepeatMasker,LTR,282812,284761,230,0.70
ptg029303l,162410,162716,306,RepeatMasker,LTR,162706,164340,11,0.04
ptg029353l,261584,261874,290,RepeatMasker,LTR,261846,261898,29,0.10
ptg029401l,150982,151306,324,RepeatMasker,LTR,151208,151857,99,0.31
ptg029406l,351676,351954,278,RepeatMasker,LTR,351663,352997,278,1.00
ptg029406l,495058,495338,280,RepeatMasker,LTR,494423,495749,280,1.00
ptg029406l,495058,495338,280,RepeatMasker,LTR,495038,496333,280,1.00
ptg029406l,495058,495338,280,RepeatMasker,LTR,495290,496371,49,0.18
ptg029419l,402202,402491,289,RepeatMasker,LTR,401399,402881,289,1.00
ptg029427l,141270,141551,281,RepeatMasker,LTR,140477,142599,281,1.00
ptg029441l,48104,48385,281,RepeatMasker,LTR,47461,48766,281,1.00
ptg029458l,224178,224455,277,RepeatMasker,LTR,224295,224646,161,0.58
ptg029471l,352498,352778,280,RepeatMasker,LTR,351708,353825,280,1.00
ptg029503l,38743,39036,293,RepeatMasker,LTR,38952,39020,69,0.24
ptg029529l,19047,19368,321,RepeatMasker,LTR,16144,19272,225,0.70
ptg029570l,1440604,1440917,313,RepeatMasker,LTR,1440611,1441503,307,0.98
ptg029602l,1174,1456,282,RepeatMasker,LTR,1141,1780,282,1.00
ptg029627l,471865,472160,295,RepeatMasker,LTR,471516,472924,295,1.00
ptg029672l,410324,410619,295,RepeatMasker,LTR,410272,410813,295,1.00
ptg029675l,393169,393467,298,RepeatMasker,LTR,391536,394538,298,1.00
ptg029746l,472570,472851,281,RepeatMasker,LTR,472537,473897,281,1.00
ptg029761l,55222,55521,299,RepeatMasker,LTR,55170,55699,299,1.00
ptg029879l,71333,71613,280,RepeatMasker,LTR,70689,72003,280,1.00
ptg029931l,342262,342584,322,RepeatMasker,LTR,342084,342423,161,0.50
ptg029964l,427376,427698,322,RepeatMasker,LTR,426690,427625,249,0.77
ptg029964l,427376,427698,322,RepeatMasker,LTR,427646,428606,53,0.16
ptg029969l,356442,356754,312,RepeatMasker,LTR,355794,357136,312,1.00
ptg030019l,60180,60484,304,RepeatMasker,LTR,59342,61381,304,1.00
ptg030075l,354747,355044,297,RepeatMasker,LTR,354695,355215,297,1.00
ptg030125l,327830,328122,292,RepeatMasker,LTR,327187,328483,292,1.00
ptg030130l,72117,72398,281,RepeatMasker,LTR,72085,72779,281,1.00
ptg030143l,194052,194333,281,RepeatMasker,LTR,194019,195471,281,1.00
ptg030143l,212103,212384,281,RepeatMasker,LTR,212070,213533,281,1.00
ptg030216l,1216922,1217202,280,RepeatMasker,LTR,1216862,1218746,280,1.00
ptg030249l,973509,973804,295,RepeatMasker,LTR,973457,973982,295,1.00
ptg030290l,63059,63341,282,RepeatMasker,LTR,58876,64755,282,1.00
ptg030290l,81712,82009,297,RepeatMasker,LTR,81678,82218,297,1.00
ptg030290l,129199,129492,293,RepeatMasker,LTR,129147,129533,293,1.00
ptg030290l,431713,431999,286,RepeatMasker,LTR,431636,432400,286,1.00
ptg030293l,156690,156992,302,RepeatMasker,LTR,156125,156841,151,0.50
ptg030293l,156690,156992,302,RepeatMasker,LTR,156755,157761,238,0.79
ptg030299l,198044,198339,295,RepeatMasker,LTR,198031,198340,295,1.00
ptg030436l,140560,140841,281,RepeatMasker,LTR,139916,141218,281,1.00
ptg030453l,202002,202304,302,RepeatMasker,LTR,201896,202367,302,1.00
ptg030455l,353632,353925,293,RepeatMasker,LTR,353580,354005,293,1.00
ptg030466l,287322,287608,286,RepeatMasker,LTR,286938,288565,286,1.00
ptg030466l,287322,287608,286,RepeatMasker,LTR,287119,288211,286,1.00
ptg030525l,234125,234415,290,RepeatMasker,LTR,233199,235804,290,1.00
ptg030568l,127858,128144,286,RepeatMasker,LTR,126980,132856,286,1.00
ptg030569l,1900738,1901024,286,RepeatMasker,LTR,1899929,1905882,286,1.00
ptg030569l,2981535,2981842,307,RepeatMasker,LTR,2981484,2981543,8,0.03
ptg030569l,2981535,2981842,307,RepeatMasker,LTR,2981499,2981579,44,0.14
ptg030597l,94434,94725,291,RepeatMasker,LTR,92651,95753,291,1.00
ptg030662l,85007,85315,308,RepeatMasker,LTR,85292,85337,24,0.08
ptg030726l,57432,57711,279,RepeatMasker,LTR,56634,58025,279,1.00
ptg030736l,585820,586100,280,RepeatMasker,LTR,585025,586482,280,1.00
ptg030736l,659618,659866,248,RepeatMasker,LTR,654558,664070,248,1.00
ptg030749l,101027,101308,281,RepeatMasker,LTR,101014,102431,281,1.00
ptg030749l,132354,132639,285,RepeatMasker,LTR,131569,133682,285,1.00
ptg030771l,542513,542812,299,RepeatMasker,LTR,542461,542990,299,1.00
ptg030776l,110832,111113,281,RepeatMasker,LTR,110819,112147,281,1.00
ptg030855l,190758,191034,276,RepeatMasker,LTR,190169,190927,169,0.61
ptg030855l,190758,191034,276,RepeatMasker,LTR,190391,191240,276,1.00
ptg030855l,259724,260027,303,RepeatMasker,LTR,259678,260068,303,1.00
ptg030925l,288235,288534,299,RepeatMasker,LTR,288188,288741,299,1.00
ptg030985l,51185,51466,281,RepeatMasker,LTR,51151,51784,281,1.00
ptg030991l,67955,68253,298,RepeatMasker,LTR,67927,69302,298,1.00
ptg031024l,67759,68072,313,RepeatMasker,LTR,66973,67927,168,0.54
ptg031030l,99626,99897,271,RepeatMasker,LTR,99861,99996,37,0.14
ptg031079l,697241,697565,324,RepeatMasker,LTR,697168,697568,324,1.00
ptg031139l,122903,123184,281,RepeatMasker,LTR,122258,123566,281,1.00
ptg031147l,136510,136790,280,RepeatMasker,LTR,135909,136853,280,1.00
ptg031180l,135798,136097,299,RepeatMasker,LTR,135746,136177,299,1.00
ptg031210l,1225691,1225990,299,RepeatMasker,LTR,1225568,1227182,299,1.00
ptg031233l,249980,250296,316,RepeatMasker,LTR,250222,250270,49,0.16
ptg031406l,299081,299384,303,RepeatMasker,LTR,296521,299109,28,0.09
ptg031420l,155687,155966,279,RepeatMasker,LTR,155040,156277,279,1.00
ptg031566l,13135,13417,282,RepeatMasker,LTR,13351,13708,67,0.24
ptg031571l,337782,338064,282,RepeatMasker,LTR,337146,339110,282,1.00
ptg031571l,350677,350969,292,RepeatMasker,LTR,350667,352010,292,1.00
ptg031621l,495309,495593,284,RepeatMasker,LTR,495296,496728,284,1.00
ptg031621l,508045,508340,295,RepeatMasker,LTR,508032,509375,295,1.00
ptg031748l,212641,212922,281,RepeatMasker,LTR,212607,213320,281,1.00
ptg031788l,106739,107019,280,RepeatMasker,LTR,106099,107336,280,1.00
ptg031894l,108247,108545,298,RepeatMasker,LTR,108195,108719,298,1.00
ptg031965l,43213,43511,298,RepeatMasker,LTR,43161,43530,298,1.00
ptg031975l,38655,38970,315,RepeatMasker,LTR,38904,39385,67,0.21
ptg032049l,174616,174906,290,RepeatMasker,LTR,174052,175427,290,1.00
ptg032080l,122231,122518,287,RepeatMasker,LTR,121368,122562,287,1.00
ptg032230l,370397,370696,299,RepeatMasker,LTR,369607,370989,299,1.00
ptg032235l,18526,18816,290,RepeatMasker,LTR,18566,18702,137,0.47
ptg032235l,18526,18816,290,RepeatMasker,LTR,18661,18944,156,0.54
ptg032256l,221829,222109,280,RepeatMasker,LTR,221177,222490,280,1.00
ptg032304l,55953,56263,310,RepeatMasker,LTR,55941,56645,310,1.00
ptg032501l,43000,43286,286,RepeatMasker,LTR,39062,45888,286,1.00
ptg032562l,2992911,2993192,281,RepeatMasker,LTR,2992874,2993586,281,1.00
ptg032568l,192574,192871,297,RepeatMasker,LTR,191257,193020,297,1.00
ptg032570l,106341,106661,320,RepeatMasker,LTR,103835,106391,50,0.16
ptg032621l,115876,116163,287,RepeatMasker,LTR,115026,117733,287,1.00
ptg032654l,312669,312950,281,RepeatMasker,LTR,311886,313996,281,1.00
ptg032670l,68861,69155,294,RepeatMasker,LTR,68809,69359,294,1.00
ptg032728l,509971,510270,299,RepeatMasker,LTR,505278,512591,299,1.00
ptg032742l,465650,465958,308,RepeatMasker,LTR,465616,465947,297,0.96
ptg032766l,410363,410642,279,RepeatMasker,LTR,409710,411057,279,1.00
ptg032772l,101250,101550,300,RepeatMasker,LTR,101198,101721,300,1.00
ptg032784l,263260,263542,282,RepeatMasker,LTR,263247,263938,282,1.00
ptg032816l,413673,413954,281,RepeatMasker,LTR,413637,415129,281,1.00
ptg032832l,32509,32789,280,RepeatMasker,LTR,31708,33171,280,1.00
ptg032852l,210781,211062,281,RepeatMasker,LTR,210768,211390,281,1.00
ptg032921l,386853,387152,299,RepeatMasker,LTR,386801,387330,299,1.00
ptg032932l,18480,18761,281,RepeatMasker,LTR,18467,19821,281,1.00
ptg032963l,293832,294113,281,RepeatMasker,LTR,293798,294180,281,1.00
ptg033003l,309408,309703,295,RepeatMasker,LTR,309356,309727,295,1.00
ptg033033l,46841,47136,295,RepeatMasker,LTR,46809,47504,295,1.00
ptg033052l,1898285,1898602,317,RepeatMasker,LTR,1898252,1898988,317,1.00
ptg033052l,3714477,3714781,304,RepeatMasker,LTR,3713545,3715703,304,1.00
ptg033053l,218112,218411,299,RepeatMasker,LTR,218078,218491,299,1.00
ptg033096l,180015,180342,327,RepeatMasker,LTR,179614,180362,327,1.00
ptg033112l,252936,253262,326,RepeatMasker,LTR,252863,253915,326,1.00
ptg033112l,302275,302555,280,RepeatMasker,LTR,301627,302937,280,1.00
ptg033120l,620458,620733,275,RepeatMasker,LTR,620527,621307,207,0.75
ptg033145l,228085,228363,278,RepeatMasker,LTR,227442,229498,278,1.00
ptg033161l,101344,101657,313,RepeatMasker,LTR,101113,103365,313,1.00
ptg033245l,75106,75392,286,RepeatMasker,LTR,74255,80085,286,1.00
ptg033264l,118436,118713,277,RepeatMasker,LTR,118423,119770,277,1.00
ptg033294l,37040,37337,297,RepeatMasker,LTR,36395,37566,297,1.00
ptg033294l,65657,65937,280,RepeatMasker,LTR,65646,66331,280,1.00
ptg033294l,65657,65937,280,RepeatMasker,LTR,64855,66258,280,1.00
ptg033629l,222020,222320,300,RepeatMasker,LTR,220466,223074,300,1.00
ptg033648l,653608,653888,280,RepeatMasker,LTR,653595,654959,280,1.00
ptg033656l,89693,90011,318,RepeatMasker,LTR,89048,90307,318,1.00
ptg033690l,1163785,1164089,304,RepeatMasker,LTR,1163411,1164028,243,0.80
ptg033690l,1163785,1164089,304,RepeatMasker,LTR,1163460,1164012,227,0.75
ptg033690l,1163785,1164089,304,RepeatMasker,LTR,1163489,1163810,25,0.08
ptg033723l,1434326,1434626,300,RepeatMasker,LTR,1434313,1435016,300,1.00
ptg033744l,146248,146528,280,RepeatMasker,LTR,145602,146910,280,1.00
ptg033902l,47611,47910,299,RepeatMasker,LTR,47559,48088,299,1.00
ptg033931l,41600,41902,302,RepeatMasker,LTR,41548,42107,302,1.00
ptg034020l,209962,210242,280,RepeatMasker,LTR,209949,211279,280,1.00
ptg034068l,162619,162900,281,RepeatMasker,LTR,161978,163282,281,1.00
ptg034179l,68276,68556,280,RepeatMasker,LTR,67641,68938,280,1.00
ptg034190l,273106,273390,284,RepeatMasker,LTR,272728,278090,284,1.00
ptg034247l,255080,255411,331,RepeatMasker,LTR,255021,255286,206,0.62
ptg034288l,31718,32017,299,RepeatMasker,LTR,31666,32211,299,1.00
ptg034379l,123433,123755,322,RepeatMasker,LTR,120669,123628,195,0.61
ptg034400l,639535,639833,298,RepeatMasker,LTR,639161,640571,298,1.00
ptg034400l,646289,646570,281,RepeatMasker,LTR,646276,647615,281,1.00
ptg034535l,196855,197162,307,RepeatMasker,LTR,195349,197081,226,0.74
ptg034565l,173995,174275,280,RepeatMasker,LTR,173354,174663,280,1.00
ptg034588l,1411,1694,283,RepeatMasker,LTR,1398,2750,283,1.00
ptg034723l,122023,122325,302,RepeatMasker,LTR,121990,122707,302,1.00
ptg034726l,112061,112365,304,RepeatMasker,LTR,111283,114614,304,1.00
ptg034759l,17186,17468,282,RepeatMasker,LTR,17153,18515,282,1.00
ptg034778l,54898,55196,298,RepeatMasker,LTR,54846,55404,298,1.00
ptg034800l,7973,8276,303,RepeatMasker,LTR,7170,8270,297,0.98
ptg034851l,278131,278429,298,RepeatMasker,LTR,278130,278300,169,0.57
ptg034851l,278131,278429,298,RepeatMasker,LTR,278428,278556,2,0.01
ptg034861l,124557,124838,281,RepeatMasker,LTR,124544,125220,281,1.00
ptg034875l,24984,25265,281,RepeatMasker,LTR,24339,25655,281,1.00
ptg034913l,66647,66927,280,RepeatMasker,LTR,66003,68057,280,1.00
ptg034922l,56925,57213,288,RepeatMasker,LTR,57169,57831,45,0.16
ptg034990l,479188,479492,304,RepeatMasker,LTR,478543,479858,304,1.00
ptg034990l,1064944,1065222,278,RepeatMasker,LTR,1064931,1066356,278,1.00
ptg034991l,60464,60773,309,RepeatMasker,LTR,60670,60892,104,0.34
ptg035114l,410677,410958,281,RepeatMasker,LTR,410034,412097,281,1.00
ptg035120l,284604,284903,299,RepeatMasker,LTR,284552,285097,299,1.00
ptg035192l,113670,113951,281,RepeatMasker,LTR,112877,115013,281,1.00
ptg035225l,134915,135233,318,RepeatMasker,LTR,134711,135433,318,1.00
ptg035263l,196337,196626,289,RepeatMasker,LTR,196526,196613,88,0.30
ptg035380l,378954,379256,302,RepeatMasker,LTR,379233,379277,24,0.08
ptg035444l,423585,423887,302,RepeatMasker,LTR,417475,423769,184,0.61
ptg035444l,423585,423887,302,RepeatMasker,LTR,423223,424089,302,1.00
ptg035448l,81633,81913,280,RepeatMasker,LTR,80829,82224,280,1.00
ptg035469l,331473,331753,280,RepeatMasker,LTR,331440,332810,280,1.00
ptg035576l,50417,50733,316,RepeatMasker,LTR,46880,50458,41,0.13
ptg035619l,151752,152034,282,RepeatMasker,LTR,151487,153445,282,1.00
ptg035637l,58372,58653,281,RepeatMasker,LTR,58345,58972,281,1.00
ptg035675l,144615,144895,280,RepeatMasker,LTR,144602,145494,280,1.00
ptg035703l,697875,698149,274,RepeatMasker,LTR,697842,698531,274,1.00
ptg035734l,398127,398419,292,RepeatMasker,LTR,395294,398761,292,1.00
ptg035911l,80175,80487,312,RepeatMasker,LTR,80464,80524,24,0.08
ptg035911l,174481,174762,281,RepeatMasker,LTR,174448,175144,281,1.00
ptg035939l,279435,279743,308,RepeatMasker,LTR,274675,280173,308,1.00
ptg036026l,310184,310465,281,RepeatMasker,LTR,310151,310846,281,1.00
ptg036048l,112612,112911,299,RepeatMasker,LTR,112560,112952,299,1.00
ptg036222l,252526,252822,296,RepeatMasker,LTR,252503,253190,296,1.00
ptg036222l,272094,272376,282,RepeatMasker,LTR,271286,272758,282,1.00
ptg036264l,23389,23706,317,RepeatMasker,LTR,23670,23725,37,0.12
ptg036287l,76641,76939,298,RepeatMasker,LTR,76589,76981,298,1.00
ptg036297l,102673,102980,307,RepeatMasker,LTR,102859,103234,122,0.40
ptg036333l,255340,255612,272,RepeatMasker,LTR,255367,256271,246,0.90
ptg036366l,208949,209248,299,RepeatMasker,LTR,208897,209403,299,1.00
ptg036480l,195486,195821,335,RepeatMasker,LTR,195459,195511,25,0.07
ptg036480l,195486,195821,335,RepeatMasker,LTR,195475,195562,76,0.23
ptg036511l,54394,54689,295,RepeatMasker,LTR,54483,54543,61,0.21
ptg036723l,147051,147330,279,RepeatMasker,LTR,146415,148376,279,1.00
ptg036899l,596978,597264,286,RepeatMasker,LTR,592956,597663,286,1.00
ptg037129l,168083,168363,280,RepeatMasker,LTR,167305,168744,280,1.00
ptg037159l,64136,64443,307,RepeatMasker,LTR,64392,64565,52,0.17
ptg037317l,152609,152923,314,RepeatMasker,LTR,150667,155274,314,1.00
ptg037328l,38221,38513,292,RepeatMasker,LTR,37579,38890,292,1.00
ptg037566l,41390,41673,283,RepeatMasker,LTR,40180,41922,283,1.00
ptg037566l,41390,41673,283,RepeatMasker,LTR,40389,41549,159,0.56
ptg037566l,41390,41673,283,RepeatMasker,LTR,40536,41923,283,1.00
ptg037615l,2796150,2796472,322,RepeatMasker,LTR,2795311,2799418,322,1.00
ptg037790l,47391,47671,280,RepeatMasker,LTR,46622,48041,280,1.00
ptg037841l,32037,32316,279,RepeatMasker,LTR,29269,33119,279,1.00
ptg037913l,206216,206497,281,RepeatMasker,LTR,206183,206879,281,1.00
ptg038252l,272528,272827,299,RepeatMasker,LTR,272476,273007,299,1.00
ptg038272l,234715,235005,290,RepeatMasker,LTR,234663,235180,290,1.00
ptg038272l,352507,352800,293,RepeatMasker,LTR,352455,352995,293,1.00
ptg038324l,135378,135678,300,RepeatMasker,LTR,135326,135902,300,1.00
ptg038334l,49314,49611,297,RepeatMasker,LTR,49014,49627,297,1.00
ptg038446l,212804,213094,290,RepeatMasker,LTR,212791,213498,290,1.00
ptg038589l,121662,121942,280,RepeatMasker,LTR,121026,123108,280,1.00
ptg038613l,18509,18790,281,RepeatMasker,LTR,17708,19180,281,1.00
ptg038613l,25139,25445,306,RepeatMasker,LTR,22578,26885,306,1.00
ptg038776l,179178,179485,307,RepeatMasker,LTR,178384,179837,307,1.00
ptg038776l,1063342,1063625,283,RepeatMasker,LTR,1063310,1064002,283,1.00
ptg038872l,79433,79714,281,RepeatMasker,LTR,78788,80089,281,1.00
ptg038872l,86540,86841,301,RepeatMasker,LTR,85738,87239,301,1.00
ptg038886l,1127301,1127581,280,RepeatMasker,LTR,1126663,1127974,280,1.00
ptg039154l,231074,231355,281,RepeatMasker,LTR,231062,231745,281,1.00
ptg039228l,410186,410466,280,RepeatMasker,LTR,409548,410848,280,1.00
ptg039228l,417314,417594,280,RepeatMasker,LTR,416522,417976,280,1.00
ptg039378l,153836,154151,315,RepeatMasker,LTR,153590,154387,315,1.00
ptg039378l,153836,154151,315,RepeatMasker,LTR,153897,154378,255,0.81
ptg039396l,28317,28598,281,RepeatMasker,LTR,27673,29642,281,1.00
ptg039452l,3478028,3478341,313,RepeatMasker,LTR,3478035,3478771,307,0.98
ptg039549l,1090564,1090844,280,RepeatMasker,LTR,1090552,1091232,280,1.00
ptg039635l,97551,97831,280,RepeatMasker,LTR,97518,98226,280,1.00
ptg039662l,2347915,2348195,280,RepeatMasker,LTR,2345486,2351492,280,1.00
ptg039663l,1123150,1123431,281,RepeatMasker,LTR,1122341,1124463,281,1.00
ptg039789l,3161229,3161533,304,RepeatMasker,LTR,3156497,3161257,28,0.09
ptg039911l,71066,71381,315,RepeatMasker,LTR,70283,71678,315,1.00
ptg040065l,1407267,1407566,299,RepeatMasker,LTR,1407215,1407744,299,1.00
ptg040151l,119736,120024,288,RepeatMasker,LTR,116695,121436,288,1.00
ptg040230l,85768,86075,307,RepeatMasker,LTR,85987,86362,89,0.29
ptg040390l,91468,91779,311,RepeatMasker,LTR,91510,91800,270,0.87
ptg040390l,91468,91779,311,RepeatMasker,LTR,91517,91974,263,0.85
ptg040455l,126727,127005,278,RepeatMasker,LTR,126092,128051,278,1.00
ptg040486l,49257,49580,323,RepeatMasker,LTR,48819,49346,89,0.28
ptg040499l,42222,42501,279,RepeatMasker,LTR,42500,44491,2,0.01
ptg040625l,70299,70596,297,RepeatMasker,LTR,70247,70676,297,1.00
ptg040757l,55508,55800,292,RepeatMasker,LTR,54705,56169,292,1.00
ptg040757l,55508,55800,292,RepeatMasker,LTR,54744,56169,292,1.00
ptg041187l,438254,438566,312,RepeatMasker,LTR,438241,439610,312,1.00
ptg041227l,541634,541915,281,RepeatMasker,LTR,540833,542963,281,1.00
ptg041253l,203980,204260,280,RepeatMasker,LTR,203967,205308,280,1.00
ptg041429l,34618,34898,280,RepeatMasker,LTR,33974,35280,280,1.00
ptg041545l,32472,32720,248,RepeatMasker,LTR,27438,33801,248,1.00
ptg041564l,342670,342970,300,RepeatMasker,LTR,342687,342789,103,0.34
ptg041668l,43725,44041,316,RepeatMasker,LTR,44018,44072,24,0.08
ptg041801l,310191,310449,258,RepeatMasker,LTR,307032,310313,122,0.47
ptg041829l,73040,73337,297,RepeatMasker,LTR,72250,73631,297,1.00
ptg042324l,79480,79757,277,RepeatMasker,LTR,77072,80504,277,1.00
ptg042415l,1645257,1645557,300,RepeatMasker,LTR,1645460,1645641,98,0.33
ptg042415l,1645257,1645557,300,RepeatMasker,LTR,1645505,1647420,53,0.18
ptg042487l,35587,35868,281,RepeatMasker,LTR,34922,36193,281,1.00
ptg042487l,42755,43036,281,RepeatMasker,LTR,41953,43447,281,1.00
ptg042566l,272639,272951,312,RepeatMasker,LTR,270423,272675,36,0.12
ptg042682l,39263,39559,296,RepeatMasker,LTR,38120,40360,296,1.00
ptg043409l,4471,4760,289,RepeatMasker,LTR,3576,4499,28,0.10
ptg043409l,4471,4760,289,RepeatMasker,LTR,4507,4733,227,0.79
ptg043423l,65251,65547,296,RepeatMasker,LTR,62089,68818,296,1.00
ptg043531l,90183,90451,268,RepeatMasker,LTR,90171,90833,268,1.00
ptg043674l,31055,31364,309,RepeatMasker,LTR,30419,31757,309,1.00
ptg043674l,41926,42174,248,RepeatMasker,LTR,36871,46369,248,1.00
ptg043740l,91133,91422,289,RepeatMasker,LTR,90989,91361,228,0.79
ptg043791l,64668,64954,286,RepeatMasker,LTR,63860,65336,286,1.00
ptg043804l,110318,110599,281,RepeatMasker,LTR,110305,110912,281,1.00
ptg043856l,131740,132036,296,RepeatMasker,LTR,131688,132212,296,1.00
ptg044050l,157273,157560,287,RepeatMasker,LTR,156414,158402,287,1.00
ptg044169l,84966,85246,280,RepeatMasker,LTR,84331,86073,280,1.00
ptg044437l,83140,83432,292,RepeatMasker,LTR,79016,83612,292,1.00
ptg044481l,770271,770558,287,RepeatMasker,LTR,769916,770701,287,1.00
ptg044581l,29068,29355,287,RepeatMasker,LTR,28209,33634,287,1.00
ptg044663l,51977,52279,302,RepeatMasker,LTR,50418,53017,302,1.00
ptg044663l,51977,52279,302,RepeatMasker,LTR,50724,52109,132,0.44
ptg044761l,21559,21839,280,RepeatMasker,LTR,21524,22239,280,1.00
ptg044934l,16064,16335,271,RepeatMasker,LTR,15251,16181,117,0.43
ptg044942l,54621,54926,305,RepeatMasker,LTR,54587,54917,296,0.97
ptg044975l,38969,39254,285,RepeatMasker,LTR,39231,39275,24,0.08
ptg044989l,19047,19341,294,RepeatMasker,LTR,18246,19654,294,1.00
ptg045213l,68631,68927,296,RepeatMasker,LTR,68171,68755,124,0.42
ptg045273l,778195,778474,279,RepeatMasker,LTR,776541,781131,279,1.00
ptg045273l,2294862,2295188,326,RepeatMasker,LTR,2294827,2294906,44,0.13
ptg045273l,2294862,2295188,326,RepeatMasker,LTR,2290006,2294896,34,0.10
ptg045274l,172712,173009,297,RepeatMasker,LTR,172660,173089,297,1.00
ptg045384l,23704,23985,281,RepeatMasker,LTR,23053,24367,281,1.00
ptg045876l,8193,8516,323,RepeatMasker,LTR,8096,8223,30,0.09
ptg045902l,6980,7261,281,RepeatMasker,LTR,6333,7664,281,1.00
ptg045902l,13427,13708,281,RepeatMasker,LTR,12629,14090,281,1.00
ptg045906l,91249,91531,282,RepeatMasker,LTR,90609,91920,282,1.00
ptg046132l,5887,6167,280,RepeatMasker,LTR,5253,6488,280,1.00
ptg046659l,365118,365421,303,RepeatMasker,LTR,364176,365281,163,0.54
ptg046659l,1389828,1390133,305,RepeatMasker,LTR,1389554,1390009,181,0.59
ptg046947l,50166,50486,320,RepeatMasker,LTR,43739,53059,320,1.00
ptg046947l,139376,139656,280,RepeatMasker,LTR,138585,140032,280,1.00
ptg047558l,63215,63499,284,RepeatMasker,LTR,62250,63235,20,0.07
ptg047786l,96199,96491,292,RepeatMasker,LTR,96118,96244,45,0.15
ptg047786l,96199,96491,292,RepeatMasker,LTR,96118,96279,80,0.27
ptg047991l,7342,7622,280,RepeatMasker,LTR,6708,8004,280,1.00
ptg048189l,14136,14413,277,RepeatMasker,LTR,14390,14434,24,0.09
ptg048467l,362111,362396,285,RepeatMasker,LTR,361260,362758,285,1.00
ptg048990l,39046,39326,280,RepeatMasker,LTR,39034,39706,280,1.00
ptg049651l,235410,235704,294,RepeatMasker,LTR,235358,235862,294,1.00
ptg050256l,113384,113719,335,RepeatMasker,LTR,113521,116363,199,0.59
ptg050610l,74281,74561,280,RepeatMasker,LTR,73487,74954,280,1.00
ptg052537l,42278,42558,280,RepeatMasker,LTR,41640,42940,280,1.00
ptg053566l,21407,21689,282,RepeatMasker,LTR,21666,21710,24,0.09
ptg053617l,949042,949331,289,RepeatMasker,LTR,949270,949519,62,0.21
ptg053699l,591969,592288,319,RepeatMasker,LTR,592222,592470,67,0.21
ptg055852l,29743,30020,277,RepeatMasker,LTR,29151,29749,6,0.02
ptg057225l,13902,14215,313,RepeatMasker,LTR,13113,14205,303,0.97
ptg057582l,86201,86497,296,RepeatMasker,LTR,86149,86577,296,1.00
ptg057582l,103573,103872,299,RepeatMasker,LTR,103521,104079,299,1.00
ptg058597l,13219,13499,280,RepeatMasker,LTR,13179,13873,280,1.00
ptg059097l,6977,7257,280,RepeatMasker,LTR,6331,7639,280,1.00
ptg059645l,10603,10891,288,RepeatMasker,LTR,7558,17048,288,1.00
ptg060855l,14598,14915,317,RepeatMasker,LTR,14434,14699,101,0.32
ptg000002l,859060,859375,315,EVM,mRNA,46146,4527702,315,1.00
ptg000002l,4292029,4292314,285,EVM,mRNA,46146,4527702,285,1.00
ptg000002l,4299152,4299439,287,EVM,mRNA,46146,4527702,287,1.00
ptg000004l,1337400,1337559,159,EVM,mRNA,1295722,1384453,159,1.00
ptg000005l,4577649,4577967,318,EVM,mRNA,4105573,7068508,318,1.00
ptg000005l,4703037,4703344,307,EVM,mRNA,4105573,7068508,307,1.00
ptg000005l,5891081,5891411,330,EVM,mRNA,4105573,7068508,330,1.00
ptg000005l,6329716,6330036,320,EVM,mRNA,4105573,7068508,320,1.00
ptg000007l,988421,988718,297,EVM,mRNA,919339,1469021,297,1.00
ptg000008l,3304453,3304754,301,EVM,mRNA,1620057,3476985,301,1.00
ptg000010l,194282,194593,311,EVM,mRNA,153866,297888,311,1.00
ptg000010l,283183,283493,310,EVM,mRNA,153866,297888,310,1.00
ptg000010l,2426002,2426270,268,EVM,mRNA,1418495,3125450,268,1.00
ptg000012l,1573577,1573858,281,EVM,mRNA,1174082,1868809,281,1.00
ptg000017l,102437,102744,307,EVM,mRNA,26148,1379437,307,1.00
ptg000017l,761000,761337,337,EVM,mRNA,26148,1379437,337,1.00
ptg000017l,1128565,1128830,265,EVM,mRNA,26148,1379437,265,1.00
ptg000018l,174772,175096,324,EVM,mRNA,12522,642806,324,1.00
ptg000020l,427444,427728,284,EVM,mRNA,20440,1311707,284,1.00
ptg000020l,1011094,1011391,297,EVM,mRNA,20440,1311707,297,1.00
ptg000020l,2651346,2651688,342,EVM,mRNA,2191420,2787481,342,1.00
ptg000020l,3055137,3055439,302,EVM,mRNA,2788432,3138408,302,1.00
ptg000020l,4060367,4060661,294,EVM,mRNA,3842877,4588894,294,1.00
ptg000023l,1438799,1439114,315,EVM,mRNA,995017,1602546,315,1.00
ptg000023l,2562941,2563257,316,EVM,mRNA,1758092,3235798,316,1.00
ptg000023l,3095331,3095619,288,EVM,mRNA,1758092,3235798,288,1.00
ptg000024l,3028770,3029084,314,EVM,mRNA,2893721,3429021,314,1.00
ptg000024l,6268010,6268337,327,EVM,mRNA,6118712,6349460,327,1.00
ptg000027l,73617,73933,316,EVM,mRNA,4181,146899,316,1.00
ptg000028l,393800,394113,313,EVM,mRNA,350497,802536,313,1.00
ptg000034l,525334,525616,282,EVM,mRNA,520448,588369,282,1.00
ptg000034l,547174,547485,311,EVM,mRNA,520448,588369,311,1.00
ptg000035l,409429,409749,320,EVM,mRNA,388508,2578542,320,1.00
ptg000035l,570025,570333,308,EVM,mRNA,388508,2578542,308,1.00
ptg000035l,729028,729337,309,EVM,mRNA,388508,2578542,309,1.00
ptg000035l,914088,914421,333,EVM,mRNA,388508,2578542,333,1.00
ptg000035l,3058589,3058886,297,EVM,mRNA,3019901,5590250,297,1.00
ptg000035l,3692458,3692757,299,EVM,mRNA,3019901,5590250,299,1.00
ptg000035l,3862496,3862769,273,EVM,mRNA,3019901,5590250,273,1.00
ptg000035l,4054247,4054545,298,EVM,mRNA,3019901,5590250,298,1.00
ptg000037l,4650641,4650951,310,EVM,mRNA,4393546,4816887,310,1.00
ptg000039l,906309,906604,295,EVM,mRNA,367101,1619910,295,1.00
ptg000039l,3359509,3359823,314,EVM,mRNA,2881423,4489599,314,1.00
ptg000043l,1114990,1115312,322,EVM,mRNA,797370,2450439,322,1.00
ptg000043l,1184801,1185115,314,EVM,mRNA,797370,2450439,314,1.00
ptg000043l,2065748,2066048,300,EVM,mRNA,797370,2450439,300,1.00
ptg000044l,1331386,1331666,280,EVM,mRNA,1259154,2127049,280,1.00
ptg000044l,3049147,3049448,301,EVM,mRNA,2968598,3078881,301,1.00
ptg000048l,1704091,1704394,303,EVM,mRNA,1126939,2341187,303,1.00
ptg000048l,2013678,2014005,327,EVM,mRNA,1126939,2341187,327,1.00
ptg000048l,2695397,2695712,315,EVM,mRNA,2470593,4396555,315,1.00
ptg000048l,3608734,3609051,317,EVM,mRNA,2470593,4396555,317,1.00
ptg000048l,4521060,4521333,273,EVM,mRNA,4489515,6515745,273,1.00
ptg000048l,7848912,7849189,277,EVM,mRNA,7063913,9875443,277,1.00
ptg000048l,8542243,8542572,329,EVM,mRNA,7063913,9875443,329,1.00
ptg000048l,12687617,12687930,313,EVM,mRNA,11771990,12709159,313,1.00
ptg000048l,13621206,13621505,299,EVM,mRNA,13609286,16499777,299,1.00
ptg000048l,14607768,14608044,276,EVM,mRNA,13609286,16499777,276,1.00
ptg000048l,14840944,14841241,297,EVM,mRNA,13609286,16499777,297,1.00
ptg000048l,16128911,16129195,284,EVM,mRNA,13609286,16499777,284,1.00
ptg000048l,16292162,16292448,286,EVM,mRNA,13609286,16499777,286,1.00
ptg000048l,16488625,16488935,310,EVM,mRNA,13609286,16499777,310,1.00
ptg000052l,273103,273385,282,EVM,mRNA,36847,1735268,282,1.00
ptg000052l,1657826,1658103,277,EVM,mRNA,36847,1735268,277,1.00
ptg000052l,1897110,1897394,284,EVM,mRNA,1868278,1963198,284,1.00
ptg000053l,1552389,1552673,284,EVM,mRNA,173597,1620431,284,1.00
ptg000054l,90096,90391,295,EVM,mRNA,2854,628794,295,1.00
ptg000054l,177948,178249,301,EVM,mRNA,2854,628794,301,1.00
ptg000054l,310742,311014,272,EVM,mRNA,2854,628794,272,1.00
ptg000054l,873101,873391,290,EVM,mRNA,791372,937237,290,1.00
ptg000055l,532302,532566,264,EVM,mRNA,368670,761688,264,1.00
ptg000057l,518824,519130,306,EVM,mRNA,30291,722912,306,1.00
ptg000061l,206189,206516,327,EVM,mRNA,14774,791807,327,1.00
ptg000062l,1424737,1425024,287,EVM,mRNA,680220,3390047,287,1.00
ptg000063l,193934,194230,296,EVM,mRNA,89735,1966211,296,1.00
ptg000063l,947885,948164,279,EVM,mRNA,89735,1966211,279,1.00
ptg000065l,318334,318629,295,EVM,mRNA,137152,2451324,295,1.00
ptg000065l,407348,407647,299,EVM,mRNA,137152,2451324,299,1.00
ptg000065l,774050,774344,294,EVM,mRNA,137152,2451324,294,1.00
ptg000065l,805164,805463,299,EVM,mRNA,137152,2451324,299,1.00
ptg000065l,1129441,1129740,299,EVM,mRNA,137152,2451324,299,1.00
ptg000065l,1157593,1157892,299,EVM,mRNA,137152,2451324,299,1.00
ptg000065l,1840748,1841043,295,EVM,mRNA,137152,2451324,295,1.00
ptg000065l,1857981,1858281,300,EVM,mRNA,137152,2451324,300,1.00
ptg000065l,1986559,1986858,299,EVM,mRNA,137152,2451324,299,1.00
ptg000065l,2308663,2308958,295,EVM,mRNA,137152,2451324,295,1.00
ptg000068l,2540355,2540671,316,EVM,mRNA,2529798,3836032,316,1.00
ptg000068l,3674743,3675023,280,EVM,mRNA,2529798,3836032,280,1.00
ptg000069l,206396,206695,299,EVM,mRNA,167744,954499,299,1.00
ptg000069l,777584,777870,286,EVM,mRNA,167744,954499,286,1.00
ptg000069l,783039,783324,285,EVM,mRNA,167744,954499,285,1.00
ptg000069l,2065507,2065774,267,EVM,mRNA,1757704,3331821,267,1.00
ptg000070l,27862,28173,311,EVM,mRNA,18570,194078,311,1.00
ptg000071l,2056942,2057248,306,EVM,mRNA,1937796,2175841,306,1.00
ptg000071l,4071855,4072147,292,EVM,mRNA,3891344,4150768,292,1.00
ptg000071l,5436447,5436717,270,EVM,mRNA,5177459,5753075,270,1.00
ptg000071l,6465228,6465520,292,EVM,mRNA,6032304,6574133,292,1.00
ptg000071l,7918417,7918717,300,EVM,mRNA,7304049,7930444,300,1.00
ptg000071l,8169680,8169978,298,EVM,mRNA,8166805,8568151,298,1.00
ptg000076l,229787,230089,302,EVM,mRNA,45572,529312,302,1.00
ptg000078l,1033029,1033338,309,EVM,mRNA,829253,4219199,309,1.00
ptg000078l,1168991,1169258,267,EVM,mRNA,829253,4219199,267,1.00
ptg000078l,1197186,1197487,301,EVM,mRNA,829253,4219199,301,1.00
ptg000078l,2065934,2066238,304,EVM,mRNA,829253,4219199,304,1.00
ptg000078l,3800185,3800462,277,EVM,mRNA,829253,4219199,277,1.00
ptg000081l,2363648,2363923,275,EVM,mRNA,9569,2605966,275,1.00
ptg000082l,405557,405873,316,EVM,mRNA,25849,943240,316,1.00
ptg000082l,748157,748456,299,EVM,mRNA,25849,943240,299,1.00
ptg000082l,5249344,5249626,282,EVM,mRNA,4759423,6231614,282,1.00
ptg000085l,1404854,1405181,327,EVM,mRNA,254752,3353483,327,1.00
ptg000085l,3287260,3287573,313,EVM,mRNA,254752,3353483,313,1.00
ptg000085l,3845860,3846155,295,EVM,mRNA,3774619,4447363,295,1.00
ptg000085l,5545859,5546159,300,EVM,mRNA,5385770,6408735,300,1.00
ptg000085l,6159217,6159554,337,EVM,mRNA,5385770,6408735,337,1.00
ptg000086l,677890,678172,282,EVM,mRNA,18327,795961,282,1.00
ptg000086l,679021,679309,288,EVM,mRNA,18327,795961,288,1.00
ptg000086l,700918,701227,309,EVM,mRNA,18327,795961,309,1.00
ptg000086l,1101198,1101482,284,EVM,mRNA,984119,1147818,284,1.00
ptg000087l,173247,173541,294,EVM,mRNA,74161,1866046,294,1.00
ptg000089l,99634,99963,329,EVM,mRNA,74384,1433661,329,1.00
ptg000089l,151915,152207,292,EVM,mRNA,74384,1433661,292,1.00
ptg000089l,340850,341130,280,EVM,mRNA,74384,1433661,280,1.00
ptg000094l,499985,500255,270,EVM,mRNA,44615,657163,270,1.00
ptg000094l,1128934,1129254,320,EVM,mRNA,996205,1287975,320,1.00
ptg000094l,3480307,3480617,310,EVM,mRNA,3480382,4285567,236,0.76
ptg000094l,3607998,3608303,305,EVM,mRNA,3480382,4285567,305,1.00
ptg000094l,3895429,3895709,280,EVM,mRNA,3480382,4285567,280,1.00
ptg000094l,7870720,7871007,287,EVM,mRNA,7779674,8182876,287,1.00
ptg000096l,1742518,1742830,312,EVM,mRNA,957460,3859327,312,1.00
ptg000096l,2271590,2271876,286,EVM,mRNA,957460,3859327,286,1.00
ptg000096l,3655902,3656215,313,EVM,mRNA,957460,3859327,313,1.00
ptg000098l,462378,462683,305,EVM,mRNA,408165,3158393,305,1.00
ptg000098l,827486,827776,290,EVM,mRNA,408165,3158393,290,1.00
ptg000098l,856228,856553,325,EVM,mRNA,408165,3158393,325,1.00
ptg000098l,1749321,1749599,278,EVM,mRNA,408165,3158393,278,1.00
ptg000098l,2290120,2290414,294,EVM,mRNA,408165,3158393,294,1.00
ptg000099l,1755712,1756006,294,EVM,mRNA,1244047,3058582,294,1.00
ptg000099l,2613986,2614280,294,EVM,mRNA,1244047,3058582,294,1.00
ptg000100l,200207,200508,301,EVM,mRNA,159073,1055643,301,1.00
ptg000100l,269895,270223,328,EVM,mRNA,159073,1055643,328,1.00
ptg000100l,504952,505255,303,EVM,mRNA,159073,1055643,303,1.00
ptg000104l,3541617,3541940,323,EVM,mRNA,2783010,4210803,323,1.00
ptg000104l,6061508,6061821,313,EVM,mRNA,6002881,7118950,313,1.00
ptg000104l,6099437,6099744,307,EVM,mRNA,6002881,7118950,307,1.00
ptg000104l,6617888,6618189,301,EVM,mRNA,6002881,7118950,301,1.00
ptg000104l,7083417,7083726,309,EVM,mRNA,6002881,7118950,309,1.00
ptg000104l,10182860,10183166,306,EVM,mRNA,9185228,10880176,306,1.00
ptg000104l,10342693,10343007,314,EVM,mRNA,9185228,10880176,314,1.00
ptg000104l,10344210,10344532,322,EVM,mRNA,9185228,10880176,322,1.00
ptg000104l,10667949,10668269,320,EVM,mRNA,9185228,10880176,320,1.00
ptg000107l,770414,770728,314,EVM,mRNA,770718,946114,11,0.04
ptg000107l,4619277,4619578,301,EVM,mRNA,4149280,4898657,301,1.00
ptg000107l,4620655,4620967,312,EVM,mRNA,4149280,4898657,312,1.00
ptg000108l,399043,399339,296,EVM,mRNA,178434,458925,296,1.00
ptg000109l,344555,344841,286,EVM,mRNA,17928,364413,286,1.00
ptg000115l,329765,330089,324,EVM,mRNA,276346,1067676,324,1.00
ptg000115l,455979,456281,302,EVM,mRNA,276346,1067676,302,1.00
ptg000115l,482409,482717,308,EVM,mRNA,276346,1067676,308,1.00
ptg000115l,562749,563081,332,EVM,mRNA,276346,1067676,332,1.00
ptg000115l,784781,785063,282,EVM,mRNA,276346,1067676,282,1.00
ptg000117l,783286,783602,316,EVM,mRNA,611082,834689,316,1.00
ptg000117l,2194705,2195014,309,EVM,mRNA,2186347,2324299,309,1.00
ptg000117l,2220654,2220950,296,EVM,mRNA,2186347,2324299,296,1.00
ptg000119l,1902693,1903004,311,EVM,mRNA,883581,2764029,311,1.00
ptg000119l,2251258,2251570,312,EVM,mRNA,883581,2764029,312,1.00
ptg000121l,426568,426866,298,EVM,mRNA,101422,567535,298,1.00
ptg000121l,1624134,1624446,312,EVM,mRNA,1031671,3010225,312,1.00
ptg000121l,2377321,2377634,313,EVM,mRNA,1031671,3010225,313,1.00
ptg000121l,2522976,2523291,315,EVM,mRNA,1031671,3010225,315,1.00
ptg000121l,2587561,2587840,279,EVM,mRNA,1031671,3010225,279,1.00
ptg000122l,4747972,4748255,283,EVM,mRNA,3875265,5500366,283,1.00
ptg000123l,4950338,4950659,321,EVM,mRNA,4833841,5446301,321,1.00
ptg000123l,5137490,5137816,326,EVM,mRNA,4833841,5446301,326,1.00
ptg000123l,5501802,5502100,298,EVM,mRNA,5468278,5544902,298,1.00
ptg000124l,680455,680770,315,EVM,mRNA,22159,1251749,315,1.00
ptg000124l,1049922,1050220,298,EVM,mRNA,22159,1251749,298,1.00
ptg000124l,2096264,2096570,306,EVM,mRNA,2088279,2441365,306,1.00
ptg000124l,2119329,2119631,302,EVM,mRNA,2088279,2441365,302,1.00
ptg000124l,2167779,2168074,295,EVM,mRNA,2088279,2441365,295,1.00
ptg000124l,2178041,2178370,329,EVM,mRNA,2088279,2441365,329,1.00
ptg000125l,865368,865684,316,EVM,mRNA,523473,1108630,316,1.00
ptg000127l,685563,685876,313,EVM,mRNA,538877,951258,313,1.00
ptg000127l,862495,862783,288,EVM,mRNA,538877,951258,288,1.00
ptg000127l,2843905,2844223,318,EVM,mRNA,1852090,3145142,318,1.00
ptg000128l,2022388,2022671,283,EVM,mRNA,1641898,2228306,283,1.00
ptg000128l,2152190,2152454,264,EVM,mRNA,1641898,2228306,264,1.00
ptg000130l,1678892,1679205,313,EVM,mRNA,1385814,2707046,313,1.00
ptg000130l,2125534,2125846,312,EVM,mRNA,1385814,2707046,312,1.00
ptg000131l,2581609,2581918,309,EVM,mRNA,1824454,4418067,309,1.00
ptg000131l,3064487,3064758,271,EVM,mRNA,1824454,4418067,271,1.00
ptg000131l,4030665,4030921,256,EVM,mRNA,1824454,4418067,256,1.00
ptg000131l,6782023,6782298,275,EVM,mRNA,6740554,6998299,275,1.00
ptg000137l,2546292,2546561,269,EVM,mRNA,2066,4909130,269,1.00
ptg000140l,327250,327528,278,EVM,mRNA,18673,2139737,278,1.00
ptg000140l,1132869,1133158,289,EVM,mRNA,18673,2139737,289,1.00
ptg000140l,2052969,2053269,300,EVM,mRNA,18673,2139737,300,1.00
ptg000140l,2138270,2138554,284,EVM,mRNA,18673,2139737,284,1.00
ptg000142l,700705,700989,284,EVM,mRNA,443005,1980528,284,1.00
ptg000142l,929535,929834,299,EVM,mRNA,443005,1980528,299,1.00
ptg000142l,1484044,1484341,297,EVM,mRNA,443005,1980528,297,1.00
ptg000147l,2213789,2214103,314,EVM,mRNA,1827026,2532639,314,1.00
ptg000147l,6072354,6072626,272,EVM,mRNA,5869724,6214641,272,1.00
ptg000148l,186886,187140,254,EVM,mRNA,148458,509966,254,1.00
ptg000148l,361237,361514,277,EVM,mRNA,148458,509966,277,1.00
ptg000148l,493450,493749,299,EVM,mRNA,148458,509966,299,1.00
ptg000148l,2206981,2207234,253,EVM,mRNA,2128606,2260474,253,1.00
ptg000148l,3332313,3332628,315,EVM,mRNA,2371577,3366752,315,1.00
ptg000149l,632533,632814,281,EVM,mRNA,99972,1587270,281,1.00
ptg000150l,196494,196824,330,EVM,mRNA,102282,1063004,330,1.00
ptg000150l,920205,920490,285,EVM,mRNA,102282,1063004,285,1.00
ptg000150l,1418260,1418508,248,EVM,mRNA,1326530,1455450,248,1.00
ptg000151l,493470,493748,278,EVM,mRNA,361616,702220,278,1.00
ptg000151l,1938203,1938517,314,EVM,mRNA,1529554,2139986,314,1.00
ptg000156l,4108238,4108519,281,EVM,mRNA,3881833,4273335,281,1.00
ptg000156l,4125792,4126080,288,EVM,mRNA,3881833,4273335,288,1.00
ptg000156l,4523511,4523789,278,EVM,mRNA,4421967,4562640,278,1.00
ptg000156l,5136774,5137080,306,EVM,mRNA,4906394,5503563,306,1.00
ptg000156l,5252829,5253116,287,EVM,mRNA,4906394,5503563,287,1.00
ptg000156l,7318562,7318857,295,EVM,mRNA,6505278,7468299,295,1.00
ptg000156l,8568031,8568312,281,EVM,mRNA,8535624,8639237,281,1.00
ptg000156l,8942980,8943289,309,EVM,mRNA,8877166,9122101,309,1.00
ptg000157l,714848,715138,290,EVM,mRNA,613054,1142123,290,1.00
ptg000157l,1823107,1823440,333,EVM,mRNA,1540283,2035576,333,1.00
ptg000158l,1235179,1235479,300,EVM,mRNA,1032893,1299992,300,1.00
ptg000161l,740477,740780,303,EVM,mRNA,4050,1629896,303,1.00
ptg000161l,900662,900950,288,EVM,mRNA,4050,1629896,288,1.00
ptg000161l,1972130,1972413,283,EVM,mRNA,1763551,2115127,283,1.00
ptg000161l,3632936,3633231,295,EVM,mRNA,3561383,3654855,295,1.00
ptg000164l,536499,536799,300,EVM,mRNA,292902,796038,300,1.00
ptg000168l,397840,398142,302,EVM,mRNA,32147,1191803,302,1.00
ptg000168l,786095,786400,305,EVM,mRNA,32147,1191803,305,1.00
ptg000170l,395121,395432,311,EVM,mRNA,3507,3233451,311,1.00
ptg000170l,2166687,2166991,304,EVM,mRNA,3507,3233451,304,1.00
ptg000173l,1091237,1091530,293,EVM,mRNA,1068172,1208554,293,1.00
ptg000180l,338554,338865,311,EVM,mRNA,24258,526340,311,1.00
ptg000180l,5338555,5338852,297,EVM,mRNA,1347957,5832585,297,1.00
ptg000180l,7366113,7366420,307,EVM,mRNA,7297647,7437541,307,1.00
ptg000180l,8127896,8128224,328,EVM,mRNA,7563899,8876233,328,1.00
ptg000180l,8306966,8307257,291,EVM,mRNA,7563899,8876233,291,1.00
ptg000180l,8706980,8707303,323,EVM,mRNA,7563899,8876233,323,1.00
ptg000183l,90151,90416,265,EVM,mRNA,77405,391583,265,1.00
ptg000186l,6227606,6227917,311,EVM,mRNA,6226226,6374072,311,1.00
ptg000186l,7423904,7424207,303,EVM,mRNA,7324936,7806431,303,1.00
ptg000186l,7441604,7441917,313,EVM,mRNA,7324936,7806431,313,1.00
ptg000190l,87559,87839,280,EVM,mRNA,87531,573077,280,1.00
ptg000193l,957033,957312,279,EVM,mRNA,388554,1190068,279,1.00
ptg000195l,405129,405446,317,EVM,mRNA,342839,690907,317,1.00
ptg000195l,643815,644126,311,EVM,mRNA,342839,690907,311,1.00
ptg000195l,1492468,1492791,323,EVM,mRNA,1415789,1624793,323,1.00
ptg000197l,2733912,2734223,311,EVM,mRNA,2391457,2907469,311,1.00
ptg000197l,3036318,3036641,323,EVM,mRNA,3023625,4406254,323,1.00
ptg000200l,2504269,2504551,282,EVM,mRNA,1184546,3285826,282,1.00
ptg000200l,5292057,5292391,334,EVM,mRNA,3532902,6134524,334,1.00
ptg000200l,5336008,5336290,282,EVM,mRNA,3532902,6134524,282,1.00
ptg000200l,5397393,5397681,288,EVM,mRNA,3532902,6134524,288,1.00
ptg000200l,5539511,5539788,277,EVM,mRNA,3532902,6134524,277,1.00
ptg000200l,5921676,5922000,324,EVM,mRNA,3532902,6134524,324,1.00
ptg000200l,6489477,6489789,312,EVM,mRNA,6136580,6750445,312,1.00
ptg000201l,101834,102137,303,EVM,mRNA,12340,131387,303,1.00
ptg000201l,378016,378323,307,EVM,mRNA,147003,603709,307,1.00
ptg000203l,389499,389803,304,EVM,mRNA,48996,1394637,304,1.00
ptg000203l,1163242,1163555,313,EVM,mRNA,48996,1394637,313,1.00
ptg000203l,1849984,1850290,306,EVM,mRNA,1759847,1885891,306,1.00
ptg000206l,454005,454306,301,EVM,mRNA,354300,4456616,301,1.00
ptg000206l,1354120,1354433,313,EVM,mRNA,354300,4456616,313,1.00
ptg000206l,2701127,2701443,316,EVM,mRNA,354300,4456616,316,1.00
ptg000206l,2740588,2740867,279,EVM,mRNA,2739276,2906482,279,1.00
ptg000206l,2740588,2740867,279,EVM,mRNA,354300,4456616,279,1.00
ptg000206l,3049061,3049343,282,EVM,mRNA,354300,4456616,282,1.00
ptg000206l,3423092,3423418,326,EVM,mRNA,354300,4456616,326,1.00
ptg000206l,3568007,3568308,301,EVM,mRNA,354300,4456616,301,1.00
ptg000206l,3657355,3657653,298,EVM,mRNA,354300,4456616,298,1.00
ptg000206l,4196601,4196930,329,EVM,mRNA,354300,4456616,329,1.00
ptg000206l,4331604,4331913,309,EVM,mRNA,354300,4456616,309,1.00
ptg000209l,857131,857397,266,EVM,mRNA,830649,951479,266,1.00
ptg000209l,4994833,4995106,273,EVM,mRNA,4969774,5463009,273,1.00
ptg000210l,2068639,2068942,303,EVM,mRNA,1868620,2210160,303,1.00
ptg000210l,3193310,3193600,290,EVM,mRNA,2546470,4858239,290,1.00
ptg000210l,4466906,4467192,286,EVM,mRNA,2546470,4858239,286,1.00
ptg000211l,1054008,1054320,312,EVM,mRNA,346911,1827539,312,1.00
ptg000211l,1101767,1102090,323,EVM,mRNA,346911,1827539,323,1.00
ptg000211l,1636016,1636335,319,EVM,mRNA,346911,1827539,319,1.00
ptg000212l,658417,658709,292,EVM,mRNA,599571,1034086,292,1.00
ptg000215l,2122988,2123295,307,EVM,mRNA,2059845,2547407,307,1.00
ptg000219l,2515734,2516011,277,EVM,mRNA,2252632,4735888,277,1.00
ptg000219l,3772436,3772733,297,EVM,mRNA,2252632,4735888,297,1.00
ptg000219l,4621767,4622062,295,EVM,mRNA,2252632,4735888,295,1.00
ptg000221l,1353341,1353627,286,EVM,mRNA,1338790,1393792,286,1.00
ptg000221l,2497942,2498249,307,EVM,mRNA,2456088,2798584,307,1.00
ptg000221l,2541189,2541488,299,EVM,mRNA,2456088,2798584,299,1.00
ptg000221l,2597189,2597510,321,EVM,mRNA,2456088,2798584,321,1.00
ptg000221l,2712924,2713218,294,EVM,mRNA,2456088,2798584,294,1.00
ptg000221l,2973189,2973490,301,EVM,mRNA,2822668,2989968,301,1.00
ptg000222l,1511129,1511429,300,EVM,mRNA,1183186,2106358,300,1.00
ptg000222l,3419532,3419834,302,EVM,mRNA,3302224,4140981,302,1.00
ptg000222l,4061018,4061315,297,EVM,mRNA,3302224,4140981,297,1.00
ptg000229l,2793999,2794309,310,EVM,mRNA,2064181,3205787,310,1.00
ptg000231l,662167,662465,298,EVM,mRNA,320975,1488792,298,1.00
ptg000231l,832106,832420,314,EVM,mRNA,320975,1488792,314,1.00
ptg000231l,1199856,1200148,292,EVM,mRNA,320975,1488792,292,1.00
ptg000234l,1366878,1367193,315,EVM,mRNA,1205575,2223706,315,1.00
ptg000234l,2218676,2218966,290,EVM,mRNA,1205575,2223706,290,1.00
ptg000235l,2409401,2409729,328,EVM,mRNA,2402373,3174141,328,1.00
ptg000236l,1581809,1582097,288,EVM,mRNA,789518,2505610,288,1.00
ptg000236l,1767640,1767912,272,EVM,mRNA,789518,2505610,272,1.00
ptg000236l,2447771,2448084,313,EVM,mRNA,789518,2505610,313,1.00
ptg000237l,955031,955359,328,EVM,mRNA,790184,1094575,328,1.00
ptg000239l,774248,774543,295,EVM,mRNA,351441,1002967,295,1.00
ptg000240l,957139,957449,310,EVM,mRNA,658831,2022383,310,1.00
ptg000240l,1092399,1092716,317,EVM,mRNA,658831,2022383,317,1.00
ptg000241l,1416587,1416916,329,EVM,mRNA,1385217,1457078,329,1.00
ptg000244l,1023741,1024042,301,EVM,mRNA,912049,3884954,301,1.00
ptg000244l,3132675,3132973,298,EVM,mRNA,912049,3884954,298,1.00
ptg000244l,3856236,3856526,290,EVM,mRNA,912049,3884954,290,1.00
ptg000247l,834594,834907,313,EVM,mRNA,154708,1506252,313,1.00
ptg000248l,1842040,1842339,299,EVM,mRNA,1629152,2359891,299,1.00
ptg000248l,3723319,3723594,275,EVM,mRNA,2640716,4057751,275,1.00
ptg000250l,1186208,1186491,283,EVM,mRNA,658913,4815339,283,1.00
ptg000250l,1234730,1235062,332,EVM,mRNA,658913,4815339,332,1.00
ptg000250l,1880355,1880682,327,EVM,mRNA,658913,4815339,327,1.00
ptg000250l,2358482,2358801,319,EVM,mRNA,658913,4815339,319,1.00
ptg000250l,2612704,2612985,281,EVM,mRNA,658913,4815339,281,1.00
ptg000250l,2914572,2914910,338,EVM,mRNA,658913,4815339,338,1.00
ptg000250l,3028213,3028467,254,EVM,mRNA,658913,4815339,254,1.00
ptg000250l,3052583,3052886,303,EVM,mRNA,658913,4815339,303,1.00
ptg000250l,3912770,3913084,314,EVM,mRNA,658913,4815339,314,1.00
ptg000250l,3978370,3978670,300,EVM,mRNA,658913,4815339,300,1.00
ptg000250l,4227667,4227974,307,EVM,mRNA,658913,4815339,307,1.00
ptg000250l,4343554,4343839,285,EVM,mRNA,658913,4815339,285,1.00
ptg000250l,4617460,4617748,288,EVM,mRNA,658913,4815339,288,1.00
ptg000251l,1270995,1271310,315,EVM,mRNA,6588,4994820,315,1.00
ptg000251l,3726512,3726800,288,EVM,mRNA,6588,4994820,288,1.00
ptg000251l,4069057,4069358,301,EVM,mRNA,6588,4994820,301,1.00
ptg000257l,1218409,1218704,295,EVM,mRNA,861115,1449289,295,1.00
ptg000258l,805480,805818,338,EVM,mRNA,487076,1491066,338,1.00
ptg000258l,1135711,1136033,322,EVM,mRNA,487076,1491066,322,1.00
ptg000258l,3150649,3150940,291,EVM,mRNA,3150682,4286353,259,0.89
ptg000258l,3210292,3210624,332,EVM,mRNA,3150682,4286353,332,1.00
ptg000258l,3256843,3257171,328,EVM,mRNA,3150682,4286353,328,1.00
ptg000258l,3730662,3730973,311,EVM,mRNA,3150682,4286353,311,1.00
ptg000258l,3944842,3945122,280,EVM,mRNA,3150682,4286353,280,1.00
ptg000258l,4212194,4212463,269,EVM,mRNA,3150682,4286353,269,1.00
ptg000265l,1194798,1195090,292,EVM,mRNA,544466,1241491,292,1.00
ptg000267l,325877,326196,319,EVM,mRNA,167392,719021,319,1.00
ptg000267l,341993,342286,293,EVM,mRNA,167392,719021,293,1.00
ptg000267l,661422,661723,301,EVM,mRNA,167392,719021,301,1.00
ptg000267l,1366998,1367304,306,EVM,mRNA,836895,1449093,306,1.00
ptg000267l,1673449,1673757,308,EVM,mRNA,1616316,2341356,308,1.00
ptg000267l,3489344,3489648,304,EVM,mRNA,2627133,6826954,304,1.00
ptg000267l,4480714,4480999,285,EVM,mRNA,2627133,6826954,285,1.00
ptg000267l,4618166,4618491,325,EVM,mRNA,2627133,6826954,325,1.00
ptg000267l,4840661,4840966,305,EVM,mRNA,2627133,6826954,305,1.00
ptg000267l,5553168,5553478,310,EVM,mRNA,2627133,6826954,310,1.00
ptg000267l,5672655,5672947,292,EVM,mRNA,2627133,6826954,292,1.00
ptg000267l,7662101,7662370,269,EVM,mRNA,7493653,8650758,269,1.00
ptg000267l,9456752,9457063,311,EVM,mRNA,9217875,10794482,311,1.00
ptg000267l,9842363,9842672,309,EVM,mRNA,9217875,10794482,309,1.00
ptg000267l,10643562,10643866,304,EVM,mRNA,9217875,10794482,304,1.00
ptg000269l,800129,800456,327,EVM,mRNA,133273,989737,327,1.00
ptg000271l,1368058,1368373,315,EVM,mRNA,384543,1793455,315,1.00
ptg000273l,35850,36159,309,EVM,mRNA,16025,59916,309,1.00
ptg000273l,1913279,1913602,323,EVM,mRNA,1383233,2492621,323,1.00
ptg000273l,1977695,1977998,303,EVM,mRNA,1383233,2492621,303,1.00
ptg000273l,2488522,2488815,293,EVM,mRNA,1383233,2492621,293,1.00
ptg000276l,557109,557435,326,EVM,mRNA,556958,1482185,326,1.00
ptg000276l,1154892,1155152,260,EVM,mRNA,556958,1482185,260,1.00
ptg000276l,1203715,1204001,286,EVM,mRNA,556958,1482185,286,1.00
ptg000276l,4471647,4471927,280,EVM,mRNA,3290714,5993206,280,1.00
ptg000276l,4478804,4479084,280,EVM,mRNA,3290714,5993206,280,1.00
ptg000276l,4760421,4760722,301,EVM,mRNA,3290714,5993206,301,1.00
ptg000276l,5862813,5863136,323,EVM,mRNA,3290714,5993206,323,1.00
ptg000278l,254799,255084,285,EVM,mRNA,105193,749902,285,1.00
ptg000278l,380945,381236,291,EVM,mRNA,105193,749902,291,1.00
ptg000278l,606849,607155,306,EVM,mRNA,105193,749902,306,1.00
ptg000280l,1659457,1659756,299,EVM,mRNA,1516702,2558455,299,1.00
ptg000281l,405508,405840,332,EVM,mRNA,78645,1211877,332,1.00
ptg000282l,367702,367989,287,EVM,mRNA,315090,1241794,287,1.00
ptg000282l,2263579,2263881,302,EVM,mRNA,2010323,3019703,302,1.00
ptg000282l,2285975,2286277,302,EVM,mRNA,2010323,3019703,302,1.00
ptg000282l,2323933,2324208,275,EVM,mRNA,2010323,3019703,275,1.00
ptg000282l,2795015,2795318,303,EVM,mRNA,2010323,3019703,303,1.00
ptg000283l,256616,256891,275,EVM,mRNA,245966,1225610,275,1.00
ptg000283l,459041,459345,304,EVM,mRNA,245966,1225610,304,1.00
ptg000283l,501225,501509,284,EVM,mRNA,245966,1225610,284,1.00
ptg000283l,4609951,4610235,284,EVM,mRNA,3537182,6919463,284,1.00
ptg000283l,4802463,4802755,292,EVM,mRNA,3537182,6919463,292,1.00
ptg000283l,4936778,4937074,296,EVM,mRNA,3537182,6919463,296,1.00
ptg000284l,310268,310548,280,EVM,mRNA,243719,725377,280,1.00
ptg000286l,402792,403111,319,EVM,mRNA,28111,593424,319,1.00
ptg000286l,498781,499069,288,EVM,mRNA,28111,593424,288,1.00
ptg000286l,2129224,2129539,315,EVM,mRNA,1774105,3115178,315,1.00
ptg000286l,2800146,2800415,269,EVM,mRNA,1774105,3115178,269,1.00
ptg000286l,5843812,5844117,305,EVM,mRNA,5686086,7686461,305,1.00
ptg000291l,469182,469485,303,EVM,mRNA,328177,1737392,303,1.00
ptg000291l,1093301,1093592,291,EVM,mRNA,328177,1737392,291,1.00
ptg000292l,904640,904938,298,EVM,mRNA,370260,1102911,298,1.00
ptg000297l,882359,882682,323,EVM,mRNA,359388,1699404,323,1.00
ptg000297l,3291419,3291750,331,EVM,mRNA,3012130,3974635,331,1.00
ptg000300l,278651,278937,286,EVM,mRNA,249363,2110753,286,1.00
ptg000300l,772149,772434,285,EVM,mRNA,249363,2110753,285,1.00
ptg000304l,706488,706787,299,EVM,mRNA,667482,1100400,299,1.00
ptg000304l,2489917,2490231,314,EVM,mRNA,1793964,2925562,314,1.00
ptg000304l,3820508,3820835,327,EVM,mRNA,3440112,4189657,327,1.00
ptg000304l,3956974,3957276,302,EVM,mRNA,3440112,4189657,302,1.00
ptg000304l,4168931,4169233,302,EVM,mRNA,3440112,4189657,302,1.00
ptg000304l,5392112,5392434,322,EVM,mRNA,4664898,5519285,322,1.00
ptg000304l,5441803,5442082,279,EVM,mRNA,4664898,5519285,279,1.00
ptg000304l,5936730,5937043,313,EVM,mRNA,5718699,6598475,313,1.00
ptg000304l,7057347,7057656,309,EVM,mRNA,7018936,8243094,309,1.00
ptg000304l,7180771,7181070,299,EVM,mRNA,7018936,8243094,299,1.00
ptg000305l,1619945,1620271,326,EVM,mRNA,957855,2449033,326,1.00
ptg000306l,2137248,2137547,299,EVM,mRNA,1977955,2211318,299,1.00
ptg000306l,2682772,2683069,297,EVM,mRNA,2396537,2870783,297,1.00
ptg000306l,2712807,2713113,306,EVM,mRNA,2396537,2870783,306,1.00
ptg000306l,3811138,3811434,296,EVM,mRNA,3520943,3875796,296,1.00
ptg000306l,4975468,4975753,285,EVM,mRNA,4141047,5031308,285,1.00
ptg000307l,829993,830308,315,EVM,mRNA,652475,4834659,315,1.00
ptg000307l,904074,904371,297,EVM,mRNA,652475,4834659,297,1.00
ptg000307l,1163071,1163392,321,EVM,mRNA,652475,4834659,321,1.00
ptg000307l,1411137,1411451,314,EVM,mRNA,652475,4834659,314,1.00
ptg000307l,2227853,2228173,320,EVM,mRNA,652475,4834659,320,1.00
ptg000307l,2968010,2968332,322,EVM,mRNA,652475,4834659,322,1.00
ptg000307l,4817321,4817589,268,EVM,mRNA,652475,4834659,268,1.00
ptg000307l,7765822,7766138,316,EVM,mRNA,7671792,7792963,316,1.00
ptg000310l,3817952,3818288,336,EVM,mRNA,3230166,7488726,336,1.00
ptg000310l,4051381,4051670,289,EVM,mRNA,3230166,7488726,289,1.00
ptg000310l,5436021,5436333,312,EVM,mRNA,3230166,7488726,312,1.00
ptg000310l,6550436,6550741,305,EVM,mRNA,3230166,7488726,305,1.00
ptg000310l,7003728,7004023,295,EVM,mRNA,3230166,7488726,295,1.00
ptg000313l,1288623,1288926,303,EVM,mRNA,1160127,1384017,303,1.00
ptg000313l,1791232,1791530,298,EVM,mRNA,1787679,2110143,298,1.00
ptg000313l,1983259,1983549,290,EVM,mRNA,1787679,2110143,290,1.00
ptg000313l,2418070,2418342,272,EVM,mRNA,2336295,2492874,272,1.00
ptg000313l,3632605,3632898,293,EVM,mRNA,3442892,3645204,293,1.00
ptg000313l,3635560,3635800,240,EVM,mRNA,3442892,3645204,240,1.00
ptg000314l,1062272,1062551,279,EVM,mRNA,785467,1592692,279,1.00
ptg000314l,1174040,1174347,307,EVM,mRNA,785467,1592692,307,1.00
ptg000319l,467068,467369,301,EVM,mRNA,83583,1188258,301,1.00
ptg000319l,1312693,1312982,289,EVM,mRNA,1188703,1564910,289,1.00
ptg000319l,2957046,2957367,321,EVM,mRNA,2208471,3247665,321,1.00
ptg000320l,398239,398547,308,EVM,mRNA,142308,897966,308,1.00
ptg000322l,633713,634029,316,EVM,mRNA,516192,3324034,316,1.00
ptg000322l,719925,720194,269,EVM,mRNA,516192,3324034,269,1.00
ptg000322l,2342369,2342668,299,EVM,mRNA,516192,3324034,299,1.00
ptg000325l,226873,227189,316,EVM,mRNA,126832,597266,316,1.00
ptg000326l,865231,865568,337,EVM,mRNA,719523,927268,337,1.00
ptg000326l,1533544,1533856,312,EVM,mRNA,1418817,1538975,312,1.00
ptg000327l,229036,229352,316,EVM,mRNA,160714,430198,316,1.00
ptg000330l,1289826,1290116,290,EVM,mRNA,615191,1444434,290,1.00
ptg000330l,2836622,2836917,295,EVM,mRNA,2646889,2976219,295,1.00
ptg000330l,3575376,3575656,280,EVM,mRNA,3108378,3809095,280,1.00
ptg000330l,3666207,3666504,297,EVM,mRNA,3108378,3809095,297,1.00
ptg000332l,519099,519428,329,EVM,mRNA,404754,2828904,329,1.00
ptg000333l,334707,335032,325,EVM,mRNA,68509,647787,325,1.00
ptg000336l,501788,502060,272,EVM,mRNA,501401,633426,272,1.00
ptg000337l,3618018,3618302,284,EVM,mRNA,3617779,3618090,72,0.25
ptg000337l,4294881,4295199,318,EVM,mRNA,3808187,4295062,181,0.57
ptg000337l,9744346,9744635,289,EVM,mRNA,6551323,12385407,289,1.00
ptg000337l,10087745,10088028,283,EVM,mRNA,6551323,12385407,283,1.00
ptg000337l,12353736,12354028,292,EVM,mRNA,6551323,12385407,292,1.00
ptg000337l,12370982,12371293,311,EVM,mRNA,6551323,12385407,311,1.00
ptg000337l,15515567,15515866,299,EVM,mRNA,15163846,15947043,299,1.00
ptg000341l,510124,510412,288,EVM,mRNA,4367,1570649,288,1.00
ptg000341l,1147527,1147838,311,EVM,mRNA,4367,1570649,311,1.00
ptg000341l,1304050,1304347,297,EVM,mRNA,4367,1570649,297,1.00
ptg000347l,236318,236629,311,EVM,mRNA,48663,480227,311,1.00
ptg000348l,1430039,1430316,277,EVM,mRNA,1118190,1658749,277,1.00
ptg000349l,1076662,1076960,298,EVM,mRNA,1043191,1796332,298,1.00
ptg000350l,747793,748102,309,EVM,mRNA,461758,989600,309,1.00
ptg000354l,577767,578053,286,EVM,mRNA,447652,841236,286,1.00
ptg000355l,281121,281406,285,EVM,mRNA,3756,1570155,285,1.00
ptg000356l,990964,991269,305,EVM,mRNA,264342,1246039,305,1.00
ptg000359l,1783008,1783326,318,EVM,mRNA,1658573,2101539,318,1.00
ptg000359l,2238586,2238894,308,EVM,mRNA,2235002,2263897,308,1.00
ptg000362l,2701426,2701719,293,EVM,mRNA,2588023,3450116,293,1.00
ptg000363l,521695,522012,317,EVM,mRNA,350876,1202942,317,1.00
ptg000365l,656988,657302,314,EVM,mRNA,633845,869908,314,1.00
ptg000365l,1725989,1726284,295,EVM,mRNA,1283451,1967185,295,1.00
ptg000367l,2227152,2227464,312,EVM,mRNA,2099445,2895555,312,1.00
ptg000373l,1390392,1390690,298,EVM,mRNA,698440,1919663,298,1.00
ptg000373l,3518742,3519013,271,EVM,mRNA,2523473,3947742,271,1.00
ptg000375l,133270,133570,300,EVM,mRNA,1685,1296792,300,1.00
ptg000375l,298507,298835,328,EVM,mRNA,1685,1296792,328,1.00
ptg000375l,360255,360565,310,EVM,mRNA,1685,1296792,310,1.00
ptg000375l,841770,842090,320,EVM,mRNA,1685,1296792,320,1.00
ptg000377l,1357549,1357863,314,EVM,mRNA,1317848,1536566,314,1.00
ptg000377l,1492713,1493028,315,EVM,mRNA,1317848,1536566,315,1.00
ptg000378l,289317,289612,295,EVM,mRNA,150586,662250,295,1.00
ptg000381l,1243072,1243378,306,EVM,mRNA,1032419,1738442,306,1.00
ptg000381l,2259803,2260091,288,EVM,mRNA,2165773,2819230,288,1.00
ptg000381l,6130951,6131262,311,EVM,mRNA,4609824,7496953,311,1.00
ptg000382l,31658,31963,305,EVM,mRNA,8284,353526,305,1.00
ptg000382l,180922,181186,264,EVM,mRNA,8284,353526,264,1.00
ptg000382l,1711849,1712144,295,EVM,mRNA,900283,1789693,295,1.00
ptg000383l,1171593,1171921,328,EVM,mRNA,859381,2123000,328,1.00
ptg000383l,1366984,1367281,297,EVM,mRNA,859381,2123000,297,1.00
ptg000384l,686472,686760,288,EVM,mRNA,446563,744820,288,1.00
ptg000385l,2321860,2322193,333,EVM,mRNA,2175755,3031472,333,1.00
ptg000385l,2339595,2339913,318,EVM,mRNA,2175755,3031472,318,1.00
ptg000385l,2831887,2832214,327,EVM,mRNA,2175755,3031472,327,1.00
ptg000385l,4690369,4690663,294,EVM,mRNA,3158222,5939850,294,1.00
ptg000385l,4902817,4903138,321,EVM,mRNA,3158222,5939850,321,1.00
ptg000387l,2638403,2638712,309,EVM,mRNA,2136794,2717495,309,1.00
ptg000387l,2640260,2640593,333,EVM,mRNA,2136794,2717495,333,1.00
ptg000389l,504523,504822,299,EVM,mRNA,288687,830477,299,1.00
ptg000389l,1163411,1163701,290,EVM,mRNA,1129804,1359021,290,1.00
ptg000389l,1205679,1206004,325,EVM,mRNA,1129804,1359021,325,1.00
ptg000391l,147269,147555,286,EVM,mRNA,18434,202326,286,1.00
ptg000391l,1670642,1670911,269,EVM,mRNA,1534305,1843416,269,1.00
ptg000393l,1716271,1716580,309,EVM,mRNA,694606,1896759,309,1.00
ptg000393l,1839410,1839727,317,EVM,mRNA,694606,1896759,317,1.00
ptg000397l,3414549,3414866,317,EVM,mRNA,3253523,3633826,317,1.00
ptg000399l,605142,605437,295,EVM,mRNA,221268,605662,295,1.00
ptg000399l,3836404,3836710,306,EVM,mRNA,3014007,3927532,306,1.00
ptg000404l,852994,853274,280,EVM,mRNA,674853,1306426,280,1.00
ptg000404l,2350912,2351177,265,EVM,mRNA,1867875,2351123,211,0.80
ptg000405l,935475,935755,280,EVM,mRNA,616038,1265933,280,1.00
ptg000405l,1542802,1543107,305,EVM,mRNA,1539512,1999376,305,1.00
ptg000407l,601659,601976,317,EVM,mRNA,583774,1249046,317,1.00
ptg000407l,815467,815775,308,EVM,mRNA,583774,1249046,308,1.00
ptg000407l,3867274,3867594,320,EVM,mRNA,3788458,4154373,320,1.00
ptg000407l,4074271,4074600,329,EVM,mRNA,3788458,4154373,329,1.00
ptg000407l,5225324,5225623,299,EVM,mRNA,4945780,6663877,299,1.00
ptg000407l,5386257,5386573,316,EVM,mRNA,4945780,6663877,316,1.00
ptg000407l,5668168,5668492,324,EVM,mRNA,4945780,6663877,324,1.00
ptg000407l,6456850,6457149,299,EVM,mRNA,4945780,6663877,299,1.00
ptg000408l,4671838,4672112,274,EVM,mRNA,3399492,6114847,274,1.00
ptg000410l,2205778,2206072,294,EVM,mRNA,407683,2254312,294,1.00
ptg000411l,3944984,3945275,291,EVM,mRNA,3933140,4507807,291,1.00
ptg000411l,4359258,4359574,316,EVM,mRNA,3933140,4507807,316,1.00
ptg000412l,1302933,1303207,274,EVM,mRNA,1018571,1850983,274,1.00
ptg000412l,1570799,1571059,260,EVM,mRNA,1018571,1850983,260,1.00
ptg000412l,1673040,1673355,315,EVM,mRNA,1018571,1850983,315,1.00
ptg000413l,636390,636677,287,EVM,mRNA,167032,1374907,287,1.00
ptg000413l,795681,795989,308,EVM,mRNA,167032,1374907,308,1.00
ptg000413l,1374376,1374639,263,EVM,mRNA,167032,1374907,263,1.00
ptg000414l,200997,201296,299,EVM,mRNA,108355,321858,299,1.00
ptg000414l,4999011,4999347,336,EVM,mRNA,4954061,5464999,336,1.00
ptg000417l,712661,712972,311,EVM,mRNA,177918,727252,311,1.00
ptg000421l,255894,256213,319,EVM,mRNA,244735,421216,319,1.00
ptg000421l,318950,319280,330,EVM,mRNA,244735,421216,330,1.00
ptg000427l,765693,765975,282,EVM,mRNA,80060,1175265,282,1.00
ptg000430l,1775948,1776283,335,EVM,mRNA,588704,1820859,335,1.00
ptg000430l,2397114,2397419,305,EVM,mRNA,2167138,2558521,305,1.00
ptg000433l,1165562,1165861,299,EVM,mRNA,451220,1552967,299,1.00
ptg000435l,2205,2505,300,EVM,mRNA,117,29945,300,1.00
ptg000435l,507850,508154,304,EVM,mRNA,54903,1289160,304,1.00
ptg000437l,419361,419671,310,EVM,mRNA,273258,699365,310,1.00
ptg000439l,1038202,1038527,325,EVM,mRNA,918869,1133702,325,1.00
ptg000442l,1560202,1560501,299,EVM,mRNA,841875,2522671,299,1.00
ptg000442l,2868256,2868570,314,EVM,mRNA,2828287,3486119,314,1.00
ptg000442l,4091097,4091369,272,EVM,mRNA,3952477,4575834,272,1.00
ptg000442l,5481519,5481829,310,EVM,mRNA,5238519,5772508,310,1.00
ptg000442l,6120650,6120928,278,EVM,mRNA,5792266,6312984,278,1.00
ptg000445l,123881,124193,312,EVM,mRNA,56824,527033,312,1.00
ptg000445l,1081448,1081758,310,EVM,mRNA,704652,1472553,310,1.00
ptg000445l,3557037,3557339,302,EVM,mRNA,2509460,4479972,302,1.00
ptg000447l,116367,116665,298,EVM,mRNA,25619,899781,298,1.00
ptg000449l,335667,335966,299,EVM,mRNA,250243,493181,299,1.00
ptg000449l,4222806,4223124,318,EVM,mRNA,4179313,4242565,318,1.00
ptg000450l,218163,218433,270,EVM,mRNA,101793,895414,270,1.00
ptg000450l,863265,863553,288,EVM,mRNA,101793,895414,288,1.00
ptg000451l,4220903,4221176,273,EVM,mRNA,4178325,4943343,273,1.00
ptg000452l,413684,413993,309,EVM,mRNA,781,4516978,309,1.00
ptg000452l,1607083,1607401,318,EVM,mRNA,781,4516978,318,1.00
ptg000452l,2185789,2186075,286,EVM,mRNA,781,4516978,286,1.00
ptg000452l,2923441,2923733,292,EVM,mRNA,781,4516978,292,1.00
ptg000452l,3623971,3624287,316,EVM,mRNA,781,4516978,316,1.00
ptg000454l,345796,346131,335,EVM,mRNA,187049,432562,335,1.00
ptg000457l,1134838,1135132,294,EVM,mRNA,567292,2306371,294,1.00
ptg000459l,458882,459178,296,EVM,mRNA,261821,716175,296,1.00
ptg000460l,1606380,1606664,284,EVM,mRNA,1465083,1753104,284,1.00
ptg000468l,599085,599380,295,EVM,mRNA,443171,1159171,295,1.00
ptg000469l,650725,651042,317,EVM,mRNA,29403,971886,317,1.00
ptg000469l,727811,728125,314,EVM,mRNA,29403,971886,314,1.00
ptg000469l,1801186,1801470,284,EVM,mRNA,1642843,1902796,284,1.00
ptg000472l,1599918,1600179,261,EVM,mRNA,787270,2721361,261,1.00
ptg000472l,1743435,1743751,316,EVM,mRNA,787270,2721361,316,1.00
ptg000472l,2184283,2184590,307,EVM,mRNA,787270,2721361,307,1.00
ptg000480l,1682367,1682676,309,EVM,mRNA,547879,2581542,309,1.00
ptg000481l,899037,899354,317,EVM,mRNA,871326,982767,317,1.00
ptg000484l,918167,918480,313,EVM,mRNA,499618,1449482,313,1.00
ptg000484l,2040400,2040698,298,EVM,mRNA,1514350,2405064,298,1.00
ptg000484l,4007180,4007495,315,EVM,mRNA,4007377,5792275,119,0.38
ptg000485l,398584,398861,277,EVM,mRNA,1736,933537,277,1.00
ptg000485l,885716,886027,311,EVM,mRNA,1736,933537,311,1.00
ptg000485l,1301188,1301498,310,EVM,mRNA,1299947,1638018,310,1.00
ptg000485l,1335646,1335941,295,EVM,mRNA,1299947,1638018,295,1.00
ptg000489l,1965694,1966003,309,EVM,mRNA,1940168,2626133,309,1.00
ptg000489l,2183594,2183904,310,EVM,mRNA,1940168,2626133,310,1.00
ptg000490l,173629,173943,314,EVM,mRNA,165586,961189,314,1.00
ptg000490l,2801932,2802233,301,EVM,mRNA,1808115,3195877,301,1.00
ptg000493l,2277547,2277874,327,EVM,mRNA,2147602,2281841,327,1.00
ptg000493l,4406999,4407304,305,EVM,mRNA,4155820,5270975,305,1.00
ptg000493l,4647894,4648180,286,EVM,mRNA,4155820,5270975,286,1.00
ptg000493l,5551356,5551669,313,EVM,mRNA,5332171,5949602,313,1.00
ptg000493l,5800555,5800857,302,EVM,mRNA,5332171,5949602,302,1.00
ptg000493l,6660029,6660356,327,EVM,mRNA,5997976,7418556,327,1.00
ptg000493l,7153992,7154307,315,EVM,mRNA,5997976,7418556,315,1.00
ptg000493l,7317383,7317676,293,EVM,mRNA,5997976,7418556,293,1.00
ptg000495l,381234,381531,297,EVM,mRNA,284495,397563,297,1.00
ptg000495l,2236685,2237006,321,EVM,mRNA,2098906,2797841,321,1.00
ptg000499l,691539,691849,310,EVM,mRNA,261625,1592497,310,1.00
ptg000499l,1373959,1374271,312,EVM,mRNA,261625,1592497,312,1.00
ptg000501l,1610142,1610418,276,EVM,mRNA,1514678,1796369,276,1.00
ptg000502l,1054334,1054617,283,EVM,mRNA,527010,1638870,283,1.00
ptg000504l,1823107,1823410,303,EVM,mRNA,1749985,3329104,303,1.00
ptg000504l,4601646,4601935,289,EVM,mRNA,3674917,4930490,289,1.00
ptg000505l,2902719,2903007,288,EVM,mRNA,2852724,3128649,288,1.00
ptg000505l,3112000,3112294,294,EVM,mRNA,2852724,3128649,294,1.00
ptg000505l,3982655,3982993,338,EVM,mRNA,3810725,4306228,338,1.00
ptg000505l,3983201,3983507,306,EVM,mRNA,3810725,4306228,306,1.00
ptg000506l,1717165,1717478,313,EVM,mRNA,1605691,1865338,313,1.00
ptg000506l,6513621,6513919,298,EVM,mRNA,6394386,6864973,298,1.00
ptg000506l,8310865,8311148,283,EVM,mRNA,8082138,8315247,283,1.00
ptg000508l,2127866,2128136,270,EVM,mRNA,1498093,2845083,270,1.00
ptg000508l,2322168,2322471,303,EVM,mRNA,1498093,2845083,303,1.00
ptg000508l,3673874,3674188,314,EVM,mRNA,3660436,4007432,314,1.00
ptg000508l,3719528,3719809,281,EVM,mRNA,3660436,4007432,281,1.00
ptg000508l,3799158,3799450,292,EVM,mRNA,3660436,4007432,292,1.00
ptg000508l,3911358,3911639,281,EVM,mRNA,3660436,4007432,281,1.00
ptg000510l,181420,181709,289,EVM,mRNA,24960,315000,289,1.00
ptg000510l,860007,860305,298,EVM,mRNA,814043,1043714,298,1.00
ptg000511l,3697725,3698036,311,EVM,mRNA,3689879,4045948,311,1.00
ptg000511l,5258251,5258543,292,EVM,mRNA,4563444,6248979,292,1.00
ptg000511l,5711545,5711864,319,EVM,mRNA,4563444,6248979,319,1.00
ptg000511l,5811999,5812271,272,EVM,mRNA,4563444,6248979,272,1.00
ptg000511l,7130110,7130406,296,EVM,mRNA,7005320,7996146,296,1.00
ptg000511l,8255556,8255833,277,EVM,mRNA,8185283,8264183,277,1.00
ptg000512l,283616,283910,294,EVM,mRNA,254613,302565,294,1.00
ptg000512l,1546345,1546682,337,EVM,mRNA,392146,2021894,337,1.00
ptg000512l,1665644,1665916,272,EVM,mRNA,392146,2021894,272,1.00
ptg000513l,606088,606412,324,EVM,mRNA,375351,685661,324,1.00
ptg000515l,968757,969056,299,EVM,mRNA,205967,1748254,299,1.00
ptg000515l,2263102,2263403,301,EVM,mRNA,2164645,2346821,301,1.00
ptg000516l,156686,156994,308,EVM,mRNA,31376,514777,308,1.00
ptg000516l,916812,917081,269,EVM,mRNA,819454,1312799,269,1.00
ptg000517l,1599263,1599583,320,EVM,mRNA,1327091,1797439,320,1.00
ptg000518l,360656,360927,271,EVM,mRNA,19222,1781273,271,1.00
ptg000518l,643593,643866,273,EVM,mRNA,19222,1781273,273,1.00
ptg000519l,219157,219432,275,EVM,mRNA,35623,292306,275,1.00
ptg000519l,6991873,6992181,308,EVM,mRNA,6924806,7164851,308,1.00
ptg000519l,8373831,8374128,297,EVM,mRNA,7453186,11813495,297,1.00
ptg000519l,11650612,11650911,299,EVM,mRNA,7453186,11813495,299,1.00
ptg000522l,475046,475351,305,EVM,mRNA,461108,584933,305,1.00
ptg000522l,2463974,2464298,324,EVM,mRNA,2371344,2557906,324,1.00
ptg000522l,2886103,2886378,275,EVM,mRNA,2734788,2923203,275,1.00
ptg000523l,635161,635477,316,EVM,mRNA,56,982697,316,1.00
ptg000523l,1198748,1199043,295,EVM,mRNA,1191777,3918893,295,1.00
ptg000523l,1251397,1251696,299,EVM,mRNA,1191777,3918893,299,1.00
ptg000523l,1323826,1324156,330,EVM,mRNA,1191777,3918893,330,1.00
ptg000523l,1614404,1614685,281,EVM,mRNA,1191777,3918893,281,1.00
ptg000523l,2761234,2761560,326,EVM,mRNA,1191777,3918893,326,1.00
ptg000523l,3516370,3516700,330,EVM,mRNA,1191777,3918893,330,1.00
ptg000523l,3765474,3765772,298,EVM,mRNA,1191777,3918893,298,1.00
ptg000526l,2728796,2729095,299,EVM,mRNA,2605148,3010207,299,1.00
ptg000527l,1271583,1271899,316,EVM,mRNA,1153408,1355175,316,1.00
ptg000527l,2839869,2840163,294,EVM,mRNA,2696128,2937449,294,1.00
ptg000528l,3305130,3305411,281,EVM,mRNA,2641276,3791730,281,1.00
ptg000529l,1047410,1047723,313,EVM,mRNA,423851,1066376,313,1.00
ptg000530l,447158,447453,295,EVM,mRNA,1399,777821,295,1.00
ptg000539l,835776,836058,282,EVM,mRNA,792437,865736,282,1.00
ptg000539l,1269912,1270201,289,EVM,mRNA,1110579,4367146,289,1.00
ptg000539l,1315010,1315338,328,EVM,mRNA,1110579,4367146,328,1.00
ptg000539l,3124534,3124819,285,EVM,mRNA,1110579,4367146,285,1.00
ptg000539l,3319469,3319756,287,EVM,mRNA,1110579,4367146,287,1.00
ptg000539l,3536854,3537139,285,EVM,mRNA,1110579,4367146,285,1.00
ptg000539l,6247213,6247513,300,EVM,mRNA,5889761,6452982,300,1.00
ptg000539l,6912500,6912788,288,EVM,mRNA,6823456,7927866,288,1.00
ptg000539l,6979893,6980165,272,EVM,mRNA,6823456,7927866,272,1.00
ptg000539l,7605670,7605980,310,EVM,mRNA,6823456,7927866,310,1.00
ptg000539l,7656374,7656680,306,EVM,mRNA,6823456,7927866,306,1.00
ptg000541l,401128,401437,309,EVM,mRNA,213786,557038,309,1.00
ptg000544l,441094,441383,289,EVM,mRNA,293474,807159,289,1.00
ptg000550l,2134878,2135144,266,EVM,mRNA,1193654,2985419,266,1.00
ptg000550l,4819182,4819493,311,EVM,mRNA,4803646,5374094,311,1.00
ptg000550l,5785105,5785366,261,EVM,mRNA,5565524,6019182,261,1.00
ptg000552l,643981,644283,302,EVM,mRNA,311241,796088,302,1.00
ptg000552l,2511636,2511918,282,EVM,mRNA,1881134,3056320,282,1.00
ptg000558l,658879,659165,286,EVM,mRNA,658040,2304098,286,1.00
ptg000558l,679439,679731,292,EVM,mRNA,658040,2304098,292,1.00
ptg000558l,3558021,3558324,303,EVM,mRNA,3354137,4197844,303,1.00
ptg000559l,486334,486653,319,EVM,mRNA,654,3545812,319,1.00
ptg000559l,979379,979682,303,EVM,mRNA,654,3545812,303,1.00
ptg000559l,1510894,1511179,285,EVM,mRNA,654,3545812,285,1.00
ptg000559l,2175959,2176255,296,EVM,mRNA,654,3545812,296,1.00
ptg000559l,3283511,3283818,307,EVM,mRNA,654,3545812,307,1.00
ptg000561l,380376,380707,331,EVM,mRNA,124753,605364,331,1.00
ptg000563l,422827,423101,274,EVM,mRNA,59348,646360,274,1.00
ptg000563l,566682,567008,326,EVM,mRNA,59348,646360,326,1.00
ptg000567l,311864,312178,314,EVM,mRNA,148217,357755,314,1.00
ptg000567l,2726018,2726342,324,EVM,mRNA,2630170,2750966,324,1.00
ptg000568l,1530537,1530839,302,EVM,mRNA,1486432,1962697,302,1.00
ptg000568l,1772073,1772366,293,EVM,mRNA,1486432,1962697,293,1.00
ptg000569l,1533697,1534004,307,EVM,mRNA,1358436,1759554,307,1.00
ptg000572l,1587958,1588264,306,EVM,mRNA,1587955,1726119,306,1.00
ptg000573l,172136,172453,317,EVM,mRNA,28364,444369,317,1.00
ptg000576l,352008,352282,274,EVM,mRNA,3504,3040196,274,1.00
ptg000576l,2239417,2239701,284,EVM,mRNA,3504,3040196,284,1.00
ptg000576l,2313610,2313898,288,EVM,mRNA,3504,3040196,288,1.00
ptg000576l,2749515,2749840,325,EVM,mRNA,3504,3040196,325,1.00
ptg000577l,1915037,1915305,268,EVM,mRNA,990426,2079223,268,1.00
ptg000580l,1099029,1099324,295,EVM,mRNA,824662,1102702,295,1.00
ptg000580l,1684982,1685311,329,EVM,mRNA,1618126,2864398,329,1.00
ptg000580l,1862237,1862528,291,EVM,mRNA,1618126,2864398,291,1.00
ptg000585l,805588,805878,290,EVM,mRNA,190688,1177243,290,1.00
ptg000586l,1528727,1529023,296,EVM,mRNA,1488679,1853983,296,1.00
ptg000595l,1525668,1525949,281,EVM,mRNA,1444177,2076471,281,1.00
ptg000595l,1549751,1550040,289,EVM,mRNA,1444177,2076471,289,1.00
ptg000595l,2063155,2063430,275,EVM,mRNA,1444177,2076471,275,1.00
ptg000599l,804486,804771,285,EVM,mRNA,704084,984720,285,1.00
ptg000602l,427320,427622,302,EVM,mRNA,339296,1650691,302,1.00
ptg000602l,946942,947222,280,EVM,mRNA,339296,1650691,280,1.00
ptg000602l,1143366,1143672,306,EVM,mRNA,339296,1650691,306,1.00
ptg000602l,1362086,1362397,311,EVM,mRNA,339296,1650691,311,1.00
ptg000602l,1388880,1389200,320,EVM,mRNA,339296,1650691,320,1.00
ptg000602l,1471927,1472254,327,EVM,mRNA,339296,1650691,327,1.00
ptg000604l,997591,997868,277,EVM,mRNA,857157,2478223,277,1.00
ptg000604l,2718693,2718970,277,EVM,mRNA,2584231,2811719,277,1.00
ptg000604l,3407684,3407958,274,EVM,mRNA,3368629,3580339,274,1.00
ptg000605l,1467665,1467980,315,EVM,mRNA,1442938,1553514,315,1.00
ptg000607l,927272,927590,318,EVM,mRNA,795815,999835,318,1.00
ptg000607l,2457725,2458017,292,EVM,mRNA,1908598,2524685,292,1.00
ptg000607l,4759896,4760206,310,EVM,mRNA,2977227,5101846,310,1.00
ptg000609l,468499,468824,325,EVM,mRNA,220676,1416035,325,1.00
ptg000609l,484771,485048,277,EVM,mRNA,220676,1416035,277,1.00
ptg000609l,593164,593445,281,EVM,mRNA,220676,1416035,281,1.00
ptg000609l,1174018,1174330,312,EVM,mRNA,220676,1416035,312,1.00
ptg000610l,978938,979231,293,EVM,mRNA,753076,1046895,293,1.00
ptg000610l,1033894,1034234,340,EVM,mRNA,753076,1046895,340,1.00
ptg000610l,4120485,4120788,303,EVM,mRNA,3994803,5353384,303,1.00
ptg000610l,4147836,4148161,325,EVM,mRNA,3994803,5353384,325,1.00
ptg000611l,1130680,1130980,300,EVM,mRNA,1130595,1130822,142,0.47
ptg000612l,2578042,2578335,293,EVM,mRNA,2056132,2836151,293,1.00
ptg000612l,2595547,2595839,292,EVM,mRNA,2056132,2836151,292,1.00
ptg000613l,1867544,1867860,316,EVM,mRNA,1080758,2265301,316,1.00
ptg000613l,3330360,3330679,319,EVM,mRNA,3237367,3961548,319,1.00
ptg000613l,4322341,4322664,323,EVM,mRNA,4244031,5077083,323,1.00
ptg000613l,4690714,4691047,333,EVM,mRNA,4244031,5077083,333,1.00
ptg000613l,5242079,5242364,285,EVM,mRNA,5191741,5877801,285,1.00
ptg000613l,5558580,5558883,303,EVM,mRNA,5191741,5877801,303,1.00
ptg000613l,5861429,5861691,262,EVM,mRNA,5191741,5877801,262,1.00
ptg000614l,201223,201514,291,EVM,mRNA,20699,1867904,291,1.00
ptg000614l,684927,685237,310,EVM,mRNA,20699,1867904,310,1.00
ptg000615l,295868,296190,322,EVM,mRNA,285381,1191154,322,1.00
ptg000615l,521846,522133,287,EVM,mRNA,285381,1191154,287,1.00
ptg000616l,1006276,1006561,285,EVM,mRNA,919556,1274742,285,1.00
ptg000616l,1135604,1135886,282,EVM,mRNA,919556,1274742,282,1.00
ptg000616l,1137647,1137929,282,EVM,mRNA,919556,1274742,282,1.00
ptg000617l,206671,207005,334,EVM,mRNA,72150,766068,334,1.00
ptg000617l,238662,238957,295,EVM,mRNA,72150,766068,295,1.00
ptg000617l,665026,665339,313,EVM,mRNA,72150,766068,313,1.00
ptg000620l,933341,933660,319,EVM,mRNA,895039,1249919,319,1.00
ptg000620l,2669306,2669621,315,EVM,mRNA,2629059,2836296,315,1.00
ptg000620l,3733047,3733343,296,EVM,mRNA,3678736,3832778,296,1.00
ptg000620l,3917571,3917875,304,EVM,mRNA,3878865,4070342,304,1.00
ptg000620l,4847001,4847288,287,EVM,mRNA,4819190,4913852,287,1.00
ptg000620l,4874294,4874567,273,EVM,mRNA,4819190,4913852,273,1.00
ptg000621l,367140,367457,317,EVM,mRNA,36280,600631,317,1.00
ptg000621l,1110110,1110413,303,EVM,mRNA,1076218,1315453,303,1.00
ptg000621l,4178826,4179144,318,EVM,mRNA,4042318,4607338,318,1.00
ptg000624l,342767,343049,282,EVM,mRNA,124812,359431,282,1.00
ptg000627l,464076,464386,310,EVM,mRNA,19536,694105,310,1.00
ptg000627l,3111705,3112018,313,EVM,mRNA,2815442,3138989,313,1.00
ptg000627l,3298949,3299256,307,EVM,mRNA,3299051,4195008,206,0.67
ptg000627l,3415156,3415475,319,EVM,mRNA,3299051,4195008,319,1.00
ptg000627l,3659298,3659601,303,EVM,mRNA,3299051,4195008,303,1.00
ptg000627l,3715972,3716298,326,EVM,mRNA,3299051,4195008,326,1.00
ptg000627l,4012971,4013292,321,EVM,mRNA,3299051,4195008,321,1.00
ptg000627l,5478283,5478588,305,EVM,mRNA,5471837,9839571,305,1.00
ptg000627l,6627250,6627526,276,EVM,mRNA,5471837,9839571,276,1.00
ptg000627l,6911497,6911813,316,EVM,mRNA,5471837,9839571,316,1.00
ptg000629l,224212,224508,296,EVM,mRNA,149945,1026792,296,1.00
ptg000629l,746604,746911,307,EVM,mRNA,149945,1026792,307,1.00
ptg000629l,2020668,2020961,293,EVM,mRNA,1737914,2521219,293,1.00
ptg000630l,1263871,1264163,292,EVM,mRNA,821520,2670723,292,1.00
ptg000631l,797213,797501,288,EVM,mRNA,724460,2625561,288,1.00
ptg000631l,1430239,1430565,326,EVM,mRNA,724460,2625561,326,1.00
ptg000631l,1589604,1589868,264,EVM,mRNA,724460,2625561,264,1.00
ptg000631l,2533621,2533890,269,EVM,mRNA,724460,2625561,269,1.00
ptg000632l,1171146,1171427,281,EVM,mRNA,1110924,1313263,281,1.00
ptg000632l,4353931,4354223,292,EVM,mRNA,3755769,4414240,292,1.00
ptg000633l,1121892,1122215,323,EVM,mRNA,912987,1876541,323,1.00
ptg000633l,6574446,6574734,288,EVM,mRNA,6431905,7308216,288,1.00
ptg000637l,1175767,1176056,289,EVM,mRNA,264674,2067666,289,1.00
ptg000637l,2320822,2321092,270,EVM,mRNA,2212671,3568447,270,1.00
ptg000637l,2639857,2640142,285,EVM,mRNA,2212671,3568447,285,1.00
ptg000637l,2798738,2799030,292,EVM,mRNA,2212671,3568447,292,1.00
ptg000637l,3532375,3532704,329,EVM,mRNA,2212671,3568447,329,1.00
ptg000639l,829550,829872,322,EVM,mRNA,3103,1101157,322,1.00
ptg000642l,790739,791023,284,EVM,mRNA,373526,2406551,284,1.00
ptg000642l,2205943,2206270,327,EVM,mRNA,373526,2406551,327,1.00
ptg000645l,2545971,2546207,236,EVM,mRNA,2506348,2582681,236,1.00
ptg000647l,1061847,1062118,271,EVM,mRNA,233926,2294670,271,1.00
ptg000647l,1388724,1389011,287,EVM,mRNA,233926,2294670,287,1.00
ptg000647l,1702924,1703226,302,EVM,mRNA,233926,2294670,302,1.00
ptg000652l,543608,543900,292,EVM,mRNA,139525,1524655,292,1.00
ptg000652l,1737555,1737849,294,EVM,mRNA,1541633,1837876,294,1.00
ptg000653l,2306065,2306359,294,EVM,mRNA,1583408,5357291,294,1.00
ptg000653l,3149264,3149586,322,EVM,mRNA,1583408,5357291,322,1.00
ptg000653l,3735768,3736078,310,EVM,mRNA,1583408,5357291,310,1.00
ptg000653l,4161243,4161517,274,EVM,mRNA,1583408,5357291,274,1.00
ptg000653l,4690670,4690930,260,EVM,mRNA,1583408,5357291,260,1.00
ptg000653l,5015504,5015831,327,EVM,mRNA,1583408,5357291,327,1.00
ptg000653l,5356404,5356719,315,EVM,mRNA,1583408,5357291,315,1.00
ptg000656l,2181351,2181677,326,EVM,mRNA,1812227,2200283,326,1.00
ptg000657l,595720,595992,272,EVM,mRNA,589329,1321065,272,1.00
ptg000658l,1146875,1147174,299,EVM,mRNA,888622,1880451,299,1.00
ptg000658l,1399305,1399589,284,EVM,mRNA,888622,1880451,284,1.00
ptg000658l,1413406,1413735,329,EVM,mRNA,888622,1880451,329,1.00
ptg000660l,1428236,1428563,327,EVM,mRNA,1002566,1632252,327,1.00
ptg000664l,908461,908742,281,EVM,mRNA,394084,1771848,281,1.00
ptg000664l,2315321,2315603,282,EVM,mRNA,2234924,2915836,282,1.00
ptg000665l,1344827,1345101,274,EVM,mRNA,262094,2782248,274,1.00
ptg000665l,2194099,2194398,299,EVM,mRNA,262094,2782248,299,1.00
ptg000665l,2375165,2375446,281,EVM,mRNA,262094,2782248,281,1.00
ptg000665l,2619197,2619487,290,EVM,mRNA,262094,2782248,290,1.00
ptg000665l,2777299,2777591,292,EVM,mRNA,262094,2782248,292,1.00
ptg000665l,5280550,5280863,313,EVM,mRNA,5085596,8973540,313,1.00
ptg000665l,7114482,7114772,290,EVM,mRNA,5085596,8973540,290,1.00
ptg000665l,9652729,9653031,302,EVM,mRNA,9512810,9893080,302,1.00
ptg000665l,10235206,10235519,313,EVM,mRNA,10151128,10723314,313,1.00
ptg000670l,3850968,3851301,333,EVM,mRNA,3253504,3979303,333,1.00
ptg000672l,365869,366162,293,EVM,mRNA,103684,464597,293,1.00
ptg000672l,1902353,1902666,313,EVM,mRNA,1763044,2169251,313,1.00
ptg000672l,1903846,1904175,329,EVM,mRNA,1763044,2169251,329,1.00
ptg000678l,182162,182451,289,EVM,mRNA,13697,489925,289,1.00
ptg000678l,361055,361335,280,EVM,mRNA,13697,489925,280,1.00
ptg000678l,444852,445171,319,EVM,mRNA,13697,489925,319,1.00
ptg000680l,619704,619976,272,EVM,mRNA,227797,3385289,272,1.00
ptg000680l,1381128,1381409,281,EVM,mRNA,227797,3385289,281,1.00
ptg000680l,1896581,1896881,300,EVM,mRNA,227797,3385289,300,1.00
ptg000682l,1234309,1234607,298,EVM,mRNA,1188271,1298613,298,1.00
ptg000683l,459689,459974,285,EVM,mRNA,454613,462438,285,1.00
ptg000685l,2332286,2332612,326,EVM,mRNA,2268622,2375834,326,1.00
ptg000687l,871069,871393,324,EVM,mRNA,62351,962734,324,1.00
ptg000689l,979867,980169,302,EVM,mRNA,839144,1324749,302,1.00
ptg000689l,1169804,1170114,310,EVM,mRNA,839144,1324749,310,1.00
ptg000689l,1268727,1269003,276,EVM,mRNA,839144,1324749,276,1.00
ptg000689l,1893834,1894127,293,EVM,mRNA,1773698,1919782,293,1.00
ptg000690l,1503409,1503706,297,EVM,mRNA,290215,3208832,297,1.00
ptg000690l,2258616,2258928,312,EVM,mRNA,290215,3208832,312,1.00
ptg000692l,910145,910460,315,EVM,mRNA,37692,1876707,315,1.00
ptg000692l,1121550,1121848,298,EVM,mRNA,37692,1876707,298,1.00
ptg000692l,1580276,1580546,270,EVM,mRNA,37692,1876707,270,1.00
ptg000694l,38669,38960,291,EVM,mRNA,31044,689898,291,1.00
ptg000697l,1057566,1057865,299,EVM,mRNA,565063,2907976,299,1.00
ptg000697l,1690731,1691034,303,EVM,mRNA,565063,2907976,303,1.00
ptg000697l,4766164,4766455,291,EVM,mRNA,3705396,5245990,291,1.00
ptg000697l,5173380,5173697,317,EVM,mRNA,3705396,5245990,317,1.00
ptg000712l,2025471,2025792,321,EVM,mRNA,1989422,2283830,321,1.00
ptg000712l,2119489,2119796,307,EVM,mRNA,1989422,2283830,307,1.00
ptg000713l,362357,362680,323,EVM,mRNA,344881,576477,323,1.00
ptg000716l,4268074,4268336,262,EVM,mRNA,3141719,4270083,262,1.00
ptg000719l,3246819,3247118,299,EVM,mRNA,2021235,3515282,299,1.00
ptg000719l,3303998,3304321,323,EVM,mRNA,2021235,3515282,323,1.00
ptg000720l,4598236,4598526,290,EVM,mRNA,2744700,4814764,290,1.00
ptg000722l,1533279,1533578,299,EVM,mRNA,993984,4309275,299,1.00
ptg000722l,2036974,2037271,297,EVM,mRNA,993984,4309275,297,1.00
ptg000722l,2732737,2733025,288,EVM,mRNA,993984,4309275,288,1.00
ptg000722l,3078329,3078625,296,EVM,mRNA,993984,4309275,296,1.00
ptg000722l,4018700,4019002,302,EVM,mRNA,993984,4309275,302,1.00
ptg000722l,4281836,4282130,294,EVM,mRNA,993984,4309275,294,1.00
ptg000724l,2486774,2487098,324,EVM,mRNA,1098313,2786892,324,1.00
ptg000724l,3555641,3555930,289,EVM,mRNA,3528770,4152624,289,1.00
ptg000724l,4857583,4857882,299,EVM,mRNA,4733986,5237353,299,1.00
ptg000726l,825802,826119,317,EVM,mRNA,109028,2883573,317,1.00
ptg000730l,19018,19285,267,EVM,mRNA,12752,804745,267,1.00
ptg000731l,213305,213585,280,EVM,mRNA,90020,1002297,280,1.00
ptg000731l,687405,687700,295,EVM,mRNA,90020,1002297,295,1.00
ptg000731l,1519610,1519890,280,EVM,mRNA,1286624,3244314,280,1.00
ptg000731l,2621945,2622216,271,EVM,mRNA,1286624,3244314,271,1.00
ptg000731l,2984435,2984737,302,EVM,mRNA,1286624,3244314,302,1.00
ptg000732l,1506974,1507248,274,EVM,mRNA,681065,3060651,274,1.00
ptg000734l,253556,253853,297,EVM,mRNA,70373,1365637,297,1.00
ptg000734l,407800,408142,342,EVM,mRNA,70373,1365637,342,1.00
ptg000734l,1100948,1101241,293,EVM,mRNA,70373,1365637,293,1.00
ptg000735l,2244602,2244901,299,EVM,mRNA,2161704,2538820,299,1.00
ptg000736l,2139594,2139865,271,EVM,mRNA,1956142,2259773,271,1.00
ptg000738l,1248325,1248633,308,EVM,mRNA,322081,2072321,308,1.00
ptg000738l,1492335,1492646,311,EVM,mRNA,322081,2072321,311,1.00
ptg000738l,1685642,1685951,309,EVM,mRNA,322081,2072321,309,1.00
ptg000738l,1706084,1706338,254,EVM,mRNA,322081,2072321,254,1.00
ptg000739l,8016584,8016902,318,EVM,mRNA,7485256,8575385,318,1.00
ptg000739l,8112974,8113277,303,EVM,mRNA,7485256,8575385,303,1.00
ptg000739l,8118652,8118951,299,EVM,mRNA,7485256,8575385,299,1.00
ptg000741l,472507,472824,317,EVM,mRNA,220828,4438273,317,1.00
ptg000741l,929083,929376,293,EVM,mRNA,220828,4438273,293,1.00
ptg000741l,1811371,1811648,277,EVM,mRNA,220828,4438273,277,1.00
ptg000741l,5791691,5792020,329,EVM,mRNA,5170026,7394665,329,1.00
ptg000741l,6270751,6271067,316,EVM,mRNA,5170026,7394665,316,1.00
ptg000741l,7020816,7021128,312,EVM,mRNA,5170026,7394665,312,1.00
ptg000742l,2265854,2266157,303,EVM,mRNA,2213672,2604658,303,1.00
ptg000742l,3864482,3864768,286,EVM,mRNA,3601746,4817650,286,1.00
ptg000742l,4570682,4570964,282,EVM,mRNA,3601746,4817650,282,1.00
ptg000745l,589384,589694,310,EVM,mRNA,14413,2271323,310,1.00
ptg000745l,825382,825676,294,EVM,mRNA,14413,2271323,294,1.00
ptg000748l,2096114,2096390,276,EVM,mRNA,898727,2417256,276,1.00
ptg000748l,2141223,2141506,283,EVM,mRNA,898727,2417256,283,1.00
ptg000748l,2729626,2729943,317,EVM,mRNA,2597762,2942799,317,1.00
ptg000748l,2765206,2765521,315,EVM,mRNA,2597762,2942799,315,1.00
ptg000748l,3400002,3400291,289,EVM,mRNA,3295608,3731617,289,1.00
ptg000748l,3771436,3771752,316,EVM,mRNA,3770530,3957148,316,1.00
ptg000748l,4498614,4498883,269,EVM,mRNA,3977815,4807091,269,1.00
ptg000748l,5686020,5686319,299,EVM,mRNA,5387266,5852183,299,1.00
ptg000749l,178805,179058,253,EVM,mRNA,103248,1165248,253,1.00
ptg000750l,111555,111833,278,EVM,mRNA,98049,430002,278,1.00
ptg000750l,1353543,1353823,280,EVM,mRNA,1234386,2268511,280,1.00
ptg000750l,1806319,1806633,314,EVM,mRNA,1234386,2268511,314,1.00
ptg000750l,1924657,1924991,334,EVM,mRNA,1234386,2268511,334,1.00
ptg000751l,188568,188894,326,EVM,mRNA,94903,263451,326,1.00
ptg000751l,650687,650985,298,EVM,mRNA,642531,4050359,298,1.00
ptg000751l,1196219,1196541,322,EVM,mRNA,642531,4050359,322,1.00
ptg000751l,1499289,1499603,314,EVM,mRNA,642531,4050359,314,1.00
ptg000751l,1829169,1829461,292,EVM,mRNA,642531,4050359,292,1.00
ptg000751l,1847884,1848194,310,EVM,mRNA,642531,4050359,310,1.00
ptg000751l,1898850,1899179,329,EVM,mRNA,642531,4050359,329,1.00
ptg000751l,2577821,2578140,319,EVM,mRNA,642531,4050359,319,1.00
ptg000751l,3131211,3131538,327,EVM,mRNA,642531,4050359,327,1.00
ptg000751l,3485500,3485780,280,EVM,mRNA,642531,4050359,280,1.00
ptg000751l,4603705,4604007,302,EVM,mRNA,4425619,5420152,302,1.00
ptg000755l,1736427,1736744,317,EVM,mRNA,1732739,1942993,317,1.00
ptg000757l,225522,225796,274,EVM,mRNA,1903,339254,274,1.00
ptg000759l,601177,601486,309,EVM,mRNA,504504,903432,309,1.00
ptg000759l,2788484,2788794,310,EVM,mRNA,2043198,3223855,310,1.00
ptg000764l,1240327,1240662,335,EVM,mRNA,1212578,3543548,335,1.00
ptg000764l,1648835,1649100,265,EVM,mRNA,1212578,3543548,265,1.00
ptg000764l,1764793,1765116,323,EVM,mRNA,1212578,3543548,323,1.00
ptg000764l,2682266,2682563,297,EVM,mRNA,1212578,3543548,297,1.00
ptg000766l,395253,395578,325,EVM,mRNA,277098,673120,325,1.00
ptg000766l,2250346,2250644,298,EVM,mRNA,1835442,2692021,298,1.00
ptg000766l,3620482,3620745,263,EVM,mRNA,3464074,3830470,263,1.00
ptg000769l,718277,718584,307,EVM,mRNA,2288,827823,307,1.00
ptg000769l,771302,771583,281,EVM,mRNA,2288,827823,281,1.00
ptg000769l,2069294,2069572,278,EVM,mRNA,1637066,2090071,278,1.00
ptg000769l,2498037,2498329,292,EVM,mRNA,2479836,3041005,292,1.00
ptg000773l,1299852,1300162,310,EVM,mRNA,690972,1362962,310,1.00
ptg000774l,45686,45997,311,EVM,mRNA,4478,360401,311,1.00
ptg000782l,206983,207302,319,EVM,mRNA,1376,2407136,319,1.00
ptg000782l,1355679,1355965,286,EVM,mRNA,1376,2407136,286,1.00
ptg000782l,1955667,1955991,324,EVM,mRNA,1376,2407136,324,1.00
ptg000783l,447967,448290,323,EVM,mRNA,3350,1310014,323,1.00
ptg000786l,1305015,1305326,311,EVM,mRNA,1231240,1838133,311,1.00
ptg000788l,3870789,3871107,318,EVM,mRNA,3809525,4012559,318,1.00
ptg000788l,4746829,4747111,282,EVM,mRNA,4081088,4810634,282,1.00
ptg000789l,3109562,3109858,296,EVM,mRNA,1352283,4079739,296,1.00
ptg000789l,4036294,4036597,303,EVM,mRNA,1352283,4079739,303,1.00
ptg000791l,204361,204651,290,EVM,mRNA,108551,394401,290,1.00
ptg000791l,643795,644096,301,EVM,mRNA,566390,683446,301,1.00
ptg000793l,383026,383296,270,EVM,mRNA,66986,416331,270,1.00
ptg000795l,1367081,1367385,304,EVM,mRNA,1302151,2699413,304,1.00
ptg000795l,1383743,1384072,329,EVM,mRNA,1302151,2699413,329,1.00
ptg000795l,2072833,2073151,318,EVM,mRNA,1302151,2699413,318,1.00
ptg000795l,2307790,2308086,296,EVM,mRNA,1302151,2699413,296,1.00
ptg000796l,278174,278449,275,EVM,mRNA,263504,299097,275,1.00
ptg000797l,680881,681156,275,EVM,mRNA,189829,1162221,275,1.00
ptg000799l,902079,902382,303,EVM,mRNA,162735,1012818,303,1.00
ptg000799l,3216769,3217029,260,EVM,mRNA,3054542,4622848,260,1.00
ptg000799l,3382272,3382564,292,EVM,mRNA,3054542,4622848,292,1.00
ptg000799l,3719724,3719996,272,EVM,mRNA,3054542,4622848,272,1.00
ptg000799l,4284140,4284415,275,EVM,mRNA,3054542,4622848,275,1.00
ptg000802l,918821,919120,299,EVM,mRNA,73950,1627458,299,1.00
ptg000802l,1351058,1351338,280,EVM,mRNA,73950,1627458,280,1.00
ptg000802l,2246502,2246832,330,EVM,mRNA,2004717,3354302,330,1.00
ptg000802l,5637472,5637762,290,EVM,mRNA,5490170,5701855,290,1.00
ptg000802l,7761448,7761759,311,EVM,mRNA,7504179,8542431,311,1.00
ptg000803l,3376023,3376295,272,EVM,mRNA,2585834,3540853,272,1.00
ptg000804l,1087394,1087671,277,EVM,mRNA,944861,1416202,277,1.00
ptg000805l,203664,203940,276,EVM,mRNA,147658,492904,276,1.00
ptg000805l,1600141,1600465,324,EVM,mRNA,1451174,2363334,324,1.00
ptg000805l,2273289,2273604,315,EVM,mRNA,1451174,2363334,315,1.00
ptg000806l,1847180,1847503,323,EVM,mRNA,1832403,3381471,323,1.00
ptg000806l,2445430,2445724,294,EVM,mRNA,1832403,3381471,294,1.00
ptg000806l,4066609,4066930,321,EVM,mRNA,3794905,4959693,321,1.00
ptg000806l,4722537,4722862,325,EVM,mRNA,3794905,4959693,325,1.00
ptg000808l,3324913,3325217,304,EVM,mRNA,3060404,4608571,304,1.00
ptg000810l,610959,611265,306,EVM,mRNA,152,1167264,306,1.00
ptg000812l,689647,689951,304,EVM,mRNA,647297,1174654,304,1.00
ptg000812l,885491,885780,289,EVM,mRNA,647297,1174654,289,1.00
ptg000813l,240124,240416,292,EVM,mRNA,30337,247157,292,1.00
ptg000816l,294348,294634,286,EVM,mRNA,210302,478178,286,1.00
ptg000817l,2701582,2701872,290,EVM,mRNA,2143761,3576632,290,1.00
ptg000817l,2754373,2754672,299,EVM,mRNA,2143761,3576632,299,1.00
ptg000817l,5429098,5429414,316,EVM,mRNA,5349244,6264664,316,1.00
ptg000819l,3940656,3940960,304,EVM,mRNA,3459407,5049705,304,1.00
ptg000819l,4501506,4501807,301,EVM,mRNA,3459407,5049705,301,1.00
ptg000819l,4577196,4577457,261,EVM,mRNA,3459407,5049705,261,1.00
ptg000819l,4827501,4827825,324,EVM,mRNA,3459407,5049705,324,1.00
ptg000819l,4989130,4989397,267,EVM,mRNA,3459407,5049705,267,1.00
ptg000819l,6801041,6801350,309,EVM,mRNA,6002174,7288756,309,1.00
ptg000820l,2358789,2359098,309,EVM,mRNA,2278706,2418198,309,1.00
ptg000820l,2713783,2714070,287,EVM,mRNA,2653181,2770376,287,1.00
ptg000821l,462523,462843,320,EVM,mRNA,26599,816505,320,1.00
ptg000821l,1569443,1569758,315,EVM,mRNA,1568927,2235023,315,1.00
ptg000821l,1768284,1768559,275,EVM,mRNA,1568927,2235023,275,1.00
ptg000822l,951148,951450,302,EVM,mRNA,752030,983432,302,1.00
ptg000824l,2128605,2128918,313,EVM,mRNA,2121928,2205158,313,1.00
ptg000824l,3297507,3297823,316,EVM,mRNA,3086697,3476481,316,1.00
ptg000824l,3322736,3323035,299,EVM,mRNA,3086697,3476481,299,1.00
ptg000828l,558724,559025,301,EVM,mRNA,232742,997038,301,1.00
ptg000837l,2190536,2190826,290,EVM,mRNA,326,2512890,290,1.00
ptg000837l,2940388,2940682,294,EVM,mRNA,2869919,3146538,294,1.00
ptg000837l,3691394,3691695,301,EVM,mRNA,3558166,3950388,301,1.00
ptg000837l,5071008,5071296,288,EVM,mRNA,4315415,5419345,288,1.00
ptg000842l,2523265,2523550,285,EVM,mRNA,2163216,3002714,285,1.00
ptg000842l,2868143,2868440,297,EVM,mRNA,2163216,3002714,297,1.00
ptg000844l,3177364,3177685,321,EVM,mRNA,3072714,3413749,321,1.00
ptg000844l,3405621,3405949,328,EVM,mRNA,3072714,3413749,328,1.00
ptg000844l,5543839,5544141,302,EVM,mRNA,4800940,5862425,302,1.00
ptg000844l,6041252,6041566,314,EVM,mRNA,5934991,6873529,314,1.00
ptg000844l,6115160,6115467,307,EVM,mRNA,5934991,6873529,307,1.00
ptg000844l,6618176,6618488,312,EVM,mRNA,5934991,6873529,312,1.00
ptg000844l,7392934,7393239,305,EVM,mRNA,7084525,7587742,305,1.00
ptg000845l,644579,644881,302,EVM,mRNA,624733,1729786,302,1.00
ptg000845l,1055026,1055308,282,EVM,mRNA,624733,1729786,282,1.00
ptg000847l,950145,950449,304,EVM,mRNA,60551,3138731,304,1.00
ptg000847l,1026588,1026885,297,EVM,mRNA,60551,3138731,297,1.00
ptg000847l,4291021,4291348,327,EVM,mRNA,3281965,4568267,327,1.00
ptg000850l,54245,54540,295,EVM,mRNA,14183,1965426,295,1.00
ptg000850l,215518,215838,320,EVM,mRNA,14183,1965426,320,1.00
ptg000850l,1026096,1026390,294,EVM,mRNA,14183,1965426,294,1.00
ptg000850l,1305901,1306213,312,EVM,mRNA,14183,1965426,312,1.00
ptg000850l,1684486,1684780,294,EVM,mRNA,14183,1965426,294,1.00
ptg000851l,1380928,1381236,308,EVM,mRNA,437748,3547190,308,1.00
ptg000851l,2050940,2051236,296,EVM,mRNA,437748,3547190,296,1.00
ptg000851l,2294811,2295096,285,EVM,mRNA,437748,3547190,285,1.00
ptg000851l,2882738,2883070,332,EVM,mRNA,437748,3547190,332,1.00
ptg000851l,3263973,3264281,308,EVM,mRNA,437748,3547190,308,1.00
ptg000851l,3614291,3614608,317,EVM,mRNA,3547361,3911854,317,1.00
ptg000852l,310613,310895,282,EVM,mRNA,152071,702917,282,1.00
ptg000853l,620382,620650,268,EVM,mRNA,602491,658530,268,1.00
ptg000853l,4272728,4273053,325,EVM,mRNA,4214438,4440577,325,1.00
ptg000853l,4375464,4375760,296,EVM,mRNA,4214438,4440577,296,1.00
ptg000855l,3629910,3630219,309,EVM,mRNA,3486015,3863497,309,1.00
ptg000857l,495671,495983,312,EVM,mRNA,287987,671566,312,1.00
ptg000857l,570417,570729,312,EVM,mRNA,287987,671566,312,1.00
ptg000858l,234076,234357,281,EVM,mRNA,204820,820126,281,1.00
ptg000866l,197765,198076,311,EVM,mRNA,2296,231007,311,1.00
ptg000867l,220621,220945,324,EVM,mRNA,46686,3215754,324,1.00
ptg000867l,780848,781133,285,EVM,mRNA,46686,3215754,285,1.00
ptg000867l,2555976,2556285,309,EVM,mRNA,46686,3215754,309,1.00
ptg000867l,2799452,2799736,284,EVM,mRNA,46686,3215754,284,1.00
ptg000867l,4448796,4449100,304,EVM,mRNA,4110733,5311257,304,1.00
ptg000867l,4515370,4515696,326,EVM,mRNA,4110733,5311257,326,1.00
ptg000867l,4933328,4933646,318,EVM,mRNA,4110733,5311257,318,1.00
ptg000867l,5565330,5565614,284,EVM,mRNA,5559221,6033692,284,1.00
ptg000867l,5576012,5576311,299,EVM,mRNA,5559221,6033692,299,1.00
ptg000868l,404410,404721,311,EVM,mRNA,141432,1395404,311,1.00
ptg000868l,686401,686710,309,EVM,mRNA,141432,1395404,309,1.00
ptg000868l,2255027,2255337,310,EVM,mRNA,2203960,2294325,310,1.00
ptg000873l,213884,214167,283,EVM,mRNA,86272,1445472,283,1.00
ptg000873l,260530,260833,303,EVM,mRNA,86272,1445472,303,1.00
ptg000873l,454637,454932,295,EVM,mRNA,86272,1445472,295,1.00
ptg000873l,1597255,1597533,278,EVM,mRNA,1581492,1649735,278,1.00
ptg000874l,8088407,8088705,298,EVM,mRNA,7780471,8242239,298,1.00
ptg000877l,1028376,1028678,302,EVM,mRNA,986331,1279628,302,1.00
ptg000877l,1854001,1854287,286,EVM,mRNA,1623428,2030323,286,1.00
ptg000878l,379188,379490,302,EVM,mRNA,148365,574937,302,1.00
ptg000878l,450696,450995,299,EVM,mRNA,148365,574937,299,1.00
ptg000878l,455880,456176,296,EVM,mRNA,148365,574937,296,1.00
ptg000880l,490833,491137,304,EVM,mRNA,487872,521374,304,1.00
ptg000882l,353025,353290,265,EVM,mRNA,124794,429899,265,1.00
ptg000883l,2119850,2120165,315,EVM,mRNA,2055951,2126936,315,1.00
ptg000883l,2428629,2428935,306,EVM,mRNA,2364957,2439791,306,1.00
ptg000885l,1271876,1272160,284,EVM,mRNA,1241157,2355046,284,1.00
ptg000885l,2276083,2276385,302,EVM,mRNA,1241157,2355046,302,1.00
ptg000885l,3322242,3322572,330,EVM,mRNA,3206368,3641772,330,1.00
ptg000885l,3513173,3513476,303,EVM,mRNA,3206368,3641772,303,1.00
ptg000885l,4040644,4040943,299,EVM,mRNA,3754977,4046531,299,1.00
ptg000885l,5070619,5070949,330,EVM,mRNA,4977961,5358416,330,1.00
ptg000885l,5710719,5711033,314,EVM,mRNA,5639508,5996032,314,1.00
ptg000885l,6973289,6973572,283,EVM,mRNA,6955927,7178029,283,1.00
ptg000885l,6984957,6985277,320,EVM,mRNA,6955927,7178029,320,1.00
ptg000886l,259985,260277,292,EVM,mRNA,191164,3306607,292,1.00
ptg000889l,230156,230457,301,EVM,mRNA,873,1820759,301,1.00
ptg000889l,2164384,2164696,312,EVM,mRNA,1973343,3145751,312,1.00
ptg000889l,2338490,2338809,319,EVM,mRNA,1973343,3145751,319,1.00
ptg000892l,482775,483081,306,EVM,mRNA,443074,589581,306,1.00
ptg000893l,1584255,1584591,336,EVM,mRNA,1440528,2787594,336,1.00
ptg000893l,1894176,1894487,311,EVM,mRNA,1440528,2787594,311,1.00
ptg000893l,2627529,2627827,298,EVM,mRNA,1440528,2787594,298,1.00
ptg000893l,5725624,5725935,311,EVM,mRNA,4921460,7266480,311,1.00
ptg000893l,6282442,6282763,321,EVM,mRNA,4921460,7266480,321,1.00
ptg000893l,6734682,6734995,313,EVM,mRNA,4921460,7266480,313,1.00
ptg000895l,1536439,1536762,323,EVM,mRNA,98750,2397184,323,1.00
ptg000895l,1851898,1852206,308,EVM,mRNA,98750,2397184,308,1.00
ptg000896l,1314313,1314616,303,EVM,mRNA,1030641,1471032,303,1.00
ptg000896l,2346231,2346512,281,EVM,mRNA,1622563,2571686,281,1.00
ptg000896l,4342846,4343153,307,EVM,mRNA,4339060,4679970,307,1.00
ptg000900l,361667,361999,332,EVM,mRNA,219874,468184,332,1.00
ptg000900l,420189,420501,312,EVM,mRNA,219874,468184,312,1.00
ptg000904l,689951,690265,314,EVM,mRNA,583804,2142856,314,1.00
ptg000904l,708143,708454,311,EVM,mRNA,583804,2142856,311,1.00
ptg000906l,1743463,1743741,278,EVM,mRNA,1047595,3477523,278,1.00
ptg000906l,1856300,1856598,298,EVM,mRNA,1047595,3477523,298,1.00
ptg000906l,2081334,2081667,333,EVM,mRNA,1047595,3477523,333,1.00
ptg000906l,2330136,2330434,298,EVM,mRNA,1047595,3477523,298,1.00
ptg000906l,2789350,2789629,279,EVM,mRNA,1047595,3477523,279,1.00
ptg000909l,549949,550235,286,EVM,mRNA,417767,1372767,286,1.00
ptg000912l,242137,242465,328,EVM,mRNA,152260,575447,328,1.00
ptg000913l,1861245,1861544,299,EVM,mRNA,26739,4295696,299,1.00
ptg000913l,5696887,5697184,297,EVM,mRNA,5003946,6326402,297,1.00
ptg000914l,1709835,1710112,277,EVM,mRNA,509136,1982677,277,1.00
ptg000914l,3295065,3295363,298,EVM,mRNA,3105595,4078648,298,1.00
ptg000914l,3532077,3532376,299,EVM,mRNA,3105595,4078648,299,1.00
ptg000914l,3684004,3684305,301,EVM,mRNA,3105595,4078648,301,1.00
ptg000914l,3870709,3870989,280,EVM,mRNA,3105595,4078648,280,1.00
ptg000914l,7617765,7618078,313,EVM,mRNA,6884159,8872864,313,1.00
ptg000914l,7749476,7749755,279,EVM,mRNA,6884159,8872864,279,1.00
ptg000915l,5763372,5763665,293,EVM,mRNA,4071893,6861808,293,1.00
ptg000919l,1257100,1257428,328,EVM,mRNA,266740,1775807,328,1.00
ptg000920l,954024,954339,315,EVM,mRNA,403917,3270645,315,1.00
ptg000920l,961414,961725,311,EVM,mRNA,403917,3270645,311,1.00
ptg000920l,2243090,2243375,285,EVM,mRNA,403917,3270645,285,1.00
ptg000920l,2389432,2389727,295,EVM,mRNA,403917,3270645,295,1.00
ptg000920l,2979374,2979675,301,EVM,mRNA,403917,3270645,301,1.00
ptg000920l,3090969,3091273,304,EVM,mRNA,403917,3270645,304,1.00
ptg000925l,2440346,2440645,299,EVM,mRNA,1878479,2930936,299,1.00
ptg000928l,2470682,2470998,316,EVM,mRNA,2219671,2887431,316,1.00
ptg000929l,236289,236594,305,EVM,mRNA,116769,3420457,305,1.00
ptg000929l,440608,440884,276,EVM,mRNA,116769,3420457,276,1.00
ptg000929l,814013,814343,330,EVM,mRNA,116769,3420457,330,1.00
ptg000929l,912574,912854,280,EVM,mRNA,116769,3420457,280,1.00
ptg000929l,2018925,2019236,311,EVM,mRNA,116769,3420457,311,1.00
ptg000929l,2545698,2545993,295,EVM,mRNA,116769,3420457,295,1.00
ptg000929l,3211555,3211836,281,EVM,mRNA,116769,3420457,281,1.00
ptg000931l,529624,529912,288,EVM,mRNA,359066,773156,288,1.00
ptg000934l,656437,656736,299,EVM,mRNA,210561,1051432,299,1.00
ptg000934l,696769,697082,313,EVM,mRNA,210561,1051432,313,1.00
ptg000936l,256747,257086,339,EVM,mRNA,396,312983,339,1.00
ptg000937l,723535,723852,317,EVM,mRNA,17163,2315760,317,1.00
ptg000937l,3948665,3948988,323,EVM,mRNA,3938212,6233015,323,1.00
ptg000937l,4162394,4162707,313,EVM,mRNA,3938212,6233015,313,1.00
ptg000937l,5262045,5262353,308,EVM,mRNA,3938212,6233015,308,1.00
ptg000937l,5319492,5319815,323,EVM,mRNA,3938212,6233015,323,1.00
ptg000937l,5372807,5373091,284,EVM,mRNA,3938212,6233015,284,1.00
ptg000937l,5547354,5547657,303,EVM,mRNA,3938212,6233015,303,1.00
ptg000940l,719065,719359,294,EVM,mRNA,322732,4270554,294,1.00
ptg000940l,730873,731167,294,EVM,mRNA,322732,4270554,294,1.00
ptg000940l,863005,863311,306,EVM,mRNA,322732,4270554,306,1.00
ptg000940l,2902568,2902889,321,EVM,mRNA,322732,4270554,321,1.00
ptg000940l,3179451,3179745,294,EVM,mRNA,322732,4270554,294,1.00
ptg000940l,3562965,3563284,319,EVM,mRNA,322732,4270554,319,1.00
ptg000940l,4060197,4060493,296,EVM,mRNA,322732,4270554,296,1.00
ptg000940l,4183048,4183349,301,EVM,mRNA,322732,4270554,301,1.00
ptg000943l,76283,76612,329,EVM,mRNA,21369,438799,329,1.00
ptg000943l,508836,509116,280,EVM,mRNA,485991,1284551,280,1.00
ptg000943l,590404,590717,313,EVM,mRNA,485991,1284551,313,1.00
ptg000943l,1119169,1119487,318,EVM,mRNA,485991,1284551,318,1.00
ptg000948l,982296,982591,295,EVM,mRNA,651181,1698542,295,1.00
ptg000948l,1065308,1065619,311,EVM,mRNA,651181,1698542,311,1.00
ptg000948l,1513455,1513766,311,EVM,mRNA,651181,1698542,311,1.00
ptg000952l,1910924,1911250,326,EVM,mRNA,14952,2495819,326,1.00
ptg000953l,884237,884498,261,EVM,mRNA,297954,1197896,261,1.00
ptg000954l,959519,959831,312,EVM,mRNA,491653,1055369,312,1.00
ptg000956l,427651,427963,312,EVM,mRNA,170778,1682114,312,1.00
ptg000956l,687143,687481,338,EVM,mRNA,170778,1682114,338,1.00
ptg000956l,783619,783876,257,EVM,mRNA,170778,1682114,257,1.00
ptg000956l,1060487,1060811,324,EVM,mRNA,170778,1682114,324,1.00
ptg000956l,2028660,2028960,300,EVM,mRNA,1805615,2444350,300,1.00
ptg000956l,2416426,2416701,275,EVM,mRNA,1805615,2444350,275,1.00
ptg000956l,4295787,4296103,316,EVM,mRNA,2901194,4305923,316,1.00
ptg000956l,4303482,4303771,289,EVM,mRNA,2901194,4305923,289,1.00
ptg000957l,328310,328623,313,EVM,mRNA,125640,358743,313,1.00
ptg000957l,934186,934509,323,EVM,mRNA,403461,2032900,323,1.00
ptg000957l,1684905,1685206,301,EVM,mRNA,403461,2032900,301,1.00
ptg000957l,1835034,1835340,306,EVM,mRNA,403461,2032900,306,1.00
ptg000957l,7987399,7987696,297,EVM,mRNA,7937669,8122542,297,1.00
ptg000957l,8068920,8069210,290,EVM,mRNA,7937669,8122542,290,1.00
ptg000960l,282893,283179,286,EVM,mRNA,108300,710396,286,1.00
ptg000961l,1169145,1169411,266,EVM,mRNA,710548,1536199,266,1.00
ptg000965l,602004,602331,327,EVM,mRNA,333775,1376349,327,1.00
ptg000965l,961393,961669,276,EVM,mRNA,333775,1376349,276,1.00
ptg000965l,4565999,4566293,294,EVM,mRNA,3876170,5275041,294,1.00
ptg000966l,3009972,3010251,279,EVM,mRNA,2411352,4248591,279,1.00
ptg000966l,3926843,3927116,273,EVM,mRNA,2411352,4248591,273,1.00
ptg000967l,1580863,1581141,278,EVM,mRNA,1508033,2040224,278,1.00
ptg000967l,1789558,1789874,316,EVM,mRNA,1508033,2040224,316,1.00
ptg000967l,2640151,2640472,321,EVM,mRNA,2226464,3020504,321,1.00
ptg000967l,3353390,3353680,290,EVM,mRNA,3325101,3407663,290,1.00
ptg000967l,3986319,3986633,314,EVM,mRNA,3886095,4293740,314,1.00
ptg000967l,4171769,4172103,334,EVM,mRNA,3886095,4293740,334,1.00
ptg000968l,417452,417747,295,EVM,mRNA,84108,1735451,295,1.00
ptg000968l,525122,525411,289,EVM,mRNA,84108,1735451,289,1.00
ptg000968l,1059097,1059365,268,EVM,mRNA,84108,1735451,268,1.00
ptg000971l,1593246,1593545,299,EVM,mRNA,1582102,1933100,299,1.00
ptg000971l,1608952,1609250,298,EVM,mRNA,1582102,1933100,298,1.00
ptg000972l,240131,240447,316,EVM,mRNA,263,858240,316,1.00
ptg000973l,321876,322179,303,EVM,mRNA,314121,1005473,303,1.00
ptg000973l,940968,941269,301,EVM,mRNA,314121,1005473,301,1.00
ptg000974l,972025,972347,322,EVM,mRNA,219511,972501,322,1.00
ptg000975l,1427663,1427967,304,EVM,mRNA,576208,6393580,304,1.00
ptg000975l,1850874,1851207,333,EVM,mRNA,576208,6393580,333,1.00
ptg000975l,1947175,1947487,312,EVM,mRNA,576208,6393580,312,1.00
ptg000975l,4681247,4681556,309,EVM,mRNA,576208,6393580,309,1.00
ptg000975l,4718290,4718606,316,EVM,mRNA,576208,6393580,316,1.00
ptg000975l,4728051,4728348,297,EVM,mRNA,576208,6393580,297,1.00
ptg000975l,6201305,6201637,332,EVM,mRNA,576208,6393580,332,1.00
ptg000975l,6224142,6224423,281,EVM,mRNA,576208,6393580,281,1.00
ptg000975l,6312666,6312912,246,EVM,mRNA,576208,6393580,246,1.00
ptg000976l,2440321,2440591,270,EVM,mRNA,2379576,2763690,270,1.00
ptg000977l,35902,36158,256,EVM,mRNA,10765,38963,256,1.00
ptg000977l,3235791,3236090,299,EVM,mRNA,2594306,3913107,299,1.00
ptg000977l,3484826,3485133,307,EVM,mRNA,2594306,3913107,307,1.00
ptg000977l,3761745,3762074,329,EVM,mRNA,2594306,3913107,329,1.00
ptg000979l,2072237,2072563,326,EVM,mRNA,2050704,2451737,326,1.00
ptg000979l,2939220,2939497,277,EVM,mRNA,2578199,3296481,277,1.00
ptg000980l,1477089,1477402,313,EVM,mRNA,1182390,2596107,313,1.00
ptg000980l,1658861,1659151,290,EVM,mRNA,1182390,2596107,290,1.00
ptg000980l,1796598,1796886,288,EVM,mRNA,1182390,2596107,288,1.00
ptg000981l,961196,961489,293,EVM,mRNA,478442,1476168,293,1.00
ptg000981l,1357177,1357464,287,EVM,mRNA,478442,1476168,287,1.00
ptg000983l,2138088,2138382,294,EVM,mRNA,2005932,2215320,294,1.00
ptg000983l,2824626,2824934,308,EVM,mRNA,2364418,2840052,308,1.00
ptg000984l,4872434,4872754,320,EVM,mRNA,2261725,5120259,320,1.00
ptg000985l,512121,512429,308,EVM,mRNA,382973,980184,308,1.00
ptg000986l,856900,857183,283,EVM,mRNA,654650,859443,283,1.00
ptg000988l,767550,767838,288,EVM,mRNA,651053,1522903,288,1.00
ptg000988l,1148352,1148660,308,EVM,mRNA,651053,1522903,308,1.00
ptg000991l,508592,508918,326,EVM,mRNA,303788,928349,326,1.00
ptg000991l,637577,637884,307,EVM,mRNA,303788,928349,307,1.00
ptg000995l,653671,653985,314,EVM,mRNA,407689,978712,314,1.00
ptg000995l,830424,830708,284,EVM,mRNA,407689,978712,284,1.00
ptg000996l,1123987,1124280,293,EVM,mRNA,1086940,1421209,293,1.00
ptg000996l,1556438,1556738,300,EVM,mRNA,1429292,2854042,300,1.00
ptg000996l,3213704,3214001,297,EVM,mRNA,3021394,3410423,297,1.00
ptg000996l,3914561,3914851,290,EVM,mRNA,3774335,3993960,290,1.00
ptg000999l,2215989,2216265,276,EVM,mRNA,1389580,2374708,276,1.00
ptg001001l,652636,652947,311,EVM,mRNA,571124,660291,311,1.00
ptg001001l,898846,899160,314,EVM,mRNA,720081,2555342,314,1.00
ptg001001l,1034888,1035157,269,EVM,mRNA,720081,2555342,269,1.00
ptg001001l,1462355,1462650,295,EVM,mRNA,720081,2555342,295,1.00
ptg001001l,1928624,1928923,299,EVM,mRNA,720081,2555342,299,1.00
ptg001001l,1995477,1995780,303,EVM,mRNA,720081,2555342,303,1.00
ptg001001l,3512580,3512866,286,EVM,mRNA,3124244,3577456,286,1.00
ptg001002l,3355485,3355797,312,EVM,mRNA,3239329,3380824,312,1.00
ptg001002l,3729465,3729769,304,EVM,mRNA,3569092,4155731,304,1.00
ptg001006l,200531,200816,285,EVM,mRNA,198037,1397017,285,1.00
ptg001006l,505411,505731,320,EVM,mRNA,198037,1397017,320,1.00
ptg001006l,798952,799273,321,EVM,mRNA,198037,1397017,321,1.00
ptg001006l,1098311,1098602,291,EVM,mRNA,198037,1397017,291,1.00
ptg001008l,335039,335329,290,EVM,mRNA,126114,1189363,290,1.00
ptg001010l,501530,501852,322,EVM,mRNA,281651,925480,322,1.00
ptg001010l,2879454,2879767,313,EVM,mRNA,2566980,3342764,313,1.00
ptg001010l,4126669,4126952,283,EVM,mRNA,3623044,4949863,283,1.00
ptg001010l,5988961,5989265,304,EVM,mRNA,5154506,6540018,304,1.00
ptg001012l,359333,359646,313,EVM,mRNA,6969,1261169,313,1.00
ptg001012l,359333,359646,313,GeneWise,mRNA,57636,1261166,313,1.00
ptg001013l,555380,555695,315,EVM,mRNA,495555,564372,315,1.00
ptg001015l,447351,447633,282,EVM,mRNA,278584,514576,282,1.00
ptg001016l,1244837,1245160,323,EVM,mRNA,1124364,1262985,323,1.00
ptg001017l,714916,715211,295,EVM,mRNA,393970,1406842,295,1.00
ptg001018l,83070,83384,314,EVM,mRNA,14966,1311171,314,1.00
ptg001018l,838303,838587,284,EVM,mRNA,14966,1311171,284,1.00
ptg001018l,6106403,6106695,292,EVM,mRNA,5845868,6220433,292,1.00
ptg001019l,456596,456895,299,EVM,mRNA,221075,2374398,299,1.00
ptg001019l,554831,555115,284,EVM,mRNA,221075,2374398,284,1.00
ptg001019l,896815,897090,275,EVM,mRNA,221075,2374398,275,1.00
ptg001019l,1471709,1471994,285,EVM,mRNA,221075,2374398,285,1.00
ptg001019l,1515815,1516110,295,EVM,mRNA,221075,2374398,295,1.00
ptg001019l,1525657,1525935,278,EVM,mRNA,221075,2374398,278,1.00
ptg001019l,1898688,1898987,299,EVM,mRNA,221075,2374398,299,1.00
ptg001019l,2089436,2089735,299,EVM,mRNA,221075,2374398,299,1.00
ptg001020l,1268478,1268789,311,EVM,mRNA,364728,1447763,311,1.00
ptg001022l,360844,361131,287,EVM,mRNA,43846,437155,287,1.00
ptg001022l,1093958,1094240,282,EVM,mRNA,951261,1257083,282,1.00
ptg001026l,962001,962291,290,EVM,mRNA,877696,1255952,290,1.00
ptg001027l,862482,862780,298,EVM,mRNA,132164,2854759,298,1.00
ptg001027l,1167368,1167646,278,EVM,mRNA,132164,2854759,278,1.00
ptg001027l,1939694,1939970,276,EVM,mRNA,132164,2854759,276,1.00
ptg001028l,650226,650529,303,EVM,mRNA,10143,959225,303,1.00
ptg001028l,655053,655359,306,EVM,mRNA,10143,959225,306,1.00
ptg001030l,1054222,1054521,299,EVM,mRNA,1003901,1506125,299,1.00
ptg001030l,2492581,2492895,314,EVM,mRNA,2437023,2988956,314,1.00
ptg001030l,2585838,2586142,304,EVM,mRNA,2437023,2988956,304,1.00
ptg001031l,3055862,3056148,286,EVM,mRNA,3028583,3311211,286,1.00
ptg001033l,272430,272756,326,EVM,mRNA,37050,491467,326,1.00
ptg001033l,1769641,1769919,278,EVM,mRNA,709120,2083243,278,1.00
ptg001033l,2208022,2208344,322,EVM,mRNA,2170823,3206357,322,1.00
ptg001038l,792454,792733,279,EVM,mRNA,471439,1581627,279,1.00
ptg001039l,1198768,1199089,321,EVM,mRNA,690898,3074344,321,1.00
ptg001039l,2042427,2042723,296,EVM,mRNA,690898,3074344,296,1.00
ptg001039l,2095110,2095441,331,EVM,mRNA,690898,3074344,331,1.00
ptg001039l,2721754,2722059,305,EVM,mRNA,690898,3074344,305,1.00
ptg001040l,1916894,1917208,314,EVM,mRNA,713854,3879598,314,1.00
ptg001040l,2256675,2256953,278,EVM,mRNA,713854,3879598,278,1.00
ptg001040l,3271763,3272084,321,EVM,mRNA,713854,3879598,321,1.00
ptg001040l,3675917,3676215,298,EVM,mRNA,713854,3879598,298,1.00
ptg001041l,1394512,1394775,263,EVM,mRNA,671556,1992960,263,1.00
ptg001041l,1396936,1397254,318,EVM,mRNA,671556,1992960,318,1.00
ptg001041l,1902916,1903186,270,EVM,mRNA,671556,1992960,270,1.00
ptg001041l,2544190,2544502,312,EVM,mRNA,2302389,3748892,312,1.00
ptg001041l,3371833,3372132,299,EVM,mRNA,2302389,3748892,299,1.00
ptg001041l,3436034,3436342,308,EVM,mRNA,2302389,3748892,308,1.00
ptg001044l,2691442,2691722,280,EVM,mRNA,1801095,3286622,280,1.00
ptg001048l,989684,989946,262,EVM,mRNA,867512,1072734,262,1.00
ptg001051l,998117,998430,313,EVM,mRNA,44467,1312731,313,1.00
ptg001053l,618003,618302,299,EVM,mRNA,3219,1492538,299,1.00
ptg001056l,519223,519542,319,EVM,mRNA,198238,2395018,319,1.00
ptg001056l,1434865,1435177,312,EVM,mRNA,198238,2395018,312,1.00
ptg001058l,1857149,1857447,298,EVM,mRNA,1827290,1900031,298,1.00
ptg001059l,5750283,5750552,269,EVM,mRNA,5474692,5909170,269,1.00
ptg001064l,246681,247008,327,EVM,mRNA,60257,716859,327,1.00
ptg001064l,347013,347305,292,EVM,mRNA,60257,716859,292,1.00
ptg001064l,443054,443334,280,EVM,mRNA,60257,716859,280,1.00
ptg001064l,475024,475347,323,EVM,mRNA,60257,716859,323,1.00
ptg001064l,571926,572239,313,EVM,mRNA,60257,716859,313,1.00
ptg001067l,550254,550572,318,EVM,mRNA,3764,602633,318,1.00
ptg001068l,102700,103022,322,EVM,mRNA,1358,177801,322,1.00
ptg001068l,3437956,3438251,295,EVM,mRNA,2877101,3594120,295,1.00
ptg001068l,3542367,3542667,300,EVM,mRNA,2877101,3594120,300,1.00
ptg001076l,2171559,2171858,299,EVM,mRNA,1337240,2402621,299,1.00
ptg001077l,2039584,2039918,334,EVM,mRNA,487150,4403881,334,1.00
ptg001077l,4193440,4193757,317,EVM,mRNA,487150,4403881,317,1.00
ptg001077l,5243300,5243634,334,EVM,mRNA,4907988,5874644,334,1.00
ptg001077l,5799262,5799549,287,EVM,mRNA,4907988,5874644,287,1.00
ptg001077l,5874262,5874561,299,EVM,mRNA,4907988,5874644,299,1.00
ptg001082l,964908,965199,291,EVM,mRNA,45293,1624191,291,1.00
ptg001082l,1508855,1509149,294,EVM,mRNA,45293,1624191,294,1.00
ptg001082l,1589517,1589845,328,EVM,mRNA,45293,1624191,328,1.00
ptg001083l,302921,303222,301,EVM,mRNA,34737,406636,301,1.00
ptg001084l,1360812,1361107,295,EVM,mRNA,944214,1405501,295,1.00
ptg001086l,2798821,2799095,274,EVM,mRNA,2767336,4979337,274,1.00
ptg001086l,2870312,2870600,288,EVM,mRNA,2767336,4979337,288,1.00
ptg001086l,3464266,3464547,281,EVM,mRNA,2767336,4979337,281,1.00
ptg001086l,4458492,4458793,301,EVM,mRNA,2767336,4979337,301,1.00
ptg001089l,171265,171533,268,EVM,mRNA,86566,196568,268,1.00
ptg001092l,1157159,1157460,301,EVM,mRNA,1065831,1234491,301,1.00
ptg001093l,1944642,1944941,299,EVM,mRNA,1928377,2045070,299,1.00
ptg001093l,4999979,5000274,295,EVM,mRNA,4950167,5111193,295,1.00
ptg001094l,441952,442265,313,EVM,mRNA,72270,1045114,313,1.00
ptg001094l,840630,840918,288,EVM,mRNA,72270,1045114,288,1.00
ptg001094l,3084601,3084907,306,EVM,mRNA,2510185,4700598,306,1.00
ptg001094l,3861067,3861351,284,EVM,mRNA,2510185,4700598,284,1.00
ptg001094l,4943922,4944221,299,EVM,mRNA,4943677,5175984,299,1.00
ptg001094l,5003990,5004276,286,EVM,mRNA,4943677,5175984,286,1.00
ptg001095l,616436,616737,301,EVM,mRNA,495089,1939544,301,1.00
ptg001095l,1000236,1000520,284,EVM,mRNA,495089,1939544,284,1.00
ptg001095l,1763833,1764158,325,EVM,mRNA,495089,1939544,325,1.00
ptg001095l,1829485,1829784,299,EVM,mRNA,495089,1939544,299,1.00
ptg001096l,481051,481374,323,EVM,mRNA,423743,962897,323,1.00
ptg001099l,464886,465166,280,EVM,mRNA,135942,761999,280,1.00
ptg001099l,648688,649004,316,EVM,mRNA,135942,761999,316,1.00
ptg001101l,618938,619254,316,EVM,mRNA,396938,755515,316,1.00
ptg001101l,657960,658250,290,EVM,mRNA,396938,755515,290,1.00
ptg001102l,796246,796574,328,EVM,mRNA,186,1804930,328,1.00
ptg001102l,2500371,2500664,293,EVM,mRNA,1985903,5102250,293,1.00
ptg001102l,2558095,2558388,293,EVM,mRNA,1985903,5102250,293,1.00
ptg001102l,2599690,2600001,311,EVM,mRNA,1985903,5102250,311,1.00
ptg001102l,3076549,3076844,295,EVM,mRNA,1985903,5102250,295,1.00
ptg001102l,3123973,3124269,296,EVM,mRNA,1985903,5102250,296,1.00
ptg001102l,3548400,3548697,297,EVM,mRNA,1985903,5102250,297,1.00
ptg001102l,4214005,4214302,297,EVM,mRNA,1985903,5102250,297,1.00
ptg001103l,1822685,1822982,297,EVM,mRNA,1643,2935506,297,1.00
ptg001105l,69269,69566,297,EVM,mRNA,1440,388213,297,1.00
ptg001106l,1334613,1334922,309,EVM,mRNA,292537,1964883,309,1.00
ptg001106l,1669175,1669467,292,EVM,mRNA,292537,1964883,292,1.00
ptg001106l,1963115,1963420,305,EVM,mRNA,292537,1964883,305,1.00
ptg001106l,5470893,5471204,311,EVM,mRNA,3954239,6087284,311,1.00
ptg001106l,5903719,5903987,268,EVM,mRNA,3954239,6087284,268,1.00
ptg001114l,305942,306257,315,EVM,mRNA,209166,414444,315,1.00
ptg001114l,388446,388763,317,EVM,mRNA,209166,414444,317,1.00
ptg001114l,746754,747050,296,EVM,mRNA,666323,1033211,296,1.00
ptg001118l,536056,536346,290,EVM,mRNA,24429,761963,290,1.00
ptg001118l,1946012,1946292,280,EVM,mRNA,1676517,2004260,280,1.00
ptg001118l,1953220,1953500,280,EVM,mRNA,1676517,2004260,280,1.00
ptg001119l,713016,713306,290,EVM,mRNA,557332,1026065,290,1.00
ptg001119l,1601334,1601645,311,EVM,mRNA,1068092,1937164,311,1.00
ptg001119l,1827463,1827785,322,EVM,mRNA,1068092,1937164,322,1.00
ptg001122l,1306877,1307166,289,EVM,mRNA,1049157,1908183,289,1.00
ptg001122l,1830816,1831100,284,EVM,mRNA,1049157,1908183,284,1.00
ptg001122l,3283998,3284305,307,EVM,mRNA,2933652,3603272,307,1.00
ptg001122l,3809204,3809481,277,EVM,mRNA,3677754,4042797,277,1.00
ptg001122l,5601941,5602258,317,EVM,mRNA,5308473,6018812,317,1.00
ptg001122l,5790161,5790479,318,EVM,mRNA,5308473,6018812,318,1.00
ptg001122l,6214818,6215112,294,EVM,mRNA,6173137,6252722,294,1.00
ptg001124l,453804,454113,309,EVM,mRNA,326742,465548,309,1.00
ptg001124l,458173,458502,329,EVM,mRNA,326742,465548,329,1.00
ptg001131l,765130,765439,309,EVM,mRNA,927,5262458,309,1.00
ptg001131l,1109613,1109880,267,EVM,mRNA,927,5262458,267,1.00
ptg001131l,1725219,1725535,316,EVM,mRNA,927,5262458,316,1.00
ptg001131l,2051364,2051649,285,EVM,mRNA,927,5262458,285,1.00
ptg001131l,2682361,2682664,303,EVM,mRNA,927,5262458,303,1.00
ptg001131l,3692428,3692725,297,EVM,mRNA,927,5262458,297,1.00
ptg001131l,4701507,4701838,331,EVM,mRNA,927,5262458,331,1.00
ptg001131l,5033433,5033703,270,EVM,mRNA,927,5262458,270,1.00
ptg001132l,68326,68624,298,EVM,mRNA,17155,154104,298,1.00
ptg001132l,4929315,4929657,342,EVM,mRNA,4817014,5353622,342,1.00
ptg001132l,5237021,5237343,322,EVM,mRNA,4817014,5353622,322,1.00
ptg001137l,224024,224312,288,EVM,mRNA,896,1381923,288,1.00
ptg001137l,879507,879820,313,EVM,mRNA,896,1381923,313,1.00
ptg001138l,1498666,1498975,309,EVM,mRNA,1456717,2361126,309,1.00
ptg001138l,1508426,1508710,284,EVM,mRNA,1456717,2361126,284,1.00
ptg001138l,2107700,2107979,279,EVM,mRNA,1456717,2361126,279,1.00
ptg001138l,2342542,2342814,272,EVM,mRNA,1456717,2361126,272,1.00
ptg001142l,279522,279835,313,EVM,mRNA,88670,440787,313,1.00
ptg001142l,322309,322621,312,EVM,mRNA,88670,440787,312,1.00
ptg001143l,621992,622289,297,EVM,mRNA,395249,1317135,297,1.00
ptg001143l,752975,753304,329,EVM,mRNA,395249,1317135,329,1.00
ptg001147l,1131588,1131913,325,EVM,mRNA,1008671,1133009,325,1.00
ptg001154l,74149,74419,270,EVM,mRNA,32293,1413965,270,1.00
ptg001155l,52774,53060,286,EVM,mRNA,15608,1053008,286,1.00
ptg001155l,174562,174863,301,EVM,mRNA,15608,1053008,301,1.00
ptg001155l,529998,530283,285,EVM,mRNA,15608,1053008,285,1.00
ptg001156l,287503,287779,276,EVM,mRNA,95085,411885,276,1.00
ptg001159l,840390,840689,299,EVM,mRNA,721991,1156360,299,1.00
ptg001160l,326807,327078,271,EVM,mRNA,275859,345307,271,1.00
ptg001161l,1051593,1051881,288,EVM,mRNA,908755,1201437,288,1.00
ptg001161l,3376724,3377011,287,EVM,mRNA,3138162,4579000,287,1.00
ptg001161l,3621430,3621706,276,EVM,mRNA,3138162,4579000,276,1.00
ptg001161l,4367864,4368177,313,EVM,mRNA,3138162,4579000,313,1.00
ptg001162l,1372941,1373220,279,EVM,mRNA,892134,5990883,279,1.00
ptg001162l,2057908,2058199,291,EVM,mRNA,892134,5990883,291,1.00
ptg001162l,2498133,2498435,302,EVM,mRNA,892134,5990883,302,1.00
ptg001162l,3625585,3625899,314,EVM,mRNA,892134,5990883,314,1.00
ptg001162l,4237213,4237533,320,EVM,mRNA,892134,5990883,320,1.00
ptg001162l,4787239,4787565,326,EVM,mRNA,892134,5990883,326,1.00
ptg001162l,5620216,5620531,315,EVM,mRNA,892134,5990883,315,1.00
ptg001166l,228401,228696,295,EVM,mRNA,154052,289303,295,1.00
ptg001166l,657238,657533,295,EVM,mRNA,489733,1939347,295,1.00
ptg001166l,3208557,3208886,329,EVM,mRNA,3115458,3281706,329,1.00
ptg001167l,541892,542191,299,EVM,mRNA,64305,778611,299,1.00
ptg001171l,782644,782904,260,EVM,mRNA,732162,1633462,260,1.00
ptg001171l,1051672,1051989,317,EVM,mRNA,732162,1633462,317,1.00
ptg001171l,1579616,1579917,301,EVM,mRNA,732162,1633462,301,1.00
ptg001171l,1583245,1583528,283,EVM,mRNA,732162,1633462,283,1.00
ptg001172l,500680,501005,325,EVM,mRNA,1622,1530403,325,1.00
ptg001173l,41850,42171,321,EVM,mRNA,2711,185324,321,1.00
ptg001175l,2272029,2272324,295,EVM,mRNA,1879651,2655200,295,1.00
ptg001175l,2327637,2327967,330,EVM,mRNA,1879651,2655200,330,1.00
ptg001175l,3851193,3851476,283,EVM,mRNA,3452053,4143803,283,1.00
ptg001177l,401016,401304,288,EVM,mRNA,378387,597788,288,1.00
ptg001177l,458570,458874,304,EVM,mRNA,378387,597788,304,1.00
ptg001177l,483887,484201,314,EVM,mRNA,378387,597788,314,1.00
ptg001177l,1567811,1568103,292,EVM,mRNA,1391292,2241721,292,1.00
ptg001185l,1262968,1263269,301,EVM,mRNA,496389,1997437,301,1.00
ptg001185l,1718493,1718787,294,EVM,mRNA,496389,1997437,294,1.00
ptg001192l,1847270,1847590,320,EVM,mRNA,789264,2270019,320,1.00
ptg001193l,202916,203205,289,EVM,mRNA,67372,248370,289,1.00
ptg001193l,3032884,3033178,294,EVM,mRNA,3028522,4953267,294,1.00
ptg001193l,3790887,3791206,319,EVM,mRNA,3028522,4953267,319,1.00
ptg001193l,4226673,4226979,306,EVM,mRNA,3028522,4953267,306,1.00
ptg001194l,1925611,1925935,324,EVM,mRNA,785383,2582248,324,1.00
ptg001196l,269827,270104,277,EVM,mRNA,183895,450979,277,1.00
ptg001196l,747873,748182,309,EVM,mRNA,607183,762691,309,1.00
ptg001204l,957986,958295,309,EVM,mRNA,884818,1671015,309,1.00
ptg001204l,1433320,1433600,280,EVM,mRNA,884818,1671015,280,1.00
ptg001208l,488797,489075,278,EVM,mRNA,113163,736263,278,1.00
ptg001208l,496673,496954,281,EVM,mRNA,113163,736263,281,1.00
ptg001208l,1325124,1325438,314,EVM,mRNA,1079145,2117114,314,1.00
ptg001208l,1455391,1455657,266,EVM,mRNA,1079145,2117114,266,1.00
ptg001208l,2273650,2273921,271,EVM,mRNA,2155445,2382811,271,1.00
ptg001208l,2881250,2881535,285,EVM,mRNA,2655534,2957062,285,1.00
ptg001208l,4911415,4911688,273,EVM,mRNA,4812054,5146981,273,1.00
ptg001208l,4938169,4938491,322,EVM,mRNA,4812054,5146981,322,1.00
ptg001208l,6136200,6136478,278,EVM,mRNA,5554155,6634680,278,1.00
ptg001208l,6287649,6287984,335,EVM,mRNA,5554155,6634680,335,1.00
ptg001208l,6325377,6325696,319,EVM,mRNA,5554155,6634680,319,1.00
ptg001208l,6598713,6599016,303,EVM,mRNA,5554155,6634680,303,1.00
ptg001209l,157441,157741,300,EVM,mRNA,154098,163463,300,1.00
ptg001212l,312911,313195,284,EVM,mRNA,232563,1070857,284,1.00
ptg001215l,2878616,2878944,328,EVM,mRNA,2084783,2946836,328,1.00
ptg001215l,4321798,4322079,281,EVM,mRNA,3588987,4611477,281,1.00
ptg001215l,4632445,4632738,293,EVM,mRNA,4617927,4916804,293,1.00
ptg001215l,9059980,9060262,282,EVM,mRNA,8968156,9088312,282,1.00
ptg001218l,1434662,1434984,322,EVM,mRNA,1401197,1964717,322,1.00
ptg001218l,1728882,1729166,284,EVM,mRNA,1401197,1964717,284,1.00
ptg001218l,4885762,4886061,299,EVM,mRNA,4763928,5028972,299,1.00
ptg001221l,300863,301139,276,EVM,mRNA,51662,562887,276,1.00
ptg001221l,481344,481643,299,EVM,mRNA,51662,562887,299,1.00
ptg001223l,926258,926579,321,EVM,mRNA,814896,1736625,321,1.00
ptg001223l,4845226,4845529,303,EVM,mRNA,4365075,4912601,303,1.00
ptg001226l,716108,716396,288,EVM,mRNA,682957,783533,288,1.00
ptg001229l,718388,718687,299,EVM,mRNA,483782,1077292,299,1.00
ptg001232l,1749676,1749969,293,EVM,mRNA,1276043,1774050,293,1.00
ptg001234l,2181338,2181617,279,EVM,mRNA,2061512,2390557,279,1.00
ptg001234l,4295527,4295812,285,EVM,mRNA,2863768,6223002,285,1.00
ptg001234l,4295527,4295818,291,EVM,mRNA,2863768,6223002,291,1.00
ptg001234l,4942886,4943200,314,EVM,mRNA,2863768,6223002,314,1.00
ptg001235l,686501,686822,321,EVM,mRNA,540480,899512,321,1.00
ptg001235l,705485,705808,323,EVM,mRNA,540480,899512,323,1.00
ptg001235l,816175,816481,306,EVM,mRNA,540480,899512,306,1.00
ptg001238l,1208350,1208649,299,EVM,mRNA,1009220,2101986,299,1.00
ptg001238l,2024225,2024542,317,EVM,mRNA,1009220,2101986,317,1.00
ptg001240l,707810,708092,282,EVM,mRNA,220863,2440696,282,1.00
ptg001241l,1078506,1078770,264,EVM,mRNA,998862,1392295,264,1.00
ptg001243l,261276,261559,283,EVM,mRNA,46682,1636348,283,1.00
ptg001243l,1063474,1063776,302,EVM,mRNA,46682,1636348,302,1.00
ptg001243l,1279866,1280168,302,EVM,mRNA,46682,1636348,302,1.00
ptg001243l,1634786,1635106,320,EVM,mRNA,46682,1636348,320,1.00
ptg001244l,1063776,1064022,246,EVM,mRNA,116629,1173578,246,1.00
ptg001246l,604974,605262,288,EVM,mRNA,447286,1739074,288,1.00
ptg001246l,1707104,1707410,306,EVM,mRNA,447286,1739074,306,1.00
ptg001247l,1350000,1350282,282,EVM,mRNA,1139674,1611242,282,1.00
ptg001248l,4473286,4473576,290,EVM,mRNA,4398817,4474102,290,1.00
ptg001248l,5527192,5527506,314,EVM,mRNA,5213405,5898052,314,1.00
ptg001248l,5837223,5837522,299,EVM,mRNA,5213405,5898052,299,1.00
ptg001248l,7914823,7915103,280,EVM,mRNA,5946088,8223348,280,1.00
ptg001251l,683884,684168,284,EVM,mRNA,608277,1225474,284,1.00
ptg001251l,1011884,1012176,292,EVM,mRNA,608277,1225474,292,1.00
ptg001254l,316598,316860,262,EVM,mRNA,260828,1194495,262,1.00
ptg001254l,875261,875540,279,EVM,mRNA,260828,1194495,279,1.00
ptg001254l,971881,972170,289,EVM,mRNA,260828,1194495,289,1.00
ptg001256l,179684,179964,280,EVM,mRNA,33970,224408,280,1.00
ptg001256l,1286907,1287235,328,EVM,mRNA,1206561,1700823,328,1.00
ptg001260l,1340281,1340556,275,EVM,mRNA,370919,2150472,275,1.00
ptg001261l,1421467,1421758,291,EVM,mRNA,970521,2395643,291,1.00
ptg001262l,807754,808061,307,EVM,mRNA,658149,1175082,307,1.00
ptg001262l,1583516,1583821,305,EVM,mRNA,1243422,2133665,305,1.00
ptg001262l,1883117,1883413,296,EVM,mRNA,1243422,2133665,296,1.00
ptg001262l,3521729,3522047,318,EVM,mRNA,2136774,3966873,318,1.00
ptg001262l,4834192,4834487,295,EVM,mRNA,4732461,5158824,295,1.00
ptg001264l,781229,781502,273,EVM,mRNA,4767,1793573,273,1.00
ptg001269l,1240487,1240756,269,EVM,mRNA,803109,2349310,269,1.00
ptg001269l,1351270,1351558,288,EVM,mRNA,803109,2349310,288,1.00
ptg001270l,3555502,3555784,282,EVM,mRNA,2614575,4078275,282,1.00
ptg001273l,1558845,1559155,310,EVM,mRNA,1494750,1677367,310,1.00
ptg001279l,1268173,1268504,331,EVM,mRNA,820082,1303226,331,1.00
ptg001279l,4039873,4040159,286,EVM,mRNA,4013757,4095680,286,1.00
ptg001283l,415656,415950,294,EVM,mRNA,265020,537096,294,1.00
ptg001284l,344746,345041,295,EVM,mRNA,4383,802395,295,1.00
ptg001284l,3835340,3835652,312,EVM,mRNA,3717081,4261823,312,1.00
ptg001285l,43806,44079,273,EVM,mRNA,17859,200466,273,1.00
ptg001288l,654118,654405,287,EVM,mRNA,161818,762499,287,1.00
ptg001289l,328924,329219,295,EVM,mRNA,2495,421388,295,1.00
ptg001290l,2307378,2307689,311,EVM,mRNA,2010783,2420771,311,1.00
ptg001292l,3351292,3351617,325,EVM,mRNA,3276776,3605976,325,1.00
ptg001292l,3861486,3861784,298,EVM,mRNA,3812438,4837712,298,1.00
ptg001293l,1363416,1363691,275,EVM,mRNA,1026138,2293810,275,1.00
ptg001293l,5217198,5217479,281,EVM,mRNA,4215763,5703831,281,1.00
ptg001293l,5246734,5247036,302,EVM,mRNA,4215763,5703831,302,1.00
ptg001295l,1566792,1567101,309,EVM,mRNA,1494149,1984814,309,1.00
ptg001295l,1767224,1767523,299,EVM,mRNA,1494149,1984814,299,1.00
ptg001298l,748695,748997,302,EVM,mRNA,719057,815896,302,1.00
ptg001301l,925032,925357,325,EVM,mRNA,890795,1438513,325,1.00
ptg001305l,1655177,1655478,301,EVM,mRNA,1123465,2544169,301,1.00
ptg001305l,5412079,5412371,292,EVM,mRNA,4750061,6425934,292,1.00
ptg001305l,5523006,5523317,311,EVM,mRNA,4750061,6425934,311,1.00
ptg001307l,2369590,2369856,266,EVM,mRNA,2074515,2713438,266,1.00
ptg001307l,2708264,2708587,323,EVM,mRNA,2074515,2713438,323,1.00
ptg001308l,943247,943544,297,EVM,mRNA,819895,1512019,297,1.00
ptg001308l,1288008,1288324,316,EVM,mRNA,819895,1512019,316,1.00
ptg001310l,101034,101333,299,EVM,mRNA,39605,1223209,299,1.00
ptg001310l,1609183,1609483,300,EVM,mRNA,1475070,1918746,300,1.00
ptg001310l,2702622,2702921,299,EVM,mRNA,2488024,2827039,299,1.00
ptg001310l,2761263,2761582,319,EVM,mRNA,2488024,2827039,319,1.00
ptg001313l,2290998,2291310,312,EVM,mRNA,2275349,2728893,312,1.00
ptg001313l,2694577,2694888,311,EVM,mRNA,2275349,2728893,311,1.00
ptg001314l,1369466,1369788,322,EVM,mRNA,72727,1634120,322,1.00
ptg001314l,1453879,1454160,281,EVM,mRNA,72727,1634120,281,1.00
ptg001314l,1954050,1954353,303,EVM,mRNA,1909152,2496405,303,1.00
ptg001314l,4262023,4262320,297,EVM,mRNA,2853774,4282917,297,1.00
ptg001316l,1870275,1870589,314,EVM,mRNA,1618249,2792118,314,1.00
ptg001317l,2181550,2181817,267,EVM,mRNA,2123457,2674518,267,1.00
ptg001317l,2383781,2384106,325,EVM,mRNA,2123457,2674518,325,1.00
ptg001321l,2430683,2430960,277,EVM,mRNA,2428326,2481259,277,1.00
ptg001323l,3172133,3172453,320,EVM,mRNA,3131238,3310271,320,1.00
ptg001325l,1564011,1564294,283,EVM,mRNA,1152768,2485015,283,1.00
ptg001325l,2152637,2152956,319,EVM,mRNA,1152768,2485015,319,1.00
ptg001326l,364243,364523,280,EVM,mRNA,301173,897010,280,1.00
ptg001326l,387581,387894,313,EVM,mRNA,301173,897010,313,1.00
ptg001328l,3023295,3023627,332,EVM,mRNA,2871212,3210118,332,1.00
ptg001332l,1051033,1051348,315,EVM,mRNA,600514,1281967,315,1.00
ptg001334l,1974265,1974581,316,EVM,mRNA,1682544,2964785,316,1.00
ptg001334l,2047321,2047629,308,EVM,mRNA,1682544,2964785,308,1.00
ptg001335l,694569,694894,325,EVM,mRNA,184181,1215099,325,1.00
ptg001335l,832804,833133,329,EVM,mRNA,184181,1215099,329,1.00
ptg001336l,1071140,1071464,324,EVM,mRNA,1029164,1103557,324,1.00
ptg001336l,1082198,1082488,290,EVM,mRNA,1029164,1103557,290,1.00
ptg001337l,138032,138347,315,EVM,mRNA,23595,1323546,315,1.00
ptg001339l,1648833,1649140,307,EVM,mRNA,769817,2093337,307,1.00
ptg001341l,2053712,2053999,287,EVM,mRNA,2051159,2314978,287,1.00
ptg001344l,992716,993013,297,EVM,mRNA,949886,1962955,297,1.00
ptg001344l,1896255,1896537,282,EVM,mRNA,949886,1962955,282,1.00
ptg001344l,2594696,2594982,286,EVM,mRNA,2133446,2728519,286,1.00
ptg001345l,526386,526694,308,EVM,mRNA,208566,623509,308,1.00
ptg001348l,751110,751436,326,EVM,mRNA,650064,848996,326,1.00
ptg001348l,2532581,2532881,300,EVM,mRNA,2480281,2589886,300,1.00
ptg001351l,607138,607443,305,EVM,mRNA,389295,1183920,305,1.00
ptg001351l,1548437,1548727,290,EVM,mRNA,1430333,2547151,290,1.00
ptg001351l,3108044,3108365,321,EVM,mRNA,2925407,3167230,321,1.00
ptg001353l,2103292,2103595,303,EVM,mRNA,1563892,2967616,303,1.00
ptg001354l,255580,255886,306,EVM,mRNA,184452,1867575,306,1.00
ptg001355l,823901,824197,296,EVM,mRNA,753534,857520,296,1.00
ptg001358l,2878899,2879183,284,EVM,mRNA,2392418,4856495,284,1.00
ptg001358l,3341756,3342044,288,EVM,mRNA,2392418,4856495,288,1.00
ptg001358l,3969231,3969548,317,EVM,mRNA,2392418,4856495,317,1.00
ptg001358l,6024667,6024995,328,EVM,mRNA,5430417,6226231,328,1.00
ptg001360l,472995,473276,281,EVM,mRNA,36436,817355,281,1.00
ptg001361l,1009579,1009894,315,EVM,mRNA,283676,1284663,315,1.00
ptg001363l,2131982,2132254,272,EVM,mRNA,1366972,2703414,272,1.00
ptg001364l,1486186,1486471,285,EVM,mRNA,1447615,1601029,285,1.00
ptg001369l,432566,432892,326,EVM,mRNA,87708,1482616,326,1.00
ptg001371l,1177777,1178067,290,EVM,mRNA,752368,4759327,290,1.00
ptg001371l,2648545,2648826,281,EVM,mRNA,752368,4759327,281,1.00
ptg001371l,2867444,2867732,288,EVM,mRNA,752368,4759327,288,1.00
ptg001371l,3310936,3311264,328,EVM,mRNA,752368,4759327,328,1.00
ptg001371l,3386675,3386960,285,EVM,mRNA,752368,4759327,285,1.00
ptg001371l,3974073,3974365,292,EVM,mRNA,752368,4759327,292,1.00
ptg001371l,4044610,4044933,323,EVM,mRNA,752368,4759327,323,1.00
ptg001371l,5880515,5880841,326,EVM,mRNA,5821510,5986693,326,1.00
ptg001371l,6245524,6245804,280,EVM,mRNA,6111022,6442484,280,1.00
ptg001371l,10358414,10358709,295,EVM,mRNA,9995122,10359457,295,1.00
ptg001371l,11776904,11777204,300,EVM,mRNA,11478820,11870818,300,1.00
ptg001371l,12139931,12140219,288,EVM,mRNA,11998967,12307638,288,1.00
ptg001372l,1392499,1392813,314,EVM,mRNA,1200978,2871381,314,1.00
ptg001372l,1659258,1659575,317,EVM,mRNA,1200978,2871381,317,1.00
ptg001379l,707616,707916,300,EVM,mRNA,707644,806515,273,0.91
ptg001379l,1282436,1282731,295,EVM,mRNA,1024523,1519613,295,1.00
ptg001381l,2309775,2310091,316,EVM,mRNA,1868494,2468840,316,1.00
ptg001381l,3193940,3194259,319,EVM,mRNA,2602821,3417638,319,1.00
ptg001381l,4616366,4616648,282,EVM,mRNA,4034284,4630463,282,1.00
ptg001385l,1316995,1317299,304,EVM,mRNA,988680,2192696,304,1.00
ptg001385l,1900242,1900495,253,EVM,mRNA,988680,2192696,253,1.00
ptg001387l,1352061,1352372,311,EVM,mRNA,1169863,1857509,311,1.00
ptg001387l,1470769,1471019,250,EVM,mRNA,1169863,1857509,250,1.00
ptg001387l,1628527,1628848,321,EVM,mRNA,1169863,1857509,321,1.00
ptg001387l,3565064,3565377,313,EVM,mRNA,3426964,3763639,313,1.00
ptg001387l,4331629,4331917,288,EVM,mRNA,4313703,4960830,288,1.00
ptg001387l,4648262,4648554,292,EVM,mRNA,4313703,4960830,292,1.00
ptg001387l,5501183,5501506,323,EVM,mRNA,5241361,5688720,323,1.00
ptg001390l,3349331,3349634,303,EVM,mRNA,3039563,5140169,303,1.00
ptg001390l,3896793,3897074,281,EVM,mRNA,3039563,5140169,281,1.00
ptg001390l,4044991,4045303,312,EVM,mRNA,3039563,5140169,312,1.00
ptg001390l,4356128,4356450,322,EVM,mRNA,3039563,5140169,322,1.00
ptg001390l,4447672,4447978,306,EVM,mRNA,3039563,5140169,306,1.00
ptg001390l,4975168,4975472,304,EVM,mRNA,3039563,5140169,304,1.00
ptg001390l,5468159,5468445,286,EVM,mRNA,5374013,5809674,286,1.00
ptg001391l,225918,226200,282,EVM,mRNA,6153,389323,282,1.00
ptg001391l,361302,361627,325,EVM,mRNA,6153,389323,325,1.00
ptg001393l,1444668,1444976,308,EVM,mRNA,803522,1458942,308,1.00
ptg001393l,2295624,2295946,322,EVM,mRNA,1625928,2921351,322,1.00
ptg001393l,2524271,2524567,296,EVM,mRNA,1625928,2921351,296,1.00
ptg001397l,482993,483268,275,EVM,mRNA,401384,645276,275,1.00
ptg001398l,153598,153910,312,EVM,mRNA,74227,168606,312,1.00
ptg001399l,585258,585562,304,EVM,mRNA,147307,3087103,304,1.00
ptg001400l,971647,971953,306,EVM,mRNA,960689,2003075,306,1.00
ptg001400l,1237452,1237764,312,EVM,mRNA,960689,2003075,312,1.00
ptg001400l,1593552,1593833,281,EVM,mRNA,960689,2003075,281,1.00
ptg001400l,1906478,1906780,302,EVM,mRNA,960689,2003075,302,1.00
ptg001404l,526701,526974,273,EVM,mRNA,107953,981132,273,1.00
ptg001406l,1208164,1208471,307,EVM,mRNA,702884,1307726,307,1.00
ptg001407l,456988,457309,321,EVM,mRNA,406270,506778,321,1.00
ptg001407l,566731,567004,273,EVM,mRNA,544406,682441,273,1.00
ptg001409l,53664,53970,306,EVM,mRNA,6354,501369,306,1.00
ptg001409l,224850,225129,279,EVM,mRNA,6354,501369,279,1.00
ptg001409l,429181,429500,319,EVM,mRNA,6354,501369,319,1.00
ptg001412l,153407,153721,314,EVM,mRNA,231,881352,314,1.00
ptg001416l,2186524,2186826,302,EVM,mRNA,1785961,3076911,302,1.00
ptg001416l,2574735,2575010,275,EVM,mRNA,1785961,3076911,275,1.00
ptg001417l,121151,121467,316,EVM,mRNA,4591,1455529,316,1.00
ptg001417l,143496,143810,314,EVM,mRNA,4591,1455529,314,1.00
ptg001417l,519408,519705,297,EVM,mRNA,4591,1455529,297,1.00
ptg001417l,1287254,1287545,291,EVM,mRNA,4591,1455529,291,1.00
ptg001417l,4604223,4604522,299,EVM,mRNA,4531236,4938021,299,1.00
ptg001417l,4879288,4879573,285,EVM,mRNA,4531236,4938021,285,1.00
ptg001422l,570460,570759,299,EVM,mRNA,137085,3163013,299,1.00
ptg001422l,757232,757548,316,EVM,mRNA,137085,3163013,316,1.00
ptg001422l,1631975,1632291,316,EVM,mRNA,137085,3163013,316,1.00
ptg001422l,1658115,1658427,312,EVM,mRNA,137085,3163013,312,1.00
ptg001422l,2864649,2864935,286,EVM,mRNA,137085,3163013,286,1.00
ptg001422l,3805681,3805972,291,EVM,mRNA,3466947,4025212,291,1.00
ptg001424l,111781,112062,281,EVM,mRNA,288,2860924,281,1.00
ptg001424l,751756,752071,315,EVM,mRNA,288,2860924,315,1.00
ptg001424l,1306084,1306397,313,EVM,mRNA,288,2860924,313,1.00
ptg001424l,2592755,2593068,313,EVM,mRNA,288,2860924,313,1.00
ptg001424l,2777034,2777348,314,EVM,mRNA,288,2860924,314,1.00
ptg001426l,2651025,2651334,309,EVM,mRNA,912908,3444298,309,1.00
ptg001427l,1551723,1552013,290,EVM,mRNA,1284834,2558938,290,1.00
ptg001427l,1676824,1677128,304,EVM,mRNA,1284834,2558938,304,1.00
ptg001427l,1823064,1823368,304,EVM,mRNA,1284834,2558938,304,1.00
ptg001430l,97538,97817,279,EVM,mRNA,68419,668540,279,1.00
ptg001436l,586803,587105,302,EVM,mRNA,136912,1114475,302,1.00
ptg001437l,2117469,2117765,296,EVM,mRNA,924767,3566296,296,1.00
ptg001437l,2120199,2120513,314,EVM,mRNA,924767,3566296,314,1.00
ptg001437l,3087698,3088008,310,EVM,mRNA,924767,3566296,310,1.00
ptg001437l,3403698,3403840,142,EVM,mRNA,924767,3566296,142,1.00
ptg001438l,791899,792208,309,EVM,mRNA,413419,1538046,309,1.00
ptg001438l,1379300,1379613,313,EVM,mRNA,413419,1538046,313,1.00
ptg001439l,2589513,2589784,271,EVM,mRNA,2289582,2627447,271,1.00
ptg001441l,461551,461827,276,EVM,mRNA,266495,876719,276,1.00
ptg001441l,779817,780091,274,EVM,mRNA,266495,876719,274,1.00
ptg001441l,1149277,1149612,335,EVM,mRNA,897128,2633199,335,1.00
ptg001441l,1804040,1804303,263,EVM,mRNA,897128,2633199,263,1.00
ptg001441l,2380124,2380403,279,EVM,mRNA,897128,2633199,279,1.00
ptg001444l,791828,792117,289,EVM,mRNA,621379,1063887,289,1.00
ptg001449l,2182512,2182788,276,EVM,mRNA,1953565,2196095,276,1.00
ptg001451l,1522287,1522583,296,EVM,mRNA,1293313,2382661,296,1.00
ptg001451l,1608694,1608997,303,EVM,mRNA,1293313,2382661,303,1.00
ptg001451l,1877141,1877433,292,EVM,mRNA,1293313,2382661,292,1.00
ptg001451l,2168588,2168904,316,EVM,mRNA,1293313,2382661,316,1.00
ptg001451l,2247790,2248073,283,EVM,mRNA,1293313,2382661,283,1.00
ptg001451l,2356337,2356650,313,EVM,mRNA,1293313,2382661,313,1.00
ptg001452l,3178724,3179009,285,EVM,mRNA,2284011,3799372,285,1.00
ptg001452l,3691009,3691327,318,EVM,mRNA,2284011,3799372,318,1.00
ptg001457l,601737,602075,338,EVM,mRNA,495177,616372,338,1.00
ptg001457l,711933,712205,272,EVM,mRNA,640155,1496837,272,1.00
ptg001459l,1529062,1529369,307,EVM,mRNA,1459448,1885443,307,1.00
ptg001459l,1537001,1537277,276,EVM,mRNA,1459448,1885443,276,1.00
ptg001460l,1000702,1001003,301,EVM,mRNA,67,2089890,301,1.00
ptg001464l,829366,829670,304,EVM,mRNA,738401,944740,304,1.00
ptg001464l,1295985,1296276,291,EVM,mRNA,1034012,1821971,291,1.00
ptg001466l,1345912,1346203,291,EVM,mRNA,889730,5192823,291,1.00
ptg001471l,429957,430260,303,EVM,mRNA,132455,537824,303,1.00
ptg001473l,1140067,1140345,278,EVM,mRNA,1056299,1155413,278,1.00
ptg001475l,134710,134963,253,EVM,mRNA,2128,813762,253,1.00
ptg001475l,154103,154414,311,EVM,mRNA,2128,813762,311,1.00
ptg001475l,465176,465506,330,EVM,mRNA,2128,813762,330,1.00
ptg001480l,2337364,2337659,295,EVM,mRNA,1623596,3377326,295,1.00
ptg001480l,2810263,2810562,299,EVM,mRNA,1623596,3377326,299,1.00
ptg001480l,3213061,3213384,323,EVM,mRNA,1623596,3377326,323,1.00
ptg001480l,3311938,3312236,298,EVM,mRNA,1623596,3377326,298,1.00
ptg001481l,1984377,1984652,275,EVM,mRNA,1569937,2949955,275,1.00
ptg001481l,2513875,2514167,292,EVM,mRNA,1569937,2949955,292,1.00
ptg001481l,2769313,2769587,274,EVM,mRNA,1569937,2949955,274,1.00
ptg001482l,570111,570398,287,EVM,mRNA,518081,603030,287,1.00
ptg001483l,1102518,1102834,316,EVM,mRNA,352810,1832908,316,1.00
ptg001483l,1400667,1400989,322,EVM,mRNA,352810,1832908,322,1.00
ptg001483l,1416159,1416444,285,EVM,mRNA,352810,1832908,285,1.00
ptg001484l,232647,232978,331,EVM,mRNA,230280,694252,331,1.00
ptg001487l,2406922,2407248,326,EVM,mRNA,193176,2804042,326,1.00
ptg001487l,2805418,2805711,293,EVM,mRNA,2805291,2807227,293,1.00
ptg001498l,375487,375800,313,EVM,mRNA,346992,1204769,313,1.00
ptg001498l,862533,862847,314,EVM,mRNA,346992,1204769,314,1.00
ptg001498l,951426,951713,287,EVM,mRNA,346992,1204769,287,1.00
ptg001499l,1192543,1192876,333,EVM,mRNA,1168490,1778729,333,1.00
ptg001502l,890561,890884,323,EVM,mRNA,674124,892853,323,1.00
ptg001502l,1688357,1688666,309,EVM,mRNA,972905,1958096,309,1.00
ptg001502l,2569127,2569454,327,EVM,mRNA,2346184,2662885,327,1.00
ptg001502l,3078988,3079285,297,EVM,mRNA,2974180,3207793,297,1.00
ptg001502l,3452536,3452797,261,EVM,mRNA,3363429,3545714,261,1.00
ptg001505l,3301221,3301526,305,EVM,mRNA,2951216,3707280,305,1.00
ptg001505l,7541382,7541687,305,EVM,mRNA,6657916,7600307,305,1.00
ptg001505l,9126880,9127178,298,EVM,mRNA,8843377,9608360,298,1.00
ptg001509l,945201,945500,299,EVM,mRNA,286,1575494,299,1.00
ptg001513l,253354,253640,286,EVM,mRNA,524,366424,286,1.00
ptg001513l,897052,897335,283,EVM,mRNA,518993,1837847,283,1.00
ptg001513l,1034870,1035183,313,EVM,mRNA,518993,1837847,313,1.00
ptg001513l,4225566,4225873,307,EVM,mRNA,3655488,4382362,307,1.00
ptg001513l,4257394,4257710,316,EVM,mRNA,3655488,4382362,316,1.00
ptg001513l,4257837,4258126,289,EVM,mRNA,3655488,4382362,289,1.00
ptg001513l,4691338,4691655,317,EVM,mRNA,4564348,5022247,317,1.00
ptg001513l,4696900,4697205,305,EVM,mRNA,4564348,5022247,305,1.00
ptg001513l,4894414,4894727,313,EVM,mRNA,4564348,5022247,313,1.00
ptg001516l,1203574,1203867,293,EVM,mRNA,120,2255767,293,1.00
ptg001516l,2211803,2212099,296,EVM,mRNA,120,2255767,296,1.00
ptg001517l,1618973,1619307,334,EVM,mRNA,1561121,1689635,334,1.00
ptg001517l,2198615,2198923,308,EVM,mRNA,1702299,2429292,308,1.00
ptg001517l,2769487,2769767,280,EVM,mRNA,2760421,4052053,280,1.00
ptg001517l,3156488,3156822,334,EVM,mRNA,2760421,4052053,334,1.00
ptg001517l,3241800,3242095,295,EVM,mRNA,2760421,4052053,295,1.00
ptg001517l,3284088,3284406,318,EVM,mRNA,2760421,4052053,318,1.00
ptg001517l,3494801,3495122,321,EVM,mRNA,2760421,4052053,321,1.00
ptg001518l,3295551,3295878,327,EVM,mRNA,2561348,5520499,327,1.00
ptg001518l,4246035,4246337,302,EVM,mRNA,2561348,5520499,302,1.00
ptg001518l,4426689,4427008,319,EVM,mRNA,2561348,5520499,319,1.00
ptg001518l,5086038,5086315,277,EVM,mRNA,2561348,5520499,277,1.00
ptg001518l,5491214,5491500,286,EVM,mRNA,2561348,5520499,286,1.00
ptg001518l,7101174,7101502,328,EVM,mRNA,6293791,8770216,328,1.00
ptg001524l,239973,240252,279,EVM,mRNA,227238,497882,279,1.00
ptg001524l,335028,335313,285,EVM,mRNA,227238,497882,285,1.00
ptg001525l,1891777,1892078,301,EVM,mRNA,1510489,2794134,301,1.00
ptg001525l,2238599,2238905,306,EVM,mRNA,1510489,2794134,306,1.00
ptg001527l,1659220,1659536,316,EVM,mRNA,493617,2236826,316,1.00
ptg001527l,1667194,1667498,304,EVM,mRNA,493617,2236826,304,1.00
ptg001530l,384790,385104,314,EVM,mRNA,142747,894680,314,1.00
ptg001530l,384790,385104,314,GeneWise,mRNA,49522,643457,314,1.00
ptg001531l,3427714,3428010,296,EVM,mRNA,2022632,4506740,296,1.00
ptg001531l,4376486,4376774,288,EVM,mRNA,2022632,4506740,288,1.00
ptg001533l,2488513,2488837,324,EVM,mRNA,2212225,3166281,324,1.00
ptg001533l,3328178,3328508,330,EVM,mRNA,3213071,4048690,330,1.00
ptg001533l,3794279,3794609,330,EVM,mRNA,3213071,4048690,330,1.00
ptg001535l,1305317,1305632,315,EVM,mRNA,464919,1958048,315,1.00
ptg001535l,1557031,1557340,309,EVM,mRNA,464919,1958048,309,1.00
ptg001536l,2132145,2132426,281,EVM,mRNA,1747466,2426124,281,1.00
ptg001541l,189993,190271,278,EVM,mRNA,189310,738314,278,1.00
ptg001541l,1099914,1100214,300,EVM,mRNA,827586,1231748,300,1.00
ptg001546l,23106,23427,321,EVM,mRNA,7455,282832,321,1.00
ptg001551l,882688,883001,313,EVM,mRNA,863926,906685,313,1.00
ptg001551l,3446102,3446399,297,EVM,mRNA,2889767,4206518,297,1.00
ptg001559l,1082542,1082825,283,EVM,mRNA,1016467,1295527,283,1.00
ptg001560l,414434,414733,299,EVM,mRNA,289041,512900,299,1.00
ptg001560l,2344608,2344928,320,EVM,mRNA,2043657,2358928,320,1.00
ptg001560l,3564505,3564822,317,EVM,mRNA,2549224,3668424,317,1.00
ptg001560l,3575417,3575734,317,EVM,mRNA,2549224,3668424,317,1.00
ptg001560l,4914224,4914537,313,EVM,mRNA,4592457,5942897,313,1.00
ptg001560l,6088264,6088572,308,EVM,mRNA,6037790,6329803,308,1.00
ptg001562l,264524,264806,282,EVM,mRNA,25895,1766541,282,1.00
ptg001562l,728765,729088,323,EVM,mRNA,25895,1766541,323,1.00
ptg001567l,2231117,2231421,304,EVM,mRNA,2062031,2698144,304,1.00
ptg001567l,2558960,2559259,299,EVM,mRNA,2062031,2698144,299,1.00
ptg001567l,2655711,2655998,287,EVM,mRNA,2062031,2698144,287,1.00
ptg001570l,574852,575166,314,EVM,mRNA,573910,656816,314,1.00
ptg001572l,442754,443039,285,EVM,mRNA,371725,2000348,285,1.00
ptg001572l,1833459,1833770,311,EVM,mRNA,371725,2000348,311,1.00
ptg001572l,1861611,1861890,279,EVM,mRNA,371725,2000348,279,1.00
ptg001574l,456307,456618,311,EVM,mRNA,152237,2981657,311,1.00
ptg001574l,2608602,2608911,309,EVM,mRNA,152237,2981657,309,1.00
ptg001574l,3974687,3974998,311,EVM,mRNA,3711261,4080819,311,1.00
ptg001575l,2077048,2077337,289,EVM,mRNA,1814542,2540801,289,1.00
ptg001575l,5803632,5803907,275,EVM,mRNA,4154471,8552828,275,1.00
ptg001575l,7061228,7061522,294,EVM,mRNA,4154471,8552828,294,1.00
ptg001575l,8545218,8545532,314,EVM,mRNA,4154471,8552828,314,1.00
ptg001577l,4600065,4600363,298,EVM,mRNA,3528164,5152800,298,1.00
ptg001577l,4783843,4784143,300,EVM,mRNA,3528164,5152800,300,1.00
ptg001577l,5066074,5066370,296,EVM,mRNA,3528164,5152800,296,1.00
ptg001577l,6467458,6467790,332,EVM,mRNA,6409395,6552534,332,1.00
ptg001578l,313597,313924,327,EVM,mRNA,227067,523566,327,1.00
ptg001578l,343050,343329,279,EVM,mRNA,227067,523566,279,1.00
ptg001579l,1469043,1469342,299,EVM,mRNA,103573,2866248,299,1.00
ptg001581l,148007,148297,290,EVM,mRNA,9434,2099139,290,1.00
ptg001581l,216261,216562,301,EVM,mRNA,9434,2099139,301,1.00
ptg001581l,925670,925978,308,EVM,mRNA,9434,2099139,308,1.00
ptg001581l,934758,935060,302,EVM,mRNA,9434,2099139,302,1.00
ptg001585l,1221115,1221403,288,EVM,mRNA,1127518,2748281,288,1.00
ptg001585l,5216209,5216503,294,EVM,mRNA,4088241,6938321,294,1.00
ptg001585l,5929390,5929686,296,EVM,mRNA,4088241,6938321,296,1.00
ptg001585l,6180281,6180571,290,EVM,mRNA,4088241,6938321,290,1.00
ptg001585l,6283064,6283363,299,EVM,mRNA,4088241,6938321,299,1.00
ptg001585l,6583798,6584110,312,EVM,mRNA,4088241,6938321,312,1.00
ptg001590l,335638,335949,311,EVM,mRNA,252302,580595,311,1.00
ptg001590l,2310913,2311242,329,EVM,mRNA,2064810,2321990,329,1.00
ptg001591l,581328,581622,294,EVM,mRNA,412464,590326,294,1.00
ptg001592l,546543,546885,342,EVM,mRNA,109445,779376,342,1.00
ptg001594l,693720,694022,302,EVM,mRNA,329943,970659,302,1.00
ptg001594l,1126327,1126645,318,EVM,mRNA,1104703,1156506,318,1.00
ptg001596l,255666,255960,294,EVM,mRNA,88695,447677,294,1.00
ptg001596l,959145,959458,313,EVM,mRNA,656126,1010387,313,1.00
ptg001598l,670965,671263,298,EVM,mRNA,374623,1889229,298,1.00
ptg001598l,1324403,1324727,324,EVM,mRNA,374623,1889229,324,1.00
ptg001598l,1611741,1612065,324,EVM,mRNA,374623,1889229,324,1.00
ptg001599l,1199114,1199402,288,EVM,mRNA,938251,1595987,288,1.00
ptg001600l,278336,278632,296,EVM,mRNA,38835,830598,296,1.00
ptg001600l,403861,404163,302,EVM,mRNA,38835,830598,302,1.00
ptg001601l,912238,912531,293,EVM,mRNA,902861,1304133,293,1.00
ptg001602l,1401648,1401950,302,EVM,mRNA,574614,3475817,302,1.00
ptg001606l,615198,615492,294,EVM,mRNA,496882,1225350,294,1.00
ptg001606l,2004889,2005161,272,EVM,mRNA,1997431,2016170,272,1.00
ptg001606l,2149836,2150145,309,EVM,mRNA,2111046,2295385,309,1.00
ptg001606l,2228272,2228608,336,EVM,mRNA,2111046,2295385,336,1.00
ptg001616l,466365,466671,306,EVM,mRNA,200740,515124,306,1.00
ptg001616l,2911614,2911911,297,EVM,mRNA,1737520,4525120,297,1.00
ptg001616l,3406326,3406622,296,EVM,mRNA,1737520,4525120,296,1.00
ptg001616l,3605961,3606262,301,EVM,mRNA,1737520,4525120,301,1.00
ptg001620l,1940034,1940313,279,EVM,mRNA,590081,4231251,279,1.00
ptg001620l,2321610,2321882,272,EVM,mRNA,590081,4231251,272,1.00
ptg001620l,5009093,5009388,295,EVM,mRNA,4691623,6103470,295,1.00
ptg001620l,8968288,8968620,332,EVM,mRNA,8842247,9833643,332,1.00
ptg001620l,9663877,9664202,325,EVM,mRNA,8842247,9833643,325,1.00
ptg001621l,3254002,3254312,310,EVM,mRNA,2199851,3339855,310,1.00
ptg001621l,5278287,5278581,294,EVM,mRNA,3926086,5316421,294,1.00
ptg001625l,1066468,1066760,292,EVM,mRNA,355487,1289554,292,1.00
ptg001625l,1764308,1764585,277,EVM,mRNA,1582141,1948347,277,1.00
ptg001625l,1911703,1912007,304,EVM,mRNA,1582141,1948347,304,1.00
ptg001627l,998351,998633,282,EVM,mRNA,120240,2256902,282,1.00
ptg001627l,1971267,1971570,303,EVM,mRNA,120240,2256902,303,1.00
ptg001627l,3361683,3361983,300,EVM,mRNA,2804992,3535277,300,1.00
ptg001627l,3411642,3411956,314,EVM,mRNA,2804992,3535277,314,1.00
ptg001628l,682101,682414,313,EVM,mRNA,664816,787074,313,1.00
ptg001628l,685708,685999,291,EVM,mRNA,664816,787074,291,1.00
ptg001628l,1756664,1756946,282,EVM,mRNA,798440,1757040,282,1.00
ptg001629l,1493234,1493512,278,EVM,mRNA,1322093,2141172,278,1.00
ptg001629l,1697157,1697485,328,EVM,mRNA,1322093,2141172,328,1.00
ptg001630l,421584,421883,299,EVM,mRNA,5837,3182133,299,1.00
ptg001630l,1210603,1210891,288,EVM,mRNA,5837,3182133,288,1.00
ptg001631l,579483,579750,267,EVM,mRNA,312679,806833,267,1.00
ptg001631l,1688865,1689142,277,EVM,mRNA,907156,4046629,277,1.00
ptg001631l,2341571,2341874,303,EVM,mRNA,907156,4046629,303,1.00
ptg001631l,2557892,2558184,292,EVM,mRNA,907156,4046629,292,1.00
ptg001631l,2892495,2892814,319,EVM,mRNA,907156,4046629,319,1.00
ptg001631l,3264143,3264456,313,EVM,mRNA,907156,4046629,313,1.00
ptg001631l,3448815,3449144,329,EVM,mRNA,907156,4046629,329,1.00
ptg001631l,6260081,6260371,290,EVM,mRNA,5171853,8386270,290,1.00
ptg001631l,7164846,7165132,286,EVM,mRNA,5171853,8386270,286,1.00
ptg001631l,7247608,7247901,293,EVM,mRNA,5171853,8386270,293,1.00
ptg001631l,7571821,7572128,307,EVM,mRNA,5171853,8386270,307,1.00
ptg001631l,8011833,8012113,280,EVM,mRNA,5171853,8386270,280,1.00
ptg001635l,676526,676818,292,EVM,mRNA,647132,1469529,292,1.00
ptg001635l,857304,857592,288,EVM,mRNA,647132,1469529,288,1.00
ptg001635l,3017382,3017663,281,EVM,mRNA,2867364,3890266,281,1.00
ptg001635l,4886362,4886641,279,EVM,mRNA,4190596,5070537,279,1.00
ptg001636l,615996,616267,271,EVM,mRNA,22122,1562027,271,1.00
ptg001636l,1024384,1024693,309,EVM,mRNA,22122,1562027,309,1.00
ptg001636l,1231818,1232092,274,EVM,mRNA,22122,1562027,274,1.00
ptg001636l,6408211,6408353,142,EVM,mRNA,5528919,6790250,142,1.00
ptg001639l,345948,346208,260,EVM,mRNA,320042,578736,260,1.00
ptg001639l,2298743,2299043,300,EVM,mRNA,751813,2849629,300,1.00
ptg001639l,2541446,2541743,297,EVM,mRNA,751813,2849629,297,1.00
ptg001640l,823054,823367,313,EVM,mRNA,37961,2219364,313,1.00
ptg001640l,1376486,1376801,315,EVM,mRNA,37961,2219364,315,1.00
ptg001641l,2229070,2229389,319,EVM,mRNA,1349694,2352520,319,1.00
ptg001641l,2685848,2686128,280,EVM,mRNA,2603001,2729584,280,1.00
ptg001642l,2446008,2446292,284,EVM,mRNA,2207221,2961649,284,1.00
ptg001642l,2589063,2589347,284,EVM,mRNA,2207221,2961649,284,1.00
ptg001643l,5250,5543,293,EVM,mRNA,159,1713663,293,1.00
ptg001643l,2281540,2281834,294,EVM,mRNA,1948148,2298319,294,1.00
ptg001643l,2288778,2289072,294,EVM,mRNA,1948148,2298319,294,1.00
ptg001646l,1674882,1675163,281,EVM,mRNA,1592405,1717463,281,1.00
ptg001648l,895818,896099,281,EVM,mRNA,640053,1351898,281,1.00
ptg001649l,479357,479665,308,EVM,mRNA,453153,1092314,308,1.00
ptg001649l,2909451,2909743,292,EVM,mRNA,2468356,3578362,292,1.00
ptg001649l,3023160,3023486,326,EVM,mRNA,2468356,3578362,326,1.00
ptg001656l,1232927,1233237,310,EVM,mRNA,3089,6288769,310,1.00
ptg001656l,1584112,1584391,279,EVM,mRNA,3089,6288769,279,1.00
ptg001656l,1649505,1649825,320,EVM,mRNA,3089,6288769,320,1.00
ptg001656l,2698287,2698605,318,EVM,mRNA,3089,6288769,318,1.00
ptg001656l,3655710,3656019,309,EVM,mRNA,3089,6288769,309,1.00
ptg001656l,4146582,4146897,315,EVM,mRNA,3089,6288769,315,1.00
ptg001656l,4272039,4272344,305,EVM,mRNA,3089,6288769,305,1.00
ptg001656l,4792007,4792306,299,EVM,mRNA,3089,6288769,299,1.00
ptg001656l,5334411,5334716,305,EVM,mRNA,3089,6288769,305,1.00
ptg001656l,5565465,5565781,316,EVM,mRNA,3089,6288769,316,1.00
ptg001656l,5714849,5715167,318,EVM,mRNA,3089,6288769,318,1.00
ptg001656l,6137219,6137535,316,EVM,mRNA,3089,6288769,316,1.00
ptg001657l,4016798,4017086,288,EVM,mRNA,2814233,4415920,288,1.00
ptg001657l,4034544,4034842,298,EVM,mRNA,2814233,4415920,298,1.00
ptg001658l,718345,718667,322,EVM,mRNA,717504,718823,322,1.00
ptg001659l,1358033,1358332,299,EVM,mRNA,1079170,2302807,299,1.00
ptg001660l,2734659,2734987,328,EVM,mRNA,1443192,3022866,328,1.00
ptg001660l,5723528,5723827,299,EVM,mRNA,4333411,6515332,299,1.00
ptg001660l,6111167,6111457,290,EVM,mRNA,4333411,6515332,290,1.00
ptg001660l,6478384,6478691,307,EVM,mRNA,4333411,6515332,307,1.00
ptg001661l,68119,68404,285,EVM,mRNA,756,865721,285,1.00
ptg001661l,1469292,1469599,307,EVM,mRNA,1426716,2414301,307,1.00
ptg001663l,5800329,5800627,298,EVM,mRNA,5701461,5962854,298,1.00
ptg001663l,7278138,7278448,310,EVM,mRNA,7246152,7386632,310,1.00
ptg001663l,9016394,9016720,326,EVM,mRNA,8687502,9142565,326,1.00
ptg001663l,10383978,10384282,304,EVM,mRNA,9423538,12039608,304,1.00
ptg001666l,687250,687557,307,EVM,mRNA,126168,2239943,307,1.00
ptg001666l,5418007,5418306,299,EVM,mRNA,4997473,5673988,299,1.00
ptg001666l,6750194,6750476,282,EVM,mRNA,6651727,7104998,282,1.00
ptg001666l,8119961,8120273,312,EVM,mRNA,7788016,8631577,312,1.00
ptg001666l,10418111,10418392,281,EVM,mRNA,10321605,10641213,281,1.00
ptg001668l,2975095,2975390,295,EVM,mRNA,1128579,3222809,295,1.00
ptg001670l,887574,887883,309,EVM,mRNA,767589,906607,309,1.00
ptg001670l,1183659,1183953,294,EVM,mRNA,1009101,1679657,294,1.00
ptg001671l,941615,941909,294,EVM,mRNA,729959,1875967,294,1.00
ptg001671l,1380420,1380737,317,EVM,mRNA,729959,1875967,317,1.00
ptg001671l,2983213,2983468,255,EVM,mRNA,2839685,3893371,255,1.00
ptg001671l,5190853,5191129,276,EVM,mRNA,5170247,5715250,276,1.00
ptg001671l,5704077,5704380,303,EVM,mRNA,5170247,5715250,303,1.00
ptg001671l,7341989,7342324,335,EVM,mRNA,6846638,7630247,335,1.00
ptg001671l,8142455,8142723,268,EVM,mRNA,7632417,8554255,268,1.00
ptg001671l,10078403,10078690,287,EVM,mRNA,9711255,10490985,287,1.00
ptg001672l,1422684,1422978,294,EVM,mRNA,445172,2183086,294,1.00
ptg001672l,3530384,3530699,315,EVM,mRNA,3142702,3651269,315,1.00
ptg001672l,4388887,4389163,276,EVM,mRNA,4012628,5249834,276,1.00
ptg001672l,4462974,4463269,295,EVM,mRNA,4012628,5249834,295,1.00
ptg001672l,4521957,4522247,290,EVM,mRNA,4012628,5249834,290,1.00
ptg001672l,4836719,4837018,299,EVM,mRNA,4012628,5249834,299,1.00
ptg001672l,4990571,4990892,321,EVM,mRNA,4012628,5249834,321,1.00
ptg001674l,592991,593278,287,EVM,mRNA,394672,678932,287,1.00
ptg001674l,932086,932409,323,EVM,mRNA,812904,1004413,323,1.00
ptg001676l,1417699,1417988,289,EVM,mRNA,1259412,1714121,289,1.00
ptg001677l,1030263,1030583,320,EVM,mRNA,528102,2242255,320,1.00
ptg001677l,2195503,2195809,306,EVM,mRNA,528102,2242255,306,1.00
ptg001681l,3425393,3425728,335,EVM,mRNA,1545209,3698039,335,1.00
ptg001681l,3489118,3489429,311,EVM,mRNA,1545209,3698039,311,1.00
ptg001681l,4491868,4492162,294,EVM,mRNA,4046884,4609438,294,1.00
ptg001681l,4579681,4579996,315,EVM,mRNA,4046884,4609438,315,1.00
ptg001682l,1429878,1430183,305,EVM,mRNA,546894,1501147,305,1.00
ptg001682l,6561133,6561419,286,EVM,mRNA,6078607,6885408,286,1.00
ptg001684l,587428,587740,312,EVM,mRNA,300416,673460,312,1.00
ptg001685l,392690,393018,328,EVM,mRNA,352864,563434,328,1.00
ptg001685l,506504,506798,294,EVM,mRNA,352864,563434,294,1.00
ptg001685l,547214,547527,313,EVM,mRNA,352864,563434,313,1.00
ptg001685l,550576,550870,294,EVM,mRNA,352864,563434,294,1.00
ptg001685l,2302155,2302435,280,EVM,mRNA,921375,4087738,280,1.00
ptg001685l,2561355,2561669,314,EVM,mRNA,921375,4087738,314,1.00
ptg001685l,2898402,2898663,261,EVM,mRNA,921375,4087738,261,1.00
ptg001685l,3864255,3864573,318,EVM,mRNA,921375,4087738,318,1.00
ptg001685l,6289184,6289477,293,EVM,mRNA,5749962,6577478,293,1.00
ptg001687l,1939239,1939551,312,EVM,mRNA,1818751,2551071,312,1.00
ptg001687l,5016543,5016820,277,EVM,mRNA,4937245,5937238,277,1.00
ptg001687l,5250884,5251166,282,EVM,mRNA,4937245,5937238,282,1.00
ptg001687l,5452739,5453024,285,EVM,mRNA,4937245,5937238,285,1.00
ptg001687l,5461735,5462032,297,EVM,mRNA,4937245,5937238,297,1.00
ptg001687l,6893901,6894198,297,EVM,mRNA,5944983,8061845,297,1.00
ptg001687l,7460675,7461003,328,EVM,mRNA,5944983,8061845,328,1.00
ptg001688l,1334504,1334795,291,EVM,mRNA,1311215,1413698,291,1.00
ptg001694l,949544,949859,315,EVM,mRNA,908962,1064502,315,1.00
ptg001695l,2000196,2000511,315,EVM,mRNA,837379,2355189,315,1.00
ptg001695l,2072079,2072396,317,EVM,mRNA,837379,2355189,317,1.00
ptg001701l,812864,813171,307,EVM,mRNA,327508,1693762,307,1.00
ptg001701l,1050467,1050733,266,EVM,mRNA,327508,1693762,266,1.00
ptg001701l,2671879,2672162,283,EVM,mRNA,2048872,3418776,283,1.00
ptg001701l,3274595,3274905,310,EVM,mRNA,2048872,3418776,310,1.00
ptg001701l,4302571,4302896,325,EVM,mRNA,4232158,4500305,325,1.00
ptg001702l,5125404,5125680,276,EVM,mRNA,4226338,7075156,276,1.00
ptg001702l,6570216,6570514,298,EVM,mRNA,4226338,7075156,298,1.00
ptg001704l,1593511,1593825,314,EVM,mRNA,1154653,6525265,314,1.00
ptg001704l,2635933,2636252,319,EVM,mRNA,1154653,6525265,319,1.00
ptg001704l,2918985,2919293,308,EVM,mRNA,1154653,6525265,308,1.00
ptg001704l,3507280,3507560,280,EVM,mRNA,1154653,6525265,280,1.00
ptg001704l,5612033,5612373,340,EVM,mRNA,1154653,6525265,340,1.00
ptg001704l,5894411,5894716,305,EVM,mRNA,1154653,6525265,305,1.00
ptg001704l,6041526,6041803,277,EVM,mRNA,1154653,6525265,277,1.00
ptg001708l,1484810,1485100,290,EVM,mRNA,1096548,3708057,290,1.00
ptg001708l,1686135,1686395,260,EVM,mRNA,1096548,3708057,260,1.00
ptg001708l,2091134,2091419,285,EVM,mRNA,1096548,3708057,285,1.00
ptg001708l,2095544,2095857,313,EVM,mRNA,1096548,3708057,313,1.00
ptg001708l,2114015,2114288,273,EVM,mRNA,1096548,3708057,273,1.00
ptg001708l,2643657,2643944,287,EVM,mRNA,1096548,3708057,287,1.00
ptg001711l,217284,217594,310,EVM,mRNA,94564,218805,310,1.00
ptg001711l,1388119,1388411,292,EVM,mRNA,1200193,2062617,292,1.00
ptg001712l,712104,712409,305,EVM,mRNA,2189,2564626,305,1.00
ptg001712l,3627984,3628310,326,EVM,mRNA,3267390,3773743,326,1.00
ptg001713l,1200928,1201224,296,EVM,mRNA,232400,1665242,296,1.00
ptg001713l,1403697,1403968,271,EVM,mRNA,232400,1665242,271,1.00
ptg001713l,2097266,2097598,332,EVM,mRNA,1859438,3627966,332,1.00
ptg001713l,2503813,2504105,292,EVM,mRNA,1859438,3627966,292,1.00
ptg001713l,2518965,2519276,311,EVM,mRNA,1859438,3627966,311,1.00
ptg001713l,3031781,3032091,310,EVM,mRNA,1859438,3627966,310,1.00
ptg001714l,670290,670568,278,EVM,mRNA,164228,683877,278,1.00
ptg001716l,520397,520708,311,EVM,mRNA,402343,630885,311,1.00
ptg001717l,2197358,2197685,327,EVM,mRNA,1915582,2358669,327,1.00
ptg001720l,133398,133697,299,EVM,mRNA,11487,402040,299,1.00
ptg001720l,1164057,1164343,286,EVM,mRNA,452446,1970383,286,1.00
ptg001720l,1872578,1872889,311,EVM,mRNA,452446,1970383,311,1.00
ptg001722l,53075,53404,329,EVM,mRNA,22279,63903,329,1.00
ptg001730l,1583546,1583864,318,EVM,mRNA,1556839,1598339,318,1.00
ptg001732l,1007248,1007519,271,EVM,mRNA,737447,4636131,271,1.00
ptg001732l,1833884,1834170,286,EVM,mRNA,737447,4636131,286,1.00
ptg001732l,1915746,1916047,301,EVM,mRNA,737447,4636131,301,1.00
ptg001732l,2755595,2755910,315,EVM,mRNA,737447,4636131,315,1.00
ptg001733l,1177938,1178223,285,EVM,mRNA,4469,2658699,285,1.00
ptg001735l,1534835,1535127,292,EVM,mRNA,1452863,1756839,292,1.00
ptg001736l,1093646,1093960,314,EVM,mRNA,703586,1222963,314,1.00
ptg001738l,488283,488596,313,EVM,mRNA,72124,1092444,313,1.00
ptg001738l,912384,912689,305,EVM,mRNA,72124,1092444,305,1.00
ptg001738l,2366950,2367253,303,EVM,mRNA,2286812,2422060,303,1.00
ptg001738l,2418655,2418949,294,EVM,mRNA,2286812,2422060,294,1.00
ptg001739l,733869,734170,301,EVM,mRNA,379220,842254,301,1.00
ptg001740l,687888,688136,248,EVM,mRNA,230741,764283,248,1.00
ptg001740l,1794056,1794384,328,EVM,mRNA,1610411,2742390,328,1.00
ptg001740l,2466988,2467271,283,EVM,mRNA,1610411,2742390,283,1.00
ptg001741l,746762,747085,323,EVM,mRNA,208110,1568945,323,1.00
ptg001741l,915716,916029,313,EVM,mRNA,208110,1568945,313,1.00
ptg001741l,1399448,1399754,306,EVM,mRNA,208110,1568945,306,1.00
ptg001741l,1659163,1659445,282,EVM,mRNA,1570973,3555941,282,1.00
ptg001741l,1700432,1700744,312,EVM,mRNA,1570973,3555941,312,1.00
ptg001745l,1849479,1849760,281,EVM,mRNA,1678770,1907798,281,1.00
ptg001746l,1190071,1190380,309,EVM,mRNA,1040059,1383672,309,1.00
ptg001746l,2448476,2448786,310,EVM,mRNA,2192638,3247878,310,1.00
ptg001746l,4557970,4558281,311,EVM,mRNA,3872603,5879419,311,1.00
ptg001746l,5667650,5667925,275,EVM,mRNA,3872603,5879419,275,1.00
ptg001746l,5698195,5698473,278,EVM,mRNA,3872603,5879419,278,1.00
ptg001747l,292824,293121,297,EVM,mRNA,8323,879062,297,1.00
ptg001747l,824465,824733,268,EVM,mRNA,8323,879062,268,1.00
ptg001748l,2795066,2795364,298,EVM,mRNA,2170830,2855255,298,1.00
ptg001748l,4473425,4473747,322,EVM,mRNA,4471789,4476482,322,1.00
ptg001749l,603629,603910,281,EVM,mRNA,43996,2367185,281,1.00
ptg001749l,1267645,1267914,269,EVM,mRNA,43996,2367185,269,1.00
ptg001752l,1385490,1385816,326,EVM,mRNA,1063879,2167721,326,1.00
ptg001759l,116841,117129,288,EVM,mRNA,400,3298289,288,1.00
ptg001759l,1402079,1402400,321,EVM,mRNA,400,3298289,321,1.00
ptg001759l,1575376,1575699,323,EVM,mRNA,400,3298289,323,1.00
ptg001760l,267580,267897,317,EVM,mRNA,67222,268805,317,1.00
ptg001762l,1112844,1113137,293,EVM,mRNA,218251,1656832,293,1.00
ptg001762l,1119737,1120030,293,EVM,mRNA,218251,1656832,293,1.00
ptg001764l,1883185,1883501,316,EVM,mRNA,1761692,2141320,316,1.00
ptg001767l,1675381,1675676,295,EVM,mRNA,844081,2216297,295,1.00
ptg001770l,1210239,1210513,274,EVM,mRNA,1153892,1604065,274,1.00
ptg001771l,1131710,1131978,268,EVM,mRNA,1080947,2968449,268,1.00
ptg001771l,1687675,1687987,312,EVM,mRNA,1080947,2968449,312,1.00
ptg001771l,1940180,1940476,296,EVM,mRNA,1080947,2968449,296,1.00
ptg001771l,4655719,4656035,316,EVM,mRNA,3825007,5047598,316,1.00
ptg001773l,2832058,2832379,321,EVM,mRNA,2718526,3016036,321,1.00
ptg001774l,1159921,1160185,264,EVM,mRNA,784753,1376620,264,1.00
ptg001775l,1164278,1164582,304,EVM,mRNA,1078340,1271751,304,1.00
ptg001776l,1357308,1357633,325,EVM,mRNA,1314486,1665496,325,1.00
ptg001778l,21749,22048,299,EVM,mRNA,584,57218,299,1.00
ptg001778l,1394098,1394433,335,EVM,mRNA,1077137,2633588,335,1.00
ptg001782l,1334435,1334721,286,EVM,mRNA,1049931,1601349,286,1.00
ptg001782l,1561072,1561391,319,EVM,mRNA,1049931,1601349,319,1.00
ptg001785l,604374,604684,310,EVM,mRNA,528776,638952,310,1.00
ptg001786l,235765,236083,318,EVM,mRNA,196617,588542,318,1.00
ptg001786l,363007,363321,314,EVM,mRNA,196617,588542,314,1.00
ptg001786l,1888163,1888454,291,EVM,mRNA,1882155,2967056,291,1.00
ptg001786l,4422232,4422545,313,EVM,mRNA,4192499,4425723,313,1.00
ptg001786l,5227470,5227743,273,EVM,mRNA,5227352,5227747,273,1.00
ptg001786l,6387113,6387424,311,EVM,mRNA,6370548,6518850,311,1.00
ptg001786l,6400285,6400596,311,EVM,mRNA,6370548,6518850,311,1.00
ptg001789l,380877,381188,311,EVM,mRNA,306864,2267582,311,1.00
ptg001789l,433333,433613,280,EVM,mRNA,306864,2267582,280,1.00
ptg001789l,475010,475315,305,EVM,mRNA,306864,2267582,305,1.00
ptg001789l,578611,578911,300,EVM,mRNA,306864,2267582,300,1.00
ptg001789l,1011313,1011601,288,EVM,mRNA,306864,2267582,288,1.00
ptg001789l,1153264,1153572,308,EVM,mRNA,306864,2267582,308,1.00
ptg001789l,2154752,2155039,287,EVM,mRNA,306864,2267582,287,1.00
ptg001791l,345653,345941,288,EVM,mRNA,337023,396340,288,1.00
ptg001792l,803496,803800,304,EVM,mRNA,258007,1017885,304,1.00
ptg001792l,1503512,1503797,285,EVM,mRNA,1166149,4741656,285,1.00
ptg001792l,1530557,1530871,314,EVM,mRNA,1166149,4741656,314,1.00
ptg001793l,1004284,1004562,278,EVM,mRNA,310030,1267244,278,1.00
ptg001797l,333888,334192,304,EVM,mRNA,72080,1382464,304,1.00
ptg001797l,455215,455519,304,EVM,mRNA,72080,1382464,304,1.00
ptg001797l,456435,456693,258,EVM,mRNA,72080,1382464,258,1.00
ptg001797l,641956,642265,309,EVM,mRNA,72080,1382464,309,1.00
ptg001797l,919235,919514,279,EVM,mRNA,72080,1382464,279,1.00
ptg001798l,491112,491433,321,EVM,mRNA,612,1294620,321,1.00
ptg001798l,670872,671185,313,EVM,mRNA,612,1294620,313,1.00
ptg001799l,5785265,5785549,284,EVM,mRNA,5507099,5942431,284,1.00
ptg001804l,156734,157033,299,EVM,mRNA,55758,231220,299,1.00
ptg001810l,824744,825017,273,EVM,mRNA,442095,1078327,273,1.00
ptg001812l,2615483,2615769,286,EVM,mRNA,1091086,5263312,286,1.00
ptg001812l,3774645,3774958,313,EVM,mRNA,1091086,5263312,313,1.00
ptg001812l,4079504,4079797,293,EVM,mRNA,1091086,5263312,293,1.00
ptg001812l,4682123,4682407,284,EVM,mRNA,1091086,5263312,284,1.00
ptg001812l,5259428,5259735,307,EVM,mRNA,1091086,5263312,307,1.00
ptg001813l,656644,656945,301,EVM,mRNA,80185,1272952,301,1.00
ptg001813l,1253316,1253623,307,EVM,mRNA,80185,1272952,307,1.00
ptg001814l,1569854,1570152,298,EVM,mRNA,914499,2097564,298,1.00
ptg001814l,1897161,1897479,318,EVM,mRNA,914499,2097564,318,1.00
ptg001814l,2354762,2355072,310,EVM,mRNA,2352601,2638130,310,1.00
ptg001814l,4528511,4528816,305,EVM,mRNA,3993113,4903437,305,1.00
ptg001814l,4546804,4547118,314,EVM,mRNA,3993113,4903437,314,1.00
ptg001814l,4706280,4706571,291,EVM,mRNA,3993113,4903437,291,1.00
ptg001814l,6901966,6902270,304,EVM,mRNA,5159231,7105866,304,1.00
ptg001814l,7369296,7369628,332,EVM,mRNA,7248047,7484951,332,1.00
ptg001815l,2511817,2512097,280,EVM,mRNA,1881276,4188409,280,1.00
ptg001815l,2818486,2818802,316,EVM,mRNA,1881276,4188409,316,1.00
ptg001815l,3675104,3675405,301,EVM,mRNA,1881276,4188409,301,1.00
ptg001815l,4088465,4088746,281,EVM,mRNA,1881276,4188409,281,1.00
ptg001816l,647075,647358,283,EVM,mRNA,562711,898709,283,1.00
ptg001820l,727888,728204,316,EVM,mRNA,439657,1039471,316,1.00
ptg001820l,4169627,4169928,301,EVM,mRNA,4087537,5573151,301,1.00
ptg001820l,4798912,4799197,285,EVM,mRNA,4087537,5573151,285,1.00
ptg001820l,5062052,5062347,295,EVM,mRNA,4087537,5573151,295,1.00
ptg001820l,5262850,5263140,290,EVM,mRNA,4087537,5573151,290,1.00
ptg001820l,5429824,5430148,324,EVM,mRNA,4087537,5573151,324,1.00
ptg001821l,2198213,2198520,307,EVM,mRNA,206076,2531540,307,1.00
ptg001821l,3895726,3896049,323,EVM,mRNA,3285365,5469818,323,1.00
ptg001821l,4121118,4121444,326,EVM,mRNA,3285365,5469818,326,1.00
ptg001821l,4637502,4637792,290,EVM,mRNA,3285365,5469818,290,1.00
ptg001821l,5067390,5067719,329,EVM,mRNA,3285365,5469818,329,1.00
ptg001826l,979008,979333,325,EVM,mRNA,523755,1343336,325,1.00
ptg001826l,3421069,3421405,336,EVM,mRNA,2781843,4947314,336,1.00
ptg001827l,1399229,1399511,282,EVM,mRNA,34882,2016689,282,1.00
ptg001827l,1977767,1978082,315,EVM,mRNA,34882,2016689,315,1.00
ptg001830l,425174,425482,308,EVM,mRNA,171220,686220,308,1.00
ptg001833l,384576,384892,316,EVM,mRNA,27174,1668239,316,1.00
ptg001833l,392283,392598,315,EVM,mRNA,27174,1668239,315,1.00
ptg001834l,1894370,1894684,314,EVM,mRNA,1695653,3173375,314,1.00
ptg001834l,2105537,2105860,323,EVM,mRNA,1695653,3173375,323,1.00
ptg001834l,2868099,2868395,296,EVM,mRNA,1695653,3173375,296,1.00
ptg001835l,1037817,1038094,277,EVM,mRNA,814371,1059848,277,1.00
ptg001835l,1062173,1062504,331,EVM,mRNA,1062464,1117842,41,0.12
ptg001836l,1475237,1475541,304,EVM,mRNA,1382013,1709669,304,1.00
ptg001836l,2437029,2437304,275,EVM,mRNA,2423624,3085280,275,1.00
ptg001836l,2924131,2924444,313,EVM,mRNA,2423624,3085280,313,1.00
ptg001836l,2939506,2939814,308,EVM,mRNA,2423624,3085280,308,1.00
ptg001836l,3024844,3025138,294,EVM,mRNA,2423624,3085280,294,1.00
ptg001839l,87235,87517,282,EVM,mRNA,18912,404191,282,1.00
ptg001840l,587552,587852,300,EVM,mRNA,336866,1217228,300,1.00
ptg001842l,6152720,6153034,314,EVM,mRNA,6070298,6220945,314,1.00
ptg001849l,990638,990941,303,EVM,mRNA,654846,1384581,303,1.00
ptg001850l,200340,200629,289,EVM,mRNA,500,2066080,289,1.00
ptg001851l,2266859,2267167,308,EVM,mRNA,1119723,2475796,308,1.00
ptg001851l,3305903,3306178,275,EVM,mRNA,3029555,5173891,275,1.00
ptg001851l,3458191,3458518,327,EVM,mRNA,3029555,5173891,327,1.00
ptg001851l,4058287,4058598,311,EVM,mRNA,3029555,5173891,311,1.00
ptg001851l,4263395,4263684,289,EVM,mRNA,3029555,5173891,289,1.00
ptg001851l,4861374,4861684,310,EVM,mRNA,3029555,5173891,310,1.00
ptg001852l,1554346,1554638,292,EVM,mRNA,1422766,2114131,292,1.00
ptg001854l,2109045,2109333,288,EVM,mRNA,1822728,2249407,288,1.00
ptg001854l,3076131,3076430,299,EVM,mRNA,2680822,3102134,299,1.00
ptg001856l,568334,568622,288,EVM,mRNA,543052,584470,288,1.00
ptg001858l,3041159,3041479,320,EVM,mRNA,2847222,3117665,320,1.00
ptg001858l,6496072,6496375,303,EVM,mRNA,4662854,6624845,303,1.00
ptg001862l,3780885,3781203,318,EVM,mRNA,2272161,4616489,318,1.00
ptg001863l,2275780,2276101,321,EVM,mRNA,1918482,3452456,321,1.00
ptg001863l,2792262,2792555,293,EVM,mRNA,1918482,3452456,293,1.00
ptg001863l,3358052,3358349,297,EVM,mRNA,1918482,3452456,297,1.00
ptg001863l,7360997,7361280,283,EVM,mRNA,6735118,8874986,283,1.00
ptg001863l,7417266,7417535,269,EVM,mRNA,6735118,8874986,269,1.00
ptg001863l,7636895,7637190,295,EVM,mRNA,6735118,8874986,295,1.00
ptg001863l,7829859,7830143,284,EVM,mRNA,6735118,8874986,284,1.00
ptg001863l,7849080,7849379,299,EVM,mRNA,6735118,8874986,299,1.00
ptg001863l,8111781,8112086,305,EVM,mRNA,6735118,8874986,305,1.00
ptg001863l,8129643,8129947,304,EVM,mRNA,6735118,8874986,304,1.00
ptg001863l,8365599,8365922,323,EVM,mRNA,6735118,8874986,323,1.00
ptg001863l,8586166,8586438,272,EVM,mRNA,6735118,8874986,272,1.00
ptg001863l,8666841,8667140,299,EVM,mRNA,6735118,8874986,299,1.00
ptg001863l,9958499,9958790,291,EVM,mRNA,9202779,10258793,291,1.00
ptg001866l,1148718,1149006,288,EVM,mRNA,106355,1463172,288,1.00
ptg001867l,716970,717274,304,EVM,mRNA,336861,2630336,304,1.00
ptg001867l,1240229,1240531,302,EVM,mRNA,336861,2630336,302,1.00
ptg001867l,2185029,2185276,247,EVM,mRNA,336861,2630336,247,1.00
ptg001875l,774963,775251,288,EVM,mRNA,118789,2213793,288,1.00
ptg001875l,2374903,2375208,305,EVM,mRNA,2357970,2492831,305,1.00
ptg001875l,3355155,3355437,282,EVM,mRNA,3229648,3390018,282,1.00
ptg001875l,3897652,3897944,292,EVM,mRNA,3828050,4278420,292,1.00
ptg001876l,765568,765852,284,EVM,mRNA,10928,2043860,284,1.00
ptg001877l,1546241,1546557,316,EVM,mRNA,1182614,1557866,316,1.00
ptg001878l,1625067,1625398,331,EVM,mRNA,994276,1693698,331,1.00
ptg001878l,5491238,5491554,316,EVM,mRNA,3853227,6780809,316,1.00
ptg001878l,5822072,5822357,285,EVM,mRNA,3853227,6780809,285,1.00
ptg001878l,6208851,6209158,307,EVM,mRNA,3853227,6780809,307,1.00
ptg001878l,6299775,6300087,312,EVM,mRNA,3853227,6780809,312,1.00
ptg001878l,7969599,7969918,319,EVM,mRNA,7942179,8407240,319,1.00
ptg001878l,9224484,9224807,323,EVM,mRNA,9193093,9678826,323,1.00
ptg001881l,246339,246628,289,EVM,mRNA,62691,592540,289,1.00
ptg001881l,418947,419243,296,EVM,mRNA,62691,592540,296,1.00
ptg001887l,139058,139354,296,EVM,mRNA,5822,1526969,296,1.00
ptg001887l,1015259,1015547,288,EVM,mRNA,5822,1526969,288,1.00
ptg001887l,1038020,1038326,306,EVM,mRNA,5822,1526969,306,1.00
ptg001887l,1355775,1356091,316,EVM,mRNA,5822,1526969,316,1.00
ptg001891l,418969,419259,290,EVM,mRNA,377393,790056,290,1.00
ptg001891l,1898347,1898630,283,EVM,mRNA,876859,5733881,283,1.00
ptg001891l,1998599,1998910,311,EVM,mRNA,876859,5733881,311,1.00
ptg001891l,4703427,4703743,316,EVM,mRNA,876859,5733881,316,1.00
ptg001895l,497852,498167,315,EVM,mRNA,4696,2134335,315,1.00
ptg001895l,2446567,2446843,276,EVM,mRNA,2418422,2449799,276,1.00
ptg001899l,2427990,2428321,331,EVM,mRNA,2023200,3000698,331,1.00
ptg001902l,422002,422322,320,EVM,mRNA,339053,608280,320,1.00
ptg001904l,783266,783595,329,EVM,mRNA,589995,967189,329,1.00
ptg001906l,1131353,1131623,270,EVM,mRNA,70712,1289525,270,1.00
ptg001906l,2765735,2766024,289,EVM,mRNA,2697445,3732901,289,1.00
ptg001906l,5621389,5621689,300,EVM,mRNA,4798119,6430875,300,1.00
ptg001906l,5919208,5919519,311,EVM,mRNA,4798119,6430875,311,1.00
ptg001908l,825181,825496,315,EVM,mRNA,417059,985812,315,1.00
ptg001908l,895660,895939,279,EVM,mRNA,417059,985812,279,1.00
ptg001909l,2136185,2136509,324,EVM,mRNA,320093,2294583,324,1.00
ptg001909l,2978363,2978664,301,EVM,mRNA,2570767,3087109,301,1.00
ptg001909l,5609315,5609612,297,EVM,mRNA,5545655,5618263,297,1.00
ptg001909l,5609315,5609612,297,GeneWise,mRNA,5545655,5785565,297,1.00
ptg001910l,121688,121989,301,EVM,mRNA,69914,533397,301,1.00
ptg001910l,263539,263824,285,EVM,mRNA,69914,533397,285,1.00
ptg001910l,1429348,1429665,317,EVM,mRNA,851835,1752255,317,1.00
ptg001911l,652168,652431,263,EVM,mRNA,190328,1868541,263,1.00
ptg001911l,1223806,1224118,312,EVM,mRNA,190328,1868541,312,1.00
ptg001911l,1475636,1475917,281,EVM,mRNA,190328,1868541,281,1.00
ptg001911l,1850337,1850651,314,EVM,mRNA,190328,1868541,314,1.00
ptg001914l,2051478,2051794,316,EVM,mRNA,1700469,3717953,316,1.00
ptg001914l,4751965,4752259,294,EVM,mRNA,3869457,5010792,294,1.00
ptg001925l,706253,706549,296,EVM,mRNA,24489,1160623,296,1.00
ptg001931l,2011371,2011671,300,EVM,mRNA,1410748,2467359,300,1.00
ptg001933l,134401,134709,308,EVM,mRNA,10426,198601,308,1.00
ptg001933l,149800,150080,280,EVM,mRNA,10426,198601,280,1.00
ptg001933l,2388830,2389113,283,EVM,mRNA,2026545,2679843,283,1.00
ptg001933l,3500686,3500964,278,EVM,mRNA,3411259,3643094,278,1.00
ptg001935l,2227756,2228052,296,EVM,mRNA,1973020,2285256,296,1.00
ptg001936l,631322,631649,327,EVM,mRNA,347721,2056706,327,1.00
ptg001936l,3263084,3263442,358,EVM,mRNA,2406985,3349659,358,1.00
ptg001936l,5255222,5255519,297,EVM,mRNA,5217201,5267176,297,1.00
ptg001938l,1525853,1526167,314,EVM,mRNA,1325452,1630112,314,1.00
ptg001938l,2276872,2277174,302,EVM,mRNA,1823577,4376447,302,1.00
ptg001938l,2888649,2888924,275,EVM,mRNA,1823577,4376447,275,1.00
ptg001938l,3754424,3754750,326,EVM,mRNA,1823577,4376447,326,1.00
ptg001938l,4135288,4135594,306,EVM,mRNA,1823577,4376447,306,1.00
ptg001939l,388751,389066,315,EVM,mRNA,188,605677,315,1.00
ptg001940l,224568,224900,332,EVM,mRNA,66483,441689,332,1.00
ptg001943l,547195,547481,286,EVM,mRNA,490422,2911216,286,1.00
ptg001943l,648640,648920,280,EVM,mRNA,490422,2911216,280,1.00
ptg001943l,1396028,1396313,285,EVM,mRNA,490422,2911216,285,1.00
ptg001943l,5819791,5820110,319,EVM,mRNA,5644207,5889197,319,1.00
ptg001944l,1519677,1519984,307,EVM,mRNA,998219,1542550,307,1.00
ptg001947l,1579364,1579668,304,EVM,mRNA,1488435,1957333,304,1.00
ptg001949l,549563,549884,321,EVM,mRNA,193402,713285,321,1.00
ptg001950l,1491873,1492170,297,EVM,mRNA,259988,2755119,297,1.00
ptg001954l,632293,632574,281,EVM,mRNA,527928,892949,281,1.00
ptg001954l,850956,851250,294,EVM,mRNA,527928,892949,294,1.00
ptg001954l,4268399,4268674,275,EVM,mRNA,3894968,5960629,275,1.00
ptg001954l,5051476,5051781,305,EVM,mRNA,3894968,5960629,305,1.00
ptg001954l,5060045,5060332,287,EVM,mRNA,3894968,5960629,287,1.00
ptg001956l,323813,324130,317,EVM,mRNA,257460,371892,317,1.00
ptg001956l,340664,340953,289,EVM,mRNA,257460,371892,289,1.00
ptg001956l,342758,343076,318,EVM,mRNA,257460,371892,318,1.00
ptg001957l,3171625,3171899,274,EVM,mRNA,1928781,3183104,274,1.00
ptg001958l,654197,654502,305,EVM,mRNA,326245,1003480,305,1.00
ptg001958l,736448,736777,329,EVM,mRNA,326245,1003480,329,1.00
ptg001959l,811469,811771,302,EVM,mRNA,578777,1288272,302,1.00
ptg001959l,1531757,1532056,299,EVM,mRNA,1368895,2244927,299,1.00
ptg001959l,1970574,1970882,308,EVM,mRNA,1368895,2244927,308,1.00
ptg001959l,2032838,2033095,257,EVM,mRNA,1368895,2244927,257,1.00
ptg001964l,1428002,1428291,289,EVM,mRNA,1135134,1822095,289,1.00
ptg001964l,1581836,1582122,286,EVM,mRNA,1135134,1822095,286,1.00
ptg001964l,3041450,3041755,305,EVM,mRNA,1966400,3119675,305,1.00
ptg001965l,1638814,1639113,299,EVM,mRNA,1522029,1885997,299,1.00
ptg001965l,1708895,1709173,278,EVM,mRNA,1522029,1885997,278,1.00
ptg001965l,2227819,2228115,296,EVM,mRNA,2009358,3012090,296,1.00
ptg001967l,614626,614943,317,EVM,mRNA,387912,1000610,317,1.00
ptg001967l,1933921,1934227,306,EVM,mRNA,1911800,2531253,306,1.00
ptg001967l,1986618,1986906,288,EVM,mRNA,1911800,2531253,288,1.00
ptg001969l,952772,953092,320,EVM,mRNA,926511,1298626,320,1.00
ptg001971l,919993,920302,309,EVM,mRNA,819765,1185995,309,1.00
ptg001972l,1325991,1326295,304,EVM,mRNA,1217146,3227572,304,1.00
ptg001972l,1745669,1745951,282,EVM,mRNA,1217146,3227572,282,1.00
ptg001972l,1955525,1955825,300,EVM,mRNA,1217146,3227572,300,1.00
ptg001972l,2865324,2865611,287,EVM,mRNA,1217146,3227572,287,1.00
ptg001972l,4796891,4797196,305,EVM,mRNA,4796722,5622751,305,1.00
ptg001972l,5392241,5392520,279,EVM,mRNA,4796722,5622751,279,1.00
ptg001973l,435994,436309,315,EVM,mRNA,374717,575971,315,1.00
ptg001974l,2242300,2242606,306,EVM,mRNA,1961542,2646171,306,1.00
ptg001974l,2486860,2487165,305,EVM,mRNA,1961542,2646171,305,1.00
ptg001975l,4083237,4083529,292,EVM,mRNA,3744461,4457980,292,1.00
ptg001979l,161344,161664,320,EVM,mRNA,1828,2400777,320,1.00
ptg001979l,522964,523290,326,EVM,mRNA,1828,2400777,326,1.00
ptg001981l,377734,378051,317,EVM,mRNA,141379,398736,317,1.00
ptg001982l,989513,989843,330,EVM,mRNA,285047,2030422,330,1.00
ptg001983l,478301,478589,288,EVM,mRNA,385353,534639,288,1.00
ptg001988l,130665,130935,270,EVM,mRNA,111046,1218202,270,1.00
ptg001988l,166523,166835,312,EVM,mRNA,111046,1218202,312,1.00
ptg001988l,500341,500662,321,EVM,mRNA,111046,1218202,321,1.00
ptg001988l,763017,763325,308,EVM,mRNA,111046,1218202,308,1.00
ptg001992l,637137,637450,313,EVM,mRNA,206197,2543248,313,1.00
ptg001992l,2313599,2313923,324,EVM,mRNA,206197,2543248,324,1.00
ptg001992l,2507714,2508034,320,EVM,mRNA,206197,2543248,320,1.00
ptg001993l,244044,244337,293,EVM,mRNA,7248,976369,293,1.00
ptg001993l,681040,681320,280,EVM,mRNA,7248,976369,280,1.00
ptg001993l,755574,755904,330,EVM,mRNA,7248,976369,330,1.00
ptg001993l,1620565,1620846,281,EVM,mRNA,1409224,3234167,281,1.00
ptg001993l,1718173,1718449,276,EVM,mRNA,1409224,3234167,276,1.00
ptg001993l,1765550,1765833,283,EVM,mRNA,1409224,3234167,283,1.00
ptg001993l,2447805,2448071,266,EVM,mRNA,1409224,3234167,266,1.00
ptg001993l,2820289,2820605,316,EVM,mRNA,1409224,3234167,316,1.00
ptg001994l,917462,917755,293,EVM,mRNA,844777,1418528,293,1.00
ptg001996l,946582,946920,338,EVM,mRNA,609972,1443106,338,1.00
ptg001998l,437826,438113,287,EVM,mRNA,1181,516527,287,1.00
ptg001998l,474047,474331,284,EVM,mRNA,1181,516527,284,1.00
ptg001999l,215091,215372,281,EVM,mRNA,42242,1135921,281,1.00
ptg002000l,541250,541568,318,EVM,mRNA,18595,888482,318,1.00
ptg002000l,1094205,1094518,313,EVM,mRNA,1067026,1234592,313,1.00
ptg002003l,1907182,1907485,303,EVM,mRNA,965909,2464575,303,1.00
ptg002003l,2011051,2011337,286,EVM,mRNA,965909,2464575,286,1.00
ptg002003l,3465169,3465483,314,EVM,mRNA,2606250,3666723,314,1.00
ptg002004l,341924,342214,290,EVM,mRNA,318736,357645,290,1.00
ptg002010l,718208,718518,310,EVM,mRNA,680668,759037,310,1.00
ptg002011l,470909,471219,310,EVM,mRNA,197131,597859,310,1.00
ptg002011l,2992634,2992922,288,EVM,mRNA,2792143,3386355,288,1.00
ptg002011l,3087030,3087319,289,EVM,mRNA,2792143,3386355,289,1.00
ptg002013l,1135618,1135933,315,EVM,mRNA,291755,2038464,315,1.00
ptg002013l,1290471,1290747,276,EVM,mRNA,291755,2038464,276,1.00
ptg002014l,4217165,4217463,298,EVM,mRNA,4082019,4376588,298,1.00
ptg002015l,3210607,3210911,304,EVM,mRNA,2958045,3408751,304,1.00
ptg002022l,1365940,1366260,320,EVM,mRNA,1226678,1680543,320,1.00
ptg002022l,1373162,1373440,278,EVM,mRNA,1226678,1680543,278,1.00
ptg002022l,4285662,4285981,319,EVM,mRNA,4283615,4511861,319,1.00
ptg002022l,4308270,4308553,283,EVM,mRNA,4283615,4511861,283,1.00
ptg002022l,6045191,6045514,323,EVM,mRNA,5907644,6366654,323,1.00
ptg002024l,3679482,3679777,295,EVM,mRNA,3611754,3785609,295,1.00
ptg002024l,5123604,5123886,282,EVM,mRNA,5120200,5218295,282,1.00
ptg002024l,5144947,5145232,285,EVM,mRNA,5120200,5218295,285,1.00
ptg002027l,2349992,2350267,275,EVM,mRNA,1207558,3289175,275,1.00
ptg002027l,2963674,2964000,326,EVM,mRNA,1207558,3289175,326,1.00
ptg002030l,573853,574153,300,EVM,mRNA,333316,638388,300,1.00
ptg002036l,638578,638894,316,EVM,mRNA,25642,1636507,316,1.00
ptg002036l,1158852,1159167,315,EVM,mRNA,25642,1636507,315,1.00
ptg002037l,3149578,3149879,301,EVM,mRNA,2671990,3331915,301,1.00
ptg002038l,2035490,2035795,305,EVM,mRNA,15536,2170373,305,1.00
ptg002043l,269976,270292,316,EVM,mRNA,190081,2895450,316,1.00
ptg002043l,1178153,1178415,262,EVM,mRNA,190081,2895450,262,1.00
ptg002043l,5028101,5028393,292,EVM,mRNA,4783586,6665530,292,1.00
ptg002043l,5920513,5920835,322,EVM,mRNA,4783586,6665530,322,1.00
ptg002043l,5984036,5984343,307,EVM,mRNA,4783586,6665530,307,1.00
ptg002043l,6165682,6165944,262,EVM,mRNA,4783586,6665530,262,1.00
ptg002043l,6596350,6596603,253,EVM,mRNA,4783586,6665530,253,1.00
ptg002046l,1327204,1327518,314,EVM,mRNA,230906,2353889,314,1.00
ptg002048l,2023326,2023610,284,EVM,mRNA,1519966,2275439,284,1.00
ptg002048l,4220908,4221213,305,EVM,mRNA,4209837,4551593,305,1.00
ptg002049l,749925,750212,287,EVM,mRNA,567676,764136,287,1.00
ptg002051l,785129,785414,285,EVM,mRNA,763849,1010157,285,1.00
ptg002051l,856290,856569,279,EVM,mRNA,763849,1010157,279,1.00
ptg002051l,1763387,1763707,320,EVM,mRNA,1506554,2059442,320,1.00
ptg002051l,2619812,2620118,306,EVM,mRNA,2377159,3326118,306,1.00
ptg002052l,391893,392193,300,EVM,mRNA,187049,693356,300,1.00
ptg002054l,445238,445524,286,EVM,mRNA,393407,600380,286,1.00
ptg002055l,3141066,3141377,311,EVM,mRNA,2812401,3426734,311,1.00
ptg002058l,2044165,2044461,296,EVM,mRNA,1859658,2105402,296,1.00
ptg002058l,2778365,2778639,274,EVM,mRNA,2655508,2792690,274,1.00
ptg002059l,1468969,1469275,306,EVM,mRNA,532197,1673758,306,1.00
ptg002063l,979333,979615,282,EVM,mRNA,642141,1899204,282,1.00
ptg002063l,1144202,1144528,326,EVM,mRNA,642141,1899204,326,1.00
ptg002064l,2813458,2813771,313,EVM,mRNA,2647149,3879032,313,1.00
ptg002064l,3328314,3328630,316,EVM,mRNA,2647149,3879032,316,1.00
ptg002065l,2486200,2486486,286,EVM,mRNA,1310861,2837889,286,1.00
ptg002071l,689146,689445,299,EVM,mRNA,650613,1113682,299,1.00
ptg002072l,3021383,3021716,333,EVM,mRNA,2153128,3248574,333,1.00
ptg002072l,3512038,3512355,317,EVM,mRNA,3444297,4108151,317,1.00
ptg002072l,3761736,3762026,290,EVM,mRNA,3444297,4108151,290,1.00
ptg002072l,4088902,4089211,309,EVM,mRNA,3444297,4108151,309,1.00
ptg002072l,4102788,4103102,314,EVM,mRNA,3444297,4108151,314,1.00
ptg002072l,4918718,4919002,284,EVM,mRNA,4743852,5064273,284,1.00
ptg002072l,5023562,5023858,296,EVM,mRNA,4743852,5064273,296,1.00
ptg002073l,3039061,3039386,325,EVM,mRNA,2929706,3045023,325,1.00
ptg002074l,2551225,2551516,291,EVM,mRNA,1298504,3782553,291,1.00
ptg002074l,3244468,3244783,315,EVM,mRNA,1298504,3782553,315,1.00
ptg002074l,5706585,5706922,337,EVM,mRNA,5506736,5857650,337,1.00
ptg002075l,924611,924916,305,EVM,mRNA,903020,1354245,305,1.00
ptg002075l,1888541,1888840,299,EVM,mRNA,1610761,2485737,299,1.00
ptg002077l,285602,285919,317,EVM,mRNA,284164,396374,317,1.00
ptg002079l,1073589,1073923,334,EVM,mRNA,961780,2195692,334,1.00
ptg002079l,1128283,1128595,312,EVM,mRNA,961780,2195692,312,1.00
ptg002079l,1650478,1650807,329,EVM,mRNA,961780,2195692,329,1.00
ptg002079l,1903483,1903786,303,EVM,mRNA,961780,2195692,303,1.00
ptg002079l,3152810,3153126,316,EVM,mRNA,3058412,3330857,316,1.00
ptg002083l,2455435,2455757,322,EVM,mRNA,1515298,4912739,322,1.00
ptg002083l,2710681,2710996,315,EVM,mRNA,1515298,4912739,315,1.00
ptg002083l,3524459,3524763,304,EVM,mRNA,1515298,4912739,304,1.00
ptg002084l,522284,522581,297,EVM,mRNA,509902,1014881,297,1.00
ptg002084l,820081,820378,297,EVM,mRNA,509902,1014881,297,1.00
ptg002085l,7803119,7803385,266,EVM,mRNA,7657044,8512102,266,1.00
ptg002086l,976015,976291,276,EVM,mRNA,678575,1189476,276,1.00
ptg002087l,1466581,1466892,311,EVM,mRNA,1302859,1600805,311,1.00
ptg002087l,4043134,4043459,325,EVM,mRNA,3137978,4509189,325,1.00
ptg002087l,4317548,4317861,313,EVM,mRNA,3137978,4509189,313,1.00
ptg002088l,919183,919501,318,EVM,mRNA,804157,1658884,318,1.00
ptg002088l,3544455,3544773,318,EVM,mRNA,2674323,4043983,318,1.00
ptg002089l,2886714,2886993,279,EVM,mRNA,2343712,3474895,279,1.00
ptg002089l,3072679,3072969,290,EVM,mRNA,2343712,3474895,290,1.00
ptg002089l,3459160,3459438,278,EVM,mRNA,2343712,3474895,278,1.00
ptg002090l,908625,908923,298,EVM,mRNA,823014,1166772,298,1.00
ptg002091l,2870948,2871260,312,EVM,mRNA,2479944,3331384,312,1.00
ptg002096l,568101,568419,318,EVM,mRNA,532104,694419,318,1.00
ptg002100l,4203165,4203436,271,EVM,mRNA,4181114,5531526,271,1.00
ptg002100l,5238996,5239274,278,EVM,mRNA,4181114,5531526,278,1.00
ptg002101l,1449765,1450062,297,EVM,mRNA,1402837,1798886,297,1.00
ptg002102l,545221,545519,298,EVM,mRNA,525860,1163331,298,1.00
ptg002102l,743014,743312,298,EVM,mRNA,525860,1163331,298,1.00
ptg002102l,966918,967249,331,EVM,mRNA,525860,1163331,331,1.00
ptg002102l,1148649,1148930,281,EVM,mRNA,525860,1163331,281,1.00
ptg002102l,2960953,2961248,295,EVM,mRNA,2442736,3157494,295,1.00
ptg002102l,2963387,2963688,301,EVM,mRNA,2442736,3157494,301,1.00
ptg002103l,2484957,2485256,299,EVM,mRNA,2369599,2644354,299,1.00
ptg002103l,2529049,2529337,288,EVM,mRNA,2369599,2644354,288,1.00
ptg002104l,327192,327506,314,EVM,mRNA,65294,2202545,314,1.00
ptg002106l,1104237,1104534,297,EVM,mRNA,556343,1759312,297,1.00
ptg002108l,1290391,1290646,255,EVM,mRNA,1082845,1393765,255,1.00
ptg002109l,416428,416729,301,EVM,mRNA,357828,470511,301,1.00
ptg002109l,1078757,1079043,286,EVM,mRNA,1058954,1240039,286,1.00
ptg002116l,2533521,2533826,305,EVM,mRNA,1417928,2797461,305,1.00
ptg002118l,3255475,3255771,296,EVM,mRNA,2893584,3484415,296,1.00
ptg002120l,1039796,1040083,287,EVM,mRNA,585286,1513272,287,1.00
ptg002123l,936822,937131,309,EVM,mRNA,602660,3672059,309,1.00
ptg002124l,753817,754132,315,EVM,mRNA,664126,807477,315,1.00
ptg002130l,3944451,3944767,316,EVM,mRNA,3878263,4389363,316,1.00
ptg002130l,4314048,4314346,298,EVM,mRNA,3878263,4389363,298,1.00
ptg002132l,1102058,1102383,325,EVM,mRNA,1053626,1218515,325,1.00
ptg002133l,931002,931290,288,EVM,mRNA,68578,951234,288,1.00
ptg002134l,2324549,2324836,287,EVM,mRNA,2045771,2537803,287,1.00
ptg002134l,2394548,2394867,319,EVM,mRNA,2045771,2537803,319,1.00
ptg002136l,716414,716721,307,EVM,mRNA,701726,754291,307,1.00
ptg002139l,1350441,1350740,299,EVM,mRNA,435390,1707135,299,1.00
ptg002140l,1967450,1967727,277,EVM,mRNA,1512924,2021079,277,1.00
ptg002141l,1506742,1507028,286,EVM,mRNA,693717,3475888,286,1.00
ptg002141l,1628989,1629281,292,EVM,mRNA,693717,3475888,292,1.00
ptg002141l,3215141,3215436,295,EVM,mRNA,693717,3475888,295,1.00
ptg002143l,1055139,1055464,325,EVM,mRNA,723853,1705789,325,1.00
ptg002143l,4309982,4310263,281,EVM,mRNA,3840724,5152526,281,1.00
ptg002143l,4388254,4388562,308,EVM,mRNA,3840724,5152526,308,1.00
ptg002147l,2613943,2614274,331,EVM,mRNA,1455388,2759699,331,1.00
ptg002150l,2136347,2136666,319,EVM,mRNA,1680639,2892477,319,1.00
ptg002150l,2886355,2886675,320,EVM,mRNA,1680639,2892477,320,1.00
ptg002155l,701277,701553,276,EVM,mRNA,28181,1417368,276,1.00
ptg002155l,2304138,2304435,297,EVM,mRNA,1820570,2849348,297,1.00
ptg002155l,3228276,3228592,316,EVM,mRNA,2998367,3444858,316,1.00
ptg002159l,1899116,1899408,292,EVM,mRNA,191532,2674748,292,1.00
ptg002159l,2574354,2574677,323,EVM,mRNA,191532,2674748,323,1.00
ptg002159l,4121541,4121842,301,EVM,mRNA,4071310,4623257,301,1.00
ptg002159l,4586180,4586505,325,EVM,mRNA,4071310,4623257,325,1.00
ptg002159l,5929490,5929788,298,EVM,mRNA,5799371,5980424,298,1.00
ptg002163l,1551389,1551689,300,EVM,mRNA,1187367,3319412,300,1.00
ptg002163l,3168472,3168781,309,EVM,mRNA,1187367,3319412,309,1.00
ptg002172l,109468,109731,263,EVM,mRNA,35842,180332,263,1.00
ptg002173l,4858734,4859059,325,EVM,mRNA,4551038,4864111,325,1.00
ptg002174l,558597,558890,293,EVM,mRNA,373067,1268708,293,1.00
ptg002174l,1020960,1021264,304,EVM,mRNA,373067,1268708,304,1.00
ptg002174l,2290759,2291048,289,EVM,mRNA,2254604,2949587,289,1.00
ptg002174l,3517310,3517602,292,EVM,mRNA,3251402,3590437,292,1.00
ptg002176l,535336,535657,321,EVM,mRNA,21573,815766,321,1.00
ptg002176l,644957,645281,324,EVM,mRNA,21573,815766,324,1.00
ptg002178l,1085873,1086164,291,EVM,mRNA,886513,1585318,291,1.00
ptg002178l,1492887,1493177,290,EVM,mRNA,886513,1585318,290,1.00
ptg002180l,664731,665050,319,EVM,mRNA,29143,706591,319,1.00
ptg002180l,2057218,2057528,310,EVM,mRNA,2043828,2123417,310,1.00
ptg002180l,2096797,2097065,268,EVM,mRNA,2043828,2123417,268,1.00
ptg002181l,868092,868391,299,EVM,mRNA,749041,1666817,299,1.00
ptg002183l,226427,226678,251,EVM,mRNA,87111,1339517,251,1.00
ptg002183l,335824,336158,334,EVM,mRNA,87111,1339517,334,1.00
ptg002184l,1971420,1971744,324,EVM,mRNA,1037513,2904846,324,1.00
ptg002184l,5172987,5173282,295,EVM,mRNA,5159383,5738851,295,1.00
ptg002186l,1072632,1072959,327,EVM,mRNA,378593,1193687,327,1.00
ptg002186l,1862310,1862606,296,EVM,mRNA,1835221,1927764,296,1.00
ptg002187l,210519,210815,296,EVM,mRNA,110026,936648,296,1.00
ptg002187l,530279,530599,320,EVM,mRNA,110026,936648,320,1.00
ptg002188l,1081217,1081514,297,EVM,mRNA,985341,1111892,297,1.00
ptg002188l,2047170,2047506,336,EVM,mRNA,1116598,2366049,336,1.00
ptg002191l,110093,110374,281,EVM,mRNA,57151,738953,281,1.00
ptg002191l,186096,186413,317,EVM,mRNA,57151,738953,317,1.00
ptg002191l,372967,373256,289,EVM,mRNA,57151,738953,289,1.00
ptg002191l,1060756,1061062,306,EVM,mRNA,934761,1276069,306,1.00
ptg002192l,1210387,1210680,293,EVM,mRNA,634065,1730025,293,1.00
ptg002192l,1484314,1484604,290,EVM,mRNA,634065,1730025,290,1.00
ptg002193l,359370,359608,238,EVM,mRNA,192926,1875578,238,1.00
ptg002193l,2231183,2231494,311,EVM,mRNA,1930651,2234063,311,1.00
ptg002196l,413589,413887,298,EVM,mRNA,159278,524196,298,1.00
ptg002197l,1958059,1958335,276,EVM,mRNA,106781,2103063,276,1.00
ptg002214l,812188,812496,308,EVM,mRNA,356821,929294,308,1.00
ptg002217l,1809835,1810132,297,EVM,mRNA,1314841,2349744,297,1.00
ptg002217l,3931159,3931474,315,EVM,mRNA,3921007,4083168,315,1.00
ptg002217l,4015448,4015755,307,EVM,mRNA,3921007,4083168,307,1.00
ptg002219l,3282094,3282369,275,EVM,mRNA,3115897,3378026,275,1.00
ptg002219l,3614610,3614955,345,EVM,mRNA,3418876,4034743,345,1.00
ptg002221l,4275413,4275712,299,EVM,mRNA,4234279,4484241,299,1.00
ptg002221l,4432797,4433084,287,EVM,mRNA,4234279,4484241,287,1.00
ptg002221l,5860475,5860792,317,EVM,mRNA,5598384,5918540,317,1.00
ptg002224l,872694,872963,269,EVM,mRNA,472672,1488434,269,1.00
ptg002224l,1332110,1332440,330,EVM,mRNA,472672,1488434,330,1.00
ptg002224l,1422419,1422700,281,EVM,mRNA,472672,1488434,281,1.00
ptg002225l,1472837,1473111,274,EVM,mRNA,1129917,1484633,274,1.00
ptg002225l,2184068,2184358,290,EVM,mRNA,1981841,2284736,290,1.00
ptg002225l,2837717,2838001,284,EVM,mRNA,2325155,3193604,284,1.00
ptg002225l,3559655,3559931,276,EVM,mRNA,3463103,3596629,276,1.00
ptg002225l,4583660,4583988,328,EVM,mRNA,4560411,4665806,328,1.00
ptg002226l,1909366,1909646,280,EVM,mRNA,1902207,5466428,280,1.00
ptg002226l,2962987,2963289,302,EVM,mRNA,1902207,5466428,302,1.00
ptg002226l,7948001,7948295,294,EVM,mRNA,7027475,8425030,294,1.00
ptg002226l,8319887,8320168,281,EVM,mRNA,7027475,8425030,281,1.00
ptg002226l,9035911,9036174,263,EVM,mRNA,8885846,9312984,263,1.00
ptg002227l,680463,680744,281,EVM,mRNA,595146,804835,281,1.00
ptg002228l,2031124,2031402,278,EVM,mRNA,1785387,2040647,278,1.00
ptg002229l,1767031,1767343,312,EVM,mRNA,1457449,2946949,312,1.00
ptg002229l,2302642,2302916,274,EVM,mRNA,1457449,2946949,274,1.00
ptg002229l,2326649,2326978,329,EVM,mRNA,1457449,2946949,329,1.00
ptg002233l,1691630,1691906,276,EVM,mRNA,1189869,2546705,276,1.00
ptg002233l,2500739,2501051,312,EVM,mRNA,1189869,2546705,312,1.00
ptg002233l,3153258,3153572,314,EVM,mRNA,3007038,3285868,314,1.00
ptg002237l,2337415,2337705,290,EVM,mRNA,2333556,2406042,290,1.00
ptg002239l,130996,131284,288,EVM,mRNA,3511,963471,288,1.00
ptg002240l,1525054,1525364,310,EVM,mRNA,1258751,1594409,310,1.00
ptg002241l,241829,242140,311,EVM,mRNA,25619,2554558,311,1.00
ptg002241l,507393,507723,330,EVM,mRNA,25619,2554558,330,1.00
ptg002241l,958122,958438,316,EVM,mRNA,25619,2554558,316,1.00
ptg002241l,1537998,1538332,334,EVM,mRNA,25619,2554558,334,1.00
ptg002241l,1936015,1936354,339,EVM,mRNA,25619,2554558,339,1.00
ptg002244l,970816,971128,312,EVM,mRNA,805635,1843180,312,1.00
ptg002249l,569116,569430,314,EVM,mRNA,62544,2467563,314,1.00
ptg002249l,1612304,1612584,280,EVM,mRNA,62544,2467563,280,1.00
ptg002249l,1721586,1721867,281,EVM,mRNA,62544,2467563,281,1.00
ptg002249l,2068019,2068344,325,EVM,mRNA,62544,2467563,325,1.00
ptg002249l,2086661,2086975,314,EVM,mRNA,62544,2467563,314,1.00
ptg002249l,4226978,4227281,303,EVM,mRNA,4181500,4605728,303,1.00
ptg002253l,319271,319577,306,EVM,mRNA,13697,1085474,306,1.00
ptg002253l,337515,337798,283,EVM,mRNA,13697,1085474,283,1.00
ptg002254l,440986,441277,291,EVM,mRNA,20991,971219,291,1.00
ptg002256l,514953,515271,318,EVM,mRNA,267231,948957,318,1.00
ptg002257l,446835,447125,290,EVM,mRNA,3486,1576957,290,1.00
ptg002257l,1461091,1461399,308,EVM,mRNA,3486,1576957,308,1.00
ptg002257l,1499546,1499814,268,EVM,mRNA,3486,1576957,268,1.00
ptg002259l,109152,109460,308,EVM,mRNA,49347,302014,308,1.00
ptg002259l,142555,142855,300,EVM,mRNA,49347,302014,300,1.00
ptg002259l,1434659,1434960,301,EVM,mRNA,1182020,1698697,301,1.00
ptg002259l,1646170,1646448,278,EVM,mRNA,1182020,1698697,278,1.00
ptg002260l,396683,396971,288,EVM,mRNA,263247,521267,288,1.00
ptg002260l,495090,495414,324,EVM,mRNA,263247,521267,324,1.00
ptg002262l,3785234,3785520,286,EVM,mRNA,3375074,3933242,286,1.00
ptg002266l,1779560,1779859,299,EVM,mRNA,711154,3041922,299,1.00
ptg002268l,1913369,1913675,306,EVM,mRNA,94885,2748429,306,1.00
ptg002268l,3157876,3158191,315,EVM,mRNA,3077676,3226628,315,1.00
ptg002269l,380184,380505,321,EVM,mRNA,246,544716,321,1.00
ptg002270l,4845927,4846248,321,EVM,mRNA,4698531,4848625,321,1.00
ptg002272l,779582,779898,316,EVM,mRNA,73707,1354638,316,1.00
ptg002274l,753165,753475,310,EVM,mRNA,680326,1200964,310,1.00
ptg002274l,983065,983367,302,EVM,mRNA,680326,1200964,302,1.00
ptg002276l,1197425,1197737,312,EVM,mRNA,2357,2513643,312,1.00
ptg002277l,472779,473073,294,EVM,mRNA,1729,1491947,294,1.00
ptg002277l,984304,984601,297,EVM,mRNA,1729,1491947,297,1.00
ptg002277l,1115971,1116299,328,EVM,mRNA,1729,1491947,328,1.00
ptg002278l,1159381,1159678,297,EVM,mRNA,1047147,1161481,297,1.00
ptg002280l,858412,858676,264,EVM,mRNA,858654,1251798,23,0.09
ptg002282l,136685,137000,315,EVM,mRNA,135464,816879,315,1.00
ptg002284l,1454859,1455170,311,EVM,mRNA,1330830,1475751,311,1.00
ptg002284l,1941155,1941480,325,EVM,mRNA,1915275,2263457,325,1.00
ptg002284l,2249709,2250002,293,EVM,mRNA,1915275,2263457,293,1.00
ptg002288l,1664665,1664981,316,EVM,mRNA,1334693,1727688,316,1.00
ptg002289l,3100092,3100406,314,EVM,mRNA,2944485,3295776,314,1.00
ptg002290l,311048,311346,298,EVM,mRNA,130,1661513,298,1.00
ptg002290l,325980,326287,307,EVM,mRNA,130,1661513,307,1.00
ptg002290l,1307472,1307779,307,EVM,mRNA,130,1661513,307,1.00
ptg002290l,1838552,1838841,289,EVM,mRNA,1781051,2352510,289,1.00
ptg002291l,507377,507677,300,EVM,mRNA,246150,1055164,300,1.00
ptg002297l,753588,753885,297,EVM,mRNA,678070,2812289,297,1.00
ptg002297l,2098402,2098732,330,EVM,mRNA,678070,2812289,330,1.00
ptg002297l,2679018,2679282,264,EVM,mRNA,678070,2812289,264,1.00
ptg002297l,3047260,3047549,289,EVM,mRNA,2937067,5416790,289,1.00
ptg002297l,3118013,3118314,301,EVM,mRNA,2937067,5416790,301,1.00
ptg002297l,4656901,4657196,295,EVM,mRNA,2937067,5416790,295,1.00
ptg002297l,5274854,5275116,262,EVM,mRNA,2937067,5416790,262,1.00
ptg002297l,6153769,6154042,273,EVM,mRNA,6128934,6609468,273,1.00
ptg002298l,699653,699929,276,EVM,mRNA,618516,807747,276,1.00
ptg002298l,731319,731613,294,EVM,mRNA,618516,807747,294,1.00
ptg002302l,700530,700847,317,EVM,mRNA,691380,1111907,317,1.00
ptg002302l,842701,842980,279,EVM,mRNA,691380,1111907,279,1.00
ptg002303l,1003789,1004070,281,EVM,mRNA,71368,1413122,281,1.00
ptg002303l,2210867,2211210,343,EVM,mRNA,2195164,2453296,343,1.00
ptg002304l,2725373,2725649,276,EVM,mRNA,2036867,3464828,276,1.00
ptg002306l,684964,685259,295,EVM,mRNA,459501,1769447,295,1.00
ptg002306l,3174617,3174905,288,EVM,mRNA,3008561,3247704,288,1.00
ptg002307l,1550904,1551226,322,EVM,mRNA,1301763,1589308,322,1.00
ptg002308l,1664503,1664808,305,EVM,mRNA,1069726,5194375,305,1.00
ptg002308l,1845001,1845324,323,EVM,mRNA,1069726,5194375,323,1.00
ptg002308l,3073438,3073758,320,EVM,mRNA,1069726,5194375,320,1.00
ptg002308l,4496349,4496589,240,EVM,mRNA,1069726,5194375,240,1.00
ptg002308l,4837553,4837869,316,EVM,mRNA,1069726,5194375,316,1.00
ptg002309l,272182,272489,307,EVM,mRNA,271682,869843,307,1.00
ptg002309l,583943,584252,309,EVM,mRNA,271682,869843,309,1.00
ptg002309l,1896009,1896318,309,EVM,mRNA,1212088,2961156,309,1.00
ptg002309l,2601734,2602012,278,EVM,mRNA,1212088,2961156,278,1.00
ptg002310l,2527834,2528101,267,EVM,mRNA,2524233,2551194,267,1.00
ptg002310l,2540839,2541165,326,EVM,mRNA,2524233,2551194,326,1.00
ptg002311l,3713170,3713460,290,EVM,mRNA,1181199,4409110,290,1.00
ptg002311l,3920124,3920423,299,EVM,mRNA,1181199,4409110,299,1.00
ptg002315l,915903,916218,315,EVM,mRNA,229661,2186661,315,1.00
ptg002315l,1000997,1001277,280,EVM,mRNA,229661,2186661,280,1.00
ptg002315l,1276950,1277268,318,EVM,mRNA,229661,2186661,318,1.00
ptg002315l,1608138,1608439,301,EVM,mRNA,229661,2186661,301,1.00
ptg002315l,1638387,1638672,285,EVM,mRNA,229661,2186661,285,1.00
ptg002315l,1662597,1662880,283,EVM,mRNA,229661,2186661,283,1.00
ptg002319l,2713215,2713520,305,EVM,mRNA,2153087,2929421,305,1.00
ptg002319l,3157951,3158261,310,EVM,mRNA,2988553,3590432,310,1.00
ptg002319l,3252883,3253209,326,EVM,mRNA,2988553,3590432,326,1.00
ptg002319l,3398011,3398290,279,EVM,mRNA,2988553,3590432,279,1.00
ptg002320l,2118157,2118478,321,EVM,mRNA,1874471,2302303,321,1.00
ptg002320l,3289111,3289430,319,EVM,mRNA,2982134,3453107,319,1.00
ptg002321l,1037322,1037614,292,EVM,mRNA,600900,1354544,292,1.00
ptg002322l,468112,468412,300,EVM,mRNA,309420,925085,300,1.00
ptg002322l,889240,889564,324,EVM,mRNA,309420,925085,324,1.00
ptg002323l,230644,230926,282,EVM,mRNA,230386,1294341,282,1.00
ptg002323l,1294066,1294382,316,EVM,mRNA,230386,1294341,275,0.87
ptg002323l,3973977,3974298,321,EVM,mRNA,3714124,4022579,321,1.00
ptg002323l,4524540,4524823,283,EVM,mRNA,4065042,4836201,283,1.00
ptg002323l,5028305,5028630,325,EVM,mRNA,4982558,5759210,325,1.00
ptg002325l,1189064,1189379,315,EVM,mRNA,777591,2223168,315,1.00
ptg002325l,1795648,1795947,299,EVM,mRNA,777591,2223168,299,1.00
ptg002325l,2867004,2867307,303,EVM,mRNA,2261354,4281173,303,1.00
ptg002325l,3349278,3349563,285,EVM,mRNA,2261354,4281173,285,1.00
ptg002325l,4197540,4197857,317,EVM,mRNA,2261354,4281173,317,1.00
ptg002325l,4746125,4746459,334,EVM,mRNA,4602257,4756977,334,1.00
ptg002332l,3419389,3419703,314,EVM,mRNA,1376024,3857707,314,1.00
ptg002332l,4265945,4266254,309,EVM,mRNA,4163838,4275560,309,1.00
ptg002336l,1042746,1043056,310,EVM,mRNA,928043,2191411,310,1.00
ptg002338l,5098757,5099068,311,EVM,mRNA,4064412,6212986,311,1.00
ptg002338l,6498912,6499220,308,EVM,mRNA,6407642,7261153,308,1.00
ptg002338l,6750565,6750868,303,EVM,mRNA,6407642,7261153,303,1.00
ptg002341l,776869,777198,329,EVM,mRNA,244236,972929,329,1.00
ptg002345l,2479063,2479347,284,EVM,mRNA,1465601,2631861,284,1.00
ptg002345l,2500375,2500664,289,EVM,mRNA,1465601,2631861,289,1.00
ptg002345l,2611095,2611412,317,EVM,mRNA,1465601,2631861,317,1.00
ptg002345l,3237912,3238161,249,EVM,mRNA,3060492,3279645,249,1.00
ptg002345l,3674616,3674893,277,EVM,mRNA,3603327,3680066,277,1.00
ptg002345l,5194596,5194906,310,EVM,mRNA,4462848,5234888,310,1.00
ptg002347l,1780726,1781026,300,EVM,mRNA,1224586,2971002,300,1.00
ptg002347l,2114384,2114661,277,EVM,mRNA,1224586,2971002,277,1.00
ptg002347l,2902435,2902760,325,EVM,mRNA,1224586,2971002,325,1.00
ptg002347l,2954168,2954505,337,EVM,mRNA,1224586,2971002,337,1.00
ptg002347l,4553170,4553460,290,EVM,mRNA,3912745,4688356,290,1.00
ptg002351l,532400,532714,314,EVM,mRNA,273853,2358572,314,1.00
ptg002351l,1407087,1407375,288,EVM,mRNA,273853,2358572,288,1.00
ptg002351l,1547929,1548239,310,EVM,mRNA,273853,2358572,310,1.00
ptg002351l,1917720,1918029,309,EVM,mRNA,273853,2358572,309,1.00
ptg002351l,4415500,4415790,290,EVM,mRNA,2687631,4593491,290,1.00
ptg002355l,1418849,1419125,276,EVM,mRNA,1232425,1427016,276,1.00
ptg002356l,2101823,2102104,281,EVM,mRNA,2083776,2202864,281,1.00
ptg002356l,2103225,2103507,282,EVM,mRNA,2083776,2202864,282,1.00
ptg002356l,2118285,2118567,282,EVM,mRNA,2083776,2202864,282,1.00
ptg002358l,2501051,2501376,325,EVM,mRNA,2304285,2584068,325,1.00
ptg002358l,5954786,5955115,329,EVM,mRNA,5680459,6557999,329,1.00
ptg002361l,683890,684157,267,EVM,mRNA,464202,871207,267,1.00
ptg002361l,2614673,2614971,298,EVM,mRNA,1955612,3402858,298,1.00
ptg002362l,458393,458706,313,EVM,mRNA,200628,630225,313,1.00
ptg002362l,552703,553013,310,EVM,mRNA,200628,630225,310,1.00
ptg002363l,291073,291375,302,EVM,mRNA,181823,507471,302,1.00
ptg002364l,1207523,1207835,312,EVM,mRNA,1192921,1242410,312,1.00
ptg002369l,854734,855045,311,EVM,mRNA,673725,2307110,311,1.00
ptg002369l,920741,921044,303,EVM,mRNA,673725,2307110,303,1.00
ptg002370l,2004291,2004559,268,EVM,mRNA,1731798,2380692,268,1.00
ptg002375l,4989193,4989495,302,EVM,mRNA,4648042,7191711,302,1.00
ptg002375l,5582315,5582606,291,EVM,mRNA,4648042,7191711,291,1.00
ptg002375l,7189421,7189745,324,EVM,mRNA,4648042,7191711,324,1.00
ptg002376l,1086692,1087003,311,EVM,mRNA,1045780,3521544,311,1.00
ptg002376l,2142014,2142293,279,EVM,mRNA,1045780,3521544,279,1.00
ptg002376l,2471729,2472040,311,EVM,mRNA,1045780,3521544,311,1.00
ptg002376l,2945271,2945582,311,EVM,mRNA,1045780,3521544,311,1.00
ptg002378l,229129,229411,282,EVM,mRNA,94069,2499576,282,1.00
ptg002378l,858723,859018,295,EVM,mRNA,94069,2499576,295,1.00
ptg002378l,995218,995522,304,EVM,mRNA,94069,2499576,304,1.00
ptg002378l,1886391,1886712,321,EVM,mRNA,94069,2499576,321,1.00
ptg002378l,1918330,1918609,279,EVM,mRNA,94069,2499576,279,1.00
ptg002378l,2499193,2499455,262,EVM,mRNA,94069,2499576,262,1.00
ptg002380l,1675482,1675807,325,EVM,mRNA,1312718,1756731,325,1.00
ptg002380l,2752671,2752972,301,EVM,mRNA,2573846,3436880,301,1.00
ptg002381l,587138,587433,295,EVM,mRNA,253859,1061283,295,1.00
ptg002382l,892068,892363,295,EVM,mRNA,69886,1294737,295,1.00
ptg002382l,1039069,1039359,290,EVM,mRNA,69886,1294737,290,1.00
ptg002384l,3310965,3311247,282,EVM,mRNA,2919558,3384950,282,1.00
ptg002385l,1820841,1821146,305,EVM,mRNA,1596330,2655460,305,1.00
ptg002386l,1138608,1138891,283,EVM,mRNA,1110997,1204481,283,1.00
ptg002387l,219480,219780,300,EVM,mRNA,6189,382863,300,1.00
ptg002387l,693575,693888,313,EVM,mRNA,604898,841578,313,1.00
ptg002387l,720580,720908,328,EVM,mRNA,604898,841578,328,1.00
ptg002387l,1617290,1617603,313,EVM,mRNA,1607207,3179763,313,1.00
ptg002387l,2116189,2116488,299,EVM,mRNA,1607207,3179763,299,1.00
ptg002387l,2213313,2213609,296,EVM,mRNA,1607207,3179763,296,1.00
ptg002387l,2827891,2828176,285,EVM,mRNA,1607207,3179763,285,1.00
ptg002391l,572147,572433,286,EVM,mRNA,351184,2078431,286,1.00
ptg002391l,726137,726422,285,EVM,mRNA,351184,2078431,285,1.00
ptg002397l,4621247,4621564,317,EVM,mRNA,3597234,4883337,317,1.00
ptg002399l,1046727,1046998,271,EVM,mRNA,900198,2993061,271,1.00
ptg002399l,1316865,1317187,322,EVM,mRNA,900198,2993061,322,1.00
ptg002399l,2028171,2028492,321,EVM,mRNA,900198,2993061,321,1.00
ptg002399l,2259320,2259616,296,EVM,mRNA,900198,2993061,296,1.00
ptg002400l,834696,835003,307,EVM,mRNA,733533,946202,307,1.00
ptg002406l,918430,918726,296,EVM,mRNA,874511,1106822,296,1.00
ptg002406l,966213,966503,290,EVM,mRNA,874511,1106822,290,1.00
ptg002406l,1920960,1921277,317,EVM,mRNA,1379911,2629021,317,1.00
ptg002409l,1825596,1825883,287,EVM,mRNA,599415,3277592,287,1.00
ptg002409l,2949838,2950146,308,EVM,mRNA,599415,3277592,308,1.00
ptg002411l,1109157,1109445,288,EVM,mRNA,545642,1340373,288,1.00
ptg002414l,867216,867531,315,EVM,mRNA,239144,1712746,315,1.00
ptg002415l,1401089,1401402,313,EVM,mRNA,1156321,2233491,313,1.00
ptg002416l,305901,306204,303,EVM,mRNA,73390,456852,303,1.00
ptg002417l,2427221,2427513,292,EVM,mRNA,2241432,2872178,292,1.00
ptg002417l,2709392,2709687,295,EVM,mRNA,2241432,2872178,295,1.00
ptg002418l,714438,714739,301,EVM,mRNA,624361,1080308,301,1.00
ptg002418l,965110,965389,279,EVM,mRNA,624361,1080308,279,1.00
ptg002419l,887967,888254,287,EVM,mRNA,801376,1204667,287,1.00
ptg002419l,1040068,1040328,260,EVM,mRNA,801376,1204667,260,1.00
ptg002420l,1799588,1799883,295,EVM,mRNA,1504803,1848204,295,1.00
ptg002421l,1402815,1403114,299,EVM,mRNA,1302060,2108881,299,1.00
ptg002421l,1756442,1756737,295,EVM,mRNA,1302060,2108881,295,1.00
ptg002424l,2015535,2015836,301,EVM,mRNA,1998422,2161216,301,1.00
ptg002425l,360259,360576,317,EVM,mRNA,128017,1142997,317,1.00
ptg002428l,1470174,1470485,311,EVM,mRNA,1273068,3910691,311,1.00
ptg002430l,1632913,1633199,286,EVM,mRNA,864278,2121793,286,1.00
ptg002430l,1813143,1813443,300,EVM,mRNA,864278,2121793,300,1.00
ptg002430l,3375732,3376059,327,EVM,mRNA,3294023,3476318,327,1.00
ptg002431l,173566,173847,281,EVM,mRNA,114123,175537,281,1.00
ptg002431l,882039,882326,287,EVM,mRNA,699746,1087888,287,1.00
ptg002431l,3533481,3533812,331,EVM,mRNA,3326212,3579569,331,1.00
ptg002431l,4068558,4068885,327,EVM,mRNA,3755658,4221789,327,1.00
ptg002433l,427656,427939,283,EVM,mRNA,376015,488014,283,1.00
ptg002436l,2108182,2108460,278,EVM,mRNA,1964030,2250969,278,1.00
ptg002438l,1066216,1066528,312,EVM,mRNA,513808,1512985,312,1.00
ptg002438l,2726725,2727029,304,EVM,mRNA,1931090,4275797,304,1.00
ptg002438l,3088869,3089167,298,EVM,mRNA,1931090,4275797,298,1.00
ptg002438l,3956723,3957018,295,EVM,mRNA,1931090,4275797,295,1.00
ptg002442l,140607,140895,288,EVM,mRNA,124843,219143,288,1.00
ptg002442l,1151985,1152294,309,EVM,mRNA,1053316,1463334,309,1.00
ptg002444l,408529,408830,301,EVM,mRNA,272441,473219,301,1.00
ptg002444l,1113330,1113604,274,EVM,mRNA,868756,3385828,274,1.00
ptg002444l,1353980,1354257,277,EVM,mRNA,868756,3385828,277,1.00
ptg002444l,2401191,2401512,321,EVM,mRNA,868756,3385828,321,1.00
ptg002444l,2845988,2846302,314,EVM,mRNA,868756,3385828,314,1.00
ptg002444l,5804078,5804411,333,EVM,mRNA,5420644,6356644,333,1.00
ptg002444l,6251139,6251476,337,EVM,mRNA,5420644,6356644,337,1.00
ptg002447l,261232,261564,332,EVM,mRNA,227721,298364,332,1.00
ptg002450l,322481,322790,309,EVM,mRNA,189411,577711,309,1.00
ptg002454l,273316,273642,326,EVM,mRNA,212752,441413,326,1.00
ptg002454l,1562783,1563073,290,EVM,mRNA,694080,1855848,290,1.00
ptg002454l,3950171,3950469,298,EVM,mRNA,3916521,3957503,298,1.00
ptg002456l,1234976,1235301,325,EVM,mRNA,1045925,1261429,325,1.00
ptg002456l,1628004,1628306,302,EVM,mRNA,1627014,1857579,302,1.00
ptg002457l,224070,224381,311,EVM,mRNA,23017,888786,311,1.00
ptg002459l,1488931,1489264,333,EVM,mRNA,300418,2691759,333,1.00
ptg002459l,2440922,2441246,324,EVM,mRNA,300418,2691759,324,1.00
ptg002460l,2295622,2295940,318,EVM,mRNA,1152111,2329846,318,1.00
ptg002467l,660203,660474,271,EVM,mRNA,652554,1699745,271,1.00
ptg002468l,2222530,2222823,293,EVM,mRNA,1388174,4053439,293,1.00
ptg002471l,701090,701406,316,EVM,mRNA,589836,916109,316,1.00
ptg002471l,1949197,1949492,295,EVM,mRNA,949932,3148208,295,1.00
ptg002471l,2074050,2074336,286,EVM,mRNA,949932,3148208,286,1.00
ptg002471l,2493556,2493869,313,EVM,mRNA,949932,3148208,313,1.00
ptg002471l,2658815,2659141,326,EVM,mRNA,949932,3148208,326,1.00
ptg002471l,3100336,3100660,324,EVM,mRNA,949932,3148208,324,1.00
ptg002471l,3113291,3113617,326,EVM,mRNA,949932,3148208,326,1.00
ptg002473l,815173,815481,308,EVM,mRNA,462788,1522462,308,1.00
ptg002473l,2075152,2075451,299,EVM,mRNA,1689616,3153715,299,1.00
ptg002473l,2193313,2193612,299,EVM,mRNA,1689616,3153715,299,1.00
ptg002473l,3426240,3426561,321,EVM,mRNA,3423125,3446195,321,1.00
ptg002473l,4366667,4366953,286,EVM,mRNA,4297525,4651358,286,1.00
ptg002473l,4467756,4468047,291,EVM,mRNA,4297525,4651358,291,1.00
ptg002473l,5896883,5897208,325,EVM,mRNA,4664323,6301357,325,1.00
ptg002473l,6124827,6125142,315,EVM,mRNA,4664323,6301357,315,1.00
ptg002474l,775483,775782,299,EVM,mRNA,41109,1578703,299,1.00
ptg002475l,2806503,2806790,287,EVM,mRNA,2310397,3725458,287,1.00
ptg002476l,102329,102587,258,EVM,mRNA,18163,110003,258,1.00
ptg002476l,1857149,1857426,277,EVM,mRNA,1798731,1998265,277,1.00
ptg002476l,5231372,5231649,277,EVM,mRNA,4865429,5325134,277,1.00
ptg002485l,981955,982279,324,EVM,mRNA,541300,2142695,324,1.00
ptg002485l,1122549,1122870,321,EVM,mRNA,541300,2142695,321,1.00
ptg002485l,2121971,2122297,326,EVM,mRNA,541300,2142695,326,1.00
ptg002488l,321409,321724,315,EVM,mRNA,291926,485189,315,1.00
ptg002488l,2165106,2165397,291,EVM,mRNA,1287124,3681740,291,1.00
ptg002489l,464927,465198,271,EVM,mRNA,315906,2839045,271,1.00
ptg002489l,1327985,1328279,294,EVM,mRNA,315906,2839045,294,1.00
ptg002489l,1387699,1387995,296,EVM,mRNA,315906,2839045,296,1.00
ptg002489l,1863769,1864065,296,EVM,mRNA,315906,2839045,296,1.00
ptg002496l,460651,460943,292,EVM,mRNA,344582,791676,292,1.00
ptg002496l,1349856,1350136,280,EVM,mRNA,1284100,1376575,280,1.00
ptg002497l,1663656,1663949,293,EVM,mRNA,1048152,2530467,293,1.00
ptg002497l,2183101,2183389,288,EVM,mRNA,1048152,2530467,288,1.00
ptg002497l,2342949,2343220,271,EVM,mRNA,1048152,2530467,271,1.00
ptg002497l,2447066,2447390,324,EVM,mRNA,1048152,2530467,324,1.00
ptg002499l,2676563,2676870,307,EVM,mRNA,2655842,2798925,307,1.00
ptg002499l,2978145,2978461,316,EVM,mRNA,2969301,3160203,316,1.00
ptg002503l,1393293,1393602,309,EVM,mRNA,1339413,1684734,309,1.00
ptg002504l,4168656,4168960,304,EVM,mRNA,3583260,5031469,304,1.00
ptg002506l,730024,730353,329,EVM,mRNA,657191,753082,329,1.00
ptg002506l,934022,934324,302,EVM,mRNA,800689,1074432,302,1.00
ptg002506l,1636566,1636880,314,EVM,mRNA,1474623,1666907,314,1.00
ptg002510l,4283884,4284170,286,EVM,mRNA,4010994,5387573,286,1.00
ptg002510l,4674860,4675127,267,EVM,mRNA,4010994,5387573,267,1.00
ptg002512l,681299,681606,307,EVM,mRNA,680129,947039,307,1.00
ptg002512l,737893,738206,313,EVM,mRNA,680129,947039,313,1.00
ptg002512l,772222,772564,342,EVM,mRNA,680129,947039,342,1.00
ptg002516l,149674,149982,308,EVM,mRNA,103000,627277,308,1.00
ptg002516l,1520225,1520533,308,EVM,mRNA,1281946,1931523,308,1.00
ptg002516l,1607381,1607653,272,EVM,mRNA,1281946,1931523,272,1.00
ptg002516l,1776954,1777262,308,EVM,mRNA,1281946,1931523,308,1.00
ptg002516l,2192182,2192468,286,EVM,mRNA,2139580,2300872,286,1.00
ptg002517l,4328629,4328954,325,EVM,mRNA,4181676,5360569,325,1.00
ptg002517l,4781559,4781858,299,EVM,mRNA,4181676,5360569,299,1.00
ptg002517l,5895320,5895599,279,EVM,mRNA,5826443,5945619,279,1.00
ptg002517l,5908834,5909120,286,EVM,mRNA,5826443,5945619,286,1.00
ptg002517l,7464017,7464289,272,EVM,mRNA,6851852,7515758,272,1.00
ptg002520l,839833,840133,300,EVM,mRNA,316442,856984,300,1.00
ptg002521l,1332706,1333006,300,EVM,mRNA,665152,2298043,300,1.00
ptg002526l,1033026,1033333,307,EVM,mRNA,1006137,1342743,307,1.00
ptg002527l,3318841,3319157,316,EVM,mRNA,2766293,6090753,316,1.00
ptg002527l,3693574,3693904,330,EVM,mRNA,2766293,6090753,330,1.00
ptg002527l,3803151,3803428,277,EVM,mRNA,2766293,6090753,277,1.00
ptg002527l,4645897,4646206,309,EVM,mRNA,2766293,6090753,309,1.00
ptg002527l,5274311,5274587,276,EVM,mRNA,2766293,6090753,276,1.00
ptg002527l,5504135,5504466,331,EVM,mRNA,2766293,6090753,331,1.00
ptg002527l,5808266,5808582,316,EVM,mRNA,2766293,6090753,316,1.00
ptg002527l,5883980,5884307,327,EVM,mRNA,2766293,6090753,327,1.00
ptg002527l,5981667,5981964,297,EVM,mRNA,2766293,6090753,297,1.00
ptg002528l,661181,661484,303,EVM,mRNA,464951,717784,303,1.00
ptg002528l,3494771,3495064,293,EVM,mRNA,3322530,3928703,293,1.00
ptg002533l,2572956,2573261,305,EVM,mRNA,2382755,2610221,305,1.00
ptg002534l,549994,550322,328,EVM,mRNA,362564,2183166,328,1.00
ptg002534l,3043648,3043959,311,EVM,mRNA,2952136,4116437,311,1.00
ptg002534l,3348191,3348506,315,EVM,mRNA,2952136,4116437,315,1.00
ptg002534l,3785983,3786259,276,EVM,mRNA,2952136,4116437,276,1.00
ptg002534l,4102176,4102510,334,EVM,mRNA,2952136,4116437,334,1.00
ptg002544l,326335,326604,269,EVM,mRNA,242668,333616,269,1.00
ptg002548l,393800,394124,324,EVM,mRNA,386,1262807,324,1.00
ptg002548l,1194113,1194399,286,EVM,mRNA,386,1262807,286,1.00
ptg002548l,3057346,3057662,316,EVM,mRNA,2631023,3599103,316,1.00
ptg002548l,3212389,3212688,299,EVM,mRNA,2631023,3599103,299,1.00
ptg002549l,771800,772128,328,EVM,mRNA,194767,1043839,328,1.00
ptg002551l,183707,184023,316,EVM,mRNA,6725,918781,316,1.00
ptg002551l,4562341,4562628,287,EVM,mRNA,4210074,4859492,287,1.00
ptg002551l,6590423,6590737,314,EVM,mRNA,6295177,7197121,314,1.00
ptg002552l,1131302,1131611,309,EVM,mRNA,984227,2476125,309,1.00
ptg002552l,1624241,1624523,282,EVM,mRNA,984227,2476125,282,1.00
ptg002552l,1878433,1878762,329,EVM,mRNA,984227,2476125,329,1.00
ptg002552l,1934592,1934887,295,EVM,mRNA,984227,2476125,295,1.00
ptg002552l,1944104,1944417,313,EVM,mRNA,984227,2476125,313,1.00
ptg002556l,652609,652896,287,EVM,mRNA,590228,806457,287,1.00
ptg002556l,1164881,1165194,313,EVM,mRNA,1013290,1312017,313,1.00
ptg002560l,1258225,1258521,296,EVM,mRNA,1052247,1357244,296,1.00
ptg002564l,207072,207360,288,EVM,mRNA,198135,2325840,288,1.00
ptg002564l,238497,238793,296,EVM,mRNA,198135,2325840,296,1.00
ptg002564l,743576,743885,309,EVM,mRNA,198135,2325840,309,1.00
ptg002564l,1034913,1035157,244,EVM,mRNA,198135,2325840,244,1.00
ptg002564l,1174819,1175127,308,EVM,mRNA,198135,2325840,308,1.00
ptg002564l,1741923,1742230,307,EVM,mRNA,198135,2325840,307,1.00
ptg002565l,1536675,1536940,265,EVM,mRNA,1134975,2211626,265,1.00
ptg002569l,411205,411495,290,EVM,mRNA,266264,1659249,290,1.00
ptg002569l,1054803,1055131,328,EVM,mRNA,266264,1659249,328,1.00
ptg002569l,1396526,1396807,281,EVM,mRNA,266264,1659249,281,1.00
ptg002569l,3325979,3326251,272,EVM,mRNA,2901058,3578579,272,1.00
ptg002573l,2045786,2046087,301,EVM,mRNA,2020743,2245660,301,1.00
ptg002573l,2088480,2088804,324,EVM,mRNA,2020743,2245660,324,1.00
ptg002573l,2786343,2786666,323,EVM,mRNA,2743142,2893173,323,1.00
ptg002573l,3342185,3342464,279,EVM,mRNA,3167551,4993988,279,1.00
ptg002573l,4788289,4788594,305,EVM,mRNA,3167551,4993988,305,1.00
ptg002573l,9332365,9332663,298,EVM,mRNA,9062600,10668011,298,1.00
ptg002573l,10233214,10233521,307,EVM,mRNA,9062600,10668011,307,1.00
ptg002574l,639271,639575,304,EVM,mRNA,132297,3386839,304,1.00
ptg002574l,2768875,2769148,273,EVM,mRNA,132297,3386839,273,1.00
ptg002575l,1179434,1179736,302,EVM,mRNA,915418,1836306,302,1.00
ptg002575l,2723838,2724133,295,EVM,mRNA,2719625,4523537,295,1.00
ptg002575l,3169129,3169430,301,EVM,mRNA,2719625,4523537,301,1.00
ptg002575l,3866711,3867007,296,EVM,mRNA,2719625,4523537,296,1.00
ptg002578l,179364,179677,313,EVM,mRNA,208,592646,313,1.00
ptg002578l,294822,295098,276,EVM,mRNA,208,592646,276,1.00
ptg002578l,516022,516301,279,EVM,mRNA,208,592646,279,1.00
ptg002579l,815577,815884,307,EVM,mRNA,773637,2019447,307,1.00
ptg002582l,306217,306506,289,EVM,mRNA,306171,516018,289,1.00
ptg002583l,668137,668423,286,EVM,mRNA,422581,981192,286,1.00
ptg002583l,798929,799207,278,EVM,mRNA,422581,981192,278,1.00
ptg002583l,3920707,3921027,320,EVM,mRNA,3229730,4983128,320,1.00
ptg002583l,4009214,4009551,337,EVM,mRNA,3229730,4983128,337,1.00
ptg002583l,8181802,8182124,322,EVM,mRNA,7775223,8714930,322,1.00
ptg002583l,9178040,9178314,274,EVM,mRNA,9166077,10228304,274,1.00
ptg002586l,1567959,1568280,321,EVM,mRNA,1166401,4712445,321,1.00
ptg002586l,3282528,3282865,337,EVM,mRNA,1166401,4712445,337,1.00
ptg002586l,4008114,4008397,283,EVM,mRNA,1166401,4712445,283,1.00
ptg002588l,774477,774787,310,EVM,mRNA,2726,1563924,310,1.00
ptg002590l,484685,484972,287,EVM,mRNA,178160,588947,287,1.00
ptg002594l,1495364,1495666,302,EVM,mRNA,562046,4251977,302,1.00
ptg002594l,1546063,1546380,317,EVM,mRNA,562046,4251977,317,1.00
ptg002594l,1686598,1686884,286,EVM,mRNA,562046,4251977,286,1.00
ptg002594l,2555543,2555846,303,EVM,mRNA,562046,4251977,303,1.00
ptg002594l,3419166,3419481,315,EVM,mRNA,562046,4251977,315,1.00
ptg002594l,3728044,3728335,291,EVM,mRNA,562046,4251977,291,1.00
ptg002594l,4246548,4246856,308,EVM,mRNA,562046,4251977,308,1.00
ptg002596l,5503893,5504228,335,EVM,mRNA,5434223,6053419,335,1.00
ptg002597l,78925,79244,319,EVM,mRNA,3774,513509,319,1.00
ptg002600l,1050211,1050515,304,EVM,mRNA,12818,1132862,304,1.00
ptg002601l,1293453,1293753,300,EVM,mRNA,429976,2620040,300,1.00
ptg002601l,1860624,1860930,306,EVM,mRNA,429976,2620040,306,1.00
ptg002601l,1896233,1896537,304,EVM,mRNA,429976,2620040,304,1.00
ptg002605l,3452940,3453217,277,EVM,mRNA,3358366,4157170,277,1.00
ptg002605l,4076027,4076309,282,EVM,mRNA,3358366,4157170,282,1.00
ptg002605l,4954525,4954835,310,EVM,mRNA,4285965,6184742,310,1.00
ptg002605l,5476462,5476776,314,EVM,mRNA,4285965,6184742,314,1.00
ptg002605l,5589625,5589943,318,EVM,mRNA,4285965,6184742,318,1.00
ptg002607l,785771,786044,273,EVM,mRNA,771606,809123,273,1.00
ptg002608l,1585618,1585918,300,EVM,mRNA,1249242,1739931,300,1.00
ptg002609l,1522960,1523276,316,EVM,mRNA,758273,2505473,316,1.00
ptg002609l,2716073,2716372,299,EVM,mRNA,2637618,4534659,299,1.00
ptg002609l,5145411,5145701,290,EVM,mRNA,4798475,5607888,290,1.00
ptg002609l,5157086,5157404,318,EVM,mRNA,4798475,5607888,318,1.00
ptg002609l,5324066,5324365,299,EVM,mRNA,4798475,5607888,299,1.00
ptg002610l,136083,136364,281,EVM,mRNA,79749,205325,281,1.00
ptg002613l,645304,645615,311,EVM,mRNA,80760,944725,311,1.00
ptg002614l,2379312,2379646,334,EVM,mRNA,301188,2527226,334,1.00
ptg002614l,2527041,2527358,317,EVM,mRNA,301188,2527226,185,0.58
ptg002614l,2800210,2800527,317,EVM,mRNA,2707476,4202701,317,1.00
ptg002616l,1715855,1716155,300,EVM,mRNA,1389628,1717229,300,1.00
ptg002617l,833018,833339,321,EVM,mRNA,147,1954343,321,1.00
ptg002617l,1732590,1732873,283,EVM,mRNA,147,1954343,283,1.00
ptg002617l,1900860,1901152,292,EVM,mRNA,147,1954343,292,1.00
ptg002617l,4927547,4927855,308,EVM,mRNA,3663595,5226060,308,1.00
ptg002621l,2186365,2186660,295,EVM,mRNA,1974757,4914103,295,1.00
ptg002621l,2296610,2296924,314,EVM,mRNA,1974757,4914103,314,1.00
ptg002621l,3172286,3172589,303,EVM,mRNA,1974757,4914103,303,1.00
ptg002621l,4290084,4290401,317,EVM,mRNA,1974757,4914103,317,1.00
ptg002621l,5314409,5314722,313,EVM,mRNA,5073984,5606629,313,1.00
ptg002621l,6105492,6105820,328,EVM,mRNA,5817005,6339157,328,1.00
ptg002621l,7384794,7385088,294,EVM,mRNA,6621612,8696468,294,1.00
ptg002621l,7550756,7551045,289,EVM,mRNA,6621612,8696468,289,1.00
ptg002621l,8609427,8609719,292,EVM,mRNA,6621612,8696468,292,1.00
ptg002622l,550281,550601,320,EVM,mRNA,91087,2308186,320,1.00
ptg002622l,1358969,1359242,273,EVM,mRNA,91087,2308186,273,1.00
ptg002622l,1838420,1838717,297,EVM,mRNA,91087,2308186,297,1.00
ptg002622l,3546692,3547021,329,EVM,mRNA,2877303,4323066,329,1.00
ptg002622l,4118552,4118833,281,EVM,mRNA,2877303,4323066,281,1.00
ptg002623l,965068,965383,315,EVM,mRNA,720575,1463183,315,1.00
ptg002626l,1966061,1966363,302,EVM,mRNA,1872364,2190087,302,1.00
ptg002627l,924302,924612,310,EVM,mRNA,830721,1176091,310,1.00
ptg002628l,3198975,3199288,313,EVM,mRNA,3138779,3841985,313,1.00
ptg002628l,3734114,3734412,298,EVM,mRNA,3138779,3841985,298,1.00
ptg002629l,1227124,1227417,293,EVM,mRNA,215270,2142603,293,1.00
ptg002629l,1597011,1597314,303,EVM,mRNA,215270,2142603,303,1.00
ptg002629l,1959634,1959947,313,EVM,mRNA,215270,2142603,313,1.00
ptg002629l,1976119,1976445,326,EVM,mRNA,215270,2142603,326,1.00
ptg002641l,627919,628238,319,EVM,mRNA,95148,1532674,319,1.00
ptg002643l,430749,431045,296,EVM,mRNA,20735,519659,296,1.00
ptg002643l,1172753,1173042,289,EVM,mRNA,1118899,1576743,289,1.00
ptg002646l,740295,740610,315,EVM,mRNA,666550,1091667,315,1.00
ptg002647l,483022,483310,288,EVM,mRNA,215135,521898,288,1.00
ptg002648l,157709,157990,281,EVM,mRNA,11879,239955,281,1.00
ptg002649l,47519,47804,285,EVM,mRNA,19040,103790,285,1.00
ptg002649l,167265,167574,309,EVM,mRNA,129176,340923,309,1.00
ptg002650l,573180,573479,299,EVM,mRNA,250329,1096629,299,1.00
ptg002650l,1456736,1457056,320,EVM,mRNA,1429122,1617884,320,1.00
ptg002650l,1488941,1489263,322,EVM,mRNA,1429122,1617884,322,1.00
ptg002650l,1862331,1862627,296,EVM,mRNA,1746023,2064847,296,1.00
ptg002650l,2014996,2015319,323,EVM,mRNA,1746023,2064847,323,1.00
ptg002653l,2836530,2836842,312,EVM,mRNA,2795003,3162534,312,1.00
ptg002654l,320107,320432,325,EVM,mRNA,20374,2938422,325,1.00
ptg002654l,3797815,3798124,309,EVM,mRNA,3449073,3999879,309,1.00
ptg002655l,2590415,2590741,326,EVM,mRNA,2434360,3016312,326,1.00
ptg002659l,463591,463889,298,EVM,mRNA,343815,564582,298,1.00
ptg002659l,1534415,1534719,304,EVM,mRNA,836126,3762699,304,1.00
ptg002660l,744178,744475,297,EVM,mRNA,597287,910921,297,1.00
ptg002660l,1797604,1797916,312,EVM,mRNA,1131877,3195734,312,1.00
ptg002660l,1961144,1961464,320,EVM,mRNA,1131877,3195734,320,1.00
ptg002660l,2620009,2620298,289,EVM,mRNA,1131877,3195734,289,1.00
ptg002660l,3836092,3836408,316,EVM,mRNA,3600643,3914070,316,1.00
ptg002660l,4924601,4924930,329,EVM,mRNA,4261792,5793097,329,1.00
ptg002663l,554735,555037,302,EVM,mRNA,150667,1113603,302,1.00
ptg002663l,872610,872925,315,EVM,mRNA,150667,1113603,315,1.00
ptg002666l,1704186,1704491,305,EVM,mRNA,1665578,2225930,305,1.00
ptg002666l,2064582,2064872,290,EVM,mRNA,1665578,2225930,290,1.00
ptg002666l,2094961,2095267,306,EVM,mRNA,1665578,2225930,306,1.00
ptg002666l,2906703,2907024,321,EVM,mRNA,2742994,3253621,321,1.00
ptg002666l,3011691,3011964,273,EVM,mRNA,2742994,3253621,273,1.00
ptg002668l,354162,354434,272,EVM,mRNA,352115,808212,272,1.00
ptg002670l,943330,943621,291,EVM,mRNA,705554,1515261,291,1.00
ptg002680l,2352202,2352498,296,EVM,mRNA,1209395,2610465,296,1.00
ptg002681l,355368,355684,316,EVM,mRNA,24948,641292,316,1.00
ptg002681l,1167666,1167972,306,EVM,mRNA,743080,1751921,306,1.00
ptg002681l,1365321,1365610,289,EVM,mRNA,743080,1751921,289,1.00
ptg002687l,3333946,3334254,308,EVM,mRNA,3288883,3462501,308,1.00
ptg002690l,3637036,3637320,284,EVM,mRNA,3492293,5576840,284,1.00
ptg002690l,4077253,4077569,316,EVM,mRNA,3492293,5576840,316,1.00
ptg002690l,4363476,4363803,327,EVM,mRNA,3492293,5576840,327,1.00
ptg002690l,4547331,4547613,282,EVM,mRNA,3492293,5576840,282,1.00
ptg002690l,4694056,4694367,311,EVM,mRNA,3492293,5576840,311,1.00
ptg002690l,4737894,4738205,311,EVM,mRNA,3492293,5576840,311,1.00
ptg002690l,4885114,4885451,337,EVM,mRNA,3492293,5576840,337,1.00
ptg002690l,4932030,4932304,274,EVM,mRNA,3492293,5576840,274,1.00
ptg002690l,4973205,4973496,291,EVM,mRNA,3492293,5576840,291,1.00
ptg002690l,5307387,5307699,312,EVM,mRNA,3492293,5576840,312,1.00
ptg002692l,420917,421207,290,EVM,mRNA,8924,970959,290,1.00
ptg002692l,440049,440330,281,EVM,mRNA,8924,970959,281,1.00
ptg002692l,893007,893306,299,EVM,mRNA,8924,970959,299,1.00
ptg002695l,852906,853216,310,EVM,mRNA,594335,1022962,310,1.00
ptg002702l,1434457,1434723,266,EVM,mRNA,91176,1567031,266,1.00
ptg002702l,1434812,1435077,265,EVM,mRNA,91176,1567031,265,1.00
ptg002702l,2150915,2151201,286,EVM,mRNA,1715197,2782891,286,1.00
ptg002704l,3753184,3753511,327,EVM,mRNA,3651476,3820110,327,1.00
ptg002708l,515361,515643,282,EVM,mRNA,456566,850288,282,1.00
ptg002708l,641870,642144,274,EVM,mRNA,456566,850288,274,1.00
ptg002708l,2307838,2308157,319,EVM,mRNA,2203290,2492818,319,1.00
ptg002708l,2742602,2742872,270,EVM,mRNA,2682657,3476461,270,1.00
ptg002708l,3050911,3051202,291,EVM,mRNA,2682657,3476461,291,1.00
ptg002714l,1569869,1570182,313,EVM,mRNA,1470879,1670091,313,1.00
ptg002716l,119499,119828,329,EVM,mRNA,14262,336176,329,1.00
ptg002717l,242046,242374,328,EVM,mRNA,12786,539207,328,1.00
ptg002721l,1575443,1575754,311,EVM,mRNA,1033932,2338220,311,1.00
ptg002721l,1825921,1826227,306,EVM,mRNA,1033932,2338220,306,1.00
ptg002721l,1962475,1962807,332,EVM,mRNA,1033932,2338220,332,1.00
ptg002721l,2021853,2022170,317,EVM,mRNA,1033932,2338220,317,1.00
ptg002722l,2104208,2104488,280,EVM,mRNA,2101936,2157565,280,1.00
ptg002722l,2111388,2111668,280,EVM,mRNA,2101936,2157565,280,1.00
ptg002723l,389349,389648,299,EVM,mRNA,133767,2123211,299,1.00
ptg002723l,440233,440537,304,EVM,mRNA,133767,2123211,304,1.00
ptg002723l,1090996,1091291,295,EVM,mRNA,133767,2123211,295,1.00
ptg002723l,1096579,1096888,309,EVM,mRNA,133767,2123211,309,1.00
ptg002723l,1268310,1268604,294,EVM,mRNA,133767,2123211,294,1.00
ptg002723l,1496524,1496820,296,EVM,mRNA,133767,2123211,296,1.00
ptg002723l,1704372,1704675,303,EVM,mRNA,133767,2123211,303,1.00
ptg002723l,2379336,2379624,288,EVM,mRNA,2225515,2490144,288,1.00
ptg002732l,3707194,3707499,305,EVM,mRNA,2117844,3750837,305,1.00
ptg002732l,5652249,5652585,336,EVM,mRNA,5050011,6623957,336,1.00
ptg002732l,6021136,6021409,273,EVM,mRNA,5050011,6623957,273,1.00
ptg002732l,7320034,7320314,280,EVM,mRNA,7157570,7488016,280,1.00
ptg002733l,2030336,2030644,308,EVM,mRNA,1047771,2093143,308,1.00
ptg002734l,929722,930041,319,EVM,mRNA,859411,1135437,319,1.00
ptg002739l,587342,587632,290,EVM,mRNA,180556,1500456,290,1.00
ptg002739l,1063433,1063726,293,EVM,mRNA,180556,1500456,293,1.00
ptg002739l,1721408,1721724,316,EVM,mRNA,1708893,1940105,316,1.00
ptg002739l,2128577,2128872,295,EVM,mRNA,2052202,2264356,295,1.00
ptg002741l,971245,971546,301,EVM,mRNA,49509,1589784,301,1.00
ptg002746l,538844,539173,329,EVM,mRNA,410305,2357362,329,1.00
ptg002746l,776957,777242,285,EVM,mRNA,410305,2357362,285,1.00
ptg002746l,1375622,1375924,302,EVM,mRNA,410305,2357362,302,1.00
ptg002746l,1772868,1773166,298,EVM,mRNA,410305,2357362,298,1.00
ptg002746l,1817669,1817959,290,EVM,mRNA,410305,2357362,290,1.00
ptg002746l,2941091,2941411,320,EVM,mRNA,2927722,3691994,320,1.00
ptg002746l,3832578,3832878,300,EVM,mRNA,3750152,3866362,300,1.00
ptg002746l,3854514,3854820,306,EVM,mRNA,3750152,3866362,306,1.00
ptg002747l,1033627,1033900,273,EVM,mRNA,1022201,1081796,273,1.00
ptg002747l,2465605,2465907,302,EVM,mRNA,2301830,4560647,302,1.00
ptg002747l,2577810,2578095,285,EVM,mRNA,2301830,4560647,285,1.00
ptg002748l,2400667,2400941,274,EVM,mRNA,2277069,2736044,274,1.00
ptg002748l,3536366,3536646,280,EVM,mRNA,3297360,4175049,280,1.00
ptg002749l,1378419,1378680,261,EVM,mRNA,947969,1644325,261,1.00
ptg002749l,1973346,1973642,296,EVM,mRNA,1721076,3743623,296,1.00
ptg002749l,2206693,2206990,297,EVM,mRNA,1721076,3743623,297,1.00
ptg002749l,2385438,2385728,290,EVM,mRNA,1721076,3743623,290,1.00
ptg002749l,2747814,2748117,303,EVM,mRNA,1721076,3743623,303,1.00
ptg002755l,691320,691607,287,EVM,mRNA,451568,897231,287,1.00
ptg002755l,865209,865518,309,EVM,mRNA,451568,897231,309,1.00
ptg002756l,850609,850891,282,EVM,mRNA,826436,927214,282,1.00
ptg002758l,885222,885528,306,EVM,mRNA,152519,1404164,306,1.00
ptg002761l,244329,244645,316,EVM,mRNA,95243,283725,316,1.00
ptg002763l,119634,119958,324,EVM,mRNA,94668,878302,324,1.00
ptg002763l,686458,686759,301,EVM,mRNA,94668,878302,301,1.00
ptg002766l,926026,926317,291,EVM,mRNA,880299,1105330,291,1.00
ptg002767l,646997,647277,280,EVM,mRNA,197773,903368,280,1.00
ptg002767l,1340618,1340923,305,EVM,mRNA,1231752,1903446,305,1.00
ptg002767l,2101673,2101965,292,EVM,mRNA,1916097,2367187,292,1.00
ptg002768l,478858,479129,271,EVM,mRNA,59111,1345484,271,1.00
ptg002768l,1019951,1020233,282,EVM,mRNA,59111,1345484,282,1.00
ptg002768l,1093404,1093705,301,EVM,mRNA,59111,1345484,301,1.00
ptg002769l,1479814,1480078,264,EVM,mRNA,1063771,2707791,264,1.00
ptg002769l,2161676,2161943,267,EVM,mRNA,1063771,2707791,267,1.00
ptg002771l,52366,52661,295,EVM,mRNA,52047,88398,295,1.00
ptg002772l,1616547,1616841,294,EVM,mRNA,1122259,3547025,294,1.00
ptg002772l,1661383,1661706,323,EVM,mRNA,1122259,3547025,323,1.00
ptg002772l,4569309,4569635,326,EVM,mRNA,3759294,5193959,326,1.00
ptg002772l,5103691,5104008,317,EVM,mRNA,3759294,5193959,317,1.00
ptg002772l,6317413,6317723,310,EVM,mRNA,6035783,6814225,310,1.00
ptg002772l,6557581,6557883,302,EVM,mRNA,6035783,6814225,302,1.00
ptg002772l,6708858,6709170,312,EVM,mRNA,6035783,6814225,312,1.00
ptg002772l,8776487,8776764,277,EVM,mRNA,8476567,10097147,277,1.00
ptg002778l,1203053,1203345,292,EVM,mRNA,949161,1284142,292,1.00
ptg002786l,1403722,1403999,277,EVM,mRNA,472426,2580910,277,1.00
ptg002786l,2235081,2235374,293,EVM,mRNA,472426,2580910,293,1.00
ptg002786l,2389431,2389748,317,EVM,mRNA,472426,2580910,317,1.00
ptg002787l,164025,164344,319,EVM,mRNA,147405,963131,319,1.00
ptg002789l,3415299,3415583,284,EVM,mRNA,3329183,3909251,284,1.00
ptg002789l,3439212,3439492,280,EVM,mRNA,3329183,3909251,280,1.00
ptg002789l,3457112,3457408,296,EVM,mRNA,3329183,3909251,296,1.00
ptg002789l,7394216,7394484,268,EVM,mRNA,7366512,7464724,268,1.00
ptg002801l,1098240,1098557,317,EVM,mRNA,360088,3386945,317,1.00
ptg002801l,2292947,2293262,315,EVM,mRNA,360088,3386945,315,1.00
ptg002801l,2963796,2964089,293,EVM,mRNA,360088,3386945,293,1.00
ptg002806l,1133423,1133713,290,EVM,mRNA,1033738,1143762,290,1.00
ptg002808l,254431,254750,319,EVM,mRNA,145520,1021763,319,1.00
ptg002808l,631712,632027,315,EVM,mRNA,145520,1021763,315,1.00
ptg002808l,842660,842971,311,EVM,mRNA,145520,1021763,311,1.00
ptg002813l,3462208,3462496,288,EVM,mRNA,2381861,3496639,288,1.00
ptg002813l,4885690,4885979,289,EVM,mRNA,4420081,5002355,289,1.00
ptg002814l,747575,747880,305,EVM,mRNA,376939,3856468,305,1.00
ptg002814l,1516859,1517173,314,EVM,mRNA,376939,3856468,314,1.00
ptg002814l,1577148,1577448,300,EVM,mRNA,376939,3856468,300,1.00
ptg002814l,3752836,3753127,291,EVM,mRNA,376939,3856468,291,1.00
ptg002814l,3781259,3781544,285,EVM,mRNA,376939,3856468,285,1.00
ptg002815l,1616958,1617274,316,EVM,mRNA,1295103,1628538,316,1.00
ptg002818l,1364762,1365054,292,EVM,mRNA,785258,1654694,292,1.00
ptg002818l,2743423,2743712,289,EVM,mRNA,2467269,4225179,289,1.00
ptg002823l,575522,575799,277,EVM,mRNA,292884,1077911,277,1.00
ptg002825l,1443995,1444287,292,EVM,mRNA,1097828,1767023,292,1.00
ptg002829l,3758965,3759285,320,EVM,mRNA,3249797,3846311,320,1.00
ptg002830l,770315,770625,310,EVM,mRNA,728101,1625309,310,1.00
ptg002833l,1878705,1878989,284,EVM,mRNA,1405613,2611769,284,1.00
ptg002834l,2155083,2155388,305,EVM,mRNA,1233199,2805954,305,1.00
ptg002836l,55175,55491,316,EVM,mRNA,2098,826655,316,1.00
ptg002836l,1022905,1023230,325,EVM,mRNA,1018952,1158117,325,1.00
ptg002836l,2346343,2346626,283,EVM,mRNA,2078799,4152490,283,1.00
ptg002836l,2638332,2638620,288,EVM,mRNA,2078799,4152490,288,1.00
ptg002836l,3301325,3301629,304,EVM,mRNA,2078799,4152490,304,1.00
ptg002842l,457441,457766,325,EVM,mRNA,370231,1039815,325,1.00
ptg002843l,745002,745272,270,EVM,mRNA,39055,1613351,270,1.00
ptg002843l,1181060,1181375,315,EVM,mRNA,39055,1613351,315,1.00
ptg002845l,913169,913472,303,EVM,mRNA,428729,1443725,303,1.00
ptg002851l,409185,409486,301,EVM,mRNA,90743,452612,301,1.00
ptg002852l,2339459,2339751,292,EVM,mRNA,1899070,3167491,292,1.00
ptg002852l,2530754,2531027,273,EVM,mRNA,1899070,3167491,273,1.00
ptg002854l,105359,105686,327,EVM,mRNA,34546,153243,327,1.00
ptg002855l,1089895,1090205,310,EVM,mRNA,930607,1150825,310,1.00
ptg002856l,81393,81694,301,EVM,mRNA,23791,622958,301,1.00
ptg002856l,574943,575210,267,EVM,mRNA,23791,622958,267,1.00
ptg002856l,1896266,1896577,311,EVM,mRNA,1879784,2409110,311,1.00
ptg002856l,1997695,1998001,306,EVM,mRNA,1879784,2409110,306,1.00
ptg002856l,2082186,2082475,289,EVM,mRNA,1879784,2409110,289,1.00
ptg002856l,2210966,2211251,285,EVM,mRNA,1879784,2409110,285,1.00
ptg002858l,2705113,2705406,293,EVM,mRNA,2612067,2818329,293,1.00
ptg002858l,4048658,4048968,310,EVM,mRNA,3920347,4256014,310,1.00
ptg002860l,1164881,1165163,282,EVM,mRNA,1122264,1251480,282,1.00
ptg002862l,320059,320332,273,EVM,mRNA,28267,401439,273,1.00
ptg002862l,1870642,1870943,301,EVM,mRNA,1245887,2301308,301,1.00
ptg002862l,2874786,2875082,296,EVM,mRNA,2573690,3298065,296,1.00
ptg002862l,3977576,3977855,279,EVM,mRNA,3914763,4566200,279,1.00
ptg002864l,766774,767105,331,EVM,mRNA,643807,784379,331,1.00
ptg002864l,999926,1000218,292,EVM,mRNA,960038,1068023,292,1.00
ptg002866l,530912,531222,310,EVM,mRNA,501011,664804,310,1.00
ptg002867l,2190073,2190364,291,EVM,mRNA,754083,2348055,291,1.00
ptg002869l,660635,660934,299,EVM,mRNA,58570,781596,299,1.00
ptg002874l,858604,858904,300,EVM,mRNA,661594,1633453,300,1.00
ptg002874l,1218154,1218470,316,EVM,mRNA,661594,1633453,316,1.00
ptg002874l,1509592,1509919,327,EVM,mRNA,661594,1633453,327,1.00
ptg002874l,2755417,2755721,304,EVM,mRNA,2458103,2759777,304,1.00
ptg002876l,103450,103766,316,EVM,mRNA,65063,1073314,316,1.00
ptg002876l,849715,849981,266,EVM,mRNA,65063,1073314,266,1.00
ptg002876l,1050549,1050843,294,EVM,mRNA,65063,1073314,294,1.00
ptg002877l,2360954,2361271,317,EVM,mRNA,1663130,3627108,317,1.00
ptg002877l,2856680,2856954,274,EVM,mRNA,1663130,3627108,274,1.00
ptg002877l,2952264,2952557,293,EVM,mRNA,1663130,3627108,293,1.00
ptg002879l,2756464,2756781,317,EVM,mRNA,2277414,2874720,317,1.00
ptg002880l,328532,328848,316,EVM,mRNA,980,530567,316,1.00
ptg002880l,331254,331528,274,EVM,mRNA,980,530567,274,1.00
ptg002880l,1480210,1480526,316,EVM,mRNA,780874,2645420,316,1.00
ptg002882l,1388811,1389124,313,EVM,mRNA,1246686,2465892,313,1.00
ptg002882l,1698438,1698718,280,EVM,mRNA,1246686,2465892,280,1.00
ptg002882l,1749329,1749621,292,EVM,mRNA,1246686,2465892,292,1.00
ptg002882l,2346502,2346789,287,EVM,mRNA,1246686,2465892,287,1.00
ptg002882l,2386283,2386612,329,EVM,mRNA,1246686,2465892,329,1.00
ptg002882l,3193097,3193382,285,EVM,mRNA,3111390,3254598,285,1.00
ptg002883l,398167,398440,273,EVM,mRNA,69850,1300812,273,1.00
ptg002886l,1342892,1343210,318,EVM,mRNA,109352,1640636,318,1.00
ptg002888l,203473,203750,277,EVM,mRNA,49051,369089,277,1.00
ptg002889l,472965,473274,309,EVM,mRNA,16126,511565,309,1.00
ptg002890l,2103802,2104089,287,EVM,mRNA,608,4059706,287,1.00
ptg002890l,4455137,4455430,293,EVM,mRNA,4059906,4626429,293,1.00
ptg002892l,943385,943694,309,EVM,mRNA,866873,1019168,309,1.00
ptg002894l,1604800,1605070,270,EVM,mRNA,1355303,2813393,270,1.00
ptg002894l,1737364,1737692,328,EVM,mRNA,1355303,2813393,328,1.00
ptg002894l,2318717,2319021,304,EVM,mRNA,1355303,2813393,304,1.00
ptg002894l,2348945,2349252,307,EVM,mRNA,1355303,2813393,307,1.00
ptg002903l,798899,799202,303,EVM,mRNA,652339,822325,303,1.00
ptg002903l,5688165,5688443,278,EVM,mRNA,4849384,8449242,278,1.00
ptg002906l,70838,71151,313,EVM,mRNA,46735,2453674,313,1.00
ptg002906l,741039,741334,295,EVM,mRNA,46735,2453674,295,1.00
ptg002906l,1198947,1199261,314,EVM,mRNA,46735,2453674,314,1.00
ptg002908l,3910587,3910917,330,EVM,mRNA,2177979,4913691,330,1.00
ptg002908l,4290065,4290346,281,EVM,mRNA,2177979,4913691,281,1.00
ptg002908l,4499528,4499800,272,EVM,mRNA,2177979,4913691,272,1.00
ptg002910l,395247,395568,321,EVM,mRNA,321673,406016,321,1.00
ptg002910l,1388161,1388475,314,EVM,mRNA,764238,2079443,314,1.00
ptg002910l,1645177,1645501,324,EVM,mRNA,764238,2079443,324,1.00
ptg002911l,463019,463328,309,EVM,mRNA,31793,481453,309,1.00
ptg002914l,195612,195921,309,EVM,mRNA,921,350170,309,1.00
ptg002914l,521905,522209,304,EVM,mRNA,418451,919942,304,1.00
ptg002914l,873336,873607,271,EVM,mRNA,418451,919942,271,1.00
ptg002914l,1486236,1486517,281,EVM,mRNA,1222918,1919416,281,1.00
ptg002920l,4035884,4036186,302,EVM,mRNA,3000671,6938327,302,1.00
ptg002920l,4554502,4554794,292,EVM,mRNA,3000671,6938327,292,1.00
ptg002920l,5962523,5962839,316,EVM,mRNA,3000671,6938327,316,1.00
ptg002920l,6613208,6613510,302,EVM,mRNA,3000671,6938327,302,1.00
ptg002920l,6782072,6782362,290,EVM,mRNA,3000671,6938327,290,1.00
ptg002920l,6881236,6881513,277,EVM,mRNA,3000671,6938327,277,1.00
ptg002926l,5088777,5089087,310,EVM,mRNA,5038408,5354866,310,1.00
ptg002930l,546552,546850,298,EVM,mRNA,461853,1031536,298,1.00
ptg002930l,849674,849976,302,EVM,mRNA,461853,1031536,302,1.00
ptg002932l,2299639,2299914,275,EVM,mRNA,1390116,3569400,275,1.00
ptg002932l,6348224,6348540,316,EVM,mRNA,4533205,8623942,316,1.00
ptg002932l,7626085,7626380,295,EVM,mRNA,4533205,8623942,295,1.00
ptg002937l,855877,856188,311,EVM,mRNA,769173,1274679,311,1.00
ptg002938l,206615,206932,317,EVM,mRNA,45939,396017,317,1.00
ptg002941l,357976,358249,273,EVM,mRNA,186481,665498,273,1.00
ptg002943l,1343884,1344201,317,EVM,mRNA,1253236,2145711,317,1.00
ptg002943l,2638970,2639264,294,EVM,mRNA,2558467,2646159,294,1.00
ptg002944l,1045402,1045727,325,EVM,mRNA,63633,2750341,325,1.00
ptg002944l,1931128,1931456,328,EVM,mRNA,63633,2750341,328,1.00
ptg002949l,2348274,2348557,283,EVM,mRNA,1467770,4012873,283,1.00
ptg002949l,2758302,2758617,315,EVM,mRNA,1467770,4012873,315,1.00
ptg002950l,1115959,1116246,287,EVM,mRNA,591108,1442408,287,1.00
ptg002951l,183609,183887,278,EVM,mRNA,72517,271859,278,1.00
ptg002951l,512771,513089,318,EVM,mRNA,492673,1132040,318,1.00
ptg002953l,678679,679002,323,EVM,mRNA,544415,1219228,323,1.00
ptg002957l,629411,629710,299,EVM,mRNA,397749,666740,299,1.00
ptg002957l,648708,649008,300,EVM,mRNA,397749,666740,300,1.00
ptg002961l,308659,308942,283,EVM,mRNA,228879,319500,283,1.00
ptg002964l,802792,803086,294,EVM,mRNA,774759,825073,294,1.00
ptg002965l,1052178,1052493,315,EVM,mRNA,344798,1294912,315,1.00
ptg002965l,4567661,4567973,312,EVM,mRNA,3747433,5787273,312,1.00
ptg002965l,5537645,5537957,312,EVM,mRNA,3747433,5787273,312,1.00
ptg002965l,6398123,6398437,314,EVM,mRNA,6286639,6595339,314,1.00
ptg002967l,796565,796856,291,EVM,mRNA,226390,804102,291,1.00
ptg002968l,306548,306849,301,EVM,mRNA,296013,878318,301,1.00
ptg002968l,468748,469058,310,EVM,mRNA,296013,878318,310,1.00
ptg002968l,733268,733587,319,EVM,mRNA,296013,878318,319,1.00
ptg002968l,1555458,1555752,294,EVM,mRNA,1176663,2199746,294,1.00
ptg002971l,2798886,2799148,262,EVM,mRNA,2730366,2913730,262,1.00
ptg002974l,316663,316988,325,EVM,mRNA,231363,791968,325,1.00
ptg002974l,533493,533774,281,EVM,mRNA,231363,791968,281,1.00
ptg002976l,1348154,1348459,305,EVM,mRNA,351619,1763409,305,1.00
ptg002976l,2147839,2148105,266,EVM,mRNA,1996305,2419388,266,1.00
ptg002976l,2377550,2377846,296,EVM,mRNA,1996305,2419388,296,1.00
ptg002977l,2037386,2037677,291,EVM,mRNA,1005887,2583050,291,1.00
ptg002978l,2465749,2466011,262,EVM,mRNA,2331766,2684400,262,1.00
ptg002978l,2877684,2877984,300,EVM,mRNA,2686659,3121055,300,1.00
ptg002981l,1674578,1674870,292,EVM,mRNA,1529899,4208719,292,1.00
ptg002981l,2843799,2844065,266,EVM,mRNA,1529899,4208719,266,1.00
ptg002981l,3952092,3952408,316,EVM,mRNA,1529899,4208719,316,1.00
ptg002982l,317849,318162,313,EVM,mRNA,303429,1899958,313,1.00
ptg002982l,1143891,1144209,318,EVM,mRNA,303429,1899958,318,1.00
ptg002982l,1262219,1262513,294,EVM,mRNA,303429,1899958,294,1.00
ptg002990l,496976,497258,282,EVM,mRNA,344123,1451910,282,1.00
ptg002990l,710344,710635,291,EVM,mRNA,344123,1451910,291,1.00
ptg002990l,2962357,2962678,321,EVM,mRNA,2827800,4095588,321,1.00
ptg002990l,3184791,3185078,287,EVM,mRNA,2827800,4095588,287,1.00
ptg002990l,3224812,3225122,310,EVM,mRNA,2827800,4095588,310,1.00
ptg002991l,600578,600870,292,EVM,mRNA,22299,2737167,292,1.00
ptg002991l,971401,971717,316,EVM,mRNA,22299,2737167,316,1.00
ptg002991l,1131041,1131307,266,EVM,mRNA,22299,2737167,266,1.00
ptg002991l,1434872,1435185,313,EVM,mRNA,22299,2737167,313,1.00
ptg002991l,2287160,2287434,274,EVM,mRNA,22299,2737167,274,1.00
ptg002991l,2591633,2591969,336,EVM,mRNA,22299,2737167,336,1.00
ptg002992l,3198629,3198926,297,EVM,mRNA,2954448,3202274,297,1.00
ptg002993l,512219,512488,269,EVM,mRNA,139751,939820,269,1.00
ptg002993l,641702,642002,300,EVM,mRNA,139751,939820,300,1.00
ptg002993l,1091341,1091646,305,EVM,mRNA,1049597,1093913,305,1.00
ptg002993l,1091341,1091646,305,GeneWise,mRNA,1049600,1173570,305,1.00
ptg002993l,1104649,1104967,318,GeneWise,mRNA,1049600,1173570,318,1.00
ptg002996l,1341790,1342089,299,EVM,mRNA,993418,1711529,299,1.00
ptg002996l,3186522,3186835,313,EVM,mRNA,3004066,3395162,313,1.00
ptg002996l,3392001,3392304,303,EVM,mRNA,3004066,3395162,303,1.00
ptg002997l,2116046,2116348,302,EVM,mRNA,1648235,2197839,302,1.00
ptg002997l,2130457,2130756,299,EVM,mRNA,1648235,2197839,299,1.00
ptg002997l,3341985,3342302,317,EVM,mRNA,2790162,4138557,317,1.00
ptg002999l,1117628,1117925,297,EVM,mRNA,807779,1739889,297,1.00
ptg003000l,737385,737651,266,EVM,mRNA,723804,1291058,266,1.00
ptg003000l,1184379,1184681,302,EVM,mRNA,723804,1291058,302,1.00
ptg003001l,547701,548019,318,EVM,mRNA,434354,1930309,318,1.00
ptg003001l,1220357,1220651,294,EVM,mRNA,434354,1930309,294,1.00
ptg003001l,1698208,1698474,266,EVM,mRNA,434354,1930309,266,1.00
ptg003001l,1748394,1748709,315,EVM,mRNA,434354,1930309,315,1.00
ptg003006l,294627,294943,316,EVM,mRNA,83674,2311165,316,1.00
ptg003006l,318232,318522,290,EVM,mRNA,83674,2311165,290,1.00
ptg003006l,567579,567894,315,EVM,mRNA,83674,2311165,315,1.00
ptg003006l,1530551,1530839,288,EVM,mRNA,83674,2311165,288,1.00
ptg003006l,1562084,1562381,297,EVM,mRNA,83674,2311165,297,1.00
ptg003006l,1967218,1967520,302,EVM,mRNA,83674,2311165,302,1.00
ptg003009l,415606,415884,278,EVM,mRNA,382561,730901,278,1.00
ptg003009l,726275,726594,319,EVM,mRNA,382561,730901,319,1.00
ptg003009l,1126257,1126543,286,EVM,mRNA,1047778,1150762,286,1.00
ptg003015l,3596328,3596630,302,EVM,mRNA,2315817,4629334,302,1.00
ptg003015l,3607570,3607883,313,EVM,mRNA,2315817,4629334,313,1.00
ptg003015l,3722881,3723195,314,EVM,mRNA,2315817,4629334,314,1.00
ptg003017l,143750,144047,297,EVM,mRNA,95524,167403,297,1.00
ptg003022l,835060,835354,294,EVM,mRNA,353029,1843180,294,1.00
ptg003022l,1399821,1400127,306,EVM,mRNA,353029,1843180,306,1.00
ptg003022l,2710837,2711124,287,EVM,mRNA,2657068,2715862,287,1.00
ptg003024l,1057596,1057892,296,EVM,mRNA,403307,1092946,296,1.00
ptg003026l,1348878,1349175,297,EVM,mRNA,1169195,1771649,297,1.00
ptg003027l,1625243,1625514,271,EVM,mRNA,1388106,2547571,271,1.00
ptg003027l,2325827,2326082,255,EVM,mRNA,1388106,2547571,255,1.00
ptg003028l,455907,456188,281,EVM,mRNA,448746,477240,281,1.00
ptg003029l,2362195,2362512,317,EVM,mRNA,1474759,2616541,317,1.00
ptg003030l,129205,129538,333,EVM,mRNA,53453,199531,333,1.00
ptg003030l,689300,689587,287,EVM,mRNA,208275,898572,287,1.00
ptg003030l,704603,704918,315,EVM,mRNA,208275,898572,315,1.00
ptg003030l,761874,762176,302,EVM,mRNA,208275,898572,302,1.00
ptg003031l,2539199,2539498,299,EVM,mRNA,2318339,3080141,299,1.00
ptg003031l,3059611,3059875,264,EVM,mRNA,2318339,3080141,264,1.00
ptg003036l,840435,840715,280,EVM,mRNA,805367,1102297,280,1.00
ptg003043l,1165144,1165450,306,EVM,mRNA,1011574,1256097,306,1.00
ptg003047l,1936578,1936866,288,EVM,mRNA,1169704,2569033,288,1.00
ptg003049l,332138,332442,304,EVM,mRNA,324458,395553,304,1.00
ptg003049l,360419,360730,311,EVM,mRNA,324458,395553,311,1.00
ptg003049l,1832347,1832669,322,EVM,mRNA,502092,2038477,322,1.00
ptg003050l,1872549,1872878,329,EVM,mRNA,1843432,2998531,329,1.00
ptg003050l,2197410,2197717,307,EVM,mRNA,1843432,2998531,307,1.00
ptg003051l,1047591,1047902,311,EVM,mRNA,922149,2467843,311,1.00
ptg003051l,2311807,2312082,275,EVM,mRNA,922149,2467843,275,1.00
ptg003051l,2355934,2356256,322,EVM,mRNA,922149,2467843,322,1.00
ptg003051l,2365391,2365674,283,EVM,mRNA,922149,2467843,283,1.00
ptg003051l,3365992,3366294,302,EVM,mRNA,3272480,3413297,302,1.00
ptg003051l,3595741,3596010,269,EVM,mRNA,3591326,4904366,269,1.00
ptg003053l,146431,146721,290,EVM,mRNA,8521,149057,290,1.00
ptg003056l,550088,550391,303,EVM,mRNA,31115,550464,303,1.00
ptg003058l,876794,877096,302,EVM,mRNA,229850,1550984,302,1.00
ptg003058l,1383800,1384098,298,EVM,mRNA,229850,1550984,298,1.00
ptg003061l,2878819,2879099,280,EVM,mRNA,2361139,4418137,280,1.00
ptg003061l,4194635,4194932,297,EVM,mRNA,2361139,4418137,297,1.00
ptg003061l,5304657,5304976,319,EVM,mRNA,5273352,5573988,319,1.00
ptg003061l,5401351,5401623,272,EVM,mRNA,5273352,5573988,272,1.00
ptg003062l,117846,118131,285,EVM,mRNA,90691,254788,285,1.00
ptg003063l,182062,182391,329,EVM,mRNA,92913,326332,329,1.00
ptg003068l,1149914,1150220,306,EVM,mRNA,34015,1327688,306,1.00
ptg003074l,626004,626293,289,EVM,mRNA,45912,704422,289,1.00
ptg003074l,2061683,2061960,277,EVM,mRNA,1575005,2206963,277,1.00
ptg003074l,2937444,2937741,297,EVM,mRNA,2799404,3213165,297,1.00
ptg003074l,4438283,4438610,327,EVM,mRNA,4072348,5576546,327,1.00
ptg003075l,525359,525633,274,EVM,mRNA,233567,1280025,274,1.00
ptg003075l,936138,936462,324,EVM,mRNA,233567,1280025,324,1.00
ptg003075l,2084480,2084799,319,EVM,mRNA,1729347,2859338,319,1.00
ptg003075l,2660144,2660422,278,EVM,mRNA,1729347,2859338,278,1.00
ptg003078l,1355450,1355770,320,EVM,mRNA,1191882,1521227,320,1.00
ptg003078l,1373567,1373853,286,EVM,mRNA,1191882,1521227,286,1.00
ptg003080l,1153496,1153774,278,EVM,mRNA,410254,1470660,278,1.00
ptg003081l,1328375,1328668,293,EVM,mRNA,499209,2073285,293,1.00
ptg003081l,3821740,3822032,292,EVM,mRNA,3256606,4791093,292,1.00
ptg003083l,514661,514980,319,EVM,mRNA,502894,531073,319,1.00
ptg003084l,702728,703007,279,EVM,mRNA,675716,1394242,279,1.00
ptg003084l,1094026,1094352,326,EVM,mRNA,675716,1394242,326,1.00
ptg003084l,1266867,1267176,309,EVM,mRNA,675716,1394242,309,1.00
ptg003088l,1674776,1675065,289,EVM,mRNA,1467315,2563001,289,1.00
ptg003088l,1805195,1805505,310,EVM,mRNA,1467315,2563001,310,1.00
ptg003090l,416795,417110,315,EVM,mRNA,256104,472154,315,1.00
ptg003090l,1305689,1306014,325,EVM,mRNA,1093808,1453094,325,1.00
ptg003092l,1125721,1126002,281,EVM,mRNA,1124849,1439482,281,1.00
ptg003093l,164947,165267,320,EVM,mRNA,66984,198860,320,1.00
ptg003093l,558195,558462,267,EVM,mRNA,373054,569100,267,1.00
ptg003098l,1460445,1460722,277,EVM,mRNA,1154935,1604677,277,1.00
ptg003098l,4641217,4641523,306,EVM,mRNA,2156771,4725030,306,1.00
ptg003099l,2649248,2649546,298,EVM,mRNA,2217447,2717800,298,1.00
ptg003100l,1005983,1006289,306,EVM,mRNA,295455,1553005,306,1.00
ptg003101l,704558,704857,299,EVM,mRNA,441581,959509,299,1.00
ptg003101l,840709,841027,318,EVM,mRNA,441581,959509,318,1.00
ptg003104l,75696,76015,319,EVM,mRNA,14023,296600,319,1.00
ptg003115l,375665,375998,333,EVM,mRNA,220278,484264,333,1.00
ptg003115l,375665,375998,333,GeneWise,mRNA,210074,461639,333,1.00
ptg003115l,382764,383086,322,EVM,mRNA,220278,484264,322,1.00
ptg003115l,382764,383086,322,GeneWise,mRNA,210074,461639,322,1.00
ptg003115l,463364,463673,309,EVM,mRNA,220278,484264,309,1.00
ptg003115l,1052084,1052414,330,EVM,mRNA,808329,3425527,330,1.00
ptg003115l,1682894,1683214,320,EVM,mRNA,808329,3425527,320,1.00
ptg003115l,2310536,2310877,341,EVM,mRNA,808329,3425527,341,1.00
ptg003115l,2657140,2657426,286,EVM,mRNA,808329,3425527,286,1.00
ptg003115l,3278765,3279052,287,EVM,mRNA,808329,3425527,287,1.00
ptg003117l,455881,456024,143,EVM,mRNA,375969,839800,143,1.00
ptg003118l,728206,728519,313,EVM,mRNA,295827,1555649,313,1.00
ptg003118l,3411894,3412206,312,EVM,mRNA,2877640,4135746,312,1.00
ptg003118l,3548919,3549237,318,EVM,mRNA,2877640,4135746,318,1.00
ptg003118l,4330260,4330570,310,EVM,mRNA,4326703,4483414,310,1.00
ptg003118l,4454842,4455129,287,EVM,mRNA,4326703,4483414,287,1.00
ptg003120l,668965,669255,290,EVM,mRNA,41490,1189539,290,1.00
ptg003122l,943334,943614,280,EVM,mRNA,833534,1543375,280,1.00
ptg003124l,749945,750251,306,EVM,mRNA,415376,1174961,306,1.00
ptg003124l,4085110,4085406,296,EVM,mRNA,3322145,5623219,296,1.00
ptg003124l,5230660,5230969,309,EVM,mRNA,3322145,5623219,309,1.00
ptg003130l,607129,607407,278,EVM,mRNA,32361,2154824,278,1.00
ptg003134l,3914904,3915219,315,EVM,mRNA,3737658,3976048,315,1.00
ptg003135l,47258,47553,295,EVM,mRNA,13727,1558910,295,1.00
ptg003135l,211092,211418,326,EVM,mRNA,13727,1558910,326,1.00
ptg003136l,3183706,3184001,295,EVM,mRNA,1877573,3982724,295,1.00
ptg003136l,3859281,3859583,302,EVM,mRNA,1877573,3982724,302,1.00
ptg003136l,5106630,5106927,297,EVM,mRNA,4373567,5566762,297,1.00
ptg003137l,1770267,1770574,307,EVM,mRNA,1692197,2229964,307,1.00
ptg003139l,86953,87245,292,EVM,mRNA,2387,126749,292,1.00
ptg003140l,2059083,2059400,317,EVM,mRNA,899699,3179196,317,1.00
ptg003140l,2952453,2952748,295,EVM,mRNA,899699,3179196,295,1.00
ptg003143l,217726,218033,307,EVM,mRNA,8631,491435,307,1.00
ptg003143l,447207,447537,330,EVM,mRNA,8631,491435,330,1.00
ptg003143l,1317591,1317914,323,EVM,mRNA,583330,1795526,323,1.00
ptg003143l,3241940,3242277,337,EVM,mRNA,2998018,3404238,337,1.00
ptg003143l,5302286,5302585,299,EVM,mRNA,4583568,5641460,299,1.00
ptg003145l,942858,943172,314,EVM,mRNA,783907,2178859,314,1.00
ptg003145l,1129515,1129825,310,EVM,mRNA,783907,2178859,310,1.00
ptg003145l,2567812,2568096,284,EVM,mRNA,2565469,3909200,284,1.00
ptg003145l,2840099,2840413,314,EVM,mRNA,2565469,3909200,314,1.00
ptg003146l,1330369,1330703,334,EVM,mRNA,323408,1933850,334,1.00
ptg003146l,1638971,1639290,319,EVM,mRNA,323408,1933850,319,1.00
ptg003147l,1708187,1708485,298,EVM,mRNA,987297,2721045,298,1.00
ptg003147l,1806963,1807253,290,EVM,mRNA,987297,2721045,290,1.00
ptg003147l,3122997,3123240,243,EVM,mRNA,2902312,3421028,243,1.00
ptg003147l,4153508,4153809,301,EVM,mRNA,4046981,5965489,301,1.00
ptg003147l,5297978,5298293,315,EVM,mRNA,4046981,5965489,315,1.00
ptg003147l,5561039,5561371,332,EVM,mRNA,4046981,5965489,332,1.00
ptg003147l,5843110,5843410,300,EVM,mRNA,4046981,5965489,300,1.00
ptg003153l,225990,226290,300,EVM,mRNA,210922,686554,300,1.00
ptg003153l,324914,325210,296,EVM,mRNA,210922,686554,296,1.00
ptg003153l,975198,975514,316,EVM,mRNA,834444,1070403,316,1.00
ptg003155l,837708,837980,272,EVM,mRNA,512116,1122293,272,1.00
ptg003155l,957829,958138,309,EVM,mRNA,512116,1122293,309,1.00
ptg003155l,1625579,1625893,314,EVM,mRNA,1572852,1837232,314,1.00
ptg003156l,3430763,3431046,283,EVM,mRNA,3043475,5166948,283,1.00
ptg003158l,26824,27117,293,EVM,mRNA,5101,283461,293,1.00
ptg003158l,1924347,1924661,314,EVM,mRNA,1066673,2505486,314,1.00
ptg003159l,2109909,2110212,303,EVM,mRNA,1839510,2606731,303,1.00
ptg003160l,538015,538345,330,EVM,mRNA,308408,538614,330,1.00
ptg003162l,58452,58764,312,EVM,mRNA,46104,210601,312,1.00
ptg003162l,2082696,2082980,284,EVM,mRNA,1912310,3222480,284,1.00
ptg003162l,2304503,2304807,304,EVM,mRNA,1912310,3222480,304,1.00
ptg003162l,2528815,2529098,283,EVM,mRNA,1912310,3222480,283,1.00
ptg003162l,2557221,2557516,295,EVM,mRNA,1912310,3222480,295,1.00
ptg003162l,2681871,2682166,295,EVM,mRNA,1912310,3222480,295,1.00
ptg003162l,2982841,2983138,297,EVM,mRNA,1912310,3222480,297,1.00
ptg003164l,1207979,1208263,284,EVM,mRNA,262396,1921710,284,1.00
ptg003173l,166427,166707,280,EVM,mRNA,108340,1408083,280,1.00
ptg003173l,543090,543401,311,EVM,mRNA,108340,1408083,311,1.00
ptg003173l,840334,840663,329,EVM,mRNA,108340,1408083,329,1.00
ptg003174l,314456,314769,313,EVM,mRNA,89708,802916,313,1.00
ptg003176l,73792,74068,276,EVM,mRNA,18427,410749,276,1.00
ptg003176l,2220200,2220498,298,EVM,mRNA,2044283,2497184,298,1.00
ptg003176l,2691677,2691976,299,EVM,mRNA,2554006,2819091,299,1.00
ptg003176l,2718713,2719012,299,EVM,mRNA,2554006,2819091,299,1.00
ptg003176l,2793809,2794108,299,EVM,mRNA,2554006,2819091,299,1.00
ptg003177l,940528,940809,281,EVM,mRNA,893,1241489,281,1.00
ptg003177l,1477041,1477350,309,EVM,mRNA,1396381,1788612,309,1.00
ptg003177l,1676704,1677001,297,EVM,mRNA,1396381,1788612,297,1.00
ptg003177l,1761415,1761701,286,EVM,mRNA,1396381,1788612,286,1.00
ptg003181l,1321541,1321854,313,EVM,mRNA,477871,1839660,313,1.00
ptg003181l,1734808,1735115,307,EVM,mRNA,477871,1839660,307,1.00
ptg003181l,2067297,2067595,298,EVM,mRNA,1898978,2284778,298,1.00
ptg003186l,871216,871535,319,EVM,mRNA,316096,1143398,319,1.00
ptg003187l,2534993,2535314,321,EVM,mRNA,2339660,3411635,321,1.00
ptg003187l,2617984,2618301,317,EVM,mRNA,2339660,3411635,317,1.00
ptg003188l,829467,829770,303,EVM,mRNA,703894,874362,303,1.00
ptg003193l,1153366,1153634,268,EVM,mRNA,1118536,1338454,268,1.00
ptg003194l,2336599,2336874,275,EVM,mRNA,1526172,3200488,275,1.00
ptg003195l,715867,716183,316,EVM,mRNA,715848,754975,316,1.00
ptg003196l,817963,818249,286,EVM,mRNA,115615,1122400,286,1.00
ptg003196l,842302,842601,299,EVM,mRNA,115615,1122400,299,1.00
ptg003197l,2116906,2117227,321,EVM,mRNA,1804437,2171239,321,1.00
ptg003197l,2167534,2167832,298,EVM,mRNA,1804437,2171239,298,1.00
ptg003199l,1447757,1448062,305,EVM,mRNA,585259,1661312,305,1.00
ptg003200l,847779,848093,314,EVM,mRNA,584995,1151739,314,1.00
ptg003201l,287156,287442,286,EVM,mRNA,2408,2193190,286,1.00
ptg003201l,558250,558548,298,EVM,mRNA,2408,2193190,298,1.00
ptg003202l,5314693,5315005,312,EVM,mRNA,5279192,5404315,312,1.00
ptg003204l,130806,131106,300,EVM,mRNA,8474,443124,300,1.00
ptg003204l,950886,951203,317,EVM,mRNA,499089,1649308,317,1.00
ptg003204l,1137661,1137990,329,EVM,mRNA,499089,1649308,329,1.00
ptg003204l,1580151,1580458,307,EVM,mRNA,499089,1649308,307,1.00
ptg003208l,1520518,1520833,315,EVM,mRNA,1403853,1692468,315,1.00
ptg003209l,275826,276120,294,EVM,mRNA,129191,281596,294,1.00
ptg003209l,2066659,2066968,309,EVM,mRNA,1851461,2420833,309,1.00
ptg003209l,2189005,2189317,312,EVM,mRNA,1851461,2420833,312,1.00
ptg003209l,2414700,2415007,307,EVM,mRNA,1851461,2420833,307,1.00
ptg003211l,2102864,2103132,268,EVM,mRNA,1976015,2242302,268,1.00
ptg003211l,2226285,2226604,319,EVM,mRNA,1976015,2242302,319,1.00
ptg003214l,543644,543954,310,EVM,mRNA,19294,774247,310,1.00
ptg003215l,2403598,2403900,302,EVM,mRNA,494995,3567641,302,1.00
ptg003216l,84151,84436,285,EVM,mRNA,17201,212869,285,1.00
ptg003216l,163929,164250,321,EVM,mRNA,17201,212869,321,1.00
ptg003216l,500106,500414,308,EVM,mRNA,360886,782282,308,1.00
ptg003216l,1451202,1451487,285,EVM,mRNA,1351865,1458577,285,1.00
ptg003217l,410444,410730,286,EVM,mRNA,335912,3250493,286,1.00
ptg003217l,1737566,1737880,314,EVM,mRNA,335912,3250493,314,1.00
ptg003217l,2438996,2439294,298,EVM,mRNA,335912,3250493,298,1.00
ptg003217l,3478897,3479210,313,EVM,mRNA,3437455,3823143,313,1.00
ptg003218l,1187342,1187628,286,EVM,mRNA,1104511,1391132,286,1.00
ptg003219l,2750173,2750498,325,EVM,mRNA,2523964,3480111,325,1.00
ptg003219l,3098523,3098829,306,EVM,mRNA,2523964,3480111,306,1.00
ptg003221l,1513546,1513863,317,EVM,mRNA,1490153,2505449,317,1.00
ptg003221l,2019435,2019740,305,EVM,mRNA,1490153,2505449,305,1.00
ptg003225l,1614668,1614960,292,EVM,mRNA,1828,1719440,292,1.00
ptg003227l,1290597,1290886,289,EVM,mRNA,1107887,1364782,289,1.00
ptg003227l,3358936,3359230,294,EVM,mRNA,1973190,4715866,294,1.00
ptg003227l,4701411,4701704,293,EVM,mRNA,1973190,4715866,293,1.00
ptg003230l,4320303,4320616,313,EVM,mRNA,3685220,4462694,313,1.00
ptg003232l,3490450,3490752,302,EVM,mRNA,2829977,3680544,302,1.00
ptg003232l,3759322,3759642,320,EVM,mRNA,3692975,3829437,320,1.00
ptg003232l,4204045,4204371,326,EVM,mRNA,3899189,5061769,326,1.00
ptg003232l,4933014,4933312,298,EVM,mRNA,3899189,5061769,298,1.00
ptg003232l,4982843,4983150,307,EVM,mRNA,3899189,5061769,307,1.00
ptg003235l,1018474,1018754,280,EVM,mRNA,945412,1189274,280,1.00
ptg003236l,734268,734557,289,EVM,mRNA,470035,737235,289,1.00
ptg003236l,4154646,4154940,294,EVM,mRNA,3229420,4980000,294,1.00
ptg003236l,4690183,4690483,300,EVM,mRNA,3229420,4980000,300,1.00
ptg003238l,165338,165623,285,EVM,mRNA,12565,435295,285,1.00
ptg003238l,1664830,1665112,282,EVM,mRNA,968290,3052305,282,1.00
ptg003238l,3021247,3021566,319,EVM,mRNA,968290,3052305,319,1.00
ptg003240l,184975,185271,296,EVM,mRNA,63475,811928,296,1.00
ptg003240l,469711,470026,315,EVM,mRNA,63475,811928,315,1.00
ptg003245l,1324007,1324299,292,EVM,mRNA,1163389,2283846,292,1.00
ptg003245l,1488663,1488976,313,EVM,mRNA,1163389,2283846,313,1.00
ptg003245l,2765246,2765566,320,EVM,mRNA,2437452,3315008,320,1.00
ptg003245l,5955858,5956176,318,EVM,mRNA,5900141,6065794,318,1.00
ptg003247l,146830,147122,292,EVM,mRNA,20571,648535,292,1.00
ptg003247l,1203265,1203581,316,EVM,mRNA,1132444,1247082,316,1.00
ptg003251l,175568,175843,275,EVM,mRNA,40106,276654,275,1.00
ptg003254l,609239,609559,320,EVM,mRNA,558889,1571687,320,1.00
ptg003257l,224446,224733,287,EVM,mRNA,121913,343887,287,1.00
ptg003257l,1294438,1294741,303,EVM,mRNA,539455,2518599,303,1.00
ptg003260l,143294,143581,287,EVM,mRNA,63987,241397,287,1.00
ptg003260l,1743685,1744015,330,EVM,mRNA,705590,1752223,330,1.00
ptg003261l,636628,636947,319,EVM,mRNA,241150,2933825,319,1.00
ptg003261l,2387369,2387666,297,EVM,mRNA,241150,2933825,297,1.00
ptg003261l,3250847,3251160,313,EVM,mRNA,3067201,3863674,313,1.00
ptg003265l,3279474,3279761,287,EVM,mRNA,2650564,3302999,287,1.00
ptg003267l,631684,631966,282,EVM,mRNA,449622,859670,282,1.00
ptg003267l,821591,821918,327,EVM,mRNA,449622,859670,327,1.00
ptg003268l,1288920,1289217,297,EVM,mRNA,1234990,1565975,297,1.00
ptg003268l,3065150,3065442,292,EVM,mRNA,2845742,3156819,292,1.00
ptg003268l,3803097,3803425,328,EVM,mRNA,3346582,3811902,328,1.00
ptg003268l,4503475,4503790,315,EVM,mRNA,4256727,5484955,315,1.00
ptg003268l,4615129,4615437,308,EVM,mRNA,4256727,5484955,308,1.00
ptg003271l,780113,780431,318,EVM,mRNA,373824,2024978,318,1.00
ptg003271l,838690,839005,315,EVM,mRNA,373824,2024978,315,1.00
ptg003271l,1689510,1689820,310,EVM,mRNA,373824,2024978,310,1.00
ptg003276l,959563,959851,288,EVM,mRNA,856472,1236694,288,1.00
ptg003276l,1035611,1035893,282,EVM,mRNA,856472,1236694,282,1.00
ptg003276l,1184848,1185156,308,EVM,mRNA,856472,1236694,308,1.00
ptg003280l,712738,713065,327,EVM,mRNA,671562,917589,327,1.00
ptg003280l,1031932,1032243,311,EVM,mRNA,956997,3363203,311,1.00
ptg003280l,1667104,1667406,302,EVM,mRNA,956997,3363203,302,1.00
ptg003280l,2086405,2086706,301,EVM,mRNA,956997,3363203,301,1.00
ptg003280l,5251850,5252167,317,EVM,mRNA,3871841,5299333,317,1.00
ptg003286l,626384,626695,311,EVM,mRNA,612299,630054,311,1.00
ptg003289l,395762,396056,294,EVM,mRNA,197183,516278,294,1.00
ptg003289l,425076,425372,296,EVM,mRNA,197183,516278,296,1.00
ptg003290l,2270920,2271210,290,EVM,mRNA,2246666,2883783,290,1.00
ptg003290l,3836020,3836314,294,EVM,mRNA,3000291,3889640,294,1.00
ptg003290l,5493670,5493963,293,EVM,mRNA,4711229,6190413,293,1.00
ptg003294l,1886490,1886803,313,EVM,mRNA,1466627,3355468,313,1.00
ptg003294l,2679788,2680075,287,EVM,mRNA,1466627,3355468,287,1.00
ptg003302l,225267,225600,333,EVM,mRNA,81168,515029,333,1.00
ptg003302l,405251,405559,308,EVM,mRNA,81168,515029,308,1.00
ptg003305l,340112,340398,286,EVM,mRNA,27184,535334,286,1.00
ptg003308l,72615,72923,308,EVM,mRNA,59261,364213,308,1.00
ptg003310l,1514683,1514958,275,EVM,mRNA,1211896,1795340,275,1.00
ptg003311l,713655,713961,306,EVM,mRNA,156490,1091217,306,1.00
ptg003311l,2970076,2970373,297,EVM,mRNA,1649836,3835508,297,1.00
ptg003312l,980468,980763,295,EVM,mRNA,873062,1785917,295,1.00
ptg003312l,2564788,2565100,312,EVM,mRNA,1990882,2612500,312,1.00
ptg003312l,4500945,4501269,324,EVM,mRNA,4229609,4764829,324,1.00
ptg003312l,5620778,5621060,282,EVM,mRNA,5392587,6059366,282,1.00
ptg003312l,9275673,9275981,308,EVM,mRNA,9260563,9354935,308,1.00
ptg003312l,9332023,9332321,298,EVM,mRNA,9260563,9354935,298,1.00
ptg003314l,311548,311836,288,EVM,mRNA,27340,753024,288,1.00
ptg003314l,323807,324095,288,EVM,mRNA,27340,753024,288,1.00
ptg003315l,1561603,1561911,308,EVM,mRNA,402195,3039399,308,1.00
ptg003315l,2328968,2329259,291,EVM,mRNA,402195,3039399,291,1.00
ptg003317l,3205417,3205742,325,EVM,mRNA,2631746,4330305,325,1.00
ptg003317l,3661108,3661402,294,EVM,mRNA,2631746,4330305,294,1.00
ptg003317l,3801348,3801675,327,EVM,mRNA,2631746,4330305,327,1.00
ptg003317l,4128568,4128840,272,EVM,mRNA,2631746,4330305,272,1.00
ptg003319l,1475533,1475848,315,EVM,mRNA,916512,1570731,315,1.00
ptg003321l,2042067,2042393,326,EVM,mRNA,1318955,3272509,326,1.00
ptg003321l,2741486,2741807,321,EVM,mRNA,1318955,3272509,321,1.00
ptg003323l,2514401,2514717,316,EVM,mRNA,2064431,2691510,316,1.00
ptg003324l,1461378,1461678,300,EVM,mRNA,1300944,1617400,300,1.00
ptg003329l,1089860,1090127,267,EVM,mRNA,37708,3112473,267,1.00
ptg003329l,2370810,2371120,310,EVM,mRNA,37708,3112473,310,1.00
ptg003339l,805399,805664,265,EVM,mRNA,773657,1145443,265,1.00
ptg003339l,809761,810046,285,EVM,mRNA,773657,1145443,285,1.00
ptg003339l,824357,824669,312,EVM,mRNA,773657,1145443,312,1.00
ptg003349l,1033359,1033631,272,EVM,mRNA,738316,1312258,272,1.00
ptg003350l,262343,262652,309,EVM,mRNA,25402,930662,309,1.00
ptg003350l,758591,758894,303,EVM,mRNA,25402,930662,303,1.00
ptg003351l,3751785,3752080,295,EVM,mRNA,1810918,4560651,295,1.00
ptg003352l,446162,446455,293,EVM,mRNA,113254,797843,293,1.00
ptg003354l,899729,900013,284,EVM,mRNA,861366,961295,284,1.00
ptg003355l,2121323,2121623,300,EVM,mRNA,1555885,2474620,300,1.00
ptg003355l,2230239,2230566,327,EVM,mRNA,1555885,2474620,327,1.00
ptg003356l,1691235,1691532,297,EVM,mRNA,461671,1942352,297,1.00
ptg003364l,111930,112208,278,EVM,mRNA,20742,896136,278,1.00
ptg003364l,228616,228901,285,EVM,mRNA,20742,896136,285,1.00
ptg003364l,449449,449729,280,EVM,mRNA,20742,896136,280,1.00
ptg003364l,486632,486946,314,EVM,mRNA,20742,896136,314,1.00
ptg003364l,639369,639668,299,EVM,mRNA,20742,896136,299,1.00
ptg003364l,1479011,1479324,313,EVM,mRNA,1384280,2008835,313,1.00
ptg003364l,1820457,1820746,289,EVM,mRNA,1384280,2008835,289,1.00
ptg003364l,2341574,2341871,297,EVM,mRNA,2218379,2654312,297,1.00
ptg003364l,2419869,2420153,284,EVM,mRNA,2218379,2654312,284,1.00
ptg003367l,668944,669238,294,EVM,mRNA,463729,1028055,294,1.00
ptg003369l,338092,338419,327,EVM,mRNA,60735,393039,327,1.00
ptg003369l,598855,599159,304,EVM,mRNA,459042,815984,304,1.00
ptg003369l,3519185,3519462,277,EVM,mRNA,3468218,3595530,277,1.00
ptg003376l,367019,367307,288,EVM,mRNA,363183,406912,288,1.00
ptg003376l,390541,390833,292,EVM,mRNA,363183,406912,292,1.00
ptg003376l,544627,544951,324,EVM,mRNA,465397,627514,324,1.00
ptg003376l,2513808,2514081,273,EVM,mRNA,1897114,2866588,273,1.00
ptg003378l,1432611,1432928,317,EVM,mRNA,1417692,1536165,317,1.00
ptg003381l,800370,800692,322,EVM,mRNA,241229,1674083,322,1.00
ptg003381l,1498070,1498384,314,EVM,mRNA,241229,1674083,314,1.00
ptg003382l,366803,367088,285,EVM,mRNA,318446,594993,285,1.00
ptg003383l,522238,522530,292,EVM,mRNA,136252,2901580,292,1.00
ptg003383l,2679104,2679413,309,EVM,mRNA,136252,2901580,309,1.00
ptg003383l,2897608,2897895,287,EVM,mRNA,136252,2901580,287,1.00
ptg003391l,2685227,2685552,325,EVM,mRNA,2595987,3720656,325,1.00
ptg003391l,3680337,3680630,293,EVM,mRNA,2595987,3720656,293,1.00
ptg003394l,2219349,2219669,320,EVM,mRNA,2079233,2623249,320,1.00
ptg003394l,2600399,2600721,322,EVM,mRNA,2079233,2623249,322,1.00
ptg003396l,1348137,1348435,298,EVM,mRNA,5645,1868264,298,1.00
ptg003397l,765919,766211,292,EVM,mRNA,275279,846382,292,1.00
ptg003398l,4057926,4058230,304,EVM,mRNA,2926026,4057996,70,0.23
ptg003399l,153227,153526,299,EVM,mRNA,128386,1990323,299,1.00
ptg003399l,540528,540826,298,EVM,mRNA,128386,1990323,298,1.00
ptg003399l,906442,906740,298,EVM,mRNA,128386,1990323,298,1.00
ptg003399l,1708399,1708698,299,EVM,mRNA,128386,1990323,299,1.00
ptg003404l,1894084,1894395,311,EVM,mRNA,1614751,5160580,311,1.00
ptg003404l,2718613,2718930,317,EVM,mRNA,1614751,5160580,317,1.00
ptg003404l,3332125,3332397,272,EVM,mRNA,1614751,5160580,272,1.00
ptg003405l,860061,860349,288,EVM,mRNA,724689,4353516,288,1.00
ptg003405l,2809464,2809763,299,EVM,mRNA,724689,4353516,299,1.00
ptg003405l,2957867,2958129,262,EVM,mRNA,724689,4353516,262,1.00
ptg003405l,3021925,3022212,287,EVM,mRNA,724689,4353516,287,1.00
ptg003405l,4944859,4945126,267,EVM,mRNA,4658356,4964135,267,1.00
ptg003408l,1785911,1786230,319,EVM,mRNA,861298,1956756,319,1.00
ptg003408l,3401788,3402080,292,EVM,mRNA,2980000,4179875,292,1.00
ptg003409l,224418,224705,287,EVM,mRNA,168490,1076800,287,1.00
ptg003409l,621482,621761,279,EVM,mRNA,168490,1076800,279,1.00
ptg003409l,1590459,1590738,279,EVM,mRNA,1527177,1647093,279,1.00
ptg003410l,540757,541037,280,EVM,mRNA,203704,1346882,280,1.00
ptg003410l,1075651,1075986,335,EVM,mRNA,203704,1346882,335,1.00
ptg003410l,1102376,1102652,276,EVM,mRNA,203704,1346882,276,1.00
ptg003411l,1194531,1194821,290,EVM,mRNA,523729,1332206,290,1.00
ptg003412l,2896168,2896499,331,EVM,mRNA,2820750,3189680,331,1.00
ptg003412l,3058885,3059182,297,EVM,mRNA,2820750,3189680,297,1.00
ptg003412l,3920557,3920851,294,EVM,mRNA,3827392,5633563,294,1.00
ptg003412l,4007408,4007703,295,EVM,mRNA,3827392,5633563,295,1.00
ptg003412l,6551582,6551896,314,EVM,mRNA,6546883,6730761,314,1.00
ptg003413l,1035241,1035525,284,EVM,mRNA,621649,1460463,284,1.00
ptg003414l,388669,388953,284,EVM,mRNA,249127,4253993,284,1.00
ptg003414l,763423,763724,301,EVM,mRNA,249127,4253993,301,1.00
ptg003414l,1689947,1690229,282,EVM,mRNA,249127,4253993,282,1.00
ptg003414l,1980979,1981278,299,EVM,mRNA,249127,4253993,299,1.00
ptg003414l,3285864,3286169,305,EVM,mRNA,249127,4253993,305,1.00
ptg003417l,505170,505446,276,EVM,mRNA,16428,1037128,276,1.00
ptg003417l,1160384,1160676,292,EVM,mRNA,1047196,1164156,292,1.00
ptg003419l,260625,260907,282,EVM,mRNA,116897,282819,282,1.00
ptg003419l,282134,282426,292,EVM,mRNA,116897,282819,292,1.00
ptg003420l,1970598,1970890,292,EVM,mRNA,1733621,2096929,292,1.00
ptg003422l,375728,376057,329,EVM,mRNA,308534,724358,329,1.00
ptg003426l,1459208,1459527,319,EVM,mRNA,229997,4118547,319,1.00
ptg003426l,1780864,1781143,279,EVM,mRNA,229997,4118547,279,1.00
ptg003426l,2392971,2393284,313,EVM,mRNA,229997,4118547,313,1.00
ptg003426l,4444466,4444763,297,EVM,mRNA,4418463,5286978,297,1.00
ptg003429l,157263,157567,304,EVM,mRNA,43906,363065,304,1.00
ptg003429l,1241687,1241976,289,EVM,mRNA,1222392,1751387,289,1.00
ptg003429l,1714290,1714583,293,EVM,mRNA,1222392,1751387,293,1.00
ptg003431l,398724,399014,290,EVM,mRNA,3409,694731,290,1.00
ptg003436l,1455952,1456236,284,EVM,mRNA,1115127,1507643,284,1.00
ptg003438l,510517,510847,330,EVM,mRNA,314412,839621,330,1.00
ptg003438l,1303803,1304094,291,EVM,mRNA,1116016,1304924,291,1.00
ptg003439l,2069511,2069784,273,EVM,mRNA,1097920,2696099,273,1.00
ptg003441l,612217,612508,291,EVM,mRNA,539830,629981,291,1.00
ptg003445l,178045,178341,296,EVM,mRNA,177616,1081843,296,1.00
ptg003446l,1919981,1920276,295,EVM,mRNA,1362795,2431090,295,1.00
ptg003446l,2089741,2090050,309,EVM,mRNA,1362795,2431090,309,1.00
ptg003446l,2103130,2103406,276,EVM,mRNA,1362795,2431090,276,1.00
ptg003446l,5667930,5668193,263,EVM,mRNA,2616582,6271182,263,1.00
ptg003449l,189133,189439,306,EVM,mRNA,2721,1548092,306,1.00
ptg003449l,562141,562449,308,EVM,mRNA,2721,1548092,308,1.00
ptg003449l,695399,695707,308,EVM,mRNA,2721,1548092,308,1.00
ptg003454l,733354,733668,314,EVM,mRNA,678534,800932,314,1.00
ptg003455l,1297139,1297435,296,EVM,mRNA,321344,3404345,296,1.00
ptg003456l,758270,758528,258,EVM,mRNA,399614,1592904,258,1.00
ptg003456l,802640,802927,287,EVM,mRNA,399614,1592904,287,1.00
ptg003456l,1577374,1577673,299,EVM,mRNA,399614,1592904,299,1.00
ptg003457l,67764,68076,312,EVM,mRNA,35575,922597,312,1.00
ptg003457l,394781,395081,300,EVM,mRNA,35575,922597,300,1.00
ptg003457l,1853892,1854165,273,EVM,mRNA,1628166,2194239,273,1.00
ptg003457l,2159959,2160282,323,EVM,mRNA,1628166,2194239,323,1.00
ptg003457l,5832739,5833042,303,EVM,mRNA,5471693,6763049,303,1.00
ptg003458l,910495,910794,299,EVM,mRNA,821834,1769818,299,1.00
ptg003458l,957272,957578,306,EVM,mRNA,821834,1769818,306,1.00
ptg003461l,1038921,1039211,290,EVM,mRNA,914314,1083099,290,1.00
ptg003462l,617521,617835,314,EVM,mRNA,36192,1266159,314,1.00
ptg003462l,1053833,1054162,329,EVM,mRNA,36192,1266159,329,1.00
ptg003463l,1330663,1330958,295,EVM,mRNA,114983,2025044,295,1.00
ptg003463l,1488787,1489079,292,EVM,mRNA,114983,2025044,292,1.00
ptg003463l,1550516,1550815,299,EVM,mRNA,114983,2025044,299,1.00
ptg003463l,1732865,1733169,304,EVM,mRNA,114983,2025044,304,1.00
ptg003463l,1763803,1764059,256,EVM,mRNA,114983,2025044,256,1.00
ptg003465l,613776,614042,266,EVM,mRNA,255636,737354,266,1.00
ptg003470l,250166,250486,320,EVM,mRNA,131542,2710682,320,1.00
ptg003470l,354225,354493,268,EVM,mRNA,131542,2710682,268,1.00
ptg003470l,974673,974998,325,EVM,mRNA,131542,2710682,325,1.00
ptg003470l,1953728,1954026,298,EVM,mRNA,131542,2710682,298,1.00
ptg003470l,1999348,1999643,295,EVM,mRNA,131542,2710682,295,1.00
ptg003470l,2324184,2324463,279,EVM,mRNA,131542,2710682,279,1.00
ptg003470l,2400623,2400908,285,EVM,mRNA,131542,2710682,285,1.00
ptg003471l,377991,378266,275,EVM,mRNA,114392,896274,275,1.00
ptg003471l,1374305,1374577,272,EVM,mRNA,975606,1921735,272,1.00
ptg003471l,3337506,3337780,274,EVM,mRNA,3030415,3924532,274,1.00
ptg003471l,3441312,3441594,282,EVM,mRNA,3030415,3924532,282,1.00
ptg003471l,3720715,3720995,280,EVM,mRNA,3030415,3924532,280,1.00
ptg003472l,2165199,2165507,308,EVM,mRNA,1614240,2479134,308,1.00
ptg003473l,105670,105959,289,EVM,mRNA,46184,1152347,289,1.00
ptg003473l,1693389,1693664,275,EVM,mRNA,1327890,4448765,275,1.00
ptg003473l,3613088,3613400,312,EVM,mRNA,1327890,4448765,312,1.00
ptg003474l,2993960,2994263,303,EVM,mRNA,2953888,3054658,303,1.00
ptg003477l,524506,524805,299,EVM,mRNA,234639,559784,299,1.00
ptg003478l,8456712,8457021,309,EVM,mRNA,8421932,9076199,309,1.00
ptg003480l,755437,755727,290,EVM,mRNA,7,2263688,290,1.00
ptg003480l,1611830,1612146,316,EVM,mRNA,7,2263688,316,1.00
ptg003482l,3438512,3438811,299,EVM,mRNA,2838010,3652902,299,1.00
ptg003482l,5593735,5594029,294,EVM,mRNA,5324069,6025231,294,1.00
ptg003487l,608788,609091,303,EVM,mRNA,579723,689530,303,1.00
ptg003489l,661872,662162,290,EVM,mRNA,271548,2437554,290,1.00
ptg003489l,937877,938172,295,EVM,mRNA,271548,2437554,295,1.00
ptg003489l,3141935,3142214,279,EVM,mRNA,2705241,3544098,279,1.00
ptg003489l,3215756,3216060,304,EVM,mRNA,2705241,3544098,304,1.00
ptg003492l,1690497,1690776,279,EVM,mRNA,1474621,2076799,279,1.00
ptg003492l,1913194,1913449,255,EVM,mRNA,1474621,2076799,255,1.00
ptg003494l,1243779,1244093,314,EVM,mRNA,1127165,1265248,314,1.00
ptg003495l,184085,184380,295,EVM,mRNA,882,1377223,295,1.00
ptg003495l,262511,262839,328,EVM,mRNA,882,1377223,328,1.00
ptg003499l,956900,957212,312,EVM,mRNA,742499,965819,312,1.00
ptg003505l,2170200,2170463,263,EVM,mRNA,2044397,2366988,263,1.00
ptg003509l,1558138,1558413,275,EVM,mRNA,1394992,1991684,275,1.00
ptg003509l,1705332,1705634,302,EVM,mRNA,1394992,1991684,302,1.00
ptg003512l,653123,653438,315,EVM,mRNA,262971,733641,315,1.00
ptg003513l,347709,348017,308,EVM,mRNA,270682,2434603,308,1.00
ptg003513l,392039,392326,287,EVM,mRNA,270682,2434603,287,1.00
ptg003513l,589794,590104,310,EVM,mRNA,270682,2434603,310,1.00
ptg003513l,1126401,1126676,275,EVM,mRNA,270682,2434603,275,1.00
ptg003513l,2231740,2232019,279,EVM,mRNA,270682,2434603,279,1.00
ptg003516l,268073,268384,311,EVM,mRNA,189674,938790,311,1.00
ptg003516l,286967,287263,296,EVM,mRNA,189674,938790,296,1.00
ptg003517l,2081105,2081391,286,EVM,mRNA,1497633,2744119,286,1.00
ptg003519l,6952658,6952989,331,EVM,mRNA,6548780,7160230,331,1.00
ptg003519l,7366307,7366639,332,EVM,mRNA,7306597,8084688,332,1.00
ptg003519l,8583309,8583593,284,EVM,mRNA,8241255,8749006,284,1.00
ptg003521l,2252278,2252555,277,EVM,mRNA,1973094,2338348,277,1.00
ptg003523l,3051083,3051392,309,EVM,mRNA,2034384,3842084,309,1.00
ptg003523l,3521723,3522020,297,EVM,mRNA,2034384,3842084,297,1.00
ptg003524l,1348243,1348508,265,EVM,mRNA,13296,1947450,265,1.00
ptg003524l,2682196,2682537,341,EVM,mRNA,2330704,3446294,341,1.00
ptg003525l,231417,231723,306,EVM,mRNA,6701,563414,306,1.00
ptg003526l,448472,448755,283,EVM,mRNA,401055,1700677,283,1.00
ptg003526l,1511188,1511504,316,EVM,mRNA,401055,1700677,316,1.00
ptg003526l,2275250,2275566,316,EVM,mRNA,2134913,2622862,316,1.00
ptg003526l,4086856,4087114,258,EVM,mRNA,3981206,4150063,258,1.00
ptg003529l,398256,398565,309,EVM,mRNA,288967,1936957,309,1.00
ptg003529l,1157036,1157367,331,EVM,mRNA,288967,1936957,331,1.00
ptg003529l,3183401,3183703,302,EVM,mRNA,3182357,3445507,302,1.00
ptg003530l,1417197,1417483,286,EVM,mRNA,703518,2511449,286,1.00
ptg003530l,3557237,3557562,325,EVM,mRNA,3488641,3970534,325,1.00
ptg003534l,1364043,1364357,314,EVM,mRNA,829949,2219861,314,1.00
ptg003534l,3250945,3251264,319,EVM,mRNA,2666696,3353715,319,1.00
ptg003534l,7054354,7054612,258,EVM,mRNA,6298359,7358442,258,1.00
ptg003534l,8908196,8908479,283,EVM,mRNA,8883892,9240194,283,1.00
ptg003534l,9712260,9712551,291,EVM,mRNA,9364403,10140272,291,1.00
ptg003534l,9932683,9932985,302,EVM,mRNA,9364403,10140272,302,1.00
ptg003534l,10436878,10437151,273,EVM,mRNA,10314474,11438741,273,1.00
ptg003534l,11122099,11122396,297,EVM,mRNA,10314474,11438741,297,1.00
ptg003534l,11224913,11225207,294,EVM,mRNA,10314474,11438741,294,1.00
ptg003534l,11357671,11357960,289,EVM,mRNA,10314474,11438741,289,1.00
ptg003537l,124084,124379,295,EVM,mRNA,97173,452153,295,1.00
ptg003537l,1392249,1392524,275,EVM,mRNA,1114434,1737494,275,1.00
ptg003537l,2269807,2270100,293,EVM,mRNA,2219751,2353746,293,1.00
ptg003537l,2595014,2595309,295,EVM,mRNA,2546770,2616575,295,1.00
ptg003539l,349693,349989,296,EVM,mRNA,762,1767680,296,1.00
ptg003539l,541757,542056,299,EVM,mRNA,762,1767680,299,1.00
ptg003539l,1602557,1602856,299,EVM,mRNA,762,1767680,299,1.00
ptg003542l,765465,765757,292,EVM,mRNA,532756,948671,292,1.00
ptg003544l,1056345,1056652,307,EVM,mRNA,892689,1415619,307,1.00
ptg003544l,2680670,2680935,265,EVM,mRNA,2218541,2699554,265,1.00
ptg003546l,1110812,1111102,290,EVM,mRNA,759220,1215091,290,1.00
ptg003547l,678624,678910,286,EVM,mRNA,409675,871054,286,1.00
ptg003548l,1682260,1682555,295,EVM,mRNA,1626375,1758227,295,1.00
ptg003551l,2360859,2361173,314,EVM,mRNA,1886293,2697488,314,1.00
ptg003553l,5769087,5769392,305,EVM,mRNA,5402318,5876732,305,1.00
ptg003553l,6335067,6335360,293,EVM,mRNA,6031353,6755624,293,1.00
ptg003553l,6423843,6424135,292,EVM,mRNA,6031353,6755624,292,1.00
ptg003555l,1362943,1363260,317,EVM,mRNA,760135,3595529,317,1.00
ptg003556l,1631511,1631831,320,EVM,mRNA,1604272,1669536,320,1.00
ptg003559l,704111,704433,322,EVM,mRNA,591189,741087,322,1.00
ptg003559l,1610762,1611055,293,EVM,mRNA,1373699,2100035,293,1.00
ptg003561l,1607958,1608274,316,EVM,mRNA,1177069,1896924,316,1.00
ptg003563l,669052,669351,299,EVM,mRNA,57484,726757,299,1.00
ptg003563l,4608687,4608999,312,EVM,mRNA,4435713,4631777,312,1.00
ptg003568l,1331491,1331812,321,EVM,mRNA,1259375,1352522,321,1.00
ptg003570l,497645,497957,312,EVM,mRNA,195073,521391,312,1.00
ptg003572l,277781,278083,302,EVM,mRNA,236443,1194487,302,1.00
ptg003572l,652521,652826,305,EVM,mRNA,236443,1194487,305,1.00
ptg003574l,448803,449102,299,EVM,mRNA,97591,750102,299,1.00
ptg003578l,211230,211502,272,EVM,mRNA,120737,811778,272,1.00
ptg003588l,341429,341710,281,EVM,mRNA,148971,698880,281,1.00
ptg003588l,977462,977732,270,EVM,mRNA,967139,1149230,270,1.00
ptg003588l,1454028,1454324,296,EVM,mRNA,1436031,1790334,296,1.00
ptg003588l,1699932,1700217,285,EVM,mRNA,1436031,1790334,285,1.00
ptg003590l,175452,175762,310,EVM,mRNA,141357,1877869,310,1.00
ptg003590l,1570001,1570323,322,EVM,mRNA,141357,1877869,322,1.00
ptg003590l,1700184,1700480,296,EVM,mRNA,141357,1877869,296,1.00
ptg003590l,1785894,1786169,275,EVM,mRNA,141357,1877869,275,1.00
ptg003590l,2711514,2711816,302,EVM,mRNA,2076256,4114576,302,1.00
ptg003590l,3717382,3717680,298,EVM,mRNA,2076256,4114576,298,1.00
ptg003591l,651262,651596,334,EVM,mRNA,52988,1120472,334,1.00
ptg003591l,929306,929630,324,EVM,mRNA,52988,1120472,324,1.00
ptg003591l,1017582,1017858,276,EVM,mRNA,52988,1120472,276,1.00
ptg003591l,1100975,1101279,304,EVM,mRNA,52988,1120472,304,1.00
ptg003597l,894759,895070,311,EVM,mRNA,683004,994110,311,1.00
ptg003598l,579495,579803,308,EVM,mRNA,488010,636476,308,1.00
ptg003598l,635515,635801,286,EVM,mRNA,488010,636476,286,1.00
ptg003601l,1792406,1792705,299,EVM,mRNA,1081125,1891455,299,1.00
ptg003605l,282154,282462,308,EVM,mRNA,172684,306165,308,1.00
ptg003606l,4007353,4007638,285,EVM,mRNA,3786231,4025686,285,1.00
ptg003607l,1755765,1756063,298,EVM,mRNA,16106,1894768,298,1.00
ptg003608l,1516139,1516431,292,EVM,mRNA,1515771,1580270,292,1.00
ptg003610l,110142,110430,288,EVM,mRNA,56807,1554545,288,1.00
ptg003610l,751679,752012,333,EVM,mRNA,56807,1554545,333,1.00
ptg003612l,158967,159298,331,EVM,mRNA,117084,166040,331,1.00
ptg003615l,2395636,2395920,284,EVM,mRNA,2213226,4413389,284,1.00
ptg003615l,3062678,3063001,323,EVM,mRNA,2213226,4413389,323,1.00
ptg003617l,1191534,1191827,293,EVM,mRNA,862382,1432460,293,1.00
ptg003617l,1201230,1201515,285,EVM,mRNA,862382,1432460,285,1.00
ptg003617l,1351313,1351587,274,EVM,mRNA,862382,1432460,274,1.00
ptg003620l,830704,831023,319,EVM,mRNA,105380,2467577,319,1.00
ptg003620l,3139422,3139721,299,EVM,mRNA,2750672,3726947,299,1.00
ptg003620l,3226233,3226530,297,EVM,mRNA,2750672,3726947,297,1.00
ptg003630l,344689,344974,285,EVM,mRNA,302294,456674,285,1.00
ptg003634l,424690,424965,275,EVM,mRNA,354711,582253,275,1.00
ptg003634l,6833287,6833595,308,EVM,mRNA,6137155,7815512,308,1.00
ptg003634l,6873566,6873836,270,EVM,mRNA,6137155,7815512,270,1.00
ptg003634l,6896172,6896471,299,EVM,mRNA,6137155,7815512,299,1.00
ptg003634l,7180496,7180782,286,EVM,mRNA,6137155,7815512,286,1.00
ptg003634l,7355519,7355842,323,EVM,mRNA,6137155,7815512,323,1.00
ptg003634l,8697521,8697829,308,EVM,mRNA,8128224,8813595,308,1.00
ptg003637l,161723,162019,296,EVM,mRNA,80673,903572,296,1.00
ptg003641l,1062804,1063096,292,EVM,mRNA,789337,1690599,292,1.00
ptg003641l,3151833,3152155,322,EVM,mRNA,2595660,4220763,322,1.00
ptg003649l,1192236,1192552,316,EVM,mRNA,1015860,1975716,316,1.00
ptg003651l,479545,479834,289,EVM,mRNA,1111,1250015,289,1.00
ptg003652l,1557145,1557457,312,EVM,mRNA,145365,2449554,312,1.00
ptg003652l,1892135,1892430,295,EVM,mRNA,145365,2449554,295,1.00
ptg003652l,2334578,2334860,282,EVM,mRNA,145365,2449554,282,1.00
ptg003659l,164299,164562,263,EVM,mRNA,250,828354,263,1.00
ptg003659l,290816,291130,314,EVM,mRNA,250,828354,314,1.00
ptg003662l,390649,390967,318,EVM,mRNA,150627,507258,318,1.00
ptg003662l,1697910,1698238,328,EVM,mRNA,1293563,1977900,328,1.00
ptg003665l,787913,788227,314,EVM,mRNA,787042,2446699,314,1.00
ptg003665l,3288358,3288676,318,EVM,mRNA,2930461,3360227,318,1.00
ptg003665l,4605594,4605894,300,EVM,mRNA,4345603,4867368,300,1.00
ptg003665l,5045278,5045574,296,EVM,mRNA,4991210,5419653,296,1.00
ptg003665l,5093352,5093651,299,EVM,mRNA,4991210,5419653,299,1.00
ptg003665l,6705655,6705950,295,EVM,mRNA,6070241,6975080,295,1.00
ptg003666l,2100241,2100564,323,EVM,mRNA,2092428,2907098,323,1.00
ptg003666l,2149000,2149296,296,EVM,mRNA,2092428,2907098,296,1.00
ptg003667l,1440273,1440576,303,EVM,mRNA,30286,1653223,303,1.00
ptg003667l,1440273,1440576,303,GeMoMa,mRNA,32779,1467598,303,1.00
ptg003670l,894157,894452,295,EVM,mRNA,629825,1295150,295,1.00
ptg003670l,1009992,1010291,299,EVM,mRNA,629825,1295150,299,1.00
ptg003673l,724593,724863,270,EVM,mRNA,643279,815888,270,1.00
ptg003675l,1293609,1293896,287,EVM,mRNA,1293701,1294005,196,0.68
ptg003675l,1676668,1676995,327,EVM,mRNA,1633678,1858231,327,1.00
ptg003678l,1935921,1936234,313,EVM,mRNA,1693012,1969530,313,1.00
ptg003681l,198796,199118,322,EVM,mRNA,3244,333670,322,1.00
ptg003681l,1936968,1937264,296,EVM,mRNA,1768259,2014420,296,1.00
ptg003681l,2884424,2884723,299,EVM,mRNA,2679075,3429043,299,1.00
ptg003681l,3132898,3133198,300,EVM,mRNA,2679075,3429043,300,1.00
ptg003681l,3331810,3332124,314,EVM,mRNA,2679075,3429043,314,1.00
ptg003683l,1395411,1395711,300,EVM,mRNA,1244603,2020225,300,1.00
ptg003683l,1673727,1674004,277,EVM,mRNA,1244603,2020225,277,1.00
ptg003683l,1869054,1869378,324,EVM,mRNA,1244603,2020225,324,1.00
ptg003693l,1706495,1706759,264,EVM,mRNA,1351908,1784496,264,1.00
ptg003696l,1071978,1072284,306,EVM,mRNA,73439,1457933,306,1.00
ptg003698l,771934,772221,287,EVM,mRNA,579464,918572,287,1.00
ptg003698l,1374404,1374690,286,EVM,mRNA,1374672,1844245,19,0.07
ptg003699l,2635017,2635298,281,EVM,mRNA,2207940,3007242,281,1.00
ptg003699l,2892865,2893143,278,EVM,mRNA,2207940,3007242,278,1.00
ptg003699l,4083667,4083975,308,EVM,mRNA,3919493,4161799,308,1.00
ptg003700l,2276811,2277088,277,EVM,mRNA,2275885,2423743,277,1.00
ptg003700l,2308453,2308735,282,EVM,mRNA,2275885,2423743,282,1.00
ptg003700l,3156662,3156981,319,EVM,mRNA,2761051,3357682,319,1.00
ptg003701l,1471489,1471806,317,EVM,mRNA,1062532,1612753,317,1.00
ptg003704l,497084,497392,308,EVM,mRNA,102921,672315,308,1.00
ptg003709l,520448,520746,298,EVM,mRNA,429478,706672,298,1.00
ptg003709l,807668,807946,278,EVM,mRNA,746084,1041582,278,1.00
ptg003709l,840894,841162,268,EVM,mRNA,746084,1041582,268,1.00
ptg003709l,3740177,3740493,316,EVM,mRNA,3727895,4531651,316,1.00
ptg003709l,4133429,4133732,303,EVM,mRNA,3727895,4531651,303,1.00
ptg003711l,130903,131193,290,EVM,mRNA,72618,1030265,290,1.00
ptg003711l,241913,242216,303,EVM,mRNA,72618,1030265,303,1.00
ptg003715l,271339,271636,297,EVM,mRNA,97545,459139,297,1.00
ptg003718l,69602,69889,287,EVM,mRNA,29234,109406,287,1.00
ptg003718l,1747967,1748281,314,EVM,mRNA,1474843,1939490,314,1.00
ptg003720l,1881256,1881513,257,EVM,mRNA,1446994,2561060,257,1.00
ptg003720l,2316847,2317165,318,EVM,mRNA,1446994,2561060,318,1.00
ptg003720l,3735592,3735888,296,EVM,mRNA,3432079,4533097,296,1.00
ptg003720l,3908130,3908407,277,EVM,mRNA,3432079,4533097,277,1.00
ptg003721l,708076,708389,313,EVM,mRNA,22822,922549,313,1.00
ptg003721l,2297969,2298267,298,EVM,mRNA,1935591,3627580,298,1.00
ptg003721l,4489391,4489704,313,EVM,mRNA,4448645,4698924,313,1.00
ptg003721l,4491775,4492088,313,EVM,mRNA,4448645,4698924,313,1.00
ptg003722l,2050218,2050511,293,EVM,mRNA,1120375,2163584,293,1.00
ptg003722l,2564851,2565124,273,EVM,mRNA,2393238,3021882,273,1.00
ptg003728l,1985962,1986261,299,EVM,mRNA,1215874,2138328,299,1.00
ptg003732l,685780,686100,320,EVM,mRNA,211021,1035466,320,1.00
ptg003737l,3848952,3849245,293,EVM,mRNA,3712006,4095135,293,1.00
ptg003737l,4091787,4092079,292,EVM,mRNA,3712006,4095135,292,1.00
ptg003737l,4666331,4666642,311,EVM,mRNA,4511105,4977787,311,1.00
ptg003737l,5863962,5864288,326,EVM,mRNA,4981557,6446729,326,1.00
ptg003747l,1075764,1076064,300,EVM,mRNA,735886,1131370,300,1.00
ptg003748l,656838,657104,266,EVM,mRNA,351526,1372158,266,1.00
ptg003748l,1486106,1486434,328,EVM,mRNA,1485685,2788577,328,1.00
ptg003748l,1511715,1511986,271,EVM,mRNA,1485685,2788577,271,1.00
ptg003749l,254692,254981,289,EVM,mRNA,193085,1890267,289,1.00
ptg003749l,958187,958488,301,EVM,mRNA,193085,1890267,301,1.00
ptg003749l,2833041,2833370,329,EVM,mRNA,2702253,3284297,329,1.00
ptg003749l,3440199,3440494,295,EVM,mRNA,3369036,3502262,295,1.00
ptg003749l,5451503,5451808,305,EVM,mRNA,4350891,8044840,305,1.00
ptg003749l,5724180,5724484,304,EVM,mRNA,4350891,8044840,304,1.00
ptg003749l,6584017,6584312,295,EVM,mRNA,4350891,8044840,295,1.00
ptg003749l,6697382,6697660,278,EVM,mRNA,4350891,8044840,278,1.00
ptg003749l,6711909,6712181,272,EVM,mRNA,4350891,8044840,272,1.00
ptg003749l,7671221,7671519,298,EVM,mRNA,4350891,8044840,298,1.00
ptg003749l,7904876,7905165,289,EVM,mRNA,4350891,8044840,289,1.00
ptg003749l,7965130,7965413,283,EVM,mRNA,4350891,8044840,283,1.00
ptg003750l,652634,652940,306,EVM,mRNA,478315,1110602,306,1.00
ptg003750l,781167,781471,304,EVM,mRNA,478315,1110602,304,1.00
ptg003751l,1149560,1149848,288,EVM,mRNA,1007194,1365345,288,1.00
ptg003752l,1905194,1905509,315,EVM,mRNA,1717057,2357376,315,1.00
ptg003753l,1714787,1715035,248,EVM,mRNA,1162955,1996133,248,1.00
ptg003753l,2261054,2261355,301,EVM,mRNA,2046727,2362935,301,1.00
ptg003754l,1557712,1558010,298,EVM,mRNA,843495,2035679,298,1.00
ptg003755l,248377,248665,288,EVM,mRNA,47905,1692079,288,1.00
ptg003766l,194967,195286,319,EVM,mRNA,69280,620445,319,1.00
ptg003768l,42180,42484,304,EVM,mRNA,40624,905327,304,1.00
ptg003774l,524872,525157,285,EVM,mRNA,14731,932769,285,1.00
ptg003778l,2220583,2220886,303,EVM,mRNA,2077756,4056579,303,1.00
ptg003778l,2652956,2653255,299,EVM,mRNA,2077756,4056579,299,1.00
ptg003779l,1837048,1837379,331,EVM,mRNA,10196,2501419,331,1.00
ptg003783l,2662460,2662763,303,EVM,mRNA,1564393,4367621,303,1.00
ptg003784l,696125,696420,295,EVM,mRNA,671801,2236019,295,1.00
ptg003784l,1270414,1270725,311,EVM,mRNA,671801,2236019,311,1.00
ptg003784l,1967028,1967356,328,EVM,mRNA,671801,2236019,328,1.00
ptg003786l,1746035,1746320,285,EVM,mRNA,435557,2112982,285,1.00
ptg003791l,302937,303255,318,EVM,mRNA,174615,322977,318,1.00
ptg003793l,345558,345880,322,EVM,mRNA,165014,1970818,322,1.00
ptg003793l,1171345,1171631,286,EVM,mRNA,165014,1970818,286,1.00
ptg003795l,706154,706454,300,EVM,mRNA,465918,754052,300,1.00
ptg003795l,710000,710316,316,EVM,mRNA,465918,754052,316,1.00
ptg003795l,999184,999477,293,EVM,mRNA,958915,5290743,293,1.00
ptg003798l,122311,122627,316,EVM,mRNA,45324,122567,256,0.81
ptg003803l,1077490,1077818,328,EVM,mRNA,891619,1205416,328,1.00
ptg003804l,1035430,1035729,299,EVM,mRNA,972506,1858723,299,1.00
ptg003804l,1633650,1633948,298,EVM,mRNA,972506,1858723,298,1.00
ptg003804l,2745166,2745444,278,EVM,mRNA,2743865,2746332,278,1.00
ptg003805l,101862,102169,307,EVM,mRNA,75691,111584,307,1.00
ptg003806l,996767,997045,278,EVM,mRNA,996810,1089730,236,0.85
ptg003807l,658538,658830,292,EVM,mRNA,88733,728615,292,1.00
ptg003809l,707302,707554,252,EVM,mRNA,668043,809051,252,1.00
ptg003812l,123475,123786,311,EVM,mRNA,10205,3132902,311,1.00
ptg003812l,1793369,1793634,265,EVM,mRNA,10205,3132902,265,1.00
ptg003812l,1816266,1816574,308,EVM,mRNA,10205,3132902,308,1.00
ptg003812l,2174621,2174907,286,EVM,mRNA,10205,3132902,286,1.00
ptg003817l,493739,494037,298,EVM,mRNA,319806,3061584,298,1.00
ptg003817l,829441,829740,299,EVM,mRNA,319806,3061584,299,1.00
ptg003817l,972519,972816,297,EVM,mRNA,319806,3061584,297,1.00
ptg003817l,1260620,1260919,299,EVM,mRNA,319806,3061584,299,1.00
ptg003817l,2569294,2569622,328,EVM,mRNA,319806,3061584,328,1.00
ptg003817l,2647221,2647517,296,EVM,mRNA,319806,3061584,296,1.00
ptg003817l,2973955,2974247,292,EVM,mRNA,319806,3061584,292,1.00
ptg003820l,696054,696358,304,EVM,mRNA,447282,832155,304,1.00
ptg003824l,1401257,1401545,288,EVM,mRNA,993751,2106051,288,1.00
ptg003824l,1478091,1478381,290,EVM,mRNA,993751,2106051,290,1.00
ptg003824l,1773196,1773523,327,EVM,mRNA,993751,2106051,327,1.00
ptg003825l,3108212,3108514,302,EVM,mRNA,2540394,3574139,302,1.00
ptg003830l,1796419,1796743,324,EVM,mRNA,1362731,2946289,324,1.00
ptg003830l,2199684,2199978,294,EVM,mRNA,1362731,2946289,294,1.00
ptg003831l,1162779,1163060,281,EVM,mRNA,1018858,2390849,281,1.00
ptg003833l,604415,604707,292,EVM,mRNA,26018,818056,292,1.00
ptg003833l,2435676,2435944,268,EVM,mRNA,2240661,2453374,268,1.00
ptg003833l,2764783,2765098,315,EVM,mRNA,2603749,2837812,315,1.00
ptg003833l,3586057,3586354,297,EVM,mRNA,3474563,3814311,297,1.00
ptg003835l,783075,783377,302,EVM,mRNA,44331,1044548,302,1.00
ptg003836l,457810,458126,316,EVM,mRNA,451597,650155,316,1.00
ptg003836l,1032841,1033164,323,EVM,mRNA,981125,1113312,323,1.00
ptg003836l,1400747,1401034,287,EVM,mRNA,1145496,1511753,287,1.00
ptg003837l,329938,330222,284,EVM,mRNA,154716,1175062,284,1.00
ptg003839l,1775888,1776205,317,EVM,mRNA,1469513,2372085,317,1.00
ptg003839l,3113024,3113322,298,EVM,mRNA,2662702,3190296,298,1.00
ptg003839l,3366835,3367137,302,EVM,mRNA,3280037,4474787,302,1.00
ptg003839l,3611958,3612246,288,EVM,mRNA,3280037,4474787,288,1.00
ptg003839l,4395230,4395547,317,EVM,mRNA,3280037,4474787,317,1.00
ptg003839l,5661036,5661322,286,EVM,mRNA,4889096,8552082,286,1.00
ptg003839l,6118351,6118648,297,EVM,mRNA,4889096,8552082,297,1.00
ptg003839l,7531348,7531660,312,EVM,mRNA,4889096,8552082,312,1.00
ptg003839l,8006414,8006733,319,EVM,mRNA,4889096,8552082,319,1.00
ptg003839l,8051438,8051733,295,EVM,mRNA,4889096,8552082,295,1.00
ptg003839l,8357601,8357887,286,EVM,mRNA,4889096,8552082,286,1.00
ptg003839l,8361434,8361746,312,EVM,mRNA,4889096,8552082,312,1.00
ptg003839l,8449515,8449841,326,EVM,mRNA,4889096,8552082,326,1.00
ptg003841l,1835243,1835578,335,EVM,mRNA,1773529,2336197,335,1.00
ptg003842l,385508,385821,313,EVM,mRNA,31055,912794,313,1.00
ptg003842l,485110,485390,280,EVM,mRNA,31055,912794,280,1.00
ptg003842l,686197,686513,316,EVM,mRNA,31055,912794,316,1.00
ptg003843l,1465609,1465897,288,EVM,mRNA,1361904,1664953,288,1.00
ptg003843l,1821423,1821742,319,EVM,mRNA,1789614,1822971,319,1.00
ptg003843l,3527365,3527649,284,EVM,mRNA,2560049,3775462,284,1.00
ptg003843l,3557689,3557983,294,EVM,mRNA,2560049,3775462,294,1.00
ptg003845l,581827,582129,302,EVM,mRNA,40281,645139,302,1.00
ptg003846l,430764,431076,312,EVM,mRNA,149963,2480807,312,1.00
ptg003846l,805970,806233,263,EVM,mRNA,149963,2480807,263,1.00
ptg003846l,1220658,1220964,306,EVM,mRNA,149963,2480807,306,1.00
ptg003846l,1375939,1376229,290,EVM,mRNA,149963,2480807,290,1.00
ptg003846l,1651610,1651890,280,EVM,mRNA,149963,2480807,280,1.00
ptg003846l,1993421,1993718,297,EVM,mRNA,149963,2480807,297,1.00
ptg003849l,261159,261454,295,EVM,mRNA,113182,365527,295,1.00
ptg003850l,2408045,2408354,309,EVM,mRNA,2154758,3541983,309,1.00
ptg003850l,3256529,3256852,323,EVM,mRNA,2154758,3541983,323,1.00
ptg003850l,3585317,3585580,263,EVM,mRNA,3569001,3879407,263,1.00
ptg003850l,5994249,5994543,294,EVM,mRNA,5280974,6262969,294,1.00
ptg003853l,2287513,2287822,309,EVM,mRNA,1666882,2355814,309,1.00
ptg003855l,739455,739774,319,EVM,mRNA,713528,809937,319,1.00
ptg003857l,3775802,3776075,273,EVM,mRNA,1894790,3826450,273,1.00
ptg003867l,500126,500406,280,EVM,mRNA,177705,1053223,280,1.00
ptg003872l,855292,855606,314,EVM,mRNA,697760,1949171,314,1.00
ptg003872l,1007566,1007872,306,EVM,mRNA,697760,1949171,306,1.00
ptg003873l,20268,20593,325,EVM,mRNA,5784,22978,325,1.00
ptg003873l,3211159,3211479,320,EVM,mRNA,3173799,3299636,320,1.00
ptg003874l,939479,939796,317,EVM,mRNA,132865,1275893,317,1.00
ptg003878l,1744096,1744375,279,EVM,mRNA,1184499,1791476,279,1.00
ptg003883l,393364,393677,313,EVM,mRNA,385345,852592,313,1.00
ptg003883l,468539,468812,273,EVM,mRNA,385345,852592,273,1.00
ptg003883l,667803,668102,299,EVM,mRNA,385345,852592,299,1.00
ptg003884l,186434,186708,274,EVM,mRNA,68268,530221,274,1.00
ptg003884l,229210,229484,274,EVM,mRNA,68268,530221,274,1.00
ptg003887l,1190950,1191281,331,EVM,mRNA,485391,1562086,331,1.00
ptg003887l,1197914,1198190,276,EVM,mRNA,485391,1562086,276,1.00
ptg003887l,2272133,2272428,295,EVM,mRNA,1678217,2496491,295,1.00
ptg003892l,152249,152576,327,EVM,mRNA,23082,302250,327,1.00
ptg003894l,911146,911426,280,EVM,mRNA,896059,1135369,280,1.00
ptg003895l,1179364,1179631,267,EVM,mRNA,714930,1313532,267,1.00
ptg003895l,2610040,2610363,323,EVM,mRNA,2480240,2855723,323,1.00
ptg003895l,2774040,2774361,321,EVM,mRNA,2480240,2855723,321,1.00
ptg003895l,2855338,2855663,325,EVM,mRNA,2480240,2855723,325,1.00
ptg003897l,127109,127399,290,EVM,mRNA,126660,683504,290,1.00
ptg003897l,341293,341584,291,EVM,mRNA,126660,683504,291,1.00
ptg003897l,1384346,1384641,295,EVM,mRNA,1055955,2091900,295,1.00
ptg003897l,2032534,2032859,325,EVM,mRNA,1055955,2091900,325,1.00
ptg003898l,1191979,1192282,303,EVM,mRNA,1102548,2494433,303,1.00
ptg003898l,1196564,1196863,299,EVM,mRNA,1102548,2494433,299,1.00
ptg003898l,1819475,1819765,290,EVM,mRNA,1102548,2494433,290,1.00
ptg003898l,2180751,2181036,285,EVM,mRNA,1102548,2494433,285,1.00
ptg003898l,2449085,2449396,311,EVM,mRNA,1102548,2494433,311,1.00
ptg003899l,1032535,1032811,276,EVM,mRNA,807721,1440929,276,1.00
ptg003900l,701626,701906,280,EVM,mRNA,238527,1631184,280,1.00
ptg003901l,27774,28084,310,EVM,mRNA,2667,181409,310,1.00
ptg003901l,2336638,2336953,315,EVM,mRNA,244810,2628848,315,1.00
ptg003901l,2514790,2515100,310,EVM,mRNA,244810,2628848,310,1.00
ptg003907l,265752,266070,318,EVM,mRNA,235015,405434,318,1.00
ptg003909l,1297495,1297817,322,EVM,mRNA,1197982,1297726,231,0.72
ptg003912l,2397387,2397679,292,EVM,mRNA,1013185,3889444,292,1.00
ptg003916l,504846,505158,312,EVM,mRNA,50764,1117740,312,1.00
ptg003916l,706446,706770,324,EVM,mRNA,50764,1117740,324,1.00
ptg003916l,2041981,2042268,287,EVM,mRNA,1830498,3453044,287,1.00
ptg003916l,2153033,2153338,305,EVM,mRNA,1830498,3453044,305,1.00
ptg003916l,3822050,3822322,272,EVM,mRNA,3608629,3822425,272,1.00
ptg003917l,803172,803494,322,EVM,mRNA,798500,830445,322,1.00
ptg003917l,2207186,2207507,321,EVM,mRNA,1870112,2675074,321,1.00
ptg003921l,1656675,1656975,300,EVM,mRNA,214989,2977211,300,1.00
ptg003921l,1907560,1907859,299,EVM,mRNA,214989,2977211,299,1.00
ptg003921l,2569667,2569966,299,EVM,mRNA,214989,2977211,299,1.00
ptg003921l,2574082,2574400,318,EVM,mRNA,214989,2977211,318,1.00
ptg003921l,2833681,2833984,303,EVM,mRNA,214989,2977211,303,1.00
ptg003923l,398389,398660,271,EVM,mRNA,213435,914314,271,1.00
ptg003923l,657571,657860,289,EVM,mRNA,213435,914314,289,1.00
ptg003923l,1131691,1132004,313,EVM,mRNA,1119207,1616312,313,1.00
ptg003923l,1573129,1573426,297,EVM,mRNA,1119207,1616312,297,1.00
ptg003925l,485549,485846,297,EVM,mRNA,274062,1343021,297,1.00
ptg003927l,1266230,1266534,304,EVM,mRNA,14490,1333847,304,1.00
ptg003933l,1106613,1106931,318,EVM,mRNA,733189,1743052,318,1.00
ptg003933l,1213836,1214128,292,EVM,mRNA,733189,1743052,292,1.00
ptg003933l,1314204,1314506,302,EVM,mRNA,733189,1743052,302,1.00
ptg003933l,1486422,1486720,298,EVM,mRNA,733189,1743052,298,1.00
ptg003933l,1616529,1616843,314,EVM,mRNA,733189,1743052,314,1.00
ptg003934l,310349,310655,306,EVM,mRNA,307487,3311871,306,1.00
ptg003934l,581892,582198,306,EVM,mRNA,307487,3311871,306,1.00
ptg003934l,1108129,1108430,301,EVM,mRNA,307487,3311871,301,1.00
ptg003934l,1339876,1340168,292,EVM,mRNA,307487,3311871,292,1.00
ptg003934l,1678571,1678852,281,EVM,mRNA,307487,3311871,281,1.00
ptg003934l,2012594,2012862,268,EVM,mRNA,307487,3311871,268,1.00
ptg003934l,2613345,2613659,314,EVM,mRNA,307487,3311871,314,1.00
ptg003934l,2726249,2726563,314,EVM,mRNA,307487,3311871,314,1.00
ptg003934l,2930827,2931117,290,EVM,mRNA,307487,3311871,290,1.00
ptg003934l,2936549,2936829,280,EVM,mRNA,307487,3311871,280,1.00
ptg003935l,929244,929538,294,EVM,mRNA,358611,4727752,294,1.00
ptg003935l,959647,959945,298,EVM,mRNA,358611,4727752,298,1.00
ptg003935l,2587239,2587550,311,EVM,mRNA,358611,4727752,311,1.00
ptg003936l,825187,825487,300,EVM,mRNA,26618,1153809,300,1.00
ptg003936l,2881827,2882158,331,EVM,mRNA,2052928,3217084,331,1.00
ptg003938l,2015656,2015970,314,EVM,mRNA,1474003,4020624,314,1.00
ptg003938l,3294634,3294928,294,EVM,mRNA,1474003,4020624,294,1.00
ptg003940l,994574,994835,261,EVM,mRNA,272214,3036012,261,1.00
ptg003940l,1265887,1266183,296,EVM,mRNA,272214,3036012,296,1.00
ptg003940l,1387277,1387591,314,EVM,mRNA,272214,3036012,314,1.00
ptg003940l,2236536,2236836,300,EVM,mRNA,272214,3036012,300,1.00
ptg003940l,2451655,2451966,311,EVM,mRNA,272214,3036012,311,1.00
ptg003941l,1285815,1286117,302,EVM,mRNA,648508,1338034,302,1.00
ptg003941l,1317836,1318123,287,EVM,mRNA,648508,1338034,287,1.00
ptg003942l,1080310,1080606,296,EVM,mRNA,906214,1374455,296,1.00
ptg003942l,1154443,1154715,272,EVM,mRNA,906214,1374455,272,1.00
ptg003942l,1176794,1177103,309,EVM,mRNA,906214,1374455,309,1.00
ptg003944l,407540,407832,292,EVM,mRNA,379729,541009,292,1.00
ptg003944l,3459810,3460108,298,EVM,mRNA,2388080,4207825,298,1.00
ptg003945l,1756648,1756950,302,EVM,mRNA,313159,2715322,302,1.00
ptg003945l,1916690,1916977,287,EVM,mRNA,313159,2715322,287,1.00
ptg003945l,2106893,2107204,311,EVM,mRNA,313159,2715322,311,1.00
ptg003945l,2432694,2433020,326,EVM,mRNA,313159,2715322,326,1.00
ptg003945l,2590290,2590622,332,EVM,mRNA,313159,2715322,332,1.00
ptg003946l,1416496,1416783,287,EVM,mRNA,1385161,1757417,287,1.00
ptg003947l,539218,539509,291,EVM,mRNA,308007,670338,291,1.00
ptg003950l,1490316,1490624,308,EVM,mRNA,593725,1726129,308,1.00
ptg003950l,5897638,5897953,315,EVM,mRNA,5866180,7061522,315,1.00
ptg003950l,5916136,5916450,314,EVM,mRNA,5866180,7061522,314,1.00
ptg003950l,6852266,6852581,315,EVM,mRNA,5866180,7061522,315,1.00
ptg003951l,592835,593142,307,EVM,mRNA,299919,3007965,307,1.00
ptg003951l,745106,745385,279,EVM,mRNA,299919,3007965,279,1.00
ptg003951l,3172166,3172430,264,EVM,mRNA,3136559,3358787,264,1.00
ptg003959l,353985,354267,282,EVM,mRNA,157324,403736,282,1.00
ptg003959l,382345,382656,311,EVM,mRNA,157324,403736,311,1.00
ptg003959l,611629,611934,305,EVM,mRNA,403751,796249,305,1.00
ptg003959l,1404332,1404621,289,EVM,mRNA,1400248,1750474,289,1.00
ptg003959l,1594530,1594847,317,EVM,mRNA,1400248,1750474,317,1.00
ptg003964l,106160,106447,287,EVM,mRNA,47303,313539,287,1.00
ptg003964l,2411547,2411829,282,EVM,mRNA,1451872,3063529,282,1.00
ptg003964l,2683463,2683749,286,EVM,mRNA,1451872,3063529,286,1.00
ptg003967l,3187675,3187943,268,EVM,mRNA,3099526,3453647,268,1.00
ptg003968l,2795798,2796117,319,EVM,mRNA,2537859,2879883,319,1.00
ptg003968l,4149767,4150087,320,EVM,mRNA,4044189,4231595,320,1.00
ptg003968l,4671710,4671993,283,EVM,mRNA,4499185,6057823,283,1.00
ptg003968l,4694667,4694976,309,EVM,mRNA,4499185,6057823,309,1.00
ptg003968l,5030181,5030480,299,EVM,mRNA,4499185,6057823,299,1.00
ptg003971l,1025768,1026053,285,EVM,mRNA,120985,1200455,285,1.00
ptg003971l,2215788,2216088,300,EVM,mRNA,1506689,2404898,300,1.00
ptg003975l,1216739,1217049,310,EVM,mRNA,575403,1489679,310,1.00
ptg003975l,1342598,1342897,299,EVM,mRNA,575403,1489679,299,1.00
ptg003982l,1406780,1407097,317,EVM,mRNA,1405906,2387106,317,1.00
ptg003982l,2340476,2340787,311,EVM,mRNA,1405906,2387106,311,1.00
ptg003984l,185211,185517,306,EVM,mRNA,17134,429338,306,1.00
ptg003985l,1238139,1238416,277,EVM,mRNA,1020230,1274719,277,1.00
ptg003994l,1102585,1102870,285,EVM,mRNA,879112,1173282,285,1.00
ptg003994l,1679012,1679323,311,EVM,mRNA,1174023,3808701,311,1.00
ptg003994l,2330534,2330836,302,EVM,mRNA,1174023,3808701,302,1.00
ptg003994l,2469090,2469403,313,EVM,mRNA,1174023,3808701,313,1.00
ptg003994l,3691286,3691578,292,EVM,mRNA,1174023,3808701,292,1.00
ptg003994l,4827349,4827638,289,EVM,mRNA,4036065,6600473,289,1.00
ptg003994l,4937880,4938174,294,EVM,mRNA,4036065,6600473,294,1.00
ptg003994l,5615141,5615476,335,EVM,mRNA,4036065,6600473,335,1.00
ptg003994l,5932050,5932362,312,EVM,mRNA,4036065,6600473,312,1.00
ptg003994l,6934485,6934781,296,EVM,mRNA,6718027,7014464,296,1.00
ptg003994l,7014132,7014420,288,EVM,mRNA,6718027,7014464,288,1.00
ptg003995l,340492,340774,282,EVM,mRNA,3300,1281807,282,1.00
ptg003995l,1207521,1207829,308,EVM,mRNA,3300,1281807,308,1.00
ptg003995l,2224937,2225211,274,EVM,mRNA,1621483,2311583,274,1.00
ptg003997l,2439475,2439742,267,EVM,mRNA,2438558,2976097,267,1.00
ptg003998l,1085784,1086038,254,EVM,mRNA,469703,3292644,254,1.00
ptg003998l,1679708,1680010,302,EVM,mRNA,469703,3292644,302,1.00
ptg003998l,2721998,2722316,318,EVM,mRNA,469703,3292644,318,1.00
ptg003998l,3007810,3008121,311,EVM,mRNA,469703,3292644,311,1.00
ptg004003l,928870,929194,324,EVM,mRNA,390951,1743548,324,1.00
ptg004004l,419031,419356,325,EVM,mRNA,76321,568786,325,1.00
ptg004007l,137098,137393,295,EVM,mRNA,122355,417382,295,1.00
ptg004007l,206446,206778,332,EVM,mRNA,122355,417382,332,1.00
ptg004007l,394896,395191,295,EVM,mRNA,122355,417382,295,1.00
ptg004008l,413193,413509,316,EVM,mRNA,270550,932161,316,1.00
ptg004008l,449489,449768,279,EVM,mRNA,270550,932161,279,1.00
ptg004008l,3010301,3010629,328,EVM,mRNA,2748106,5809795,328,1.00
ptg004008l,3831333,3831612,279,EVM,mRNA,2748106,5809795,279,1.00
ptg004008l,4910368,4910672,304,EVM,mRNA,2748106,5809795,304,1.00
ptg004008l,5325067,5325351,284,EVM,mRNA,2748106,5809795,284,1.00
ptg004008l,5500510,5500798,288,EVM,mRNA,2748106,5809795,288,1.00
ptg004008l,7516911,7517211,300,EVM,mRNA,6879856,8219911,300,1.00
ptg004008l,7981529,7981867,338,EVM,mRNA,6879856,8219911,338,1.00
ptg004009l,7314705,7315026,321,EVM,mRNA,5794624,8603401,321,1.00
ptg004009l,7578793,7579068,275,EVM,mRNA,5794624,8603401,275,1.00
ptg004009l,11055111,11055426,315,EVM,mRNA,11041113,11145926,315,1.00
ptg004009l,11131116,11131401,285,EVM,mRNA,11041113,11145926,285,1.00
ptg004010l,1282097,1282354,257,EVM,mRNA,666710,1283192,257,1.00
ptg004012l,484325,484629,304,EVM,mRNA,424597,1477528,304,1.00
ptg004012l,556912,557201,289,EVM,mRNA,424597,1477528,289,1.00
ptg004012l,597025,597314,289,EVM,mRNA,424597,1477528,289,1.00
ptg004012l,1062036,1062336,300,EVM,mRNA,424597,1477528,300,1.00
ptg004012l,2756356,2756667,311,EVM,mRNA,2577275,4449036,311,1.00
ptg004012l,3290018,3290303,285,EVM,mRNA,2577275,4449036,285,1.00
ptg004012l,3337524,3337819,295,EVM,mRNA,2577275,4449036,295,1.00
ptg004012l,3963262,3963566,304,EVM,mRNA,2577275,4449036,304,1.00
ptg004012l,4156555,4156868,313,EVM,mRNA,2577275,4449036,313,1.00
ptg004013l,320207,320494,287,EVM,mRNA,296224,399316,287,1.00
ptg004014l,5379663,5379965,302,EVM,mRNA,5034866,5560932,302,1.00
ptg004016l,3444182,3444480,298,EVM,mRNA,2729083,3890725,298,1.00
ptg004020l,800041,800332,291,EVM,mRNA,635646,1282742,291,1.00
ptg004021l,2968260,2968541,281,EVM,mRNA,2912219,5509017,281,1.00
ptg004021l,4520613,4520925,312,EVM,mRNA,2912219,5509017,312,1.00
ptg004021l,4771585,4771879,294,EVM,mRNA,2912219,5509017,294,1.00
ptg004022l,3962506,3962817,311,EVM,mRNA,2994458,5377577,311,1.00
ptg004022l,4886409,4886711,302,EVM,mRNA,2994458,5377577,302,1.00
ptg004023l,1541223,1541545,322,EVM,mRNA,280209,2234119,322,1.00
ptg004023l,2090874,2091190,316,EVM,mRNA,280209,2234119,316,1.00
ptg004023l,3331218,3331548,330,EVM,mRNA,3111570,4140752,330,1.00
ptg004023l,3730536,3730816,280,EVM,mRNA,3111570,4140752,280,1.00
ptg004026l,328986,329288,302,EVM,mRNA,205,811769,302,1.00
ptg004026l,1400735,1400988,253,EVM,mRNA,818507,1401714,253,1.00
ptg004028l,844214,844512,298,EVM,mRNA,404022,1520665,298,1.00
ptg004029l,239285,239578,293,EVM,mRNA,201695,911869,293,1.00
ptg004029l,405127,405424,297,EVM,mRNA,201695,911869,297,1.00
ptg004029l,541744,542061,317,EVM,mRNA,201695,911869,317,1.00
ptg004030l,1076792,1077113,321,EVM,mRNA,896575,1566280,321,1.00
ptg004033l,607092,607389,297,EVM,mRNA,451751,1129458,297,1.00
ptg004033l,863420,863724,304,EVM,mRNA,451751,1129458,304,1.00
ptg004033l,863420,863730,310,EVM,mRNA,451751,1129458,310,1.00
ptg004033l,945800,946104,304,EVM,mRNA,451751,1129458,304,1.00
ptg004033l,945800,946110,310,EVM,mRNA,451751,1129458,310,1.00
ptg004033l,1033038,1033366,328,EVM,mRNA,451751,1129458,328,1.00
ptg004033l,1815318,1815628,310,EVM,mRNA,1688768,2102719,310,1.00
ptg004033l,5263428,5263742,314,EVM,mRNA,4360432,5680505,314,1.00
ptg004033l,5596174,5596513,339,EVM,mRNA,4360432,5680505,339,1.00
ptg004033l,11050262,11050596,334,EVM,mRNA,10977835,11210332,334,1.00
ptg004036l,659148,659471,323,EVM,mRNA,157811,4263700,323,1.00
ptg004037l,558315,558627,312,EVM,mRNA,27326,839064,312,1.00
ptg004041l,2670426,2670744,318,EVM,mRNA,2604351,3004194,318,1.00
ptg004041l,3002929,3003218,289,EVM,mRNA,2604351,3004194,289,1.00
ptg004041l,3878535,3878816,281,EVM,mRNA,3877933,3908511,281,1.00
ptg004041l,4203530,4203822,292,EVM,mRNA,3963890,4233352,292,1.00
ptg004043l,688478,688776,298,EVM,mRNA,530215,759588,298,1.00
ptg004049l,97876,98184,308,EVM,mRNA,17,171712,308,1.00
ptg004049l,630529,630833,304,EVM,mRNA,509967,715922,304,1.00
ptg004049l,3294827,3295108,281,EVM,mRNA,3106941,3996900,281,1.00
ptg004049l,3791050,3791367,317,EVM,mRNA,3106941,3996900,317,1.00
ptg004056l,379884,380212,328,EVM,mRNA,261626,387363,328,1.00
ptg004057l,237999,238292,293,EVM,mRNA,234928,809788,293,1.00
ptg004057l,522266,522572,306,EVM,mRNA,234928,809788,306,1.00
ptg004058l,211688,211987,299,EVM,mRNA,858,1237656,299,1.00
ptg004059l,331874,332156,282,EVM,mRNA,68003,742297,282,1.00
ptg004059l,430869,431164,295,EVM,mRNA,68003,742297,295,1.00
ptg004060l,119062,119379,317,EVM,mRNA,3530,793573,317,1.00
ptg004060l,2792062,2792353,291,EVM,mRNA,1685438,4139537,291,1.00
ptg004060l,2808360,2808640,280,EVM,mRNA,1685438,4139537,280,1.00
ptg004060l,4645709,4646001,292,EVM,mRNA,4554222,4958666,292,1.00
ptg004062l,3528066,3528360,294,EVM,mRNA,3240987,4485549,294,1.00
ptg004062l,3901931,3902260,329,EVM,mRNA,3240987,4485549,329,1.00
ptg004064l,1231207,1231513,306,EVM,mRNA,11612,1683676,306,1.00
ptg004065l,472525,472816,291,EVM,mRNA,168202,2716464,291,1.00
ptg004065l,1058360,1058660,300,EVM,mRNA,168202,2716464,300,1.00
ptg004065l,2314733,2315006,273,EVM,mRNA,168202,2716464,273,1.00
ptg004068l,297990,298268,278,EVM,mRNA,239755,358584,278,1.00
ptg004071l,281169,281469,300,EVM,mRNA,224963,821445,300,1.00
ptg004071l,1224909,1225194,285,EVM,mRNA,1027808,1225833,285,1.00
ptg004072l,4371902,4372215,313,EVM,mRNA,4325337,4478002,313,1.00
ptg004080l,182283,182619,336,EVM,mRNA,106396,1095234,336,1.00
ptg004080l,2932146,2932426,280,EVM,mRNA,2769604,4990873,280,1.00
ptg004080l,3185517,3185799,282,EVM,mRNA,2769604,4990873,282,1.00
ptg004080l,4949021,4949343,322,EVM,mRNA,2769604,4990873,322,1.00
ptg004082l,2632413,2632725,312,EVM,mRNA,2392651,3888349,312,1.00
ptg004082l,6350041,6350332,291,EVM,mRNA,5647841,6525373,291,1.00
ptg004088l,496415,496730,315,EVM,mRNA,6997,625546,315,1.00
ptg004088l,1091903,1092194,291,EVM,mRNA,887634,2834187,291,1.00
ptg004088l,1331595,1331912,317,EVM,mRNA,887634,2834187,317,1.00
ptg004088l,1637357,1637632,275,EVM,mRNA,887634,2834187,275,1.00
ptg004088l,2393915,2394221,306,EVM,mRNA,887634,2834187,306,1.00
ptg004088l,2515462,2515743,281,EVM,mRNA,887634,2834187,281,1.00
ptg004092l,2644985,2645301,316,EVM,mRNA,2526945,2956558,316,1.00
ptg004092l,4007180,4007457,277,EVM,mRNA,3853351,4210024,277,1.00
ptg004093l,364918,365222,304,EVM,mRNA,314572,496356,304,1.00
ptg004093l,823671,823951,280,EVM,mRNA,721016,1018815,280,1.00
ptg004093l,831603,831883,280,EVM,mRNA,721016,1018815,280,1.00
ptg004093l,1375178,1375476,298,EVM,mRNA,1299334,1503268,298,1.00
ptg004102l,1276972,1277299,327,EVM,mRNA,1202669,1414362,327,1.00
ptg004102l,3564118,3564369,251,EVM,mRNA,3337616,3584811,251,1.00
ptg004104l,339523,339805,282,EVM,mRNA,96851,492615,282,1.00
ptg004107l,539460,539764,304,EVM,mRNA,486294,1361953,304,1.00
ptg004107l,904067,904355,288,EVM,mRNA,486294,1361953,288,1.00
ptg004107l,4554505,4554797,292,EVM,mRNA,4327980,5368134,292,1.00
ptg004107l,5003725,5003993,268,EVM,mRNA,4327980,5368134,268,1.00
ptg004107l,5109192,5109501,309,EVM,mRNA,4327980,5368134,309,1.00
ptg004108l,1114788,1115060,272,EVM,mRNA,1043341,1258830,272,1.00
ptg004109l,2617729,2618039,310,EVM,mRNA,2072277,2620695,310,1.00
ptg004111l,1932900,1933226,326,EVM,mRNA,892833,3215844,326,1.00
ptg004111l,2187760,2188080,320,EVM,mRNA,892833,3215844,320,1.00
ptg004111l,3604449,3604757,308,EVM,mRNA,3297834,3628447,308,1.00
ptg004115l,804284,804596,312,EVM,mRNA,4053,1689964,312,1.00
ptg004116l,900976,901303,327,EVM,mRNA,881562,1072950,327,1.00
ptg004118l,392000,392340,340,EVM,mRNA,22944,489507,340,1.00
ptg004119l,1072870,1073171,301,EVM,mRNA,959269,1670511,301,1.00
ptg004119l,1325166,1325459,293,EVM,mRNA,959269,1670511,293,1.00
ptg004119l,2598694,2598983,289,EVM,mRNA,2362614,2742548,289,1.00
ptg004119l,3190706,3190991,285,EVM,mRNA,3027270,3374551,285,1.00
ptg004119l,3323055,3323368,313,EVM,mRNA,3027270,3374551,313,1.00
ptg004119l,3581457,3581747,290,EVM,mRNA,3535103,3876971,290,1.00
ptg004120l,1265720,1266004,284,EVM,mRNA,1196998,1424170,284,1.00
ptg004120l,1368396,1368683,287,EVM,mRNA,1196998,1424170,287,1.00
ptg004122l,669556,669863,307,EVM,mRNA,118581,828206,307,1.00
ptg004123l,723773,724056,283,EVM,mRNA,651142,986010,283,1.00
ptg004123l,1564137,1564446,309,EVM,mRNA,1461639,1587961,309,1.00
ptg004123l,1803861,1804153,292,EVM,mRNA,1804145,2323340,9,0.03
ptg004123l,1811567,1811840,273,EVM,mRNA,1804145,2323340,273,1.00
ptg004123l,1818742,1819023,281,EVM,mRNA,1804145,2323340,281,1.00
ptg004126l,293763,294055,292,EVM,mRNA,3147,323513,292,1.00
ptg004126l,1692742,1693067,325,EVM,mRNA,1511074,1746097,325,1.00
ptg004129l,130327,130610,283,EVM,mRNA,101096,236354,283,1.00
ptg004130l,868962,869274,312,EVM,mRNA,281575,989446,312,1.00
ptg004132l,2473733,2474017,284,EVM,mRNA,2039099,3169456,284,1.00
ptg004132l,3151655,3151966,311,EVM,mRNA,2039099,3169456,311,1.00
ptg004133l,1683456,1683748,292,EVM,mRNA,1641874,1819196,292,1.00
ptg004133l,1708493,1708810,317,EVM,mRNA,1641874,1819196,317,1.00
ptg004135l,1837505,1837787,282,EVM,mRNA,30819,1892973,282,1.00
ptg004136l,1104821,1105120,299,EVM,mRNA,505809,1190124,299,1.00
ptg004136l,1902077,1902374,297,EVM,mRNA,1372251,2595482,297,1.00
ptg004136l,2594682,2594932,250,EVM,mRNA,1372251,2595482,250,1.00
ptg004136l,3533454,3533749,295,EVM,mRNA,3455379,3719225,295,1.00
ptg004137l,216429,216748,319,EVM,mRNA,467,1284279,319,1.00
ptg004139l,1227092,1227387,295,EVM,mRNA,643812,1823166,295,1.00
ptg004141l,266518,266802,284,EVM,mRNA,59557,431261,284,1.00
ptg004141l,1920329,1920650,321,EVM,mRNA,1836337,2071782,321,1.00
ptg004141l,1922863,1923138,275,EVM,mRNA,1836337,2071782,275,1.00
ptg004142l,415541,415836,295,EVM,mRNA,230641,489368,295,1.00
ptg004145l,1235717,1236030,313,EVM,mRNA,698467,3413002,313,1.00
ptg004145l,1771925,1772218,293,EVM,mRNA,698467,3413002,293,1.00
ptg004145l,2450837,2451120,283,EVM,mRNA,698467,3413002,283,1.00
ptg004145l,3652725,3653005,280,EVM,mRNA,3467259,3921815,280,1.00
ptg004148l,764319,764605,286,EVM,mRNA,179791,1333576,286,1.00
ptg004148l,1269442,1269744,302,EVM,mRNA,179791,1333576,302,1.00
ptg004152l,1833826,1834121,295,EVM,mRNA,525587,2010691,295,1.00
ptg004152l,3536742,3537046,304,EVM,mRNA,2136064,4342889,304,1.00
ptg004157l,1974193,1974510,317,EVM,mRNA,1607559,3048693,317,1.00
ptg004157l,2421535,2421852,317,EVM,mRNA,1607559,3048693,317,1.00
ptg004157l,2658608,2658920,312,EVM,mRNA,1607559,3048693,312,1.00
ptg004164l,981555,981826,271,EVM,mRNA,316259,1155892,271,1.00
ptg004164l,1445040,1445322,282,EVM,mRNA,1281726,1502778,282,1.00
ptg004165l,560733,561025,292,EVM,mRNA,298662,1629681,292,1.00
ptg004165l,776813,777126,313,EVM,mRNA,298662,1629681,313,1.00
ptg004165l,1162067,1162394,327,EVM,mRNA,298662,1629681,327,1.00
ptg004168l,130865,131167,302,EVM,mRNA,112356,2197772,302,1.00
ptg004168l,717996,718303,307,EVM,mRNA,112356,2197772,307,1.00
ptg004168l,988196,988515,319,EVM,mRNA,112356,2197772,319,1.00
ptg004168l,3221355,3221643,288,EVM,mRNA,3081449,3231495,288,1.00
ptg004169l,576543,576826,283,EVM,mRNA,9609,796564,283,1.00
ptg004169l,611489,611787,298,EVM,mRNA,9609,796564,298,1.00
ptg004174l,515885,516214,329,EVM,mRNA,260322,830930,329,1.00
ptg004179l,1445333,1445609,276,EVM,mRNA,1210443,1787638,276,1.00
ptg004179l,1618167,1618460,293,EVM,mRNA,1210443,1787638,293,1.00
ptg004179l,1689118,1689401,283,EVM,mRNA,1210443,1787638,283,1.00
ptg004183l,1275895,1276209,314,EVM,mRNA,522891,1580684,314,1.00
ptg004189l,404264,404577,313,EVM,mRNA,334570,944113,313,1.00
ptg004189l,2025458,2025751,293,EVM,mRNA,1911270,2096907,293,1.00
ptg004191l,725758,726067,309,EVM,mRNA,250189,3046816,309,1.00
ptg004191l,983499,983812,313,EVM,mRNA,250189,3046816,313,1.00
ptg004191l,988835,989147,312,EVM,mRNA,250189,3046816,312,1.00
ptg004191l,2044155,2044477,322,EVM,mRNA,250189,3046816,322,1.00
ptg004192l,4245761,4246058,297,EVM,mRNA,2865708,4486234,297,1.00
ptg004194l,977123,977417,294,EVM,mRNA,754337,1050462,294,1.00
ptg004194l,1087439,1087765,326,EVM,mRNA,1073040,1613344,326,1.00
ptg004196l,2527964,2528290,326,EVM,mRNA,2304647,3171008,326,1.00
ptg004200l,461011,461331,320,EVM,mRNA,371699,488377,320,1.00
ptg004200l,3530681,3530990,309,EVM,mRNA,3478132,4222780,309,1.00
ptg004200l,3720844,3721159,315,EVM,mRNA,3478132,4222780,315,1.00
ptg004200l,4141040,4141343,303,EVM,mRNA,3478132,4222780,303,1.00
ptg004200l,4147344,4147645,301,EVM,mRNA,3478132,4222780,301,1.00
ptg004205l,733856,734144,288,EVM,mRNA,520315,787974,288,1.00
ptg004208l,179704,180016,312,EVM,mRNA,110571,1268601,312,1.00
ptg004208l,2065515,2065829,314,EVM,mRNA,1477809,6042696,314,1.00
ptg004208l,2638864,2639132,268,EVM,mRNA,1477809,6042696,268,1.00
ptg004208l,2663714,2664012,298,EVM,mRNA,1477809,6042696,298,1.00
ptg004208l,2872167,2872473,306,EVM,mRNA,1477809,6042696,306,1.00
ptg004208l,3837088,3837401,313,EVM,mRNA,1477809,6042696,313,1.00
ptg004208l,4032802,4033114,312,EVM,mRNA,1477809,6042696,312,1.00
ptg004208l,4158463,4158763,300,EVM,mRNA,1477809,6042696,300,1.00
ptg004208l,4490212,4490488,276,EVM,mRNA,1477809,6042696,276,1.00
ptg004220l,362938,363243,305,EVM,mRNA,259567,497721,305,1.00
ptg004222l,915975,916270,295,EVM,mRNA,40810,2897900,295,1.00
ptg004222l,1555487,1555786,299,EVM,mRNA,40810,2897900,299,1.00
ptg004222l,1710635,1710939,304,EVM,mRNA,40810,2897900,304,1.00
ptg004225l,414310,414606,296,EVM,mRNA,8589,1075856,296,1.00
ptg004225l,601811,602144,333,EVM,mRNA,8589,1075856,333,1.00
ptg004227l,862203,862518,315,EVM,mRNA,728790,1069503,315,1.00
ptg004231l,37301,37574,273,EVM,mRNA,984,387544,273,1.00
ptg004231l,148088,148431,343,EVM,mRNA,984,387544,343,1.00
ptg004231l,229730,230049,319,EVM,mRNA,984,387544,319,1.00
ptg004233l,2435584,2435884,300,EVM,mRNA,2273868,2843684,300,1.00
ptg004233l,2641808,2642101,293,EVM,mRNA,2273868,2843684,293,1.00
ptg004233l,2686322,2686623,301,EVM,mRNA,2273868,2843684,301,1.00
ptg004233l,4436259,4436601,342,EVM,mRNA,4231467,4453980,342,1.00
ptg004234l,789939,790208,269,EVM,mRNA,789142,1057872,269,1.00
ptg004239l,744839,745119,280,EVM,mRNA,576859,1246483,280,1.00
ptg004239l,1792187,1792505,318,EVM,mRNA,1292522,2758841,318,1.00
ptg004239l,2186456,2186768,312,EVM,mRNA,1292522,2758841,312,1.00
ptg004242l,423541,423845,304,EVM,mRNA,366419,456545,304,1.00
ptg004243l,629529,629857,328,EVM,mRNA,285625,645945,328,1.00
ptg004243l,3289588,3289888,300,EVM,mRNA,2479027,3412341,300,1.00
ptg004244l,603031,603360,329,EVM,mRNA,8165,703852,329,1.00
ptg004245l,803413,803726,313,EVM,mRNA,167583,2927682,313,1.00
ptg004245l,2252421,2252709,288,EVM,mRNA,167583,2927682,288,1.00
ptg004245l,2406797,2407092,295,EVM,mRNA,167583,2927682,295,1.00
ptg004257l,1004359,1004658,299,EVM,mRNA,757474,1397895,299,1.00
ptg004261l,544333,544614,281,EVM,mRNA,46861,882128,281,1.00
ptg004261l,830398,830712,314,EVM,mRNA,46861,882128,314,1.00
ptg004261l,1800456,1800752,296,EVM,mRNA,1145946,1865563,296,1.00
ptg004261l,1837840,1838136,296,EVM,mRNA,1145946,1865563,296,1.00
ptg004262l,420960,421216,256,EVM,mRNA,336933,977305,256,1.00
ptg004262l,651675,651962,287,EVM,mRNA,336933,977305,287,1.00
ptg004264l,118779,119075,296,EVM,mRNA,7050,860983,296,1.00
ptg004265l,1906573,1906874,301,EVM,mRNA,1898477,1983294,301,1.00
ptg004266l,4518072,4518385,313,EVM,mRNA,4460122,4549197,313,1.00
ptg004266l,4528088,4528403,315,EVM,mRNA,4460122,4549197,315,1.00
ptg004267l,2043446,2043729,283,EVM,mRNA,1541745,2227512,283,1.00
ptg004267l,2145077,2145374,297,EVM,mRNA,1541745,2227512,297,1.00
ptg004270l,2390861,2391170,309,EVM,mRNA,1875673,2403718,309,1.00
ptg004277l,242071,242390,319,EVM,mRNA,171874,321218,319,1.00
ptg004277l,2426269,2426553,284,EVM,mRNA,1254227,2778674,284,1.00
ptg004279l,145545,145826,281,EVM,mRNA,86880,739302,281,1.00
ptg004279l,165570,165896,326,EVM,mRNA,86880,739302,326,1.00
ptg004279l,442239,442500,261,EVM,mRNA,86880,739302,261,1.00
ptg004279l,955698,956034,336,EVM,mRNA,857658,2009946,336,1.00
ptg004279l,1375204,1375469,265,EVM,mRNA,857658,2009946,265,1.00
ptg004284l,253531,253805,274,EVM,mRNA,145751,287996,274,1.00
ptg004284l,264929,265234,305,EVM,mRNA,145751,287996,305,1.00
ptg004288l,642218,642530,312,EVM,mRNA,89439,1193608,312,1.00
ptg004288l,1179791,1180072,281,EVM,mRNA,89439,1193608,281,1.00
ptg004289l,1486984,1487247,263,EVM,mRNA,1312382,3825386,263,1.00
ptg004291l,3198116,3198426,310,EVM,mRNA,2835802,4120390,310,1.00
ptg004291l,3437980,3438277,297,EVM,mRNA,2835802,4120390,297,1.00
ptg004291l,3715404,3715736,332,EVM,mRNA,2835802,4120390,332,1.00
ptg004291l,3749924,3750246,322,EVM,mRNA,2835802,4120390,322,1.00
ptg004294l,2148264,2148529,265,EVM,mRNA,2016236,3672230,265,1.00
ptg004294l,4914054,4914344,290,EVM,mRNA,3980476,5166750,290,1.00
ptg004294l,4932912,4933230,318,EVM,mRNA,3980476,5166750,318,1.00
ptg004295l,429561,429859,298,EVM,mRNA,388166,1320570,298,1.00
ptg004296l,8094,8377,283,EVM,mRNA,2133,214960,283,1.00
ptg004296l,1448088,1448415,327,EVM,mRNA,457020,1523775,327,1.00
ptg004300l,1102519,1102820,301,EVM,mRNA,1030035,1249695,301,1.00
ptg004300l,1248717,1249027,310,EVM,mRNA,1030035,1249695,310,1.00
ptg004300l,2248619,2248944,325,EVM,mRNA,1627300,3555035,325,1.00
ptg004300l,4171253,4171564,311,EVM,mRNA,3947927,4272601,311,1.00
ptg004302l,223543,223865,322,EVM,mRNA,96436,998636,322,1.00
ptg004302l,223543,223865,322,GeneWise,mRNA,96432,916437,322,1.00
ptg004302l,580443,580744,301,EVM,mRNA,96436,998636,301,1.00
ptg004302l,580443,580744,301,GeneWise,mRNA,96432,916437,301,1.00
ptg004302l,935763,936064,301,EVM,mRNA,96436,998636,301,1.00
ptg004302l,1395439,1395717,278,EVM,mRNA,1139525,3700933,278,1.00
ptg004302l,2231766,2232087,321,EVM,mRNA,1139525,3700933,321,1.00
ptg004302l,2860069,2860389,320,EVM,mRNA,1139525,3700933,320,1.00
ptg004302l,2990407,2990698,291,EVM,mRNA,1139525,3700933,291,1.00
ptg004302l,3066758,3067051,293,EVM,mRNA,1139525,3700933,293,1.00
ptg004302l,3656148,3656428,280,EVM,mRNA,1139525,3700933,280,1.00
ptg004303l,3791134,3791440,306,EVM,mRNA,3621247,4729333,306,1.00
ptg004303l,6435107,6435405,298,EVM,mRNA,6414609,6599794,298,1.00
ptg004309l,204422,204705,283,EVM,mRNA,20882,204978,283,1.00
ptg004314l,701208,701501,293,EVM,mRNA,32,2332483,293,1.00
ptg004314l,979858,980157,299,EVM,mRNA,32,2332483,299,1.00
ptg004314l,1125128,1125427,299,EVM,mRNA,32,2332483,299,1.00
ptg004314l,1460305,1460602,297,EVM,mRNA,32,2332483,297,1.00
ptg004314l,1497754,1498030,276,EVM,mRNA,32,2332483,276,1.00
ptg004314l,1736600,1736925,325,EVM,mRNA,32,2332483,325,1.00
ptg004314l,1934379,1934681,302,EVM,mRNA,32,2332483,302,1.00
ptg004314l,2090827,2091139,312,EVM,mRNA,32,2332483,312,1.00
ptg004317l,267831,268151,320,EVM,mRNA,260034,278092,320,1.00
ptg004317l,2404552,2404863,311,EVM,mRNA,1579360,3877451,311,1.00
ptg004321l,572923,573225,302,EVM,mRNA,19989,1175134,302,1.00
ptg004323l,2449353,2449602,249,EVM,mRNA,2234433,3009892,249,1.00
ptg004323l,2788604,2788901,297,EVM,mRNA,2234433,3009892,297,1.00
ptg004323l,3007677,3008019,342,EVM,mRNA,2234433,3009892,342,1.00
ptg004326l,3604776,3605071,295,EVM,mRNA,1017044,4222598,295,1.00
ptg004326l,3663263,3663531,268,EVM,mRNA,1017044,4222598,268,1.00
ptg004327l,552520,552840,320,EVM,mRNA,422499,2129628,320,1.00
ptg004327l,1154198,1154479,281,EVM,mRNA,422499,2129628,281,1.00
ptg004327l,7222100,7222361,261,EVM,mRNA,7179080,7260698,261,1.00
ptg004327l,7226993,7227277,284,EVM,mRNA,7179080,7260698,284,1.00
ptg004328l,3511902,3512205,303,EVM,mRNA,2646989,4696891,303,1.00
ptg004328l,3803818,3804120,302,EVM,mRNA,2646989,4696891,302,1.00
ptg004330l,2489019,2489318,299,EVM,mRNA,2138717,2627093,299,1.00
ptg004338l,489473,489798,325,EVM,mRNA,460911,2032574,325,1.00
ptg004338l,908378,908682,304,EVM,mRNA,460911,2032574,304,1.00
ptg004338l,926587,926877,290,EVM,mRNA,460911,2032574,290,1.00
ptg004338l,1493626,1493948,322,EVM,mRNA,460911,2032574,322,1.00
ptg004338l,1836549,1836850,301,EVM,mRNA,460911,2032574,301,1.00
ptg004342l,456137,456436,299,EVM,mRNA,424358,659271,299,1.00
ptg004343l,1401005,1401296,291,EVM,mRNA,3569,1486021,291,1.00
ptg004347l,378361,378661,300,EVM,mRNA,365645,957056,300,1.00
ptg004349l,1789366,1789643,277,EVM,mRNA,1699336,2717486,277,1.00
ptg004349l,2126780,2127077,297,EVM,mRNA,1699336,2717486,297,1.00
ptg004351l,1391329,1391610,281,EVM,mRNA,3430,2194788,281,1.00
ptg004353l,1831878,1832164,286,EVM,mRNA,1618326,2416407,286,1.00
ptg004356l,612070,612384,314,EVM,mRNA,412584,1481200,314,1.00
ptg004362l,656302,656607,305,EVM,mRNA,567233,1657623,305,1.00
ptg004362l,905487,905816,329,EVM,mRNA,567233,1657623,329,1.00
ptg004362l,1268108,1268417,309,EVM,mRNA,567233,1657623,309,1.00
ptg004362l,3246893,3247160,267,EVM,mRNA,2757684,3433046,267,1.00
ptg004362l,5136083,5136369,286,EVM,mRNA,3696979,6906988,286,1.00
ptg004362l,6843237,6843558,321,EVM,mRNA,3696979,6906988,321,1.00
ptg004364l,1909004,1909292,288,EVM,mRNA,1877524,2020486,288,1.00
ptg004373l,331596,331898,302,EVM,mRNA,185059,392285,302,1.00
ptg004373l,347063,347358,295,EVM,mRNA,185059,392285,295,1.00
ptg004376l,211930,212234,304,EVM,mRNA,167618,1110188,304,1.00
ptg004376l,789607,789857,250,EVM,mRNA,167618,1110188,250,1.00
ptg004379l,489481,489805,324,EVM,mRNA,23053,521264,324,1.00
ptg004379l,768704,769019,315,EVM,mRNA,767166,1360068,315,1.00
ptg004382l,3202857,3203174,317,EVM,mRNA,2813238,5228051,317,1.00
ptg004382l,4348976,4349265,289,EVM,mRNA,2813238,5228051,289,1.00
ptg004383l,717883,718163,280,EVM,mRNA,447004,1681414,280,1.00
ptg004383l,808928,809206,278,EVM,mRNA,447004,1681414,278,1.00
ptg004384l,282662,282970,308,EVM,mRNA,64812,639039,308,1.00
ptg004384l,600003,600284,281,EVM,mRNA,64812,639039,281,1.00
ptg004385l,1510816,1511131,315,EVM,mRNA,1444377,1830158,315,1.00
ptg004386l,700818,701140,322,EVM,mRNA,441961,1848222,322,1.00
ptg004387l,165567,165847,280,EVM,mRNA,6000,167059,280,1.00
ptg004387l,1741339,1741618,279,EVM,mRNA,1724221,2109504,279,1.00
ptg004394l,529166,529461,295,EVM,mRNA,20964,1131486,295,1.00
ptg004399l,355615,355896,281,EVM,mRNA,307292,1099344,281,1.00
ptg004399l,1470406,1470700,294,EVM,mRNA,1358848,1499265,294,1.00
ptg004399l,3663975,3664254,279,EVM,mRNA,3654703,3708114,279,1.00
ptg004404l,947979,948266,287,EVM,mRNA,354477,2114912,287,1.00
ptg004404l,1155698,1156027,329,EVM,mRNA,354477,2114912,329,1.00
ptg004409l,2100811,2101138,327,EVM,mRNA,1117916,2896105,327,1.00
ptg004409l,2228997,2229273,276,EVM,mRNA,1117916,2896105,276,1.00
ptg004409l,2349508,2349788,280,EVM,mRNA,1117916,2896105,280,1.00
ptg004410l,719086,719420,334,EVM,mRNA,62962,1031651,334,1.00
ptg004414l,941306,941603,297,EVM,mRNA,163629,1198819,297,1.00
ptg004416l,846071,846375,304,EVM,mRNA,716467,971516,304,1.00
ptg004417l,1308249,1308565,316,EVM,mRNA,890490,1559544,316,1.00
ptg004420l,850152,850426,274,EVM,mRNA,479370,1370226,274,1.00
ptg004422l,2016048,2016347,299,EVM,mRNA,1830412,3172545,299,1.00
ptg004422l,2703746,2704010,264,EVM,mRNA,1830412,3172545,264,1.00
ptg004422l,2783343,2783670,327,EVM,mRNA,1830412,3172545,327,1.00
ptg004425l,660700,660993,293,EVM,mRNA,546598,697272,293,1.00
ptg004426l,1026112,1026387,275,EVM,mRNA,949970,1227763,275,1.00
ptg004428l,2170643,2170916,273,EVM,mRNA,1263214,2437437,273,1.00
ptg004429l,1094391,1094720,329,EVM,mRNA,1091185,1481191,329,1.00
ptg004429l,1140512,1140780,268,EVM,mRNA,1091185,1481191,268,1.00
ptg004431l,381714,382032,318,EVM,mRNA,6039,768088,318,1.00
ptg004434l,321836,322159,323,EVM,mRNA,195393,528169,323,1.00
ptg004434l,855549,855872,323,EVM,mRNA,814260,2191099,323,1.00
ptg004434l,2109959,2110267,308,EVM,mRNA,814260,2191099,308,1.00
ptg004434l,2692795,2693087,292,EVM,mRNA,2333245,2741220,292,1.00
ptg004434l,7455658,7455944,286,EVM,mRNA,4479443,7901610,286,1.00
ptg004445l,35199,35511,312,EVM,mRNA,40,168558,312,1.00
ptg004446l,1411056,1411379,323,EVM,mRNA,1148729,1431503,323,1.00
ptg004448l,195843,196146,303,EVM,mRNA,1751,210070,303,1.00
ptg004449l,729698,730027,329,EVM,mRNA,572277,2620580,329,1.00
ptg004449l,1510099,1510410,311,EVM,mRNA,572277,2620580,311,1.00
ptg004449l,1913465,1913797,332,EVM,mRNA,572277,2620580,332,1.00
ptg004453l,479309,479602,293,EVM,mRNA,229414,762044,293,1.00
ptg004456l,1495843,1496143,300,EVM,mRNA,1291079,1510050,300,1.00
ptg004456l,2930437,2930736,299,EVM,mRNA,2903973,3178597,299,1.00
ptg004457l,89613,89898,285,EVM,mRNA,66224,181754,285,1.00
ptg004457l,1166374,1166655,281,EVM,mRNA,780784,1806901,281,1.00
ptg004460l,1183823,1184092,269,EVM,mRNA,1118110,2095518,269,1.00
ptg004460l,1261213,1261505,292,EVM,mRNA,1118110,2095518,292,1.00
ptg004460l,1910298,1910607,309,EVM,mRNA,1118110,2095518,309,1.00
ptg004466l,64238,64512,274,EVM,mRNA,59432,294707,274,1.00
ptg004468l,165540,165837,297,EVM,mRNA,22,3271886,297,1.00
ptg004468l,1145124,1145430,306,EVM,mRNA,22,3271886,306,1.00
ptg004468l,2457733,2458032,299,EVM,mRNA,22,3271886,299,1.00
ptg004477l,531238,531551,313,EVM,mRNA,402196,952138,313,1.00
ptg004478l,2985241,2985520,279,EVM,mRNA,2927765,3282484,279,1.00
ptg004479l,2996795,2997120,325,EVM,mRNA,2855671,3581172,325,1.00
ptg004479l,3238547,3238846,299,EVM,mRNA,2855671,3581172,299,1.00
ptg004482l,2060287,2060599,312,EVM,mRNA,2040740,2239253,312,1.00
ptg004482l,2343369,2343665,296,EVM,mRNA,2261973,2568711,296,1.00
ptg004482l,3199623,3199914,291,EVM,mRNA,2773960,3251964,291,1.00
ptg004487l,473983,474278,295,EVM,mRNA,1708,691922,295,1.00
ptg004489l,2652030,2652362,332,EVM,mRNA,2313272,3576003,332,1.00
ptg004491l,344730,345064,334,EVM,mRNA,317111,770656,334,1.00
ptg004491l,1278722,1279016,294,EVM,mRNA,1147982,1857129,294,1.00
ptg004493l,1581771,1582029,258,EVM,mRNA,1325521,2271128,258,1.00
ptg004493l,1703261,1703546,285,EVM,mRNA,1325521,2271128,285,1.00
ptg004493l,3378227,3378475,248,EVM,mRNA,2856244,3394654,248,1.00
ptg004495l,2071564,2071848,284,EVM,mRNA,1906228,2165998,284,1.00
ptg004495l,3512601,3512882,281,EVM,mRNA,2389717,3513263,281,1.00
ptg004497l,1680559,1680893,334,EVM,mRNA,1647419,2029450,334,1.00
ptg004497l,2550700,2550968,268,EVM,mRNA,2122895,2556410,268,1.00
ptg004497l,3685388,3685705,317,EVM,mRNA,3414830,3760451,317,1.00
ptg004499l,2465725,2466076,351,EVM,mRNA,1880407,2591540,351,1.00
ptg004500l,1681314,1681642,328,EVM,mRNA,663614,2307806,328,1.00
ptg004501l,1282704,1283019,315,EVM,mRNA,1253102,1653546,315,1.00
ptg004502l,1016592,1016872,280,EVM,mRNA,946169,2119653,280,1.00
ptg004510l,485502,485819,317,EVM,mRNA,216,1413287,317,1.00
ptg004510l,839912,840211,299,EVM,mRNA,216,1413287,299,1.00
ptg004510l,1040976,1041257,281,EVM,mRNA,216,1413287,281,1.00
ptg004510l,2874108,2874412,304,EVM,mRNA,2870247,4175864,304,1.00
ptg004510l,3189759,3190090,331,EVM,mRNA,2870247,4175864,331,1.00
ptg004510l,3881464,3881776,312,EVM,mRNA,2870247,4175864,312,1.00
ptg004512l,333884,334183,299,EVM,mRNA,224744,569837,299,1.00
ptg004512l,2830558,2830842,284,EVM,mRNA,2502183,3344832,284,1.00
ptg004512l,4030135,4030424,289,EVM,mRNA,4012842,5034870,289,1.00
ptg004512l,4198403,4198739,336,EVM,mRNA,4012842,5034870,336,1.00
ptg004512l,4412962,4413274,312,EVM,mRNA,4012842,5034870,312,1.00
ptg004512l,4682382,4682715,333,EVM,mRNA,4012842,5034870,333,1.00
ptg004521l,576123,576391,268,EVM,mRNA,211189,1007227,268,1.00
ptg004521l,594607,594884,277,EVM,mRNA,211189,1007227,277,1.00
ptg004522l,139225,139510,285,EVM,mRNA,110273,387063,285,1.00
ptg004523l,767140,767461,321,EVM,mRNA,739561,1054482,321,1.00
ptg004523l,3546630,3546922,292,EVM,mRNA,3164721,3550493,292,1.00
ptg004523l,5069344,5069636,292,EVM,mRNA,4705394,6593159,292,1.00
ptg004523l,5271511,5271816,305,EVM,mRNA,4705394,6593159,305,1.00
ptg004523l,5452766,5453075,309,EVM,mRNA,4705394,6593159,309,1.00
ptg004523l,5478454,5478744,290,EVM,mRNA,4705394,6593159,290,1.00
ptg004528l,1847363,1847664,301,EVM,mRNA,1215074,2230871,301,1.00
ptg004530l,386463,386785,322,EVM,mRNA,231573,1294077,322,1.00
ptg004530l,3368374,3368697,323,EVM,mRNA,3307605,3797944,323,1.00
ptg004530l,4753213,4753490,277,EVM,mRNA,4540665,7357994,277,1.00
ptg004530l,5428297,5428592,295,EVM,mRNA,4540665,7357994,295,1.00
ptg004530l,5744545,5744826,281,EVM,mRNA,4540665,7357994,281,1.00
ptg004530l,6380757,6381030,273,EVM,mRNA,4540665,7357994,273,1.00
ptg004530l,6970326,6970604,278,EVM,mRNA,4540665,7357994,278,1.00
ptg004530l,7274251,7274525,274,EVM,mRNA,4540665,7357994,274,1.00
ptg004535l,1029544,1029834,290,EVM,mRNA,937090,1455243,290,1.00
ptg004535l,1260866,1261142,276,EVM,mRNA,937090,1455243,276,1.00
ptg004535l,1440335,1440610,275,EVM,mRNA,937090,1455243,275,1.00
ptg004541l,1753627,1753949,322,EVM,mRNA,1277300,2377498,322,1.00
ptg004541l,2092811,2093108,297,EVM,mRNA,1277300,2377498,297,1.00
ptg004541l,2246726,2247021,295,EVM,mRNA,1277300,2377498,295,1.00
ptg004543l,2424744,2425045,301,EVM,mRNA,2378145,2798800,301,1.00
ptg004544l,3582590,3582873,283,EVM,mRNA,3336816,3951504,283,1.00
ptg004544l,3635050,3635346,296,EVM,mRNA,3336816,3951504,296,1.00
ptg004544l,3858814,3859135,321,EVM,mRNA,3336816,3951504,321,1.00
ptg004544l,5213293,5213588,295,EVM,mRNA,5007239,5323758,295,1.00
ptg004546l,176612,176908,296,EVM,mRNA,175013,224381,296,1.00
ptg004549l,324010,324296,286,EVM,mRNA,301242,566059,286,1.00
ptg004549l,815533,815831,298,EVM,mRNA,639547,1121515,298,1.00
ptg004549l,1835027,1835343,316,EVM,mRNA,1151202,2569437,316,1.00
ptg004552l,228357,228500,143,EVM,mRNA,175016,698238,143,1.00
ptg004556l,1049970,1050261,291,EVM,mRNA,826571,1598586,291,1.00
ptg004556l,2123499,2123761,262,EVM,mRNA,1754139,2201873,262,1.00
ptg004556l,2464481,2464773,292,EVM,mRNA,2212552,2825422,292,1.00
ptg004557l,339845,340152,307,EVM,mRNA,297035,355647,307,1.00
ptg004557l,341947,342232,285,EVM,mRNA,297035,355647,285,1.00
ptg004557l,549880,550160,280,EVM,mRNA,531000,564499,280,1.00
ptg004558l,1744128,1744423,295,EVM,mRNA,1525267,2307774,295,1.00
ptg004561l,674507,674814,307,EVM,mRNA,346392,936334,307,1.00
ptg004563l,275318,275597,279,EVM,mRNA,3643,1812933,279,1.00
ptg004563l,3796536,3796825,289,EVM,mRNA,3749136,4080221,289,1.00
ptg004567l,3173658,3173978,320,EVM,mRNA,2719614,4220125,320,1.00
ptg004567l,3635523,3635851,328,EVM,mRNA,2719614,4220125,328,1.00
ptg004570l,235740,236058,318,EVM,mRNA,168892,375952,318,1.00
ptg004571l,326116,326420,304,EVM,mRNA,1836,2685022,304,1.00
ptg004571l,330014,330325,311,EVM,mRNA,1836,2685022,311,1.00
ptg004571l,373599,373904,305,EVM,mRNA,1836,2685022,305,1.00
ptg004571l,865022,865313,291,EVM,mRNA,1836,2685022,291,1.00
ptg004571l,1222082,1222364,282,EVM,mRNA,1836,2685022,282,1.00
ptg004571l,2248760,2249042,282,EVM,mRNA,1836,2685022,282,1.00
ptg004571l,2574646,2574934,288,EVM,mRNA,1836,2685022,288,1.00
ptg004572l,775021,775287,266,EVM,mRNA,725677,780483,266,1.00
ptg004573l,58895,59213,318,EVM,mRNA,38230,737258,318,1.00
ptg004573l,70269,70583,314,EVM,mRNA,38230,737258,314,1.00
ptg004576l,438950,439211,261,EVM,mRNA,373901,607372,261,1.00
ptg004577l,1292949,1293249,300,EVM,mRNA,909259,2952857,300,1.00
ptg004578l,146309,146640,331,EVM,mRNA,41407,252672,331,1.00
ptg004578l,1224338,1224615,277,EVM,mRNA,849967,1371917,277,1.00
ptg004578l,1297507,1297804,297,EVM,mRNA,849967,1371917,297,1.00
ptg004584l,815428,815725,297,EVM,mRNA,12854,928640,297,1.00
ptg004584l,3657804,3658121,317,EVM,mRNA,1850633,3849435,317,1.00
ptg004594l,619316,619628,312,EVM,mRNA,102809,2587493,312,1.00
ptg004594l,704029,704338,309,EVM,mRNA,102809,2587493,309,1.00
ptg004594l,952752,953063,311,EVM,mRNA,102809,2587493,311,1.00
ptg004597l,2528375,2528706,331,EVM,mRNA,2520622,4501655,331,1.00
ptg004597l,2710391,2710704,313,EVM,mRNA,2520622,4501655,313,1.00
ptg004597l,5561533,5561799,266,EVM,mRNA,5560589,5694808,266,1.00
ptg004600l,697833,698160,327,EVM,mRNA,445586,1946041,327,1.00
ptg004600l,1308572,1308870,298,EVM,mRNA,445586,1946041,298,1.00
ptg004602l,96456,96772,316,EVM,mRNA,17488,202563,316,1.00
ptg004604l,1025738,1026026,288,EVM,mRNA,726296,1215363,288,1.00
ptg004605l,544019,544300,281,EVM,mRNA,8367,544506,281,1.00
ptg004608l,3322925,3323223,298,EVM,mRNA,2230504,3453264,298,1.00
ptg004608l,3421989,3422270,281,EVM,mRNA,2230504,3453264,281,1.00
ptg004615l,363457,363745,288,EVM,mRNA,136091,851919,288,1.00
ptg004615l,401110,401404,294,EVM,mRNA,136091,851919,294,1.00
ptg004615l,584243,584562,319,EVM,mRNA,136091,851919,319,1.00
ptg004616l,627375,627689,314,EVM,mRNA,613241,946547,314,1.00
ptg004616l,672539,672841,302,EVM,mRNA,613241,946547,302,1.00
ptg004616l,764156,764456,300,EVM,mRNA,613241,946547,300,1.00
ptg004619l,2687610,2687890,280,EVM,mRNA,2495126,4527779,280,1.00
ptg004619l,3691531,3691827,296,EVM,mRNA,2495126,4527779,296,1.00
ptg004619l,3921546,3921864,318,EVM,mRNA,2495126,4527779,318,1.00
ptg004620l,1444237,1444547,310,EVM,mRNA,453645,1615413,310,1.00
ptg004626l,989331,989610,279,EVM,mRNA,662551,2663274,279,1.00
ptg004626l,1763127,1763441,314,EVM,mRNA,662551,2663274,314,1.00
ptg004627l,167138,167401,263,EVM,mRNA,166494,316579,263,1.00
ptg004628l,640776,641104,328,EVM,mRNA,574742,708815,328,1.00
ptg004632l,908554,908850,296,EVM,mRNA,791945,2859767,296,1.00
ptg004632l,2102885,2103186,301,EVM,mRNA,791945,2859767,301,1.00
ptg004633l,912062,912390,328,EVM,mRNA,801888,926364,328,1.00
ptg004637l,1512737,1513067,330,EVM,mRNA,467704,1535718,330,1.00
ptg004639l,2193828,2194137,309,EVM,mRNA,1716945,2746544,309,1.00
ptg004639l,2353254,2353583,329,EVM,mRNA,1716945,2746544,329,1.00
ptg004639l,2418030,2418359,329,EVM,mRNA,1716945,2746544,329,1.00
ptg004639l,2717104,2717392,288,EVM,mRNA,1716945,2746544,288,1.00
ptg004639l,3581833,3582118,285,EVM,mRNA,3327477,3648108,285,1.00
ptg004639l,4115587,4115886,299,EVM,mRNA,3683647,4841801,299,1.00
ptg004639l,4411054,4411350,296,EVM,mRNA,3683647,4841801,296,1.00
ptg004639l,4810202,4810499,297,EVM,mRNA,3683647,4841801,297,1.00
ptg004641l,1532754,1533062,308,EVM,mRNA,1329719,3005210,308,1.00
ptg004641l,1810098,1810375,277,EVM,mRNA,1329719,3005210,277,1.00
ptg004641l,5808414,5808709,295,EVM,mRNA,5702433,8070706,295,1.00
ptg004641l,6422751,6423058,307,EVM,mRNA,5702433,8070706,307,1.00
ptg004645l,942038,942347,309,EVM,mRNA,71739,1599005,309,1.00
ptg004649l,3114884,3115196,312,EVM,mRNA,3029708,3195228,312,1.00
ptg004650l,1588202,1588509,307,EVM,mRNA,231700,1767564,307,1.00
ptg004655l,470187,470465,278,EVM,mRNA,15535,1093928,278,1.00
ptg004660l,455121,455457,336,EVM,mRNA,383848,913518,336,1.00
ptg004661l,625318,625633,315,EVM,mRNA,433664,820118,315,1.00
ptg004663l,3752805,3753085,280,EVM,mRNA,2981575,3786902,280,1.00
ptg004667l,32942,33272,330,EVM,mRNA,31782,35558,330,1.00
ptg004667l,1246685,1247007,322,EVM,mRNA,390571,1420413,322,1.00
ptg004670l,474962,475270,308,EVM,mRNA,226206,543964,308,1.00
ptg004674l,1564156,1564472,316,EVM,mRNA,840821,1767009,316,1.00
ptg004674l,2637939,2638242,303,EVM,mRNA,2335598,2723555,303,1.00
ptg004674l,2670714,2671028,314,EVM,mRNA,2335598,2723555,314,1.00
ptg004674l,3205348,3205657,309,EVM,mRNA,2874419,3765934,309,1.00
ptg004677l,3520941,3521257,316,EVM,mRNA,3481048,3901922,316,1.00
ptg004679l,1459245,1459563,318,EVM,mRNA,324539,1614052,318,1.00
ptg004679l,1704408,1704670,262,EVM,mRNA,1696241,1871731,262,1.00
ptg004679l,2810453,2810768,315,EVM,mRNA,2269547,4536508,315,1.00
ptg004679l,3062704,3063000,296,EVM,mRNA,2269547,4536508,296,1.00
ptg004679l,3079699,3080000,301,EVM,mRNA,2269547,4536508,301,1.00
ptg004679l,4882619,4882945,326,EVM,mRNA,4876642,4968186,326,1.00
ptg004679l,5106169,5106486,317,EVM,mRNA,4979298,5758135,317,1.00
ptg004680l,625132,625408,276,EVM,mRNA,425112,659904,276,1.00
ptg004681l,217043,217343,300,EVM,mRNA,67499,324245,300,1.00
ptg004682l,2903639,2903917,278,EVM,mRNA,2347872,4345757,278,1.00
ptg004682l,3393815,3394095,280,EVM,mRNA,2347872,4345757,280,1.00
ptg004682l,4119303,4119583,280,EVM,mRNA,2347872,4345757,280,1.00
ptg004682l,4192134,4192443,309,EVM,mRNA,2347872,4345757,309,1.00
ptg004685l,753216,753549,333,EVM,mRNA,82300,2781646,333,1.00
ptg004685l,1216730,1217039,309,EVM,mRNA,82300,2781646,309,1.00
ptg004685l,1529223,1529503,280,EVM,mRNA,82300,2781646,280,1.00
ptg004685l,2007799,2008119,320,EVM,mRNA,82300,2781646,320,1.00
ptg004688l,100658,100939,281,EVM,mRNA,1972,516910,281,1.00
ptg004693l,1162280,1162600,320,EVM,mRNA,166488,1211402,320,1.00
ptg004694l,694359,694643,284,EVM,mRNA,395649,2338019,284,1.00
ptg004696l,445253,445559,306,EVM,mRNA,165160,2005780,306,1.00
ptg004696l,1081213,1081519,306,EVM,mRNA,165160,2005780,306,1.00
ptg004696l,1351252,1351537,285,EVM,mRNA,165160,2005780,285,1.00
ptg004696l,1483591,1483892,301,EVM,mRNA,165160,2005780,301,1.00
ptg004696l,3776683,3777020,337,EVM,mRNA,2728230,4649010,337,1.00
ptg004696l,4324538,4324840,302,EVM,mRNA,2728230,4649010,302,1.00
ptg004697l,839215,839530,315,EVM,mRNA,626788,996372,315,1.00
ptg004699l,1302834,1303142,308,EVM,mRNA,362447,2197470,308,1.00
ptg004699l,1849802,1850103,301,EVM,mRNA,362447,2197470,301,1.00
ptg004700l,68015,68310,295,EVM,mRNA,11790,286905,295,1.00
ptg004700l,251457,251748,291,EVM,mRNA,11790,286905,291,1.00
ptg004705l,260802,261129,327,EVM,mRNA,24788,556199,327,1.00
ptg004705l,928840,929129,289,EVM,mRNA,904861,2525802,289,1.00
ptg004705l,1220607,1220934,327,EVM,mRNA,904861,2525802,327,1.00
ptg004705l,1263064,1263360,296,EVM,mRNA,904861,2525802,296,1.00
ptg004705l,2488304,2488581,277,EVM,mRNA,904861,2525802,277,1.00
ptg004705l,2502977,2503295,318,EVM,mRNA,904861,2525802,318,1.00
ptg004705l,3184389,3184673,284,EVM,mRNA,3010918,3268838,284,1.00
ptg004706l,1066603,1066883,280,EVM,mRNA,891293,1163167,280,1.00
ptg004708l,2443163,2443460,297,EVM,mRNA,26480,2452949,297,1.00
ptg004709l,779438,779744,306,EVM,mRNA,774395,957016,306,1.00
ptg004712l,1863470,1863773,303,EVM,mRNA,1812910,2173547,303,1.00
ptg004712l,3242809,3243110,301,EVM,mRNA,3162531,3818138,301,1.00
ptg004712l,3760486,3760781,295,EVM,mRNA,3162531,3818138,295,1.00
ptg004716l,39046,39358,312,EVM,mRNA,984,306326,312,1.00
ptg004717l,658272,658565,293,EVM,mRNA,99209,966295,293,1.00
ptg004717l,683615,683897,282,EVM,mRNA,99209,966295,282,1.00
ptg004717l,3129491,3129816,325,EVM,mRNA,2015309,3802189,325,1.00
ptg004717l,3362951,3363227,276,EVM,mRNA,2015309,3802189,276,1.00
ptg004717l,7343012,7343310,298,EVM,mRNA,7292665,9327428,298,1.00
ptg004717l,8911290,8911583,293,EVM,mRNA,7292665,9327428,293,1.00
ptg004723l,313485,313767,282,EVM,mRNA,21839,471389,282,1.00
ptg004724l,1959708,1960020,312,EVM,mRNA,1823448,2206880,312,1.00
ptg004725l,469545,469857,312,EVM,mRNA,310250,602754,312,1.00
ptg004727l,226947,227276,329,EVM,mRNA,81770,615247,329,1.00
ptg004728l,1153357,1153637,280,EVM,mRNA,863414,1953053,280,1.00
ptg004728l,1196430,1196710,280,EVM,mRNA,863414,1953053,280,1.00
ptg004728l,1203565,1203855,290,EVM,mRNA,863414,1953053,290,1.00
ptg004728l,1941819,1942133,314,EVM,mRNA,863414,1953053,314,1.00
ptg004728l,3005170,3005495,325,EVM,mRNA,2580816,3620034,325,1.00
ptg004728l,3199238,3199534,296,EVM,mRNA,2580816,3620034,296,1.00
ptg004733l,1346040,1346333,293,EVM,mRNA,81659,1353440,293,1.00
ptg004734l,52424,52723,299,EVM,mRNA,36269,114527,299,1.00
ptg004734l,1392962,1393255,293,EVM,mRNA,604062,4518641,293,1.00
ptg004736l,1322537,1322853,316,EVM,mRNA,1126193,1448403,316,1.00
ptg004737l,237254,237534,280,EVM,mRNA,16146,282074,280,1.00
ptg004742l,2836603,2836882,279,EVM,mRNA,2441164,3152823,279,1.00
ptg004742l,3058596,3058870,274,EVM,mRNA,2441164,3152823,274,1.00
ptg004743l,2955043,2955329,286,EVM,mRNA,2876797,3076568,286,1.00
ptg004743l,3845455,3845767,312,EVM,mRNA,3818089,3904545,312,1.00
ptg004752l,1149245,1149518,273,EVM,mRNA,893884,4887757,273,1.00
ptg004752l,3248101,3248426,325,EVM,mRNA,893884,4887757,325,1.00
ptg004752l,3368064,3368363,299,EVM,mRNA,893884,4887757,299,1.00
ptg004752l,3920672,3920972,300,EVM,mRNA,893884,4887757,300,1.00
ptg004752l,3976084,3976378,294,EVM,mRNA,893884,4887757,294,1.00
ptg004752l,4797584,4797877,293,EVM,mRNA,893884,4887757,293,1.00
ptg004754l,417968,418250,282,EVM,mRNA,175785,687371,282,1.00
ptg004758l,162092,162345,253,EVM,mRNA,158971,180578,253,1.00
ptg004758l,162744,163013,269,EVM,mRNA,158971,180578,269,1.00
ptg004758l,731574,731867,293,EVM,mRNA,443284,2230188,293,1.00
ptg004758l,1024252,1024551,299,EVM,mRNA,443284,2230188,299,1.00
ptg004758l,1468767,1469057,290,EVM,mRNA,443284,2230188,290,1.00
ptg004758l,2000099,2000384,285,EVM,mRNA,443284,2230188,285,1.00
ptg004759l,1053621,1053899,278,EVM,mRNA,32053,1614852,278,1.00
ptg004763l,1264867,1265189,322,EVM,mRNA,1247191,1678915,322,1.00
ptg004763l,1669477,1669738,261,EVM,mRNA,1247191,1678915,261,1.00
ptg004763l,2434595,2434893,298,EVM,mRNA,2096509,2608160,298,1.00
ptg004764l,606102,606394,292,EVM,mRNA,462628,810824,292,1.00
ptg004764l,706229,706519,290,EVM,mRNA,462628,810824,290,1.00
ptg004769l,103207,103514,307,EVM,mRNA,40133,197088,307,1.00
ptg004772l,642133,642449,316,EVM,mRNA,151279,1507523,316,1.00
ptg004772l,2337895,2338222,327,EVM,mRNA,1894621,3077302,327,1.00
ptg004774l,408361,408648,287,EVM,mRNA,347087,1371430,287,1.00
ptg004774l,835198,835492,294,EVM,mRNA,347087,1371430,294,1.00
ptg004774l,1052360,1052656,296,EVM,mRNA,347087,1371430,296,1.00
ptg004774l,1283799,1284073,274,EVM,mRNA,347087,1371430,274,1.00
ptg004774l,2534173,2534488,315,EVM,mRNA,2449471,2857143,315,1.00
ptg004775l,6299,6564,265,EVM,mRNA,4116,1641830,265,1.00
ptg004775l,1455523,1455811,288,EVM,mRNA,4116,1641830,288,1.00
ptg004782l,3259866,3260163,297,EVM,mRNA,3150261,3284162,297,1.00
ptg004782l,6614926,6615260,334,EVM,mRNA,6284368,6983791,334,1.00
ptg004788l,674903,675173,270,EVM,mRNA,393807,2217492,270,1.00
ptg004788l,697947,698236,289,EVM,mRNA,393807,2217492,289,1.00
ptg004788l,1935615,1935944,329,EVM,mRNA,393807,2217492,329,1.00
ptg004790l,926079,926349,270,EVM,mRNA,844202,1549669,270,1.00
ptg004790l,1269521,1269826,305,EVM,mRNA,844202,1549669,305,1.00
ptg004791l,588951,589254,303,EVM,mRNA,316166,725429,303,1.00
ptg004792l,588643,588929,286,EVM,mRNA,166361,740866,286,1.00
ptg004803l,830187,830491,304,EVM,mRNA,329534,1607342,304,1.00
ptg004803l,2210705,2210985,280,EVM,mRNA,2080145,3136550,280,1.00
ptg004803l,3132314,3132622,308,EVM,mRNA,2080145,3136550,308,1.00
ptg004804l,1591551,1591872,321,EVM,mRNA,1355861,2044356,321,1.00
ptg004808l,52516,52828,312,EVM,mRNA,15546,667171,312,1.00
ptg004808l,414727,415021,294,EVM,mRNA,15546,667171,294,1.00
ptg004815l,1327108,1327428,320,EVM,mRNA,1313621,1546952,320,1.00
ptg004816l,2942295,2942556,261,EVM,mRNA,2807800,3828588,261,1.00
ptg004816l,2956617,2956893,276,EVM,mRNA,2807800,3828588,276,1.00
ptg004816l,3331675,3331977,302,EVM,mRNA,2807800,3828588,302,1.00
ptg004819l,316494,316778,284,EVM,mRNA,300570,572128,284,1.00
ptg004819l,321363,321657,294,EVM,mRNA,300570,572128,294,1.00
ptg004826l,466189,466479,290,EVM,mRNA,43174,1955840,290,1.00
ptg004829l,610262,610573,311,EVM,mRNA,322725,1979281,311,1.00
ptg004829l,1302858,1303131,273,EVM,mRNA,322725,1979281,273,1.00
ptg004829l,1893817,1894131,314,EVM,mRNA,322725,1979281,314,1.00
ptg004834l,1049379,1049692,313,EVM,mRNA,395151,2106481,313,1.00
ptg004834l,1096942,1097224,282,EVM,mRNA,395151,2106481,282,1.00
ptg004834l,1646133,1646441,308,EVM,mRNA,395151,2106481,308,1.00
ptg004839l,1545654,1545969,315,EVM,mRNA,1397683,1735874,315,1.00
ptg004840l,1075449,1075742,293,EVM,mRNA,880974,1197882,293,1.00
ptg004840l,1126383,1126672,289,EVM,mRNA,880974,1197882,289,1.00
ptg004841l,3323253,3323546,293,EVM,mRNA,2208965,3505003,293,1.00
ptg004845l,261831,262103,272,EVM,mRNA,210497,1087270,272,1.00
ptg004845l,681928,682239,311,EVM,mRNA,210497,1087270,311,1.00
ptg004845l,791548,791834,286,EVM,mRNA,210497,1087270,286,1.00
ptg004846l,587650,587947,297,EVM,mRNA,456966,706160,297,1.00
ptg004850l,1476783,1477089,306,EVM,mRNA,1322442,2084828,306,1.00
ptg004851l,678457,678729,272,EVM,mRNA,561774,778377,272,1.00
ptg004851l,3091132,3091444,312,EVM,mRNA,3090058,4311514,312,1.00
ptg004852l,230233,230548,315,EVM,mRNA,93190,807843,315,1.00
ptg004857l,186707,187022,315,EVM,mRNA,6187,1507274,315,1.00
ptg004857l,324667,324960,293,EVM,mRNA,6187,1507274,293,1.00
ptg004857l,396159,396457,298,EVM,mRNA,6187,1507274,298,1.00
ptg004857l,832003,832313,310,EVM,mRNA,6187,1507274,310,1.00
ptg004857l,994462,994759,297,EVM,mRNA,6187,1507274,297,1.00
ptg004858l,731523,731800,277,EVM,mRNA,23339,1084671,277,1.00
ptg004862l,125194,125510,316,EVM,mRNA,28843,343339,316,1.00
ptg004864l,1053892,1054205,313,EVM,mRNA,845150,1178900,313,1.00
ptg004870l,446234,446533,299,EVM,mRNA,29953,1234530,299,1.00
ptg004870l,827111,827410,299,EVM,mRNA,29953,1234530,299,1.00
ptg004871l,1866575,1866880,305,EVM,mRNA,392708,1946826,305,1.00
ptg004871l,7146830,7147136,306,EVM,mRNA,6720025,8362028,306,1.00
ptg004871l,7867939,7868249,310,EVM,mRNA,6720025,8362028,310,1.00
ptg004871l,7874250,7874538,288,EVM,mRNA,6720025,8362028,288,1.00
ptg004871l,8003827,8004108,281,EVM,mRNA,6720025,8362028,281,1.00
ptg004878l,2980562,2980867,305,EVM,mRNA,2442787,4721055,305,1.00
ptg004878l,4170164,4170461,297,EVM,mRNA,2442787,4721055,297,1.00
ptg004885l,2030486,2030770,284,EVM,mRNA,1985570,2217455,284,1.00
ptg004885l,2055203,2055504,301,EVM,mRNA,1985570,2217455,301,1.00
ptg004892l,424054,424334,280,EVM,mRNA,304209,433846,280,1.00
ptg004893l,360250,360556,306,EVM,mRNA,269632,493393,306,1.00
ptg004894l,705508,705788,280,EVM,mRNA,489482,829815,280,1.00
ptg004897l,943997,944312,315,EVM,mRNA,777441,1007955,315,1.00
ptg004900l,677612,677911,299,EVM,mRNA,471624,881217,299,1.00
ptg004900l,1863695,1864008,313,EVM,mRNA,1508783,2456663,313,1.00
ptg004900l,3339344,3339662,318,EVM,mRNA,3035978,4621984,318,1.00
ptg004901l,854662,854960,298,EVM,mRNA,277354,2861080,298,1.00
ptg004901l,1115179,1115498,319,EVM,mRNA,277354,2861080,319,1.00
ptg004901l,1847477,1847777,300,EVM,mRNA,277354,2861080,300,1.00
ptg004901l,2098503,2098837,334,EVM,mRNA,277354,2861080,334,1.00
ptg004901l,2376027,2376337,310,EVM,mRNA,277354,2861080,310,1.00
ptg004901l,2425818,2426084,266,EVM,mRNA,277354,2861080,266,1.00
ptg004903l,658277,658564,287,EVM,mRNA,421760,1960989,287,1.00
ptg004903l,1045540,1045848,308,EVM,mRNA,421760,1960989,308,1.00
ptg004903l,1281872,1282168,296,EVM,mRNA,421760,1960989,296,1.00
ptg004903l,1342964,1343296,332,EVM,mRNA,421760,1960989,332,1.00
ptg004903l,1430327,1430602,275,EVM,mRNA,421760,1960989,275,1.00
ptg004905l,2782314,2782610,296,EVM,mRNA,2585882,3684415,296,1.00
ptg004905l,2835822,2836113,291,EVM,mRNA,2585882,3684415,291,1.00
ptg004908l,1246190,1246476,286,EVM,mRNA,767480,2476199,286,1.00
ptg004908l,1565743,1566026,283,EVM,mRNA,767480,2476199,283,1.00
ptg004908l,1956310,1956622,312,EVM,mRNA,767480,2476199,312,1.00
ptg004908l,2256526,2256841,315,EVM,mRNA,767480,2476199,315,1.00
ptg004911l,1162096,1162409,313,EVM,mRNA,920461,1298467,313,1.00
ptg004916l,390809,391083,274,EVM,mRNA,66805,595791,274,1.00
ptg004916l,558677,559010,333,EVM,mRNA,66805,595791,333,1.00
ptg004917l,127816,128132,316,EVM,mRNA,55655,622751,316,1.00
ptg004918l,1073119,1073391,272,EVM,mRNA,86310,1646237,272,1.00
ptg004918l,2102998,2103330,332,EVM,mRNA,1927595,2286079,332,1.00
ptg004921l,1287539,1287782,243,EVM,mRNA,18428,1462340,243,1.00
ptg004923l,2038587,2038863,276,EVM,mRNA,2027767,2338414,276,1.00
ptg004923l,3452852,3453133,281,EVM,mRNA,2456235,3525221,281,1.00
ptg004924l,824167,824453,286,EVM,mRNA,242225,937910,286,1.00
ptg004927l,1635999,1636299,300,EVM,mRNA,262614,3165531,300,1.00
ptg004927l,3629420,3629722,302,EVM,mRNA,3454145,4405156,302,1.00
ptg004929l,1129763,1130029,266,EVM,mRNA,74203,1758446,266,1.00
ptg004931l,1578246,1578547,301,EVM,mRNA,70440,1735281,301,1.00
ptg004933l,1008863,1009194,331,EVM,mRNA,484373,1390419,331,1.00
ptg004933l,1033849,1034175,326,EVM,mRNA,484373,1390419,326,1.00
ptg004933l,1125596,1125893,297,EVM,mRNA,484373,1390419,297,1.00
ptg004933l,2941815,2942107,292,EVM,mRNA,1516603,3020269,292,1.00
ptg004937l,2286015,2286259,244,EVM,mRNA,2283998,2332501,244,1.00
ptg004937l,4319425,4319712,287,EVM,mRNA,4144941,4416790,287,1.00
ptg004940l,90053,90355,302,EVM,mRNA,82009,685086,302,1.00
ptg004946l,676630,676948,318,EVM,mRNA,642506,1103304,318,1.00
ptg004946l,820880,821154,274,EVM,mRNA,642506,1103304,274,1.00
ptg004950l,266882,267179,297,EVM,mRNA,7741,583856,297,1.00
ptg004955l,1363738,1364018,280,EVM,mRNA,1348772,1799501,280,1.00
ptg004955l,1641625,1641907,282,EVM,mRNA,1348772,1799501,282,1.00
ptg004955l,1958630,1958931,301,EVM,mRNA,1945659,2574214,301,1.00
ptg004955l,3428559,3428862,303,EVM,mRNA,3356749,3514725,303,1.00
ptg004955l,4235349,4235642,293,EVM,mRNA,3946533,4298544,293,1.00
ptg004956l,994220,994542,322,EVM,mRNA,196087,1175188,322,1.00
ptg004960l,818371,818642,271,EVM,mRNA,517746,1701465,271,1.00
ptg004960l,1007992,1008313,321,EVM,mRNA,517746,1701465,321,1.00
ptg004960l,1282851,1283146,295,EVM,mRNA,517746,1701465,295,1.00
ptg004960l,1678829,1679088,259,EVM,mRNA,517746,1701465,259,1.00
ptg004962l,467531,467806,275,EVM,mRNA,455201,1032065,275,1.00
ptg004968l,1573448,1573720,272,EVM,mRNA,1264118,3142667,272,1.00
ptg004968l,2667975,2668290,315,EVM,mRNA,1264118,3142667,315,1.00
ptg004968l,4700468,4700768,300,EVM,mRNA,4465825,5100946,300,1.00
ptg004968l,4922386,4922649,263,EVM,mRNA,4465825,5100946,263,1.00
ptg004968l,5171800,5172097,297,EVM,mRNA,5158903,5281471,297,1.00
ptg004968l,6534400,6534712,312,EVM,mRNA,6521330,7264548,312,1.00
ptg004968l,6645549,6645850,301,EVM,mRNA,6521330,7264548,301,1.00
ptg004968l,8532192,8532478,286,EVM,mRNA,8308168,10192404,286,1.00
ptg004968l,8613825,8614135,310,EVM,mRNA,8308168,10192404,310,1.00
ptg004968l,9638381,9638664,283,EVM,mRNA,8308168,10192404,283,1.00
ptg004984l,90917,91222,305,EVM,mRNA,28511,273269,305,1.00
ptg004984l,248116,248441,325,EVM,mRNA,28511,273269,325,1.00
ptg004984l,464506,464817,311,EVM,mRNA,435693,1191355,311,1.00
ptg004984l,1112223,1112549,326,EVM,mRNA,435693,1191355,326,1.00
ptg004984l,3580429,3580718,289,EVM,mRNA,3220926,3581297,289,1.00
ptg004984l,5266535,5266859,324,EVM,mRNA,5166295,5550956,324,1.00
ptg004984l,5307839,5308136,297,EVM,mRNA,5166295,5550956,297,1.00
ptg004984l,5494265,5494588,323,EVM,mRNA,5166295,5550956,323,1.00
ptg004985l,215940,216234,294,EVM,mRNA,140825,1239400,294,1.00
ptg004985l,1267981,1268271,290,EVM,mRNA,1242886,1333436,290,1.00
ptg004986l,1348794,1349094,300,EVM,mRNA,1176823,1360724,300,1.00
ptg004987l,1041877,1042176,299,EVM,mRNA,617184,1950553,299,1.00
ptg004987l,1191424,1191733,309,EVM,mRNA,617184,1950553,309,1.00
ptg004987l,1656746,1657057,311,EVM,mRNA,617184,1950553,311,1.00
ptg004990l,308328,308610,282,EVM,mRNA,178154,633426,282,1.00
ptg004990l,1573743,1574052,309,EVM,mRNA,1217164,2205515,309,1.00
ptg004990l,1746971,1747263,292,EVM,mRNA,1217164,2205515,292,1.00
ptg004990l,2366100,2366393,293,EVM,mRNA,2338131,2777041,293,1.00
ptg004991l,732044,732356,312,EVM,mRNA,180649,1546653,312,1.00
ptg004991l,1327015,1327319,304,EVM,mRNA,180649,1546653,304,1.00
ptg004995l,611418,611715,297,EVM,mRNA,191122,680456,297,1.00
ptg004995l,1030628,1030906,278,EVM,mRNA,935226,1547576,278,1.00
ptg004999l,1149439,1149752,313,EVM,mRNA,447429,1180319,313,1.00
ptg005001l,1056942,1057262,320,EVM,mRNA,312983,1257249,320,1.00
ptg005001l,1223897,1224194,297,EVM,mRNA,312983,1257249,297,1.00
ptg005006l,348813,349114,301,EVM,mRNA,256313,574422,301,1.00
ptg005006l,374094,374411,317,EVM,mRNA,256313,574422,317,1.00
ptg005006l,546335,546646,311,EVM,mRNA,256313,574422,311,1.00
ptg005006l,2808485,2808794,309,EVM,mRNA,2478613,3926460,309,1.00
ptg005007l,2676814,2677134,320,EVM,mRNA,2288235,3154486,320,1.00
ptg005007l,4073992,4074294,302,EVM,mRNA,4012539,4332864,302,1.00
ptg005011l,2363834,2364133,299,EVM,mRNA,2299375,3296024,299,1.00
ptg005013l,634488,634786,298,EVM,mRNA,283538,1910864,298,1.00
ptg005013l,1326165,1326458,293,EVM,mRNA,283538,1910864,293,1.00
ptg005013l,1421179,1421479,300,EVM,mRNA,283538,1910864,300,1.00
ptg005013l,1520304,1520602,298,EVM,mRNA,283538,1910864,298,1.00
ptg005014l,1862900,1863290,390,EVM,mRNA,1677746,2226138,390,1.00
ptg005018l,710346,710632,286,EVM,mRNA,224111,1570279,286,1.00
ptg005018l,1309145,1309440,295,EVM,mRNA,224111,1570279,295,1.00
ptg005019l,1073883,1074170,287,EVM,mRNA,1032121,2948304,287,1.00
ptg005019l,2560038,2560336,298,EVM,mRNA,1032121,2948304,298,1.00
ptg005019l,4419173,4419480,307,EVM,mRNA,4243877,4815583,307,1.00
ptg005019l,4670876,4671188,312,EVM,mRNA,4243877,4815583,312,1.00
ptg005021l,593957,594271,314,EVM,mRNA,197410,2652157,314,1.00
ptg005021l,2044974,2045288,314,EVM,mRNA,197410,2652157,314,1.00
ptg005021l,2440910,2441223,313,EVM,mRNA,197410,2652157,313,1.00
ptg005021l,2644692,2644972,280,EVM,mRNA,197410,2652157,280,1.00
ptg005024l,465360,465655,295,EVM,mRNA,294294,1115750,295,1.00
ptg005024l,1239136,1239464,328,EVM,mRNA,1213526,1264570,328,1.00
ptg005024l,3582293,3582590,297,EVM,mRNA,3504591,3653810,297,1.00
ptg005026l,1219943,1220269,326,EVM,mRNA,1146698,2008032,326,1.00
ptg005026l,4106408,4106693,285,EVM,mRNA,3502966,4630393,285,1.00
ptg005026l,5905619,5905953,334,EVM,mRNA,5188082,6169907,334,1.00
ptg005028l,580931,581248,317,EVM,mRNA,42437,1258198,317,1.00
ptg005032l,561477,561797,320,EVM,mRNA,222771,2243787,320,1.00
ptg005034l,2817645,2817952,307,EVM,mRNA,1766501,3025021,307,1.00
ptg005035l,179142,179432,290,EVM,mRNA,134297,1088054,290,1.00
ptg005035l,932983,933281,298,EVM,mRNA,134297,1088054,298,1.00
ptg005038l,1658792,1659093,301,EVM,mRNA,123721,3633932,301,1.00
ptg005038l,1777582,1777905,323,EVM,mRNA,123721,3633932,323,1.00
ptg005038l,2458603,2458889,286,EVM,mRNA,123721,3633932,286,1.00
ptg005040l,3149543,3149842,299,EVM,mRNA,3009002,3196045,299,1.00
ptg005042l,1116502,1116800,298,EVM,mRNA,868232,1387965,298,1.00
ptg005042l,1186249,1186551,302,EVM,mRNA,868232,1387965,302,1.00
ptg005045l,209067,209383,316,EVM,mRNA,202496,279758,316,1.00
ptg005045l,252410,252726,316,EVM,mRNA,202496,279758,316,1.00
ptg005048l,1551967,1552259,292,EVM,mRNA,1497805,2199669,292,1.00
ptg005048l,2802028,2802333,305,EVM,mRNA,2572194,2850395,305,1.00
ptg005050l,1168457,1168741,284,EVM,mRNA,1023244,1862428,284,1.00
ptg005052l,562065,562379,314,EVM,mRNA,462851,2035929,314,1.00
ptg005052l,1730769,1731072,303,EVM,mRNA,462851,2035929,303,1.00
ptg005054l,2159239,2159539,300,EVM,mRNA,699780,3582749,300,1.00
ptg005055l,1030509,1030813,304,EVM,mRNA,688433,2343271,304,1.00
ptg005055l,1736886,1737182,296,EVM,mRNA,688433,2343271,296,1.00
ptg005056l,479196,479489,293,EVM,mRNA,84367,1874138,293,1.00
ptg005056l,736398,736696,298,EVM,mRNA,84367,1874138,298,1.00
ptg005056l,1045056,1045353,297,EVM,mRNA,84367,1874138,297,1.00
ptg005056l,1533987,1534299,312,EVM,mRNA,84367,1874138,312,1.00
ptg005058l,1390686,1390972,286,EVM,mRNA,743534,1651050,286,1.00
ptg005058l,2036693,2036976,283,EVM,mRNA,1721339,2103934,283,1.00
ptg005059l,735074,735372,298,EVM,mRNA,297037,1215264,298,1.00
ptg005059l,1562685,1562998,313,EVM,mRNA,1498763,2342754,313,1.00
ptg005059l,1925214,1925487,273,EVM,mRNA,1498763,2342754,273,1.00
ptg005062l,1757986,1758265,279,EVM,mRNA,1679567,2951244,279,1.00
ptg005064l,1141457,1141778,321,EVM,mRNA,683399,1264310,321,1.00
ptg005065l,379343,379643,300,EVM,mRNA,70115,839516,300,1.00
ptg005065l,1786788,1787084,296,EVM,mRNA,1049842,2681232,296,1.00
ptg005066l,2579707,2580010,303,EVM,mRNA,2575064,3467623,303,1.00
ptg005069l,869824,870101,277,EVM,mRNA,85436,4143763,277,1.00
ptg005069l,4134159,4134441,282,EVM,mRNA,85436,4143763,282,1.00
ptg005070l,1284508,1284802,294,EVM,mRNA,975469,1347329,294,1.00
ptg005072l,1325700,1326035,335,EVM,mRNA,556868,1748042,335,1.00
ptg005072l,2336078,2336396,318,EVM,mRNA,2038653,2653540,318,1.00
ptg005077l,1056850,1057167,317,EVM,mRNA,1052076,1283559,317,1.00
ptg005077l,1056850,1057167,317,GeneWise,mRNA,1052079,1283910,317,1.00
ptg005077l,1178959,1179247,288,EVM,mRNA,1052076,1283559,288,1.00
ptg005077l,1178959,1179247,288,GeneWise,mRNA,1052079,1283910,288,1.00
ptg005078l,527251,527556,305,EVM,mRNA,200547,1296655,305,1.00
ptg005078l,590822,591115,293,EVM,mRNA,200547,1296655,293,1.00
ptg005078l,793107,793408,301,EVM,mRNA,200547,1296655,301,1.00
ptg005078l,905177,905452,275,EVM,mRNA,200547,1296655,275,1.00
ptg005080l,1533045,1533365,320,EVM,mRNA,599566,2031801,320,1.00
ptg005080l,1744942,1745229,287,EVM,mRNA,599566,2031801,287,1.00
ptg005081l,286293,286592,299,EVM,mRNA,153378,1950136,299,1.00
ptg005081l,1299281,1299586,305,EVM,mRNA,153378,1950136,305,1.00
ptg005081l,1931829,1932146,317,EVM,mRNA,153378,1950136,317,1.00
ptg005083l,1407543,1407796,253,EVM,mRNA,1189501,1840481,253,1.00
ptg005083l,1623483,1623776,293,EVM,mRNA,1189501,1840481,293,1.00
ptg005083l,2291054,2291345,291,EVM,mRNA,2032178,2520820,291,1.00
ptg005084l,761411,761707,296,EVM,mRNA,234557,1201146,296,1.00
ptg005084l,830394,830693,299,EVM,mRNA,234557,1201146,299,1.00
ptg005084l,876596,876895,299,EVM,mRNA,234557,1201146,299,1.00
ptg005084l,972246,972545,299,EVM,mRNA,234557,1201146,299,1.00
ptg005086l,2281001,2281300,299,EVM,mRNA,764967,2864732,299,1.00
ptg005086l,3234957,3235246,289,EVM,mRNA,3196698,3545467,289,1.00
ptg005086l,5576796,5577095,299,EVM,mRNA,5497516,6198403,299,1.00
ptg005086l,5953681,5953989,308,EVM,mRNA,5497516,6198403,308,1.00
ptg005088l,3859094,3859398,304,EVM,mRNA,3275690,4237521,304,1.00
ptg005088l,5179529,5179860,331,EVM,mRNA,4806837,5402869,331,1.00
ptg005088l,5258943,5259264,321,EVM,mRNA,4806837,5402869,321,1.00
ptg005088l,5356344,5356641,297,EVM,mRNA,4806837,5402869,297,1.00
ptg005090l,1653106,1653401,295,EVM,mRNA,1526361,1807886,295,1.00
ptg005091l,915691,915983,292,EVM,mRNA,510953,1079684,292,1.00
ptg005093l,4025891,4026212,321,EVM,mRNA,3766633,4066679,321,1.00
ptg005095l,1935050,1935349,299,EVM,mRNA,1555916,2220672,299,1.00
ptg005097l,357996,358330,334,EVM,mRNA,119594,1059925,334,1.00
ptg005097l,964566,964871,305,EVM,mRNA,119594,1059925,305,1.00
ptg005097l,999598,999891,293,EVM,mRNA,119594,1059925,293,1.00
ptg005106l,1544956,1545262,306,EVM,mRNA,1479941,2255012,306,1.00
ptg005107l,422373,422684,311,EVM,mRNA,529,1171356,311,1.00
ptg005107l,731118,731417,299,EVM,mRNA,529,1171356,299,1.00
ptg005107l,3547827,3548139,312,EVM,mRNA,1899651,3663439,312,1.00
ptg005109l,866191,866482,291,EVM,mRNA,512290,1405519,291,1.00
ptg005114l,2089047,2089363,316,EVM,mRNA,2078651,2423157,316,1.00
ptg005117l,51233,51550,317,EVM,mRNA,34437,72198,317,1.00
ptg005118l,836781,837072,291,EVM,mRNA,446023,988219,291,1.00
ptg005121l,638465,638748,283,EVM,mRNA,551269,2352317,283,1.00
ptg005121l,705426,705708,282,EVM,mRNA,551269,2352317,282,1.00
ptg005121l,1419619,1419911,292,EVM,mRNA,551269,2352317,292,1.00
ptg005121l,3649536,3649826,290,EVM,mRNA,3083167,4325324,290,1.00
ptg005121l,4078279,4078556,277,EVM,mRNA,3083167,4325324,277,1.00
ptg005121l,4103594,4103921,327,EVM,mRNA,3083167,4325324,327,1.00
ptg005123l,853771,854083,312,EVM,mRNA,511675,2905193,312,1.00
ptg005123l,860502,860818,316,EVM,mRNA,511675,2905193,316,1.00
ptg005127l,674440,674707,267,EVM,mRNA,629668,917115,267,1.00
ptg005131l,1053992,1054306,314,EVM,mRNA,977757,1140288,314,1.00
ptg005133l,1442774,1443060,286,EVM,mRNA,1338304,2043922,286,1.00
ptg005133l,1708731,1709007,276,EVM,mRNA,1338304,2043922,276,1.00
ptg005138l,485222,485503,281,EVM,mRNA,305328,606330,281,1.00
ptg005138l,1400098,1400380,282,EVM,mRNA,1362178,1581958,282,1.00
ptg005140l,869508,869788,280,EVM,mRNA,852447,1049558,280,1.00
ptg005140l,891667,891974,307,EVM,mRNA,852447,1049558,307,1.00
ptg005140l,1008737,1009062,325,EVM,mRNA,852447,1049558,325,1.00
ptg005141l,1037524,1037800,276,EVM,mRNA,362587,1576448,276,1.00
ptg005141l,1057500,1057798,298,EVM,mRNA,362587,1576448,298,1.00
ptg005145l,2643948,2644250,302,EVM,mRNA,2281013,2700430,302,1.00
ptg005146l,1086059,1086379,320,EVM,mRNA,765664,2812475,320,1.00
ptg005146l,3567377,3567707,330,EVM,mRNA,3117708,3608613,330,1.00
ptg005147l,1101944,1102245,301,EVM,mRNA,933370,1336683,301,1.00
ptg005147l,1288455,1288762,307,EVM,mRNA,933370,1336683,307,1.00
ptg005150l,41578,41858,280,EVM,mRNA,30719,1265106,280,1.00
ptg005150l,173583,173900,317,EVM,mRNA,30719,1265106,317,1.00
ptg005150l,561221,561514,293,EVM,mRNA,30719,1265106,293,1.00
ptg005150l,566265,566537,272,EVM,mRNA,30719,1265106,272,1.00
ptg005150l,677070,677339,269,EVM,mRNA,30719,1265106,269,1.00
ptg005152l,50472,50758,286,EVM,mRNA,16465,99915,286,1.00
ptg005152l,1614471,1614749,278,EVM,mRNA,981285,3424627,278,1.00
ptg005152l,1786802,1787119,317,EVM,mRNA,981285,3424627,317,1.00
ptg005159l,873167,873448,281,EVM,mRNA,674258,1183190,281,1.00
ptg005161l,1783771,1784052,281,EVM,mRNA,1671954,2100844,281,1.00
ptg005161l,3025843,3026153,310,EVM,mRNA,2411631,4432454,310,1.00
ptg005161l,3816301,3816616,315,EVM,mRNA,2411631,4432454,315,1.00
ptg005164l,859784,860083,299,EVM,mRNA,515140,1030471,299,1.00
ptg005168l,858590,858875,285,EVM,mRNA,63880,1404684,285,1.00
ptg005169l,127275,127557,282,EVM,mRNA,27650,143467,282,1.00
ptg005169l,2562797,2563108,311,EVM,mRNA,2254246,2678434,311,1.00
ptg005173l,3018963,3019262,299,EVM,mRNA,701356,5184848,299,1.00
ptg005173l,3125964,3126253,289,EVM,mRNA,701356,5184848,289,1.00
ptg005173l,6117868,6118182,314,EVM,mRNA,5470904,6675762,314,1.00
ptg005177l,1513724,1514003,279,EVM,mRNA,910568,2200174,279,1.00
ptg005177l,1786087,1786422,335,EVM,mRNA,910568,2200174,335,1.00
ptg005178l,1149123,1149401,278,EVM,mRNA,649337,1725284,278,1.00
ptg005178l,1500908,1501202,294,EVM,mRNA,649337,1725284,294,1.00
ptg005179l,548474,548792,318,EVM,mRNA,25803,1278692,318,1.00
ptg005179l,1454768,1455055,287,EVM,mRNA,1330194,1689470,287,1.00
ptg005180l,950385,950696,311,EVM,mRNA,735379,1034018,311,1.00
ptg005180l,1026937,1027268,331,EVM,mRNA,735379,1034018,331,1.00
ptg005180l,2591589,2591856,267,EVM,mRNA,2490277,2609074,267,1.00
ptg005182l,1285282,1285564,282,EVM,mRNA,990517,1496949,282,1.00
ptg005186l,663282,663565,283,EVM,mRNA,601759,837336,283,1.00
ptg005186l,666846,667154,308,EVM,mRNA,601759,837336,308,1.00
ptg005186l,754033,754313,280,EVM,mRNA,601759,837336,280,1.00
ptg005187l,440953,441264,311,EVM,mRNA,142543,519235,311,1.00
ptg005187l,1039668,1039967,299,EVM,mRNA,649967,2229786,299,1.00
ptg005189l,44527,44826,299,EVM,mRNA,1933,912061,299,1.00
ptg005189l,220295,220601,306,EVM,mRNA,1933,912061,306,1.00
ptg005194l,675629,675928,299,EVM,mRNA,322781,1639111,299,1.00
ptg005196l,1776023,1776333,310,EVM,mRNA,1379309,2666407,310,1.00
ptg005196l,1780421,1780722,301,EVM,mRNA,1379309,2666407,301,1.00
ptg005196l,2483585,2483873,288,EVM,mRNA,1379309,2666407,288,1.00
ptg005198l,1278030,1278317,287,EVM,mRNA,814084,1848089,287,1.00
ptg005205l,962811,963090,279,EVM,mRNA,617123,1046190,279,1.00
ptg005211l,3505363,3505670,307,EVM,mRNA,3464467,3560046,307,1.00
ptg005212l,210558,210873,315,EVM,mRNA,178257,956520,315,1.00
ptg005216l,708013,708281,268,EVM,mRNA,695970,796460,268,1.00
ptg005219l,63634,63919,285,EVM,mRNA,10106,268740,285,1.00
ptg005220l,1498141,1498455,314,EVM,mRNA,1348598,1514536,314,1.00
ptg005225l,581379,581697,318,EVM,mRNA,96293,848569,318,1.00
ptg005227l,324288,324573,285,EVM,mRNA,1379,1059355,285,1.00
ptg005228l,790705,791022,317,EVM,mRNA,481956,1158004,317,1.00
ptg005229l,2517408,2517671,263,EVM,mRNA,1939674,5003022,263,1.00
ptg005231l,361207,361466,259,EVM,mRNA,97173,1515547,259,1.00
ptg005231l,538472,538767,295,EVM,mRNA,97173,1515547,295,1.00
ptg005231l,662045,662302,257,EVM,mRNA,97173,1515547,257,1.00
ptg005231l,936554,936868,314,EVM,mRNA,97173,1515547,314,1.00
ptg005231l,1074710,1075015,305,EVM,mRNA,97173,1515547,305,1.00
ptg005232l,128779,129084,305,EVM,mRNA,42277,412240,305,1.00
ptg005233l,4484647,4484946,299,EVM,mRNA,4374713,4995705,299,1.00
ptg005233l,4554767,4555043,276,EVM,mRNA,4374713,4995705,276,1.00
ptg005233l,5090175,5090479,304,EVM,mRNA,5082852,5101032,304,1.00
ptg005237l,2597330,2597610,280,EVM,mRNA,2314456,3426731,280,1.00
ptg005237l,3010379,3010647,268,EVM,mRNA,2314456,3426731,268,1.00
ptg005237l,4941036,4941349,313,EVM,mRNA,4772915,5305556,313,1.00
ptg005238l,995992,996282,290,EVM,mRNA,25877,1094837,290,1.00
ptg005239l,550031,550304,273,EVM,mRNA,43360,608653,273,1.00
ptg005241l,1006180,1006482,302,EVM,mRNA,3290,1027539,302,1.00
ptg005242l,681588,681900,312,EVM,mRNA,641872,683307,312,1.00
ptg005243l,1729574,1729878,304,EVM,mRNA,1330520,2076870,304,1.00
ptg005245l,395900,396176,276,EVM,mRNA,121462,1082562,276,1.00
ptg005245l,3683940,3684269,329,EVM,mRNA,3566680,4430849,329,1.00
ptg005245l,3868195,3868478,283,EVM,mRNA,3566680,4430849,283,1.00
ptg005246l,128162,128421,259,EVM,mRNA,46394,1323312,259,1.00
ptg005246l,451755,452086,331,EVM,mRNA,46394,1323312,331,1.00
ptg005246l,1256095,1256392,297,EVM,mRNA,46394,1323312,297,1.00
ptg005250l,1214219,1214548,329,EVM,mRNA,352424,1537422,329,1.00
ptg005250l,1338314,1338609,295,EVM,mRNA,352424,1537422,295,1.00
ptg005250l,1449485,1449794,309,EVM,mRNA,352424,1537422,309,1.00
ptg005250l,2350747,2351036,289,EVM,mRNA,1665162,2596582,289,1.00
ptg005250l,2427975,2428266,291,EVM,mRNA,1665162,2596582,291,1.00
ptg005250l,2742814,2743111,297,EVM,mRNA,2715499,4024897,297,1.00
ptg005250l,2798796,2799074,278,EVM,mRNA,2715499,4024897,278,1.00
ptg005250l,3888813,3889134,321,EVM,mRNA,2715499,4024897,321,1.00
ptg005250l,3968483,3968773,290,EVM,mRNA,2715499,4024897,290,1.00
ptg005251l,568336,568642,306,EVM,mRNA,386433,2130439,306,1.00
ptg005251l,1335838,1336118,280,EVM,mRNA,386433,2130439,280,1.00
ptg005251l,2021085,2021381,296,EVM,mRNA,386433,2130439,296,1.00
ptg005254l,189975,190274,299,EVM,mRNA,69376,587989,299,1.00
ptg005254l,1390249,1390569,320,EVM,mRNA,1035083,3031050,320,1.00
ptg005254l,2998239,2998541,302,EVM,mRNA,1035083,3031050,302,1.00
ptg005255l,3504159,3504492,333,EVM,mRNA,3489107,3655746,333,1.00
ptg005257l,1422762,1423071,309,EVM,mRNA,1359324,1728866,309,1.00
ptg005259l,1701936,1702216,280,EVM,mRNA,1497047,1709477,280,1.00
ptg005260l,673105,673386,281,EVM,mRNA,1735,1224933,281,1.00
ptg005260l,801043,801363,320,EVM,mRNA,1735,1224933,320,1.00
ptg005260l,1447723,1448016,293,EVM,mRNA,1355895,3292464,293,1.00
ptg005260l,2987874,2988171,297,EVM,mRNA,1355895,3292464,297,1.00
ptg005269l,776296,776549,253,EVM,mRNA,2356,1765869,253,1.00
ptg005269l,1475707,1476010,303,EVM,mRNA,2356,1765869,303,1.00
ptg005269l,1744959,1745250,291,EVM,mRNA,2356,1765869,291,1.00
ptg005272l,230748,231063,315,EVM,mRNA,227153,526246,315,1.00
ptg005272l,1314295,1314608,313,EVM,mRNA,1260387,1844156,313,1.00
ptg005274l,1184208,1184489,281,EVM,mRNA,547030,2671094,281,1.00
ptg005274l,2998762,2999084,322,EVM,mRNA,2790649,3230878,322,1.00
ptg005274l,3222099,3222422,323,EVM,mRNA,2790649,3230878,323,1.00
ptg005281l,1572226,1572526,300,EVM,mRNA,1549567,1613197,300,1.00
ptg005289l,443104,443427,323,EVM,mRNA,341427,643465,323,1.00
ptg005292l,1005558,1005820,262,EVM,mRNA,2829,1087350,262,1.00
ptg005294l,1105900,1106206,306,EVM,mRNA,1017440,1438042,306,1.00
ptg005296l,2029032,2029313,281,EVM,mRNA,1960979,2088758,281,1.00
ptg005299l,1370474,1370809,335,EVM,mRNA,1248524,1970930,335,1.00
ptg005299l,1920097,1920391,294,EVM,mRNA,1248524,1970930,294,1.00
ptg005299l,3424516,3424837,321,EVM,mRNA,3364065,4978703,321,1.00
ptg005299l,3801820,3802118,298,EVM,mRNA,3364065,4978703,298,1.00
ptg005299l,4043557,4043856,299,EVM,mRNA,3364065,4978703,299,1.00
ptg005299l,4505601,4505892,291,EVM,mRNA,3364065,4978703,291,1.00
ptg005300l,2198064,2198367,303,EVM,mRNA,962,2743306,303,1.00
ptg005300l,2366777,2367055,278,EVM,mRNA,962,2743306,278,1.00
ptg005302l,680859,681123,264,EVM,mRNA,90919,1436928,264,1.00
ptg005302l,1088215,1088539,324,EVM,mRNA,90919,1436928,324,1.00
ptg005302l,1271201,1271521,320,EVM,mRNA,90919,1436928,320,1.00
ptg005302l,3267334,3267629,295,EVM,mRNA,2983526,3717204,295,1.00
ptg005302l,3381813,3382113,300,EVM,mRNA,2983526,3717204,300,1.00
ptg005304l,1574380,1574702,322,EVM,mRNA,1036299,4083133,322,1.00
ptg005304l,1607313,1607624,311,EVM,mRNA,1036299,4083133,311,1.00
ptg005304l,1723406,1723716,310,EVM,mRNA,1036299,4083133,310,1.00
ptg005304l,2128318,2128634,316,EVM,mRNA,1036299,4083133,316,1.00
ptg005304l,2815618,2815906,288,EVM,mRNA,1036299,4083133,288,1.00
ptg005309l,3579396,3579714,318,EVM,mRNA,2369493,3750652,318,1.00
ptg005311l,1394430,1394740,310,EVM,mRNA,523364,1429921,310,1.00
ptg005314l,1143370,1143653,283,EVM,mRNA,551470,1575869,283,1.00
ptg005314l,2619518,2619839,321,EVM,mRNA,2436148,3100854,321,1.00
ptg005314l,5605625,5605934,309,EVM,mRNA,4711429,5890301,309,1.00
ptg005314l,5825763,5826059,296,EVM,mRNA,4711429,5890301,296,1.00
ptg005314l,5831118,5831407,289,EVM,mRNA,4711429,5890301,289,1.00
ptg005316l,815477,815778,301,EVM,mRNA,810873,1129284,301,1.00
ptg005316l,864261,864540,279,EVM,mRNA,810873,1129284,279,1.00
ptg005316l,2368272,2368600,328,EVM,mRNA,2061952,2416327,328,1.00
ptg005321l,2008726,2009048,322,EVM,mRNA,1738482,2083211,322,1.00
ptg005327l,709463,709766,303,EVM,mRNA,53823,710323,303,1.00
ptg005331l,619761,620019,258,EVM,mRNA,387620,1844126,258,1.00
ptg005331l,1464224,1464505,281,EVM,mRNA,387620,1844126,281,1.00
ptg005331l,1525639,1525918,279,EVM,mRNA,387620,1844126,279,1.00
ptg005331l,1644313,1644619,306,EVM,mRNA,387620,1844126,306,1.00
ptg005332l,439605,439914,309,EVM,mRNA,340358,1460095,309,1.00
ptg005332l,1104876,1105207,331,EVM,mRNA,340358,1460095,331,1.00
ptg005335l,314993,315310,317,EVM,mRNA,236991,767695,317,1.00
ptg005335l,1768371,1768647,276,EVM,mRNA,1536207,1857512,276,1.00
ptg005342l,2200427,2200704,277,EVM,mRNA,628545,2702256,277,1.00
ptg005345l,2010230,2010511,281,EVM,mRNA,1701464,2620161,281,1.00
ptg005345l,2053770,2054072,302,EVM,mRNA,1701464,2620161,302,1.00
ptg005346l,4143384,4143677,293,EVM,mRNA,3314043,4875860,293,1.00
ptg005351l,668337,668641,304,EVM,mRNA,495411,745545,304,1.00
ptg005354l,1064134,1064428,294,EVM,mRNA,630792,2362884,294,1.00
ptg005354l,1416849,1417163,314,EVM,mRNA,630792,2362884,314,1.00
ptg005354l,1778046,1778345,299,EVM,mRNA,630792,2362884,299,1.00
ptg005354l,1986541,1986870,329,EVM,mRNA,630792,2362884,329,1.00
ptg005355l,1826463,1826790,327,EVM,mRNA,767188,1920211,327,1.00
ptg005355l,1833192,1833492,300,EVM,mRNA,767188,1920211,300,1.00
ptg005356l,2671832,2672106,274,EVM,mRNA,2606129,2713417,274,1.00
ptg005356l,2787036,2787302,266,EVM,mRNA,2715025,2975558,266,1.00
ptg005356l,3764309,3764614,305,EVM,mRNA,3086122,3864756,305,1.00
ptg005358l,441383,441670,287,EVM,mRNA,2872,1113202,287,1.00
ptg005358l,2231185,2231481,296,EVM,mRNA,1964332,2489591,296,1.00
ptg005363l,685626,685934,308,EVM,mRNA,190944,1408980,308,1.00
ptg005364l,622668,622969,301,EVM,mRNA,15956,874111,301,1.00
ptg005364l,666959,667280,321,EVM,mRNA,15956,874111,321,1.00
ptg005366l,784021,784301,280,EVM,mRNA,421230,1318209,280,1.00
ptg005367l,564109,564419,310,EVM,mRNA,324579,1050073,310,1.00
ptg005370l,313895,314199,304,EVM,mRNA,304981,374831,304,1.00
ptg005371l,325201,325506,305,EVM,mRNA,158838,1132509,305,1.00
ptg005371l,671456,671790,334,EVM,mRNA,158838,1132509,334,1.00
ptg005371l,3007688,3007970,282,EVM,mRNA,2414275,3293894,282,1.00
ptg005371l,3019023,3019352,329,EVM,mRNA,2414275,3293894,329,1.00
ptg005372l,1688177,1688475,298,EVM,mRNA,772488,3109989,298,1.00
ptg005372l,3657532,3657810,278,EVM,mRNA,3547717,3973655,278,1.00
ptg005374l,1246150,1246432,282,EVM,mRNA,811287,1542911,282,1.00
ptg005375l,1704405,1704720,315,EVM,mRNA,800469,2703910,315,1.00
ptg005375l,1770059,1770361,302,EVM,mRNA,800469,2703910,302,1.00
ptg005377l,1083064,1083365,301,EVM,mRNA,250159,1172720,301,1.00
ptg005385l,1835814,1836108,294,EVM,mRNA,794976,2502143,294,1.00
ptg005385l,3748046,3748331,285,EVM,mRNA,3705917,4400775,285,1.00
ptg005386l,841612,841917,305,EVM,mRNA,317255,1018734,305,1.00
ptg005386l,961524,961844,320,EVM,mRNA,317255,1018734,320,1.00
ptg005393l,674809,675126,317,EVM,mRNA,532056,1119539,317,1.00
ptg005394l,1087768,1088077,309,EVM,mRNA,483268,1201939,309,1.00
ptg005394l,1189333,1189664,331,EVM,mRNA,483268,1201939,331,1.00
ptg005400l,2342820,2343123,303,EVM,mRNA,84142,2375844,303,1.00
ptg005402l,1239515,1239833,318,EVM,mRNA,1019142,1335285,318,1.00
ptg005402l,1536061,1536389,328,EVM,mRNA,1402618,1647034,328,1.00
ptg005402l,1599845,1600121,276,EVM,mRNA,1402618,1647034,276,1.00
ptg005403l,1295577,1295901,324,EVM,mRNA,1251731,1752340,324,1.00
ptg005403l,2710755,2711044,289,EVM,mRNA,2680143,2852922,289,1.00
ptg005403l,2727790,2728074,284,EVM,mRNA,2680143,2852922,284,1.00
ptg005404l,708326,708648,322,EVM,mRNA,564084,811752,322,1.00
ptg005404l,1330119,1330416,297,EVM,mRNA,814111,1572339,297,1.00
ptg005405l,796058,796354,296,EVM,mRNA,658716,1419766,296,1.00
ptg005406l,840221,840527,306,EVM,mRNA,59454,1051336,306,1.00
ptg005406l,1116433,1116716,283,EVM,mRNA,1105343,1243626,283,1.00
ptg005407l,1670295,1670596,301,EVM,mRNA,1530361,1671972,301,1.00
ptg005408l,167609,167904,295,EVM,mRNA,97241,474038,295,1.00
ptg005409l,1139320,1139647,327,EVM,mRNA,1099924,1394113,327,1.00
ptg005411l,1747873,1748163,290,EVM,mRNA,998787,2115297,290,1.00
ptg005411l,2661038,2661312,274,EVM,mRNA,2246529,2869218,274,1.00
ptg005412l,271557,271872,315,EVM,mRNA,108411,281649,315,1.00
ptg005413l,102528,102828,300,EVM,mRNA,4215,807569,300,1.00
ptg005413l,580374,580695,321,EVM,mRNA,4215,807569,321,1.00
ptg005413l,2695532,2695842,310,EVM,mRNA,2200113,3270759,310,1.00
ptg005413l,2706939,2707269,330,EVM,mRNA,2200113,3270759,330,1.00
ptg005413l,2752519,2752818,299,EVM,mRNA,2200113,3270759,299,1.00
ptg005419l,1025317,1025587,270,EVM,mRNA,968370,1182252,270,1.00
ptg005421l,396959,397266,307,EVM,mRNA,263530,562988,307,1.00
ptg005421l,987765,988069,304,EVM,mRNA,761311,1377473,304,1.00
ptg005421l,1113783,1114083,300,EVM,mRNA,761311,1377473,300,1.00
ptg005421l,2776797,2777102,305,EVM,mRNA,1925245,2955608,305,1.00
ptg005421l,3398940,3399252,312,EVM,mRNA,3055430,4104838,312,1.00
ptg005421l,3868843,3869131,288,EVM,mRNA,3055430,4104838,288,1.00
ptg005422l,1385293,1385592,299,EVM,mRNA,699086,4415783,299,1.00
ptg005422l,1768763,1769065,302,EVM,mRNA,699086,4415783,302,1.00
ptg005422l,3430318,3430617,299,EVM,mRNA,699086,4415783,299,1.00
ptg005422l,5262747,5263038,291,EVM,mRNA,5125576,5412071,291,1.00
ptg005427l,2430575,2430891,316,EVM,mRNA,2301349,2431508,316,1.00
ptg005428l,1090540,1090846,306,EVM,mRNA,147289,1104990,306,1.00
ptg005432l,792731,793005,274,EVM,mRNA,736772,1086079,274,1.00
ptg005432l,1015631,1015930,299,EVM,mRNA,736772,1086079,299,1.00
ptg005432l,2325764,2326044,280,EVM,mRNA,1086715,4058753,280,1.00
ptg005432l,3629134,3629437,303,EVM,mRNA,1086715,4058753,303,1.00
ptg005438l,782216,782512,296,EVM,mRNA,689952,1041214,296,1.00
ptg005438l,3906482,3906822,340,EVM,mRNA,3879906,3928469,340,1.00
ptg005441l,1924448,1924730,282,EVM,mRNA,1568134,2155685,282,1.00
ptg005442l,787526,787803,277,EVM,mRNA,663156,974512,277,1.00
ptg005442l,788039,788364,325,EVM,mRNA,663156,974512,325,1.00
ptg005442l,836648,836943,295,EVM,mRNA,663156,974512,295,1.00
ptg005442l,1066185,1066480,295,EVM,mRNA,1052691,2118595,295,1.00
ptg005442l,1708314,1708638,324,EVM,mRNA,1052691,2118595,324,1.00
ptg005442l,1983732,1983997,265,EVM,mRNA,1052691,2118595,265,1.00
ptg005443l,387215,387523,308,EVM,mRNA,252066,1826113,308,1.00
ptg005445l,1669614,1669919,305,EVM,mRNA,1474328,2094149,305,1.00
ptg005445l,1748227,1748522,295,EVM,mRNA,1474328,2094149,295,1.00
ptg005445l,2077804,2078136,332,EVM,mRNA,1474328,2094149,332,1.00
ptg005452l,70509,70828,319,EVM,mRNA,22785,2405131,319,1.00
ptg005454l,413581,413866,285,EVM,mRNA,74127,2134201,285,1.00
ptg005456l,1552835,1553124,289,EVM,mRNA,1545639,1610752,289,1.00
ptg005459l,2919608,2919881,273,EVM,mRNA,2318147,3351753,273,1.00
ptg005459l,3064733,3065039,306,EVM,mRNA,2318147,3351753,306,1.00
ptg005460l,1291765,1292066,301,EVM,mRNA,813232,1292142,301,1.00
ptg005461l,311485,311801,316,EVM,mRNA,48478,323867,316,1.00
ptg005462l,1280571,1280845,274,EVM,mRNA,911218,2718173,274,1.00
ptg005462l,5332118,5332394,276,EVM,mRNA,3950702,5632732,276,1.00
ptg005462l,6633637,6633917,280,EVM,mRNA,5932820,6806215,280,1.00
ptg005466l,952084,952379,295,EVM,mRNA,592415,5512906,295,1.00
ptg005466l,1430182,1430481,299,EVM,mRNA,592415,5512906,299,1.00
ptg005466l,1798293,1798591,298,EVM,mRNA,592415,5512906,298,1.00
ptg005466l,2622023,2622319,296,EVM,mRNA,592415,5512906,296,1.00
ptg005469l,861556,861856,300,EVM,mRNA,13729,1585918,300,1.00
ptg005471l,693027,693306,279,EVM,mRNA,191310,939985,279,1.00
ptg005473l,1906086,1906372,286,EVM,mRNA,145902,1994190,286,1.00
ptg005476l,1161547,1161847,300,EVM,mRNA,644683,1306366,300,1.00
ptg005476l,2123792,2124100,308,EVM,mRNA,1693810,3760710,308,1.00
ptg005476l,2589978,2590268,290,EVM,mRNA,1693810,3760710,290,1.00
ptg005476l,3056965,3057263,298,EVM,mRNA,1693810,3760710,298,1.00
ptg005477l,3988275,3988571,296,EVM,mRNA,3721602,4444466,296,1.00
ptg005478l,3117424,3117721,297,EVM,mRNA,2243759,5165023,297,1.00
ptg005478l,4556078,4556389,311,EVM,mRNA,2243759,5165023,311,1.00
ptg005478l,4603486,4603806,320,EVM,mRNA,2243759,5165023,320,1.00
ptg005478l,5042794,5043074,280,EVM,mRNA,2243759,5165023,280,1.00
ptg005479l,1109450,1109786,336,EVM,mRNA,1080782,1170737,336,1.00
ptg005481l,1315463,1315778,315,EVM,mRNA,1158892,1515179,315,1.00
ptg005483l,58473,58760,287,EVM,mRNA,9700,339633,287,1.00
ptg005483l,266983,267253,270,EVM,mRNA,9700,339633,270,1.00
ptg005483l,760441,760738,297,EVM,mRNA,694322,844658,297,1.00
ptg005483l,860291,860565,274,EVM,mRNA,845634,942815,274,1.00
ptg005483l,1334198,1334513,315,EVM,mRNA,1075702,1358304,315,1.00
ptg005483l,2155551,2155847,296,EVM,mRNA,1852089,2230712,296,1.00
ptg005484l,198463,198776,313,EVM,mRNA,27489,198769,306,0.98
ptg005484l,2637394,2637718,324,EVM,mRNA,2534290,2878968,324,1.00
ptg005486l,74533,74840,307,EVM,mRNA,11807,164447,307,1.00
ptg005486l,413729,414054,325,EVM,mRNA,186548,1552177,325,1.00
ptg005486l,890995,891276,281,EVM,mRNA,186548,1552177,281,1.00
ptg005486l,898177,898458,281,EVM,mRNA,186548,1552177,281,1.00
ptg005486l,1284354,1284653,299,EVM,mRNA,186548,1552177,299,1.00
ptg005487l,1122946,1123255,309,EVM,mRNA,223194,1362461,309,1.00
ptg005487l,3882915,3883219,304,EVM,mRNA,3514213,3961769,304,1.00
ptg005489l,791592,791906,314,EVM,mRNA,791324,791815,223,0.71
ptg005491l,297995,298257,262,EVM,mRNA,96085,749518,262,1.00
ptg005492l,2328366,2328670,304,EVM,mRNA,1824093,2731281,304,1.00
ptg005498l,636895,637177,282,EVM,mRNA,552271,889574,282,1.00
ptg005501l,835547,835871,324,EVM,mRNA,693616,930715,324,1.00
ptg005502l,59533,59835,302,EVM,mRNA,2380,1420699,302,1.00
ptg005502l,1248679,1248983,304,EVM,mRNA,2380,1420699,304,1.00
ptg005505l,161047,161331,284,EVM,mRNA,102251,1313446,284,1.00
ptg005505l,598378,598691,313,EVM,mRNA,102251,1313446,313,1.00
ptg005508l,293218,293531,313,EVM,mRNA,14455,2196918,313,1.00
ptg005508l,3829688,3829989,301,EVM,mRNA,3367395,3955628,301,1.00
ptg005508l,5560547,5560860,313,EVM,mRNA,5057835,6000165,313,1.00
ptg005508l,5850833,5851102,269,EVM,mRNA,5057835,6000165,269,1.00
ptg005510l,1125846,1126141,295,EVM,mRNA,872062,1133849,295,1.00
ptg005510l,2116111,2116404,293,EVM,mRNA,1960014,2594208,293,1.00
ptg005510l,2208104,2208420,316,EVM,mRNA,1960014,2594208,316,1.00
ptg005510l,2485676,2485958,282,EVM,mRNA,1960014,2594208,282,1.00
ptg005521l,544505,544768,263,EVM,mRNA,82018,2051418,263,1.00
ptg005522l,1185343,1185635,292,EVM,mRNA,910358,3285946,292,1.00
ptg005522l,1788191,1788465,274,EVM,mRNA,910358,3285946,274,1.00
ptg005522l,1999412,1999689,277,EVM,mRNA,910358,3285946,277,1.00
ptg005528l,250489,250775,286,EVM,mRNA,184928,299334,286,1.00
ptg005529l,2707199,2707517,318,EVM,mRNA,2577544,4786292,318,1.00
ptg005529l,3621793,3622103,310,EVM,mRNA,2577544,4786292,310,1.00
ptg005529l,3778706,3778981,275,EVM,mRNA,2577544,4786292,275,1.00
ptg005529l,5879663,5879949,286,EVM,mRNA,5755454,6566522,286,1.00
ptg005529l,5884917,5885203,286,EVM,mRNA,5755454,6566522,286,1.00
ptg005529l,6389899,6390199,300,EVM,mRNA,5755454,6566522,300,1.00
ptg005529l,7318818,7319115,297,EVM,mRNA,6934599,7324972,297,1.00
ptg005529l,8224525,8224801,276,EVM,mRNA,8176656,8430513,276,1.00
ptg005529l,8408436,8408716,280,EVM,mRNA,8176656,8430513,280,1.00
ptg005530l,660669,660953,284,EVM,mRNA,411925,891830,284,1.00
ptg005530l,2104646,2104925,279,EVM,mRNA,1973556,2308707,279,1.00
ptg005532l,2269934,2270203,269,EVM,mRNA,1042656,3762627,269,1.00
ptg005532l,2506089,2506401,312,EVM,mRNA,1042656,3762627,312,1.00
ptg005537l,446324,446664,340,EVM,mRNA,304541,493253,340,1.00
ptg005538l,438207,438482,275,EVM,mRNA,1225,601363,275,1.00
ptg005539l,634295,634599,304,EVM,mRNA,83419,751075,304,1.00
ptg005539l,985034,985325,291,EVM,mRNA,858551,987339,291,1.00
ptg005542l,970803,971110,307,EVM,mRNA,826581,1677192,307,1.00
ptg005542l,1650071,1650370,299,EVM,mRNA,826581,1677192,299,1.00
ptg005542l,2732236,2732520,284,EVM,mRNA,2347813,3118406,284,1.00
ptg005542l,2914726,2915034,308,EVM,mRNA,2347813,3118406,308,1.00
ptg005542l,3097722,3098032,310,EVM,mRNA,2347813,3118406,310,1.00
ptg005545l,815705,816011,306,EVM,mRNA,755844,2142756,306,1.00
ptg005545l,956233,956539,306,EVM,mRNA,755844,2142756,306,1.00
ptg005545l,1608967,1609292,325,EVM,mRNA,755844,2142756,325,1.00
ptg005545l,1699142,1699426,284,EVM,mRNA,755844,2142756,284,1.00
ptg005550l,1080019,1080339,320,EVM,mRNA,493218,1410285,320,1.00
ptg005550l,1213157,1213472,315,EVM,mRNA,493218,1410285,315,1.00
ptg005552l,1702449,1702765,316,EVM,mRNA,329397,2684728,316,1.00
ptg005552l,1854297,1854586,289,EVM,mRNA,329397,2684728,289,1.00
ptg005554l,3322420,3322725,305,EVM,mRNA,2036546,5224061,305,1.00
ptg005554l,8142615,8142905,290,EVM,mRNA,6512345,8616149,290,1.00
ptg005554l,9736595,9736909,314,EVM,mRNA,8940454,10405109,314,1.00
ptg005554l,10106665,10106957,292,EVM,mRNA,8940454,10405109,292,1.00
ptg005555l,15623,15962,339,EVM,mRNA,247,16500,339,1.00
ptg005558l,959367,959658,291,EVM,mRNA,941745,1201777,291,1.00
ptg005558l,1016979,1017283,304,EVM,mRNA,941745,1201777,304,1.00
ptg005558l,1176214,1176539,325,EVM,mRNA,941745,1201777,325,1.00
ptg005559l,78679,78975,296,EVM,mRNA,4238,723992,296,1.00
ptg005559l,234841,235145,304,EVM,mRNA,4238,723992,304,1.00
ptg005562l,230415,230742,327,EVM,mRNA,204882,2159264,327,1.00
ptg005562l,619059,619358,299,EVM,mRNA,204882,2159264,299,1.00
ptg005562l,1494904,1495192,288,EVM,mRNA,204882,2159264,288,1.00
ptg005562l,1776668,1776972,304,EVM,mRNA,204882,2159264,304,1.00
ptg005562l,4542304,4542590,286,EVM,mRNA,4399827,5502986,286,1.00
ptg005564l,1732988,1733279,291,EVM,mRNA,1315896,1767143,291,1.00
ptg005571l,1544526,1544835,309,EVM,mRNA,1520194,1920801,309,1.00
ptg005573l,566902,567197,295,EVM,mRNA,7978,1212411,295,1.00
ptg005573l,1200727,1201066,339,EVM,mRNA,7978,1212411,339,1.00
ptg005573l,1204720,1204986,266,EVM,mRNA,7978,1212411,266,1.00
ptg005578l,340362,340661,299,EVM,mRNA,220413,1606057,299,1.00
ptg005578l,390835,391134,299,EVM,mRNA,220413,1606057,299,1.00
ptg005578l,694284,694584,300,EVM,mRNA,220413,1606057,300,1.00
ptg005578l,1503182,1503504,322,EVM,mRNA,220413,1606057,322,1.00
ptg005579l,118898,119221,323,EVM,mRNA,94592,270099,323,1.00
ptg005579l,1037635,1037950,315,EVM,mRNA,612326,1062645,315,1.00
ptg005581l,328183,328478,295,EVM,mRNA,21192,511648,295,1.00
ptg005581l,428129,428445,316,EVM,mRNA,21192,511648,316,1.00
ptg005582l,219103,219394,291,EVM,mRNA,108689,673410,291,1.00
ptg005585l,325487,325802,315,EVM,mRNA,196977,404797,315,1.00
ptg005585l,380300,380580,280,EVM,mRNA,196977,404797,280,1.00
ptg005588l,2487109,2487417,308,EVM,mRNA,1817676,5693380,308,1.00
ptg005588l,2606193,2606467,274,EVM,mRNA,1817676,5693380,274,1.00
ptg005588l,2868654,2868979,325,EVM,mRNA,1817676,5693380,325,1.00
ptg005588l,4117033,4117343,310,EVM,mRNA,1817676,5693380,310,1.00
ptg005588l,4256371,4256684,313,EVM,mRNA,1817676,5693380,313,1.00
ptg005588l,4291665,4291965,300,EVM,mRNA,1817676,5693380,300,1.00
ptg005591l,851757,852051,294,EVM,mRNA,184275,967375,294,1.00
ptg005591l,917570,917868,298,EVM,mRNA,184275,967375,298,1.00
ptg005592l,556944,557251,307,EVM,mRNA,315524,758238,307,1.00
ptg005594l,224290,224582,292,EVM,mRNA,83421,474893,292,1.00
ptg005594l,371394,371675,281,EVM,mRNA,83421,474893,281,1.00
ptg005594l,1003586,1003887,301,EVM,mRNA,652510,1283712,301,1.00
ptg005602l,1901067,1901395,328,EVM,mRNA,1321186,2009662,328,1.00
ptg005606l,404650,404950,300,EVM,mRNA,231371,614733,300,1.00
ptg005607l,477253,477579,326,EVM,mRNA,294317,837462,326,1.00
ptg005615l,752485,752772,287,EVM,mRNA,7802,887725,287,1.00
ptg005615l,3807260,3807561,301,EVM,mRNA,2871628,3825844,301,1.00
ptg005615l,7080161,7080469,308,EVM,mRNA,4149827,7877899,308,1.00
ptg005615l,7275729,7276052,323,EVM,mRNA,4149827,7877899,323,1.00
ptg005615l,7536744,7537037,293,EVM,mRNA,4149827,7877899,293,1.00
ptg005617l,252675,252992,317,EVM,mRNA,53116,466453,317,1.00
ptg005617l,350517,350809,292,EVM,mRNA,53116,466453,292,1.00
ptg005619l,407618,407913,295,EVM,mRNA,398756,1222897,295,1.00
ptg005621l,218681,218979,298,EVM,mRNA,93563,781993,298,1.00
ptg005622l,1827377,1827680,303,EVM,mRNA,1776169,1954822,303,1.00
ptg005623l,576079,576369,290,EVM,mRNA,295157,736649,290,1.00
ptg005626l,603810,604125,315,EVM,mRNA,77170,1401813,315,1.00
ptg005626l,2793039,2793344,305,EVM,mRNA,2586112,3054264,305,1.00
ptg005628l,2086492,2086800,308,EVM,mRNA,1847745,2316950,308,1.00
ptg005629l,819142,819422,280,EVM,mRNA,284933,1102075,280,1.00
ptg005629l,867034,867320,286,EVM,mRNA,284933,1102075,286,1.00
ptg005629l,2263976,2264278,302,EVM,mRNA,1948173,2379661,302,1.00
ptg005629l,2263976,2264284,308,EVM,mRNA,1948173,2379661,308,1.00
ptg005637l,453994,454294,300,EVM,mRNA,262555,2481482,300,1.00
ptg005637l,490171,490484,313,EVM,mRNA,262555,2481482,313,1.00
ptg005637l,1402977,1403281,304,EVM,mRNA,262555,2481482,304,1.00
ptg005637l,1656885,1657135,250,EVM,mRNA,262555,2481482,250,1.00
ptg005638l,3108541,3108841,300,EVM,mRNA,2054509,3208814,300,1.00
ptg005638l,4922209,4922484,275,EVM,mRNA,3912014,5032765,275,1.00
ptg005642l,820373,820686,313,EVM,mRNA,2587,1173814,313,1.00
ptg005642l,908945,909275,330,EVM,mRNA,2587,1173814,330,1.00
ptg005642l,1049901,1050209,308,EVM,mRNA,2587,1173814,308,1.00
ptg005646l,616538,616860,322,EVM,mRNA,23509,706685,322,1.00
ptg005646l,696662,696991,329,EVM,mRNA,23509,706685,329,1.00
ptg005652l,2389948,2390271,323,EVM,mRNA,2337778,2414247,323,1.00
ptg005653l,1366012,1366329,317,EVM,mRNA,312242,1472230,317,1.00
ptg005653l,2287306,2287581,275,EVM,mRNA,2095153,2416962,275,1.00
ptg005653l,2310163,2310442,279,EVM,mRNA,2095153,2416962,279,1.00
ptg005654l,384064,384375,311,EVM,mRNA,168141,395759,311,1.00
ptg005658l,51274,51568,294,EVM,mRNA,1614,138029,294,1.00
ptg005661l,236228,236516,288,EVM,mRNA,871,1176079,288,1.00
ptg005661l,999083,999391,308,EVM,mRNA,871,1176079,308,1.00
ptg005665l,131994,132310,316,EVM,mRNA,15025,1200874,316,1.00
ptg005671l,149067,149357,290,EVM,mRNA,9889,177379,290,1.00
ptg005671l,539122,539412,290,EVM,mRNA,533353,2161004,290,1.00
ptg005671l,1043169,1043483,314,EVM,mRNA,533353,2161004,314,1.00
ptg005671l,1928504,1928795,291,EVM,mRNA,533353,2161004,291,1.00
ptg005671l,2418212,2418523,311,EVM,mRNA,2400988,3083704,311,1.00
ptg005671l,2959790,2960085,295,EVM,mRNA,2400988,3083704,295,1.00
ptg005671l,3071576,3071884,308,EVM,mRNA,2400988,3083704,308,1.00
ptg005672l,68857,69171,314,EVM,mRNA,49688,153273,314,1.00
ptg005672l,580605,580910,305,EVM,mRNA,568403,902413,305,1.00
ptg005674l,204671,204946,275,EVM,mRNA,34039,219860,275,1.00
ptg005676l,293791,294068,277,EVM,mRNA,109021,307290,277,1.00
ptg005684l,436882,437149,267,EVM,mRNA,139879,1155150,267,1.00
ptg005685l,1817212,1817496,284,EVM,mRNA,731805,2336788,284,1.00
ptg005685l,1905306,1905620,314,EVM,mRNA,731805,2336788,314,1.00
ptg005687l,1379601,1379921,320,EVM,mRNA,124122,1869239,320,1.00
ptg005688l,838232,838519,287,EVM,mRNA,633512,1074389,287,1.00
ptg005693l,96379,96674,295,EVM,mRNA,66117,1452137,295,1.00
ptg005693l,1389845,1390179,334,EVM,mRNA,66117,1452137,334,1.00
ptg005695l,807681,807979,298,EVM,mRNA,409902,1244981,298,1.00
ptg005695l,1225768,1226061,293,EVM,mRNA,409902,1244981,293,1.00
ptg005695l,1528326,1528626,300,EVM,mRNA,1489962,1971184,300,1.00
ptg005696l,461073,461400,327,EVM,mRNA,304243,903947,327,1.00
ptg005696l,470869,471165,296,EVM,mRNA,304243,903947,296,1.00
ptg005702l,1416835,1417106,271,EVM,mRNA,1403834,1910638,271,1.00
ptg005702l,2651213,2651537,324,EVM,mRNA,2019641,3412205,324,1.00
ptg005708l,548365,548669,304,EVM,mRNA,284879,638993,304,1.00
ptg005709l,1339689,1339988,299,EVM,mRNA,524934,1721839,299,1.00
ptg005709l,2758601,2758884,283,EVM,mRNA,2055102,3109062,283,1.00
ptg005714l,144949,145236,287,EVM,mRNA,11568,1522377,287,1.00
ptg005714l,1451216,1451549,333,EVM,mRNA,11568,1522377,333,1.00
ptg005714l,1452972,1453292,320,EVM,mRNA,11568,1522377,320,1.00
ptg005720l,1884315,1884622,307,EVM,mRNA,1820819,2663857,307,1.00
ptg005720l,2095836,2096132,296,EVM,mRNA,1820819,2663857,296,1.00
ptg005720l,2326432,2326761,329,EVM,mRNA,1820819,2663857,329,1.00
ptg005721l,138154,138473,319,EVM,mRNA,2116,733016,319,1.00
ptg005721l,232132,232419,287,EVM,mRNA,2116,733016,287,1.00
ptg005721l,2402585,2402886,301,EVM,mRNA,1803513,2479287,301,1.00
ptg005722l,880879,881166,287,EVM,mRNA,74534,3568638,287,1.00
ptg005722l,1138234,1138532,298,EVM,mRNA,74534,3568638,298,1.00
ptg005722l,1280309,1280612,303,EVM,mRNA,74534,3568638,303,1.00
ptg005722l,2220631,2220941,310,EVM,mRNA,74534,3568638,310,1.00
ptg005722l,3119104,3119394,290,EVM,mRNA,74534,3568638,290,1.00
ptg005722l,3551956,3552253,297,EVM,mRNA,74534,3568638,297,1.00
ptg005722l,3827190,3827474,284,EVM,mRNA,3683300,3975074,284,1.00
ptg005724l,1345450,1345743,293,EVM,mRNA,1249605,2035265,293,1.00
ptg005724l,1557851,1558163,312,EVM,mRNA,1249605,2035265,312,1.00
ptg005725l,1536470,1536759,289,EVM,mRNA,1023936,2099687,289,1.00
ptg005725l,1619060,1619341,281,EVM,mRNA,1023936,2099687,281,1.00
ptg005727l,769803,770112,309,EVM,mRNA,315299,964065,309,1.00
ptg005727l,1410144,1410436,292,EVM,mRNA,1217347,1553357,292,1.00
ptg005728l,110183,110494,311,EVM,mRNA,98958,412212,311,1.00
ptg005728l,388559,388883,324,EVM,mRNA,98958,412212,324,1.00
ptg005731l,1422201,1422522,321,EVM,mRNA,941686,1558005,321,1.00
ptg005731l,1458579,1458886,307,EVM,mRNA,941686,1558005,307,1.00
ptg005733l,467208,467526,318,EVM,mRNA,428661,586658,318,1.00
ptg005734l,2798091,2798410,319,EVM,mRNA,2682201,2832393,319,1.00
ptg005736l,436170,436484,314,EVM,mRNA,371151,854204,314,1.00
ptg005736l,1631271,1631590,319,EVM,mRNA,1237010,1675318,319,1.00
ptg005737l,110032,110324,292,EVM,mRNA,96727,548032,292,1.00
ptg005737l,4488028,4488325,297,EVM,mRNA,3951359,6715142,297,1.00
ptg005737l,4965975,4966262,287,EVM,mRNA,3951359,6715142,287,1.00
ptg005737l,5431027,5431340,313,EVM,mRNA,3951359,6715142,313,1.00
ptg005737l,5453611,5453914,303,EVM,mRNA,3951359,6715142,303,1.00
ptg005738l,2174988,2175271,283,EVM,mRNA,1968311,3086146,283,1.00
ptg005738l,2446216,2446532,316,EVM,mRNA,1968311,3086146,316,1.00
ptg005738l,4811658,4811943,285,EVM,mRNA,4619511,4934459,285,1.00
ptg005738l,5231148,5231459,311,EVM,mRNA,5051055,5444024,311,1.00
ptg005739l,1192649,1192931,282,EVM,mRNA,1061723,1378064,282,1.00
ptg005742l,3089487,3089775,288,EVM,mRNA,2383326,4003195,288,1.00
ptg005746l,583698,583997,299,EVM,mRNA,391785,1682387,299,1.00
ptg005746l,956081,956373,292,EVM,mRNA,391785,1682387,292,1.00
ptg005746l,1097290,1097587,297,EVM,mRNA,391785,1682387,297,1.00
ptg005746l,1100317,1100613,296,EVM,mRNA,391785,1682387,296,1.00
ptg005746l,1275308,1275606,298,EVM,mRNA,391785,1682387,298,1.00
ptg005746l,1666919,1667238,319,EVM,mRNA,391785,1682387,319,1.00
ptg005747l,313999,314307,308,EVM,mRNA,929,612417,308,1.00
ptg005747l,610164,610494,330,EVM,mRNA,929,612417,330,1.00
ptg005748l,1255984,1256268,284,EVM,mRNA,1099863,1323222,284,1.00
ptg005757l,195576,195891,315,EVM,mRNA,1351,392947,315,1.00
ptg005757l,1946531,1946871,340,EVM,mRNA,1944260,2588050,340,1.00
ptg005757l,2524294,2524604,310,EVM,mRNA,1944260,2588050,310,1.00
ptg005761l,886066,886371,305,EVM,mRNA,778216,1113746,305,1.00
ptg005761l,1742839,1743118,279,EVM,mRNA,1209468,1872075,279,1.00
ptg005761l,2157606,2157909,303,EVM,mRNA,2029327,2906456,303,1.00
ptg005770l,969395,969680,285,EVM,mRNA,390544,1089108,285,1.00
ptg005771l,533403,533708,305,EVM,mRNA,25825,881864,305,1.00
ptg005772l,847695,847955,260,EVM,mRNA,520309,1017645,260,1.00
ptg005772l,1386408,1386694,286,EVM,mRNA,1064478,4816418,286,1.00
ptg005772l,1401718,1401997,279,EVM,mRNA,1064478,4816418,279,1.00
ptg005772l,1488718,1489019,301,EVM,mRNA,1064478,4816418,301,1.00
ptg005772l,1722841,1723128,287,EVM,mRNA,1064478,4816418,287,1.00
ptg005772l,4117094,4117377,283,EVM,mRNA,1064478,4816418,283,1.00
ptg005773l,1017236,1017497,261,EVM,mRNA,39836,1410330,261,1.00
ptg005775l,691047,691338,291,EVM,mRNA,672309,981401,291,1.00
ptg005776l,505997,506300,303,EVM,mRNA,285112,803584,303,1.00
ptg005777l,1743180,1743441,261,EVM,mRNA,1626241,2058518,261,1.00
ptg005777l,4729998,4730276,278,EVM,mRNA,4702600,5322402,278,1.00
ptg005778l,546238,546529,291,EVM,mRNA,132684,1606723,291,1.00
ptg005778l,2032614,2032927,313,EVM,mRNA,1828987,2112890,313,1.00
ptg005780l,2962022,2962337,315,EVM,mRNA,2727563,2975880,315,1.00
ptg005786l,298934,299251,317,EVM,mRNA,82,1468945,317,1.00
ptg005791l,240040,240330,290,EVM,mRNA,22062,2313468,290,1.00
ptg005791l,363260,363552,292,EVM,mRNA,22062,2313468,292,1.00
ptg005791l,1860837,1861145,308,EVM,mRNA,22062,2313468,308,1.00
ptg005793l,847363,847661,298,EVM,mRNA,764675,848024,298,1.00
ptg005795l,717424,717711,287,EVM,mRNA,611692,972608,287,1.00
ptg005801l,315997,316320,323,EVM,mRNA,89239,317356,323,1.00
ptg005802l,1280063,1280317,254,EVM,mRNA,854497,1456924,254,1.00
ptg005803l,146756,147050,294,EVM,mRNA,657,1129196,294,1.00
ptg005804l,1244182,1244476,294,EVM,mRNA,1097768,1920250,294,1.00
ptg005804l,1349455,1349727,272,EVM,mRNA,1097768,1920250,272,1.00
ptg005804l,1365488,1365770,282,EVM,mRNA,1097768,1920250,282,1.00
ptg005804l,1779366,1779651,285,EVM,mRNA,1097768,1920250,285,1.00
ptg005804l,2245969,2246280,311,EVM,mRNA,2069101,2331019,311,1.00
ptg005806l,2458161,2458484,323,EVM,mRNA,2377639,2498759,323,1.00
ptg005806l,4053714,4054043,329,EVM,mRNA,2976650,4257433,329,1.00
ptg005806l,4188470,4188746,276,EVM,mRNA,2976650,4257433,276,1.00
ptg005807l,951893,952210,317,EVM,mRNA,476699,1834382,317,1.00
ptg005807l,1078001,1078281,280,EVM,mRNA,476699,1834382,280,1.00
ptg005809l,154479,154806,327,EVM,mRNA,15861,1005854,327,1.00
ptg005809l,184775,185073,298,EVM,mRNA,15861,1005854,298,1.00
ptg005809l,326072,326376,304,EVM,mRNA,15861,1005854,304,1.00
ptg005809l,1355866,1356195,329,EVM,mRNA,1125818,2424144,329,1.00
ptg005809l,1537621,1537920,299,EVM,mRNA,1125818,2424144,299,1.00
ptg005809l,2398933,2399226,293,EVM,mRNA,1125818,2424144,293,1.00
ptg005813l,432012,432317,305,EVM,mRNA,389559,894513,305,1.00
ptg005816l,1148314,1148605,291,EVM,mRNA,969314,1272459,291,1.00
ptg005816l,1270979,1271271,292,EVM,mRNA,969314,1272459,292,1.00
ptg005819l,156802,157075,273,EVM,mRNA,9360,244393,273,1.00
ptg005819l,752412,752697,285,EVM,mRNA,535664,1234129,285,1.00
ptg005820l,921273,921581,308,EVM,mRNA,875236,1001334,308,1.00
ptg005823l,1606428,1606734,306,EVM,mRNA,1606680,1606855,55,0.18
ptg005828l,1790792,1791071,279,EVM,mRNA,1677617,2070511,279,1.00
ptg005834l,3386022,3386302,280,EVM,mRNA,2488188,3691152,280,1.00
ptg005837l,823115,823438,323,EVM,mRNA,181660,1718732,323,1.00
ptg005837l,1431275,1431558,283,EVM,mRNA,181660,1718732,283,1.00
ptg005841l,703651,703970,319,EVM,mRNA,30576,1480739,319,1.00
ptg005843l,364937,365219,282,EVM,mRNA,29386,446614,282,1.00
ptg005850l,1208945,1209242,297,EVM,mRNA,21310,1317013,297,1.00
ptg005851l,843410,843722,312,EVM,mRNA,729364,3850328,312,1.00
ptg005851l,3145816,3146131,315,EVM,mRNA,729364,3850328,315,1.00
ptg005851l,3309320,3309633,313,EVM,mRNA,729364,3850328,313,1.00
ptg005851l,3710150,3710443,293,EVM,mRNA,729364,3850328,293,1.00
ptg005856l,511495,511796,301,EVM,mRNA,112939,1088433,301,1.00
ptg005857l,1346464,1346783,319,EVM,mRNA,207824,1915147,319,1.00
ptg005865l,396897,397188,291,EVM,mRNA,142539,1008155,291,1.00
ptg005865l,587053,587361,308,EVM,mRNA,142539,1008155,308,1.00
ptg005867l,234017,234344,327,EVM,mRNA,131801,581321,327,1.00
ptg005868l,39597,39907,310,EVM,mRNA,39718,400835,190,0.61
ptg005872l,616587,616894,307,EVM,mRNA,22261,1878966,307,1.00
ptg005872l,692221,692501,280,EVM,mRNA,22261,1878966,280,1.00
ptg005872l,1710819,1711107,288,EVM,mRNA,22261,1878966,288,1.00
ptg005883l,215242,215554,312,EVM,mRNA,171446,388868,312,1.00
ptg005884l,686618,686920,302,EVM,mRNA,170376,1101601,302,1.00
ptg005890l,580525,580821,296,EVM,mRNA,455398,1327681,296,1.00
ptg005890l,1046066,1046403,337,EVM,mRNA,455398,1327681,337,1.00
ptg005894l,1901320,1901606,286,EVM,mRNA,1736912,2396095,286,1.00
ptg005894l,2067739,2068055,316,EVM,mRNA,1736912,2396095,316,1.00
ptg005897l,116010,116323,313,EVM,mRNA,78890,226941,313,1.00
ptg005900l,429261,429557,296,EVM,mRNA,14810,511146,296,1.00
ptg005904l,3122903,3123229,326,EVM,mRNA,3113982,3176878,326,1.00
ptg005907l,3217886,3218198,312,EVM,mRNA,3193403,3234258,312,1.00
ptg005908l,196118,196414,296,EVM,mRNA,139784,284864,296,1.00
ptg005908l,2195945,2196256,311,EVM,mRNA,1751421,3667799,311,1.00
ptg005908l,2342458,2342746,288,EVM,mRNA,1751421,3667799,288,1.00
ptg005908l,2798415,2798751,336,EVM,mRNA,1751421,3667799,336,1.00
ptg005908l,3004183,3004496,313,EVM,mRNA,1751421,3667799,313,1.00
ptg005908l,3607403,3607697,294,EVM,mRNA,1751421,3667799,294,1.00
ptg005909l,403856,404173,317,EVM,mRNA,101334,840448,317,1.00
ptg005909l,523711,524004,293,EVM,mRNA,101334,840448,293,1.00
ptg005913l,814284,814570,286,EVM,mRNA,740872,1526842,286,1.00
ptg005913l,1513903,1514213,310,EVM,mRNA,740872,1526842,310,1.00
ptg005913l,2311432,2311732,300,EVM,mRNA,2035345,2458041,300,1.00
ptg005914l,928998,929299,301,EVM,mRNA,21825,2273662,301,1.00
ptg005914l,1044423,1044746,323,EVM,mRNA,21825,2273662,323,1.00
ptg005914l,1568777,1569058,281,EVM,mRNA,21825,2273662,281,1.00
ptg005914l,2331320,2331605,285,EVM,mRNA,2323035,2630608,285,1.00
ptg005914l,2492603,2492879,276,EVM,mRNA,2323035,2630608,276,1.00
ptg005917l,431191,431515,324,EVM,mRNA,144100,711460,324,1.00
ptg005928l,202396,202699,303,EVM,mRNA,18404,423150,303,1.00
ptg005929l,2277606,2277915,309,EVM,mRNA,1696609,3795792,309,1.00
ptg005929l,3333465,3333770,305,EVM,mRNA,1696609,3795792,305,1.00
ptg005929l,3504194,3504506,312,EVM,mRNA,1696609,3795792,312,1.00
ptg005935l,593396,593706,310,EVM,mRNA,398058,1428138,310,1.00
ptg005935l,634163,634447,284,EVM,mRNA,398058,1428138,284,1.00
ptg005935l,1298606,1298891,285,EVM,mRNA,398058,1428138,285,1.00
ptg005939l,446478,446781,303,EVM,mRNA,346694,480343,303,1.00
ptg005942l,114523,114839,316,EVM,mRNA,55293,721747,316,1.00
ptg005942l,177286,177610,324,EVM,mRNA,55293,721747,324,1.00
ptg005943l,1821539,1821822,283,EVM,mRNA,1526619,2234946,283,1.00
ptg005943l,2228314,2228603,289,EVM,mRNA,1526619,2234946,289,1.00
ptg005946l,1605568,1605899,331,EVM,mRNA,625846,1794950,331,1.00
ptg005948l,902569,902857,288,EVM,mRNA,3619,1283133,288,1.00
ptg005954l,1046521,1046832,311,EVM,mRNA,599641,1296566,311,1.00
ptg005954l,1878466,1878764,298,EVM,mRNA,1558774,2849276,298,1.00
ptg005954l,3693266,3693554,288,EVM,mRNA,3497609,4237157,288,1.00
ptg005954l,3978030,3978350,320,EVM,mRNA,3497609,4237157,320,1.00
ptg005954l,4113716,4114004,288,EVM,mRNA,3497609,4237157,288,1.00
ptg005960l,2186246,2186541,295,EVM,mRNA,2091362,3473129,295,1.00
ptg005960l,3245779,3246080,301,EVM,mRNA,2091362,3473129,301,1.00
ptg005960l,3273041,3273325,284,EVM,mRNA,2091362,3473129,284,1.00
ptg005960l,3333002,3333307,305,EVM,mRNA,2091362,3473129,305,1.00
ptg005964l,813396,813686,290,EVM,mRNA,780401,1033199,290,1.00
ptg005964l,1145309,1145641,332,EVM,mRNA,1141278,1451748,332,1.00
ptg005964l,2016668,2016946,278,EVM,mRNA,1517945,2026942,278,1.00
ptg005966l,1539242,1539538,296,EVM,mRNA,1245018,2592388,296,1.00
ptg005966l,2004446,2004707,261,EVM,mRNA,1245018,2592388,261,1.00
ptg005968l,933651,933942,291,EVM,mRNA,570635,2243509,291,1.00
ptg005968l,1494958,1495252,294,EVM,mRNA,570635,2243509,294,1.00
ptg005968l,1915933,1916228,295,EVM,mRNA,570635,2243509,295,1.00
ptg005975l,16571,16839,268,EVM,mRNA,539,1096172,268,1.00
ptg005975l,520218,520486,268,EVM,mRNA,539,1096172,268,1.00
ptg005976l,642300,642595,295,EVM,mRNA,503727,701726,295,1.00
ptg005978l,468090,468371,281,EVM,mRNA,13363,492180,281,1.00
ptg005978l,1868219,1868512,293,EVM,mRNA,1328626,2817053,293,1.00
ptg005978l,2064774,2065089,315,EVM,mRNA,1328626,2817053,315,1.00
ptg005979l,1430389,1430698,309,EVM,mRNA,613528,1582446,309,1.00
ptg005979l,2910547,2910856,309,EVM,mRNA,2474612,2931119,309,1.00
ptg005979l,3486004,3486331,327,EVM,mRNA,3469095,4450277,327,1.00
ptg005985l,3590357,3590686,329,EVM,mRNA,3553787,3667664,329,1.00
ptg005986l,250465,250768,303,EVM,mRNA,232733,499293,303,1.00
ptg005987l,648938,649251,313,EVM,mRNA,524805,668704,313,1.00
ptg005990l,1659148,1659434,286,EVM,mRNA,627491,1923658,286,1.00
ptg005998l,2493366,2493638,272,EVM,mRNA,2485086,2584577,272,1.00
ptg005999l,187573,187879,306,EVM,mRNA,12612,193314,306,1.00
ptg006000l,417437,417749,312,EVM,mRNA,253895,815764,312,1.00
ptg006011l,48306,48598,292,EVM,mRNA,47324,455823,292,1.00
ptg006011l,233466,233778,312,EVM,mRNA,47324,455823,312,1.00
ptg006012l,549508,549784,276,EVM,mRNA,3690,823563,276,1.00
ptg006013l,868114,868413,299,EVM,mRNA,84055,1403699,299,1.00
ptg006013l,1508141,1508431,290,EVM,mRNA,1445154,1931853,290,1.00
ptg006014l,636026,636310,284,EVM,mRNA,456883,977618,284,1.00
ptg006014l,672113,672414,301,EVM,mRNA,456883,977618,301,1.00
ptg006014l,931944,932223,279,EVM,mRNA,456883,977618,279,1.00
ptg006015l,1382179,1382481,302,EVM,mRNA,1296318,2651494,302,1.00
ptg006015l,1970313,1970612,299,EVM,mRNA,1296318,2651494,299,1.00
ptg006015l,2051716,2052041,325,EVM,mRNA,1296318,2651494,325,1.00
ptg006015l,2532103,2532423,320,EVM,mRNA,1296318,2651494,320,1.00
ptg006019l,316623,316913,290,EVM,mRNA,139314,396625,290,1.00
ptg006020l,640467,640793,326,EVM,mRNA,367113,1309131,326,1.00
ptg006020l,821451,821718,267,EVM,mRNA,367113,1309131,267,1.00
ptg006020l,1081598,1081883,285,EVM,mRNA,367113,1309131,285,1.00
ptg006020l,1135407,1135702,295,EVM,mRNA,367113,1309131,295,1.00
ptg006022l,1288185,1288496,311,EVM,mRNA,790517,3013954,311,1.00
ptg006022l,2076328,2076610,282,EVM,mRNA,790517,3013954,282,1.00
ptg006026l,639957,640301,344,EVM,mRNA,21561,839271,344,1.00
ptg006026l,791098,791389,291,EVM,mRNA,21561,839271,291,1.00
ptg006027l,4755848,4756150,302,EVM,mRNA,4708049,5186810,302,1.00
ptg006035l,450063,450372,309,EVM,mRNA,284185,683508,309,1.00
ptg006037l,1967209,1967524,315,EVM,mRNA,1526458,2616682,315,1.00
ptg006043l,1468598,1468898,300,EVM,mRNA,428636,1763937,300,1.00
ptg006045l,883925,884211,286,EVM,mRNA,826063,1028488,286,1.00
ptg006047l,2300650,2300930,280,EVM,mRNA,2242306,2395062,280,1.00
ptg006047l,2307774,2308054,280,EVM,mRNA,2242306,2395062,280,1.00
ptg006048l,1413662,1413954,292,EVM,mRNA,1216828,2545881,292,1.00
ptg006051l,1130409,1130699,290,EVM,mRNA,926826,1804211,290,1.00
ptg006052l,883306,883612,306,EVM,mRNA,863977,1232799,306,1.00
ptg006055l,1948113,1948437,324,EVM,mRNA,1391018,1999704,324,1.00
ptg006056l,1313658,1313950,292,EVM,mRNA,1089898,1319916,292,1.00
ptg006056l,2191794,2192109,315,EVM,mRNA,1556124,2587880,315,1.00
ptg006058l,681313,681647,334,EVM,mRNA,518961,975060,334,1.00
ptg006058l,2306853,2307148,295,EVM,mRNA,2297889,2473540,295,1.00
ptg006061l,314075,314349,274,EVM,mRNA,307350,462284,274,1.00
ptg006063l,626752,627042,290,EVM,mRNA,307358,1005287,290,1.00
ptg006065l,394299,394568,269,EVM,mRNA,380437,1260250,269,1.00
ptg006069l,415511,415801,290,EVM,mRNA,45725,1073419,290,1.00
ptg006077l,559957,560231,274,EVM,mRNA,514232,656848,274,1.00
ptg006077l,1362426,1362683,257,EVM,mRNA,1311762,1415698,257,1.00
ptg006078l,1323358,1323640,282,EVM,mRNA,317,2047350,282,1.00
ptg006078l,1421614,1421892,278,EVM,mRNA,317,2047350,278,1.00
ptg006081l,947476,947780,304,EVM,mRNA,85049,2499706,304,1.00
ptg006083l,251933,252250,317,EVM,mRNA,4489,576035,317,1.00
ptg006083l,268675,268974,299,EVM,mRNA,4489,576035,299,1.00
ptg006083l,414674,414927,253,EVM,mRNA,4489,576035,253,1.00
ptg006083l,430755,431054,299,EVM,mRNA,4489,576035,299,1.00
ptg006083l,1719233,1719549,316,EVM,mRNA,1061876,2057209,316,1.00
ptg006083l,2461047,2461328,281,EVM,mRNA,2457862,2479718,281,1.00
ptg006083l,2782260,2782547,287,EVM,mRNA,2745061,3795691,287,1.00
ptg006087l,784839,785162,323,EVM,mRNA,2556,846760,323,1.00
ptg006087l,1032807,1033119,312,EVM,mRNA,980470,1533087,312,1.00
ptg006089l,1043038,1043346,308,EVM,mRNA,956181,1074942,308,1.00
ptg006090l,370451,370729,278,EVM,mRNA,266844,1768238,278,1.00
ptg006090l,666328,666600,272,EVM,mRNA,266844,1768238,272,1.00
ptg006090l,3541038,3541344,306,EVM,mRNA,3467433,3801121,306,1.00
ptg006094l,259236,259527,291,EVM,mRNA,109879,871926,291,1.00
ptg006094l,286266,286565,299,EVM,mRNA,109879,871926,299,1.00
ptg006094l,541978,542277,299,EVM,mRNA,109879,871926,299,1.00
ptg006094l,2746326,2746623,297,EVM,mRNA,1112098,3500678,297,1.00
ptg006095l,697902,698170,268,EVM,mRNA,647965,764577,268,1.00
ptg006095l,1606937,1607243,306,EVM,mRNA,1584804,1722108,306,1.00
ptg006095l,1937667,1937981,314,EVM,mRNA,1841710,2040478,314,1.00
ptg006097l,214883,215161,278,EVM,mRNA,205246,364858,278,1.00
ptg006099l,1190463,1190761,298,EVM,mRNA,944437,1977171,298,1.00
ptg006099l,1541580,1541878,298,EVM,mRNA,944437,1977171,298,1.00
ptg006103l,1710864,1711195,331,EVM,mRNA,1108753,1867776,331,1.00
ptg006104l,120987,121291,304,EVM,mRNA,18411,885212,304,1.00
ptg006104l,648744,649074,330,EVM,mRNA,18411,885212,330,1.00
ptg006104l,1950465,1950760,295,EVM,mRNA,1904838,3666743,295,1.00
ptg006104l,2658157,2658457,300,EVM,mRNA,1904838,3666743,300,1.00
ptg006104l,3225184,3225506,322,EVM,mRNA,1904838,3666743,322,1.00
ptg006104l,3926361,3926672,311,EVM,mRNA,3725347,3946020,311,1.00
ptg006107l,175379,175645,266,EVM,mRNA,6785,364476,266,1.00
ptg006107l,1566891,1567176,285,EVM,mRNA,515775,1788817,285,1.00
ptg006107l,1658804,1659080,276,EVM,mRNA,515775,1788817,276,1.00
ptg006109l,765249,765516,267,EVM,mRNA,757507,1307263,267,1.00
ptg006110l,1254506,1254764,258,EVM,mRNA,946661,1557892,258,1.00
ptg006110l,1329011,1329292,281,EVM,mRNA,946661,1557892,281,1.00
ptg006110l,3910667,3910986,319,EVM,mRNA,2205748,4934368,319,1.00
ptg006115l,1134243,1134534,291,EVM,mRNA,770791,1622455,291,1.00
ptg006118l,1440842,1441107,265,EVM,mRNA,1301886,1616818,265,1.00
ptg006118l,1540901,1541220,319,EVM,mRNA,1301886,1616818,319,1.00
ptg006121l,924107,924431,324,EVM,mRNA,655903,1021553,324,1.00
ptg006127l,238010,238276,266,EVM,mRNA,231878,634661,266,1.00
ptg006127l,323864,324154,290,EVM,mRNA,231878,634661,290,1.00
ptg006132l,139241,139532,291,EVM,mRNA,45745,622976,291,1.00
ptg006134l,1381480,1381789,309,EVM,mRNA,2003,1633810,309,1.00
ptg006136l,426738,427040,302,EVM,mRNA,140098,1118329,302,1.00
ptg006136l,1115799,1116088,289,EVM,mRNA,140098,1118329,289,1.00
ptg006139l,1325405,1325690,285,EVM,mRNA,157584,1389036,285,1.00
ptg006140l,1449491,1449780,289,EVM,mRNA,1415541,1851620,289,1.00
ptg006144l,419997,420323,326,EVM,mRNA,216323,1426031,326,1.00
ptg006144l,983541,983836,295,EVM,mRNA,216323,1426031,295,1.00
ptg006146l,1272682,1272991,309,EVM,mRNA,186300,1915719,309,1.00
ptg006150l,384193,384458,265,EVM,mRNA,5209,840096,265,1.00
ptg006153l,422544,422835,291,EVM,mRNA,93867,3768532,291,1.00
ptg006153l,872985,873278,293,EVM,mRNA,93867,3768532,293,1.00
ptg006153l,1511920,1512244,324,EVM,mRNA,1435176,1523718,324,1.00
ptg006153l,1511920,1512244,324,EVM,mRNA,93867,3768532,324,1.00
ptg006153l,1916123,1916397,274,EVM,mRNA,93867,3768532,274,1.00
ptg006153l,2042271,2042552,281,EVM,mRNA,93867,3768532,281,1.00
ptg006153l,2597766,2598079,313,EVM,mRNA,93867,3768532,313,1.00
ptg006153l,2700070,2700388,318,EVM,mRNA,93867,3768532,318,1.00
ptg006153l,3424854,3425132,278,EVM,mRNA,93867,3768532,278,1.00
ptg006153l,3756023,3756351,328,EVM,mRNA,93867,3768532,328,1.00
ptg006156l,738161,738475,314,EVM,mRNA,169034,2043887,314,1.00
ptg006156l,3166782,3167096,314,EVM,mRNA,3027914,3560949,314,1.00
ptg006159l,1395092,1395373,281,EVM,mRNA,43142,1905425,281,1.00
ptg006159l,2993902,2994198,296,EVM,mRNA,2876507,4440078,296,1.00
ptg006163l,623393,623725,332,EVM,mRNA,286184,939478,332,1.00
ptg006163l,739706,740005,299,EVM,mRNA,286184,939478,299,1.00
ptg006167l,1216769,1217037,268,EVM,mRNA,334197,2178012,268,1.00
ptg006167l,2661424,2661704,280,EVM,mRNA,2579810,2821796,280,1.00
ptg006171l,1007922,1008238,316,EVM,mRNA,949134,2084120,316,1.00
ptg006171l,1999850,2000140,290,EVM,mRNA,949134,2084120,290,1.00
ptg006174l,515224,515478,254,EVM,mRNA,470439,557424,254,1.00
ptg006174l,857649,857946,297,EVM,mRNA,839276,862616,297,1.00
ptg006176l,1616941,1617279,338,EVM,mRNA,596368,2046859,338,1.00
ptg006177l,744018,744317,299,EVM,mRNA,666706,872622,299,1.00
ptg006183l,2126256,2126562,306,EVM,mRNA,2061126,2444314,306,1.00
ptg006183l,2157491,2157807,316,EVM,mRNA,2061126,2444314,316,1.00
ptg006183l,2213990,2214278,288,EVM,mRNA,2061126,2444314,288,1.00
ptg006183l,3152148,3152426,278,EVM,mRNA,3054408,3209213,278,1.00
ptg006186l,1582157,1582432,275,EVM,mRNA,25062,1651635,275,1.00
ptg006189l,607421,607742,321,EVM,mRNA,439905,1092778,321,1.00
ptg006189l,989159,989452,293,EVM,mRNA,439905,1092778,293,1.00
ptg006190l,1765391,1765697,306,EVM,mRNA,1324504,1792321,306,1.00
ptg006191l,1098343,1098642,299,EVM,mRNA,585967,1492435,299,1.00
ptg006191l,1297968,1298240,272,EVM,mRNA,585967,1492435,272,1.00
ptg006191l,2240291,2240577,286,EVM,mRNA,2236280,2644844,286,1.00
ptg006193l,374070,374353,283,EVM,mRNA,57841,374310,240,0.85
ptg006193l,2217955,2218250,295,EVM,mRNA,2027837,2221678,295,1.00
ptg006193l,3436031,3436343,312,EVM,mRNA,2777027,3768562,312,1.00
ptg006193l,4044717,4045026,309,EVM,mRNA,3989250,4776476,309,1.00
ptg006193l,4089152,4089428,276,EVM,mRNA,3989250,4776476,276,1.00
ptg006196l,545527,545854,327,EVM,mRNA,306600,902308,327,1.00
ptg006197l,1728178,1728450,272,EVM,mRNA,1673657,3233033,272,1.00
ptg006197l,1738383,1738645,262,EVM,mRNA,1673657,3233033,262,1.00
ptg006197l,1784738,1785066,328,EVM,mRNA,1673657,3233033,328,1.00
ptg006197l,2099388,2099666,278,EVM,mRNA,1673657,3233033,278,1.00
ptg006197l,2914635,2914930,295,EVM,mRNA,1673657,3233033,295,1.00
ptg006197l,5172977,5173295,318,EVM,mRNA,5148545,5689862,318,1.00
ptg006197l,5405431,5405737,306,EVM,mRNA,5148545,5689862,306,1.00
ptg006200l,1542889,1543188,299,EVM,mRNA,1340721,1964412,299,1.00
ptg006200l,1616712,1617015,303,EVM,mRNA,1340721,1964412,303,1.00
ptg006200l,1732615,1732914,299,EVM,mRNA,1340721,1964412,299,1.00
ptg006200l,1817131,1817423,292,EVM,mRNA,1340721,1964412,292,1.00
ptg006201l,596841,597167,326,EVM,mRNA,576827,617292,326,1.00
ptg006202l,1061569,1061912,343,EVM,mRNA,558986,1387489,343,1.00
ptg006202l,1344382,1344662,280,EVM,mRNA,558986,1387489,280,1.00
ptg006206l,257442,257693,251,EVM,mRNA,30976,496374,251,1.00
ptg006213l,2581059,2581367,308,EVM,mRNA,1158804,2799857,308,1.00
ptg006215l,973716,974012,296,EVM,mRNA,973400,1028861,296,1.00
ptg006215l,2410699,2410998,299,EVM,mRNA,2203142,3774079,299,1.00
ptg006215l,2447845,2448169,324,EVM,mRNA,2203142,3774079,324,1.00
ptg006215l,4298300,4298584,284,EVM,mRNA,4298128,4788971,284,1.00
ptg006217l,668680,668969,289,EVM,mRNA,551724,927804,289,1.00
ptg006217l,1220457,1220755,298,EVM,mRNA,1100396,3603682,298,1.00
ptg006217l,3600933,3601253,320,EVM,mRNA,1100396,3603682,320,1.00
ptg006219l,3210186,3210505,319,EVM,mRNA,2801916,4296501,319,1.00
ptg006219l,3598954,3599224,270,EVM,mRNA,2801916,4296501,270,1.00
ptg006219l,3833613,3833926,313,EVM,mRNA,2801916,4296501,313,1.00
ptg006222l,139407,139721,314,EVM,mRNA,50379,584550,314,1.00
ptg006223l,31297,31583,286,EVM,mRNA,5125,2318812,286,1.00
ptg006223l,529797,530116,319,EVM,mRNA,5125,2318812,319,1.00
ptg006223l,1101972,1102279,307,EVM,mRNA,5125,2318812,307,1.00
ptg006223l,1363159,1363469,310,EVM,mRNA,5125,2318812,310,1.00
ptg006224l,1295779,1296086,307,EVM,mRNA,1138114,2407952,307,1.00
ptg006224l,5031612,5031917,305,EVM,mRNA,3253552,5827610,305,1.00
ptg006228l,2410688,2411008,320,EVM,mRNA,1556068,2755037,320,1.00
ptg006233l,2243799,2244104,305,EVM,mRNA,2126691,2683334,305,1.00
ptg006233l,3868765,3869068,303,EVM,mRNA,2977978,3967451,303,1.00
ptg006235l,634242,634533,291,EVM,mRNA,87103,744970,291,1.00
ptg006239l,364402,364703,301,EVM,mRNA,334812,463092,301,1.00
ptg006239l,2102311,2102605,294,EVM,mRNA,1863049,2471123,294,1.00
ptg006239l,2286196,2286486,290,EVM,mRNA,1863049,2471123,290,1.00
ptg006240l,1824048,1824341,293,EVM,mRNA,1600193,1824627,293,1.00
ptg006244l,1393518,1393804,286,EVM,mRNA,1385435,1434051,286,1.00
ptg006248l,283975,284250,275,EVM,mRNA,248437,360525,275,1.00
ptg006253l,341918,342222,304,EVM,mRNA,71253,408662,304,1.00
ptg006253l,1887777,1888060,283,EVM,mRNA,1624362,1890117,283,1.00
ptg006256l,1405371,1405672,301,EVM,mRNA,13658,1665169,301,1.00
ptg006260l,864998,865321,323,EVM,mRNA,536894,996931,323,1.00
ptg006260l,1252827,1253125,298,EVM,mRNA,1173295,1441490,298,1.00
ptg006261l,683444,683775,331,EVM,mRNA,607829,793688,331,1.00
ptg006263l,299943,300249,306,EVM,mRNA,190294,510856,306,1.00
ptg006263l,422180,422510,330,EVM,mRNA,190294,510856,330,1.00
ptg006272l,2216029,2216358,329,EVM,mRNA,1695516,3219414,329,1.00
ptg006272l,2597979,2598290,311,EVM,mRNA,1695516,3219414,311,1.00
ptg006272l,3078207,3078522,315,EVM,mRNA,1695516,3219414,315,1.00
ptg006277l,1168150,1168455,305,EVM,mRNA,959187,1474193,305,1.00
ptg006280l,535857,536147,290,EVM,mRNA,397852,1560269,290,1.00
ptg006280l,965535,965823,288,EVM,mRNA,397852,1560269,288,1.00
ptg006280l,1211181,1211483,302,EVM,mRNA,397852,1560269,302,1.00
ptg006280l,1292169,1292467,298,EVM,mRNA,397852,1560269,298,1.00
ptg006284l,1511562,1511856,294,EVM,mRNA,1316422,1856286,294,1.00
ptg006284l,1511562,1511856,294,GeneWise,mRNA,1477989,1856283,294,1.00
ptg006285l,50592,50848,256,EVM,mRNA,395,90348,256,1.00
ptg006287l,383226,383528,302,EVM,mRNA,233459,750811,302,1.00
ptg006288l,98530,98825,295,EVM,mRNA,14571,99697,295,1.00
ptg006289l,3987805,3988075,270,EVM,mRNA,3919312,6519255,270,1.00
ptg006289l,6260063,6260379,316,EVM,mRNA,3919312,6519255,316,1.00
ptg006296l,2420020,2420308,288,EVM,mRNA,1949995,3283454,288,1.00
ptg006296l,2488594,2488909,315,EVM,mRNA,1949995,3283454,315,1.00
ptg006298l,2870558,2870909,351,EVM,mRNA,2808707,3262063,351,1.00
ptg006298l,3045340,3045670,330,EVM,mRNA,2808707,3262063,330,1.00
ptg006298l,5525775,5526057,282,EVM,mRNA,5154739,5904391,282,1.00
ptg006298l,5710589,5710868,279,EVM,mRNA,5154739,5904391,279,1.00
ptg006298l,5750841,5751129,288,EVM,mRNA,5154739,5904391,288,1.00
ptg006298l,8288959,8289240,281,EVM,mRNA,8122785,9443401,281,1.00
ptg006298l,8957572,8957885,313,EVM,mRNA,8122785,9443401,313,1.00
ptg006301l,491416,491721,305,EVM,mRNA,127796,1784576,305,1.00
ptg006301l,687701,688010,309,EVM,mRNA,127796,1784576,309,1.00
ptg006301l,1123802,1124076,274,EVM,mRNA,127796,1784576,274,1.00
ptg006302l,2191740,2192045,305,EVM,mRNA,2084046,2925235,305,1.00
ptg006302l,2197685,2197989,304,EVM,mRNA,2084046,2925235,304,1.00
ptg006302l,2701138,2701451,313,EVM,mRNA,2084046,2925235,313,1.00
ptg006305l,808788,809065,277,EVM,mRNA,109478,888914,277,1.00
ptg006310l,699008,699322,314,EVM,mRNA,632726,733447,314,1.00
ptg006310l,1679868,1680160,292,EVM,mRNA,1495838,2090115,292,1.00
ptg006310l,1679868,1680160,292,GeMoMa,mRNA,1495838,2708178,292,1.00
ptg006310l,2900412,2900720,308,EVM,mRNA,2900511,2900834,210,0.68
ptg006314l,3299648,3299954,306,EVM,mRNA,3257927,3526972,306,1.00
ptg006314l,4753978,4754257,279,EVM,mRNA,4095352,4886759,279,1.00
ptg006314l,5621006,5621336,330,EVM,mRNA,5114223,6626063,330,1.00
ptg006314l,5671822,5672114,292,EVM,mRNA,5114223,6626063,292,1.00
ptg006314l,6007722,6008013,291,EVM,mRNA,5114223,6626063,291,1.00
ptg006314l,6010307,6010596,289,EVM,mRNA,5114223,6626063,289,1.00
ptg006314l,6055660,6055957,297,EVM,mRNA,5114223,6626063,297,1.00
ptg006314l,6599958,6600254,296,EVM,mRNA,5114223,6626063,296,1.00
ptg006314l,10766611,10766888,277,EVM,mRNA,10185107,10802090,277,1.00
ptg006314l,11849909,11850200,291,EVM,mRNA,11508130,11999618,291,1.00
ptg006316l,986343,986642,299,EVM,mRNA,514742,1217510,299,1.00
ptg006320l,1186463,1186789,326,EVM,mRNA,1041406,1661398,326,1.00
ptg006321l,575357,575646,289,EVM,mRNA,462221,1108565,289,1.00
ptg006325l,583352,583650,298,EVM,mRNA,521098,891184,298,1.00
ptg006325l,670052,670347,295,EVM,mRNA,521098,891184,295,1.00
ptg006326l,1493474,1493792,318,EVM,mRNA,1490152,1841120,318,1.00
ptg006327l,1407004,1407315,311,EVM,mRNA,1406174,2779694,311,1.00
ptg006327l,2207267,2207550,283,EVM,mRNA,1406174,2779694,283,1.00
ptg006327l,2478606,2478900,294,EVM,mRNA,1406174,2779694,294,1.00
ptg006328l,1320926,1321221,295,EVM,mRNA,1311758,1815367,295,1.00
ptg006328l,1405463,1405763,300,EVM,mRNA,1311758,1815367,300,1.00
ptg006329l,730801,731090,289,EVM,mRNA,721781,1736580,289,1.00
ptg006329l,836992,837315,323,EVM,mRNA,721781,1736580,323,1.00
ptg006330l,603708,603970,262,EVM,mRNA,407052,671565,262,1.00
ptg006334l,539583,539855,272,EVM,mRNA,187687,725931,272,1.00
ptg006334l,592417,592740,323,EVM,mRNA,187687,725931,323,1.00
ptg006335l,1135326,1135602,276,EVM,mRNA,48652,1818618,276,1.00
ptg006335l,1171755,1172054,299,EVM,mRNA,48652,1818618,299,1.00
ptg006339l,433825,434152,327,EVM,mRNA,7918,489173,327,1.00
ptg006339l,1599585,1599859,274,EVM,mRNA,1586982,1809699,274,1.00
ptg006339l,1675822,1676121,299,EVM,mRNA,1586982,1809699,299,1.00
ptg006339l,3945832,3946128,296,EVM,mRNA,3142215,4645942,296,1.00
ptg006344l,836735,837031,296,EVM,mRNA,640605,2028711,296,1.00
ptg006344l,1208541,1208832,291,EVM,mRNA,640605,2028711,291,1.00
ptg006346l,17829,18161,332,EVM,mRNA,668,345234,332,1.00
ptg006346l,632902,633215,313,EVM,mRNA,528560,837285,313,1.00
ptg006349l,435243,435541,298,EVM,mRNA,103751,477395,298,1.00
ptg006353l,952180,952503,323,EVM,mRNA,811874,953958,323,1.00
ptg006354l,612844,613132,288,EVM,mRNA,155408,733574,288,1.00
ptg006354l,1208658,1208965,307,EVM,mRNA,900466,1236253,307,1.00
ptg006356l,1303595,1303861,266,EVM,mRNA,892067,2786827,266,1.00
ptg006356l,2334879,2335192,313,EVM,mRNA,892067,2786827,313,1.00
ptg006361l,146211,146500,289,EVM,mRNA,15154,146988,289,1.00
ptg006361l,1918085,1918397,312,EVM,mRNA,1884388,2046092,312,1.00
ptg006361l,1918678,1918953,275,EVM,mRNA,1884388,2046092,275,1.00
ptg006362l,319842,320128,286,EVM,mRNA,269925,488050,286,1.00
ptg006362l,2310635,2310936,301,EVM,mRNA,2137086,2977001,301,1.00
ptg006364l,738079,738361,282,EVM,mRNA,714768,912728,282,1.00
ptg006364l,1268246,1268574,328,EVM,mRNA,1260377,1455403,328,1.00
ptg006365l,602254,602536,282,EVM,mRNA,600,892075,282,1.00
ptg006365l,3171911,3172212,301,EVM,mRNA,2193609,3368665,301,1.00
ptg006369l,1323380,1323675,295,EVM,mRNA,772127,1461756,295,1.00
ptg006371l,836810,837127,317,EVM,mRNA,18514,1166163,317,1.00
ptg006372l,2239408,2239685,277,EVM,mRNA,1261986,6258827,277,1.00
ptg006372l,4137165,4137441,276,EVM,mRNA,1261986,6258827,276,1.00
ptg006372l,4295674,4295942,268,EVM,mRNA,1261986,6258827,268,1.00
ptg006372l,5483360,5483687,327,EVM,mRNA,1261986,6258827,327,1.00
ptg006372l,5763058,5763359,301,EVM,mRNA,1261986,6258827,301,1.00
ptg006373l,884483,884775,292,EVM,mRNA,767542,886764,292,1.00
ptg006374l,128952,129268,316,EVM,mRNA,15905,756051,316,1.00
ptg006378l,3007105,3007402,297,EVM,mRNA,2066049,3008993,297,1.00
ptg006378l,4080438,4080739,301,EVM,mRNA,4067195,4109426,301,1.00
ptg006379l,122448,122726,278,EVM,mRNA,28543,160185,278,1.00
ptg006380l,309357,309656,299,EVM,mRNA,10580,394654,299,1.00
ptg006380l,1966575,1966859,284,EVM,mRNA,1325247,2223183,284,1.00
ptg006380l,4661297,4661558,261,EVM,mRNA,2509637,5004074,261,1.00
ptg006380l,7747728,7748013,285,EVM,mRNA,7557168,8479916,285,1.00
ptg006382l,1015072,1015357,285,EVM,mRNA,928419,1616718,285,1.00
ptg006383l,1426018,1426320,302,EVM,mRNA,1017862,2192559,302,1.00
ptg006383l,1785159,1785456,297,EVM,mRNA,1017862,2192559,297,1.00
ptg006383l,2027471,2027789,318,EVM,mRNA,1017862,2192559,318,1.00
ptg006383l,2368459,2368735,276,EVM,mRNA,2193976,3601699,276,1.00
ptg006383l,2432463,2432755,292,EVM,mRNA,2193976,3601699,292,1.00
ptg006383l,3910778,3911057,279,EVM,mRNA,3907575,4142538,279,1.00
ptg006384l,604135,604436,301,EVM,mRNA,185782,642082,301,1.00
ptg006389l,997974,998246,272,EVM,mRNA,781208,1083533,272,1.00
ptg006389l,4167094,4167378,284,EVM,mRNA,4079243,4274544,284,1.00
ptg006389l,4221404,4221691,287,EVM,mRNA,4079243,4274544,287,1.00
ptg006392l,736219,736558,339,EVM,mRNA,80297,736663,339,1.00
ptg006393l,2199723,2200043,320,EVM,mRNA,886004,2251340,320,1.00
ptg006405l,479490,479785,295,EVM,mRNA,37884,483740,295,1.00
ptg006406l,555181,555493,312,EVM,mRNA,404403,1692093,312,1.00
ptg006406l,787553,787851,298,EVM,mRNA,404403,1692093,298,1.00
ptg006406l,847680,847979,299,EVM,mRNA,404403,1692093,299,1.00
ptg006406l,980761,981078,317,EVM,mRNA,404403,1692093,317,1.00
ptg006406l,1130669,1130990,321,EVM,mRNA,404403,1692093,321,1.00
ptg006408l,1636725,1637000,275,EVM,mRNA,1423206,2159079,275,1.00
ptg006409l,96588,96857,269,EVM,mRNA,10590,1248650,269,1.00
ptg006409l,265750,266045,295,EVM,mRNA,10590,1248650,295,1.00
ptg006409l,536604,536894,290,EVM,mRNA,10590,1248650,290,1.00
ptg006412l,77586,77860,274,EVM,mRNA,32667,549168,274,1.00
ptg006413l,1903011,1903331,320,EVM,mRNA,1804397,1964793,320,1.00
ptg006413l,3136917,3137213,296,EVM,mRNA,2862691,3242983,296,1.00
ptg006418l,1619606,1619878,272,EVM,mRNA,1510728,2431783,272,1.00
ptg006420l,801606,801884,278,EVM,mRNA,311696,817397,278,1.00
ptg006422l,1634119,1634407,288,EVM,mRNA,744250,2638912,288,1.00
ptg006423l,678333,678640,307,EVM,mRNA,197453,770028,307,1.00
ptg006426l,2931170,2931465,295,EVM,mRNA,2761817,5484765,295,1.00
ptg006426l,3336145,3336422,277,EVM,mRNA,2761817,5484765,277,1.00
ptg006426l,4884221,4884521,300,EVM,mRNA,2761817,5484765,300,1.00
ptg006427l,594244,594568,324,EVM,mRNA,251648,1452252,324,1.00
ptg006427l,826478,826774,296,EVM,mRNA,251648,1452252,296,1.00
ptg006427l,2538838,2539153,315,EVM,mRNA,2098875,2672149,315,1.00
ptg006427l,2594854,2595171,317,EVM,mRNA,2098875,2672149,317,1.00
ptg006427l,2924522,2924809,287,EVM,mRNA,2846647,3502805,287,1.00
ptg006432l,356414,356735,321,EVM,mRNA,353357,523429,321,1.00
ptg006432l,1506295,1506568,273,EVM,mRNA,937631,1561956,273,1.00
ptg006434l,360833,361108,275,EVM,mRNA,316110,812884,275,1.00
ptg006436l,258381,258680,299,EVM,mRNA,216035,676807,299,1.00
ptg006442l,820025,820301,276,EVM,mRNA,499451,1039357,276,1.00
ptg006442l,952456,952745,289,EVM,mRNA,499451,1039357,289,1.00
ptg006444l,1906133,1906444,311,EVM,mRNA,1459132,2112730,311,1.00
ptg006449l,467007,467340,333,EVM,mRNA,410608,592798,333,1.00
ptg006453l,1023163,1023462,299,EVM,mRNA,605661,1519789,299,1.00
ptg006454l,241053,241337,284,EVM,mRNA,27119,280316,284,1.00
ptg006454l,961299,961596,297,EVM,mRNA,439413,1133471,297,1.00
ptg006454l,2170012,2170304,292,EVM,mRNA,1233257,2330154,292,1.00
ptg006454l,3624247,3624569,322,EVM,mRNA,3346174,3626317,322,1.00
ptg006454l,5816497,5816783,286,EVM,mRNA,3834417,6562880,286,1.00
ptg006454l,6413113,6413422,309,EVM,mRNA,3834417,6562880,309,1.00
ptg006455l,2009263,2009572,309,EVM,mRNA,1840660,2056495,309,1.00
ptg006456l,184325,184636,311,EVM,mRNA,72881,260468,311,1.00
ptg006460l,934986,935280,294,EVM,mRNA,175251,1067595,294,1.00
ptg006461l,2479204,2479519,315,EVM,mRNA,2055424,4435222,315,1.00
ptg006461l,2617003,2617327,324,EVM,mRNA,2055424,4435222,324,1.00
ptg006461l,3199750,3200063,313,EVM,mRNA,2055424,4435222,313,1.00
ptg006466l,608840,609127,287,EVM,mRNA,497127,1182310,287,1.00
ptg006466l,678278,678580,302,EVM,mRNA,497127,1182310,302,1.00
ptg006466l,2739688,2740025,337,EVM,mRNA,2501079,2741295,337,1.00
ptg006467l,358012,358326,314,EVM,mRNA,228537,1924444,314,1.00
ptg006468l,964534,964856,322,EVM,mRNA,397852,1112700,322,1.00
ptg006471l,1391127,1391406,279,EVM,mRNA,1236760,1455580,279,1.00
ptg006473l,1356071,1356359,288,EVM,mRNA,994878,1552870,288,1.00
ptg006480l,743444,743733,289,EVM,mRNA,714580,894176,289,1.00
ptg006481l,1172406,1172725,319,EVM,mRNA,868599,1237665,319,1.00
ptg006482l,1359497,1359815,318,EVM,mRNA,1257813,1370292,318,1.00
ptg006482l,2202260,2202573,313,EVM,mRNA,1885159,2498992,313,1.00
ptg006482l,2399717,2400016,299,EVM,mRNA,1885159,2498992,299,1.00
ptg006482l,2476772,2477086,314,EVM,mRNA,1885159,2498992,314,1.00
ptg006486l,751776,752057,281,EVM,mRNA,592785,860566,281,1.00
ptg006486l,1927702,1928034,332,EVM,mRNA,1904943,2139725,332,1.00
ptg006486l,3269932,3270199,267,EVM,mRNA,2524389,3382724,267,1.00
ptg006492l,4174976,4175267,291,EVM,mRNA,3984410,4871225,291,1.00
ptg006493l,1449997,1450249,252,EVM,mRNA,1215353,1705654,252,1.00
ptg006493l,1597532,1597840,308,EVM,mRNA,1215353,1705654,308,1.00
ptg006494l,194100,194411,311,EVM,mRNA,59321,350630,311,1.00
ptg006495l,884757,885045,288,EVM,mRNA,780491,917075,288,1.00
ptg006495l,1791496,1791810,314,EVM,mRNA,1608546,1858154,314,1.00
ptg006496l,710191,710492,301,EVM,mRNA,1408,1961111,301,1.00
ptg006496l,960188,960513,325,EVM,mRNA,1408,1961111,325,1.00
ptg006496l,1926447,1926760,313,EVM,mRNA,1408,1961111,313,1.00
ptg006500l,14728,15047,319,EVM,mRNA,14329,186162,319,1.00
ptg006500l,673276,673602,326,EVM,mRNA,456980,799222,326,1.00
ptg006501l,3656030,3656320,290,EVM,mRNA,3006609,4262655,290,1.00
ptg006501l,4166237,4166552,315,EVM,mRNA,3006609,4262655,315,1.00
ptg006511l,524180,524485,305,EVM,mRNA,198357,1729776,305,1.00
ptg006511l,2557244,2557545,301,EVM,mRNA,1945186,4045033,301,1.00
ptg006511l,2599147,2599444,297,EVM,mRNA,1945186,4045033,297,1.00
ptg006511l,2787191,2787463,272,EVM,mRNA,1945186,4045033,272,1.00
ptg006512l,55895,56189,294,EVM,mRNA,54560,181209,294,1.00
ptg006512l,90404,90742,338,EVM,mRNA,54560,181209,338,1.00
ptg006513l,2300117,2300428,311,EVM,mRNA,1195794,3727676,311,1.00
ptg006513l,3425784,3426108,324,EVM,mRNA,1195794,3727676,324,1.00
ptg006514l,1034778,1035070,292,EVM,mRNA,1029964,2015995,292,1.00
ptg006514l,1254560,1254873,313,EVM,mRNA,1029964,2015995,313,1.00
ptg006514l,1269445,1269732,287,EVM,mRNA,1029964,2015995,287,1.00
ptg006514l,1525229,1525566,337,EVM,mRNA,1029964,2015995,337,1.00
ptg006514l,1688003,1688290,287,EVM,mRNA,1029964,2015995,287,1.00
ptg006514l,1921319,1921647,328,EVM,mRNA,1029964,2015995,328,1.00
ptg006516l,1008310,1008605,295,EVM,mRNA,931359,2450961,295,1.00
ptg006516l,1273709,1274029,320,EVM,mRNA,931359,2450961,320,1.00
ptg006516l,2151530,2151806,276,EVM,mRNA,931359,2450961,276,1.00
ptg006516l,5187088,5187382,294,EVM,mRNA,5149053,5214571,294,1.00
ptg006520l,370994,371290,296,EVM,mRNA,308005,572672,296,1.00
ptg006522l,1524539,1524832,293,EVM,mRNA,1465499,1669529,293,1.00
ptg006522l,3781852,3782151,299,EVM,mRNA,3433703,3852556,299,1.00
ptg006524l,418210,418514,304,EVM,mRNA,8082,1401335,304,1.00
ptg006524l,2225910,2226246,336,EVM,mRNA,1900773,2631063,336,1.00
ptg006524l,2441800,2442092,292,EVM,mRNA,1900773,2631063,292,1.00
ptg006524l,3747825,3748135,310,EVM,mRNA,2992858,5244427,310,1.00
ptg006524l,4627457,4627756,299,EVM,mRNA,2992858,5244427,299,1.00
ptg006524l,5006348,5006675,327,EVM,mRNA,2992858,5244427,327,1.00
ptg006525l,692936,693269,333,EVM,mRNA,603066,823702,333,1.00
ptg006525l,2773058,2773357,299,EVM,mRNA,2635468,3011598,299,1.00
ptg006528l,199579,199898,319,EVM,mRNA,191878,363240,319,1.00
ptg006529l,1030293,1030586,293,EVM,mRNA,512587,1529325,293,1.00
ptg006530l,1632408,1632723,315,EVM,mRNA,1296669,1670855,315,1.00
ptg006531l,541227,541549,322,EVM,mRNA,441775,1309485,322,1.00
ptg006535l,196933,197230,297,EVM,mRNA,192233,237051,297,1.00
ptg006536l,2669072,2669401,329,EVM,mRNA,2547337,3010313,329,1.00
ptg006536l,2678146,2678436,290,EVM,mRNA,2547337,3010313,290,1.00
ptg006537l,574613,574879,266,EVM,mRNA,271583,611734,266,1.00
ptg006537l,1815546,1815846,300,EVM,mRNA,1692860,1983080,300,1.00
ptg006537l,3195778,3196104,326,EVM,mRNA,3143040,4586264,326,1.00
ptg006537l,6009761,6010036,275,EVM,mRNA,5408634,7668532,275,1.00
ptg006537l,6166000,6166314,314,EVM,mRNA,5408634,7668532,314,1.00
ptg006537l,6375882,6376195,313,EVM,mRNA,5408634,7668532,313,1.00
ptg006537l,7006444,7006721,277,EVM,mRNA,5408634,7668532,277,1.00
ptg006537l,7200944,7201226,282,EVM,mRNA,5408634,7668532,282,1.00
ptg006541l,716768,717094,326,EVM,mRNA,716217,952910,326,1.00
ptg006545l,1975269,1975540,271,EVM,mRNA,1355021,2037618,271,1.00
ptg006551l,868159,868476,317,EVM,mRNA,839458,906622,317,1.00
ptg006551l,1070403,1070702,299,EVM,mRNA,997420,1632074,299,1.00
ptg006551l,2990361,2990686,325,EVM,mRNA,2905254,4126131,325,1.00
ptg006551l,3565878,3566187,309,EVM,mRNA,2905254,4126131,309,1.00
ptg006551l,4004902,4005202,300,EVM,mRNA,2905254,4126131,300,1.00
ptg006555l,1972719,1973036,317,EVM,mRNA,1715246,3396858,317,1.00
ptg006555l,2078041,2078302,261,EVM,mRNA,1715246,3396858,261,1.00
ptg006555l,2257904,2258199,295,EVM,mRNA,1715246,3396858,295,1.00
ptg006555l,2310806,2311119,313,EVM,mRNA,1715246,3396858,313,1.00
ptg006555l,2696360,2696678,318,EVM,mRNA,1715246,3396858,318,1.00
ptg006557l,137883,138193,310,EVM,mRNA,137089,450206,310,1.00
ptg006564l,1823021,1823346,325,EVM,mRNA,1611438,2690008,325,1.00
ptg006564l,1836046,1836311,265,EVM,mRNA,1611438,2690008,265,1.00
ptg006564l,1960297,1960600,303,EVM,mRNA,1611438,2690008,303,1.00
ptg006564l,2072477,2072749,272,EVM,mRNA,1611438,2690008,272,1.00
ptg006564l,2124685,2125001,316,EVM,mRNA,1611438,2690008,316,1.00
ptg006564l,2270718,2271000,282,EVM,mRNA,1611438,2690008,282,1.00
ptg006565l,943700,943969,269,EVM,mRNA,825333,1387367,269,1.00
ptg006567l,240215,240522,307,EVM,mRNA,3668,454454,307,1.00
ptg006569l,1759697,1760022,325,EVM,mRNA,1654377,1808280,325,1.00
ptg006569l,1975125,1975417,292,EVM,mRNA,1855446,2930172,292,1.00
ptg006569l,1975125,1975417,292,GeneWise,mRNA,1855449,2939956,292,1.00
ptg006572l,500369,500692,323,EVM,mRNA,193246,521816,323,1.00
ptg006582l,1600197,1600470,273,EVM,mRNA,721531,1772778,273,1.00
ptg006582l,2133317,2133630,313,EVM,mRNA,1829938,2604011,313,1.00
ptg006582l,2203649,2203921,272,EVM,mRNA,1829938,2604011,272,1.00
ptg006583l,83011,83295,284,EVM,mRNA,31956,303197,284,1.00
ptg006583l,1845401,1845708,307,EVM,mRNA,425299,3346532,307,1.00
ptg006583l,2561674,2561962,288,EVM,mRNA,425299,3346532,288,1.00
ptg006583l,2849304,2849588,284,EVM,mRNA,425299,3346532,284,1.00
ptg006583l,3285818,3286131,313,EVM,mRNA,425299,3346532,313,1.00
ptg006584l,548872,549162,290,EVM,mRNA,459772,1408001,290,1.00
ptg006584l,978732,979015,283,EVM,mRNA,459772,1408001,283,1.00
ptg006588l,2572568,2572867,299,EVM,mRNA,2308551,2887482,299,1.00
ptg006588l,2806937,2807214,277,EVM,mRNA,2308551,2887482,277,1.00
ptg006589l,1529572,1529872,300,EVM,mRNA,1262616,2454457,300,1.00
ptg006590l,1825865,1826135,270,EVM,mRNA,1544747,2419240,270,1.00
ptg006590l,2345191,2345464,273,EVM,mRNA,1544747,2419240,273,1.00
ptg006592l,1830134,1830454,320,EVM,mRNA,258322,2232577,320,1.00
ptg006595l,1025033,1025304,271,EVM,mRNA,6314,1212700,271,1.00
ptg006595l,1150089,1150415,326,EVM,mRNA,6314,1212700,326,1.00
ptg006607l,355755,356066,311,EVM,mRNA,355710,4294911,311,1.00
ptg006607l,762822,763116,294,EVM,mRNA,355710,4294911,294,1.00
ptg006607l,1426052,1426307,255,EVM,mRNA,355710,4294911,255,1.00
ptg006607l,3138384,3138685,301,EVM,mRNA,355710,4294911,301,1.00
ptg006609l,1938803,1939128,325,EVM,mRNA,1768897,2364661,325,1.00
ptg006609l,2746317,2746647,330,EVM,mRNA,2558193,2958098,330,1.00
ptg006610l,802495,802823,328,EVM,mRNA,620368,1119442,328,1.00
ptg006610l,1078776,1079085,309,EVM,mRNA,620368,1119442,309,1.00
ptg006611l,444198,444520,322,EVM,mRNA,372397,688594,322,1.00
ptg006613l,1988517,1988802,285,EVM,mRNA,1850895,1999499,285,1.00
ptg006614l,1623499,1623794,295,EVM,mRNA,1379082,2189523,295,1.00
ptg006615l,993321,993627,306,EVM,mRNA,824501,1047848,306,1.00
ptg006617l,838712,839005,293,EVM,mRNA,696490,846035,293,1.00
ptg006618l,662841,663141,300,EVM,mRNA,147374,887301,300,1.00
ptg006619l,2051279,2051608,329,EVM,mRNA,1963271,2088059,329,1.00
ptg006620l,295300,295604,304,EVM,mRNA,291906,4773329,304,1.00
ptg006620l,624296,624595,299,EVM,mRNA,291906,4773329,299,1.00
ptg006620l,1054748,1055059,311,EVM,mRNA,291906,4773329,311,1.00
ptg006620l,1070621,1070957,336,EVM,mRNA,291906,4773329,336,1.00
ptg006620l,2026373,2026680,307,EVM,mRNA,291906,4773329,307,1.00
ptg006620l,3587367,3587683,316,EVM,mRNA,291906,4773329,316,1.00
ptg006620l,3693145,3693458,313,EVM,mRNA,291906,4773329,313,1.00
ptg006620l,3798236,3798508,272,EVM,mRNA,291906,4773329,272,1.00
ptg006623l,1888771,1889051,280,EVM,mRNA,1646824,2097946,280,1.00
ptg006623l,3253555,3253859,304,EVM,mRNA,3171560,3332574,304,1.00
ptg006630l,1548191,1548497,306,EVM,mRNA,822827,1623276,306,1.00
ptg006632l,72933,73236,303,EVM,mRNA,7684,687037,303,1.00
ptg006632l,492943,493243,300,EVM,mRNA,7684,687037,300,1.00
ptg006633l,209918,210217,299,EVM,mRNA,87079,765983,299,1.00
ptg006633l,2770340,2770678,338,EVM,mRNA,2626640,3771705,338,1.00
ptg006633l,2771941,2772237,296,EVM,mRNA,2626640,3771705,296,1.00
ptg006634l,1942803,1943080,277,EVM,mRNA,890683,2925025,277,1.00
ptg006634l,2421835,2422141,306,EVM,mRNA,890683,2925025,306,1.00
ptg006634l,2917367,2917677,310,EVM,mRNA,890683,2925025,310,1.00
ptg006638l,2509659,2509932,273,EVM,mRNA,1974158,2548455,273,1.00
ptg006638l,3121606,3121919,313,EVM,mRNA,2978709,4088060,313,1.00
ptg006638l,4069158,4069451,293,EVM,mRNA,2978709,4088060,293,1.00
ptg006639l,1461601,1461871,270,EVM,mRNA,212166,3349258,270,1.00
ptg006639l,1917081,1917381,300,EVM,mRNA,212166,3349258,300,1.00
ptg006639l,2244770,2245064,294,EVM,mRNA,212166,3349258,294,1.00
ptg006639l,2624824,2625137,313,EVM,mRNA,212166,3349258,313,1.00
ptg006639l,3344663,3344995,332,EVM,mRNA,212166,3349258,332,1.00
ptg006639l,4048660,4048981,321,EVM,mRNA,4022444,4068701,321,1.00
ptg006642l,217809,218096,287,EVM,mRNA,29859,1289882,287,1.00
ptg006654l,169410,169731,321,EVM,mRNA,113124,284821,321,1.00
ptg006654l,746565,746855,290,EVM,mRNA,477947,1590591,290,1.00
ptg006657l,711782,712055,273,EVM,mRNA,622556,2013818,273,1.00
ptg006657l,787472,787771,299,EVM,mRNA,622556,2013818,299,1.00
ptg006660l,3225164,3225466,302,EVM,mRNA,3224976,5084944,302,1.00
ptg006660l,3268546,3268843,297,EVM,mRNA,3224976,5084944,297,1.00
ptg006660l,3383847,3384154,307,EVM,mRNA,3224976,5084944,307,1.00
ptg006660l,3401400,3401686,286,EVM,mRNA,3224976,5084944,286,1.00
ptg006660l,3478016,3478338,322,EVM,mRNA,3224976,5084944,322,1.00
ptg006665l,64159,64458,299,EVM,mRNA,10221,292092,299,1.00
ptg006665l,1362715,1363011,296,EVM,mRNA,1196379,1396271,296,1.00
ptg006666l,1321487,1321775,288,EVM,mRNA,1007073,1372138,288,1.00
ptg006669l,624424,624713,289,EVM,mRNA,367846,1754709,289,1.00
ptg006669l,870904,871190,286,EVM,mRNA,367846,1754709,286,1.00
ptg006671l,684955,685269,314,EVM,mRNA,300114,1128980,314,1.00
ptg006671l,722508,722822,314,EVM,mRNA,300114,1128980,314,1.00
ptg006673l,984573,984872,299,EVM,mRNA,982002,1113194,299,1.00
ptg006674l,2271818,2272116,298,EVM,mRNA,2037530,2717665,298,1.00
ptg006684l,1200841,1201152,311,EVM,mRNA,153412,1346392,311,1.00
ptg006687l,525292,525587,295,EVM,mRNA,2794,831506,295,1.00
ptg006687l,827794,828126,332,EVM,mRNA,2794,831506,332,1.00
ptg006687l,2177658,2177937,279,EVM,mRNA,1026365,2394038,279,1.00
ptg006692l,660543,660820,277,EVM,mRNA,556439,799084,277,1.00
ptg006692l,720653,720940,287,EVM,mRNA,556439,799084,287,1.00
ptg006698l,126150,126434,284,EVM,mRNA,65308,1027440,284,1.00
ptg006698l,1475318,1475612,294,EVM,mRNA,1441376,1533354,294,1.00
ptg006699l,3603525,3603841,316,EVM,mRNA,3455296,4527806,316,1.00
ptg006704l,1761188,1761476,288,EVM,mRNA,1582982,2041390,288,1.00
ptg006706l,315097,315394,297,EVM,mRNA,77,1914628,297,1.00
ptg006706l,1853595,1853890,295,EVM,mRNA,77,1914628,295,1.00
ptg006707l,1172960,1173261,301,EVM,mRNA,1008401,1304275,301,1.00
ptg006708l,349727,350043,316,EVM,mRNA,276869,818812,316,1.00
ptg006709l,1274137,1274453,316,EVM,mRNA,1236956,1344812,316,1.00
ptg006709l,1473127,1473459,332,EVM,mRNA,1392596,2166712,332,1.00
ptg006709l,1944214,1944532,318,EVM,mRNA,1392596,2166712,318,1.00
ptg006709l,2371129,2371448,319,EVM,mRNA,2276944,2442611,319,1.00
ptg006710l,664254,664547,293,EVM,mRNA,634143,1496699,293,1.00
ptg006710l,1353255,1353546,291,EVM,mRNA,634143,1496699,291,1.00
ptg006711l,1354505,1354845,340,EVM,mRNA,895929,1769588,340,1.00
ptg006711l,3147074,3147350,276,EVM,mRNA,2000376,3544615,276,1.00
ptg006711l,3174476,3174757,281,EVM,mRNA,2000376,3544615,281,1.00
ptg006711l,3181600,3181893,293,EVM,mRNA,2000376,3544615,293,1.00
ptg006711l,3450628,3450967,339,EVM,mRNA,2000376,3544615,339,1.00
ptg006711l,4774930,4775223,293,EVM,mRNA,4065289,5024156,293,1.00
ptg006712l,1596585,1596859,274,EVM,mRNA,221213,3812258,274,1.00
ptg006712l,2289034,2289342,308,EVM,mRNA,221213,3812258,308,1.00
ptg006712l,4575136,4575433,297,EVM,mRNA,4148369,5257023,297,1.00
ptg006716l,2927126,2927415,289,EVM,mRNA,2302450,3039266,289,1.00
ptg006716l,3894548,3894862,314,EVM,mRNA,3751531,4235734,314,1.00
ptg006716l,4163102,4163349,247,EVM,mRNA,3751531,4235734,247,1.00
ptg006723l,230115,230377,262,EVM,mRNA,173396,2125533,262,1.00
ptg006723l,562534,562826,292,EVM,mRNA,173396,2125533,292,1.00
ptg006723l,736463,736744,281,EVM,mRNA,173396,2125533,281,1.00
ptg006723l,990618,990912,294,EVM,mRNA,173396,2125533,294,1.00
ptg006723l,1953793,1954101,308,EVM,mRNA,173396,2125533,308,1.00
ptg006723l,2062680,2062998,318,EVM,mRNA,173396,2125533,318,1.00
ptg006727l,959701,960041,340,EVM,mRNA,930730,2057169,340,1.00
ptg006727l,1511379,1511671,292,EVM,mRNA,930730,2057169,292,1.00
ptg006727l,1569632,1569960,328,EVM,mRNA,930730,2057169,328,1.00
ptg006728l,861991,862316,325,EVM,mRNA,47483,1306360,325,1.00
ptg006734l,815885,816178,293,EVM,mRNA,211278,895534,293,1.00
ptg006735l,1419005,1419270,265,EVM,mRNA,271174,1504201,265,1.00
ptg006737l,341449,341753,304,EVM,mRNA,61379,871252,304,1.00
ptg006737l,1429130,1429435,305,EVM,mRNA,1362654,3589387,305,1.00
ptg006737l,2105720,2106027,307,EVM,mRNA,1362654,3589387,307,1.00
ptg006737l,2233053,2233344,291,EVM,mRNA,1362654,3589387,291,1.00
ptg006737l,2951441,2951769,328,EVM,mRNA,1362654,3589387,328,1.00
ptg006737l,3157621,3157904,283,EVM,mRNA,1362654,3589387,283,1.00
ptg006738l,74948,75260,312,EVM,mRNA,33809,77261,312,1.00
ptg006738l,592544,592853,309,EVM,mRNA,386003,1152588,309,1.00
ptg006742l,3394691,3395003,312,EVM,mRNA,3379066,3451292,312,1.00
ptg006742l,4163284,4163565,281,EVM,mRNA,3874265,4188721,281,1.00
ptg006744l,393845,394165,320,EVM,mRNA,39677,817871,320,1.00
ptg006744l,471049,471377,328,EVM,mRNA,39677,817871,328,1.00
ptg006748l,344104,344405,301,EVM,mRNA,23758,437054,301,1.00
ptg006749l,661789,662068,279,EVM,mRNA,237783,751095,279,1.00
ptg006751l,110131,110430,299,EVM,mRNA,60666,132604,299,1.00
ptg006752l,655662,655965,303,EVM,mRNA,71627,815890,303,1.00
ptg006755l,3753983,3754281,298,EVM,mRNA,3404763,4377645,298,1.00
ptg006755l,4028233,4028540,307,EVM,mRNA,3404763,4377645,307,1.00
ptg006758l,339798,340123,325,EVM,mRNA,115926,1932322,325,1.00
ptg006758l,347988,348284,296,EVM,mRNA,115926,1932322,296,1.00
ptg006758l,393557,393858,301,EVM,mRNA,115926,1932322,301,1.00
ptg006758l,427901,428193,292,EVM,mRNA,115926,1932322,292,1.00
ptg006760l,513180,513442,262,EVM,mRNA,7761,1358339,262,1.00
ptg006760l,1155700,1156025,325,EVM,mRNA,7761,1358339,325,1.00
ptg006761l,1359799,1360134,335,EVM,mRNA,1349174,1925439,335,1.00
ptg006765l,938422,938705,283,EVM,mRNA,859864,1048434,283,1.00
ptg006767l,1453476,1453784,308,EVM,mRNA,156007,3216571,308,1.00
ptg006767l,2618864,2619156,292,EVM,mRNA,156007,3216571,292,1.00
ptg006771l,1118238,1118541,303,EVM,mRNA,967841,1397986,303,1.00
ptg006776l,845987,846279,292,EVM,mRNA,686063,940287,292,1.00
ptg006783l,25573,25880,307,EVM,mRNA,17710,118173,307,1.00
ptg006783l,783442,783734,292,EVM,mRNA,588309,1181840,292,1.00
ptg006786l,385644,385925,281,EVM,mRNA,239500,411427,281,1.00
ptg006787l,128332,128625,293,EVM,mRNA,27020,1244397,293,1.00
ptg006788l,107598,107912,314,EVM,mRNA,2895,339498,314,1.00
ptg006788l,210791,211095,304,EVM,mRNA,2895,339498,304,1.00
ptg006788l,3021675,3021977,302,EVM,mRNA,2975028,3113606,302,1.00
ptg006791l,219835,220166,331,EVM,mRNA,218984,236750,331,1.00
ptg006791l,235129,235402,273,EVM,mRNA,218984,236750,273,1.00
ptg006791l,828651,828963,312,EVM,mRNA,822006,1408782,312,1.00
ptg006794l,390239,390521,282,EVM,mRNA,177816,653998,282,1.00
ptg006796l,308729,309012,283,EVM,mRNA,48078,2122478,283,1.00
ptg006796l,1009910,1010217,307,EVM,mRNA,48078,2122478,307,1.00
ptg006797l,853210,853488,278,EVM,mRNA,710596,1375123,278,1.00
ptg006800l,1435596,1435915,319,EVM,mRNA,15206,2196871,319,1.00
ptg006802l,1150380,1150671,291,EVM,mRNA,1079381,1405459,291,1.00
ptg006802l,1727488,1727775,287,EVM,mRNA,1627212,2557856,287,1.00
ptg006802l,1744517,1744812,295,EVM,mRNA,1627212,2557856,295,1.00
ptg006803l,1172960,1173263,303,EVM,mRNA,846082,1555366,303,1.00
ptg006803l,1190666,1190968,302,EVM,mRNA,846082,1555366,302,1.00
ptg006804l,799380,799679,299,EVM,mRNA,663919,1151378,299,1.00
ptg006804l,1449931,1450254,323,EVM,mRNA,1226258,1565251,323,1.00
ptg006805l,828161,828442,281,EVM,mRNA,2808,907293,281,1.00
ptg006809l,257848,258132,284,EVM,mRNA,95597,292482,284,1.00
ptg006809l,269169,269483,314,EVM,mRNA,95597,292482,314,1.00
ptg006811l,1428698,1428997,299,EVM,mRNA,1331252,1649349,299,1.00
ptg006814l,1916268,1916556,288,EVM,mRNA,1893685,1997073,288,1.00
ptg006817l,1774221,1774520,299,EVM,mRNA,1617878,1783038,299,1.00
ptg006822l,3484036,3484357,321,EVM,mRNA,2803441,5269000,321,1.00
ptg006825l,2624543,2624868,325,EVM,mRNA,967967,3091244,325,1.00
ptg006826l,1492208,1492522,314,EVM,mRNA,545874,1939558,314,1.00
ptg006827l,900430,900744,314,EVM,mRNA,671034,979821,314,1.00
ptg006829l,551313,551607,294,EVM,mRNA,309166,969226,294,1.00
ptg006838l,44157,44486,329,EVM,mRNA,1405,905667,329,1.00
ptg006838l,388104,388376,272,EVM,mRNA,1405,905667,272,1.00
ptg006842l,625658,625978,320,EVM,mRNA,432705,938701,320,1.00
ptg006843l,279623,279948,325,EVM,mRNA,30836,1943078,325,1.00
ptg006843l,1673306,1673605,299,EVM,mRNA,30836,1943078,299,1.00
ptg006843l,1864314,1864631,317,EVM,mRNA,30836,1943078,317,1.00
ptg006843l,3127738,3128052,314,EVM,mRNA,2937765,4679841,314,1.00
ptg006844l,356710,357007,297,EVM,mRNA,267529,356930,220,0.74
ptg006844l,1276324,1276598,274,EVM,mRNA,1149468,1278348,274,1.00
ptg006845l,391712,392029,317,EVM,mRNA,194397,503899,317,1.00
ptg006846l,95250,95537,287,EVM,mRNA,17782,619984,287,1.00
ptg006846l,456524,456828,304,EVM,mRNA,17782,619984,304,1.00
ptg006858l,736694,736975,281,EVM,mRNA,547778,2367257,281,1.00
ptg006858l,929364,929668,304,EVM,mRNA,547778,2367257,304,1.00
ptg006859l,117141,117415,274,EVM,mRNA,968,860771,274,1.00
ptg006867l,367678,367964,286,EVM,mRNA,81020,536862,286,1.00
ptg006867l,816976,817312,336,EVM,mRNA,759776,852530,336,1.00
ptg006870l,715753,716076,323,EVM,mRNA,712718,1080423,323,1.00
ptg006870l,732450,732765,315,EVM,mRNA,712718,1080423,315,1.00
ptg006870l,1667134,1667437,303,EVM,mRNA,1328641,2489125,303,1.00
ptg006870l,2272577,2272862,285,EVM,mRNA,1328641,2489125,285,1.00
ptg006870l,2448147,2448454,307,EVM,mRNA,1328641,2489125,307,1.00
ptg006870l,2932811,2933145,334,EVM,mRNA,2727010,4368455,334,1.00
ptg006873l,808767,809076,309,EVM,mRNA,187507,1872325,309,1.00
ptg006873l,849942,850261,319,EVM,mRNA,187507,1872325,319,1.00
ptg006873l,1997608,1997882,274,EVM,mRNA,1955441,2088724,274,1.00
ptg006873l,2029889,2030190,301,EVM,mRNA,1955441,2088724,301,1.00
ptg006873l,2584962,2585254,292,EVM,mRNA,2438992,3612732,292,1.00
ptg006873l,2610001,2610302,301,EVM,mRNA,2438992,3612732,301,1.00
ptg006873l,3150907,3151200,293,EVM,mRNA,2438992,3612732,293,1.00
ptg006873l,3508983,3509266,283,EVM,mRNA,2438992,3612732,283,1.00
ptg006873l,4019317,4019597,280,EVM,mRNA,3962094,4574018,280,1.00
ptg006885l,29503,29794,291,EVM,mRNA,86,181452,291,1.00
ptg006888l,1020640,1020936,296,EVM,mRNA,446430,2270157,296,1.00
ptg006888l,1366344,1366637,293,EVM,mRNA,446430,2270157,293,1.00
ptg006888l,1468765,1469084,319,EVM,mRNA,446430,2270157,319,1.00
ptg006889l,389618,389907,289,EVM,mRNA,33527,482938,289,1.00
ptg006889l,1955380,1955692,312,EVM,mRNA,1825957,2792930,312,1.00
ptg006890l,434121,434456,335,EVM,mRNA,423823,501757,335,1.00
ptg006900l,3395709,3396030,321,EVM,mRNA,2953459,6035577,321,1.00
ptg006900l,3574386,3574693,307,EVM,mRNA,2953459,6035577,307,1.00
ptg006900l,4479952,4480262,310,EVM,mRNA,2953459,6035577,310,1.00
ptg006900l,5209902,5210166,264,EVM,mRNA,2953459,6035577,264,1.00
ptg006900l,5770899,5771226,327,EVM,mRNA,2953459,6035577,327,1.00
ptg006900l,6021346,6021633,287,EVM,mRNA,2953459,6035577,287,1.00
ptg006900l,8366088,8366389,301,EVM,mRNA,8122602,9760103,301,1.00
ptg006900l,9005755,9006076,321,EVM,mRNA,8122602,9760103,321,1.00
ptg006900l,9429540,9429851,311,EVM,mRNA,8122602,9760103,311,1.00
ptg006900l,10279313,10279598,285,EVM,mRNA,10050557,13100316,285,1.00
ptg006900l,12358149,12358468,319,EVM,mRNA,10050557,13100316,319,1.00
ptg006900l,12923495,12923765,270,EVM,mRNA,10050557,13100316,270,1.00
ptg006900l,16005919,16006213,294,EVM,mRNA,13718292,16731816,294,1.00
ptg006912l,460842,461133,291,EVM,mRNA,174219,867460,291,1.00
ptg006912l,533965,534247,282,EVM,mRNA,174219,867460,282,1.00
ptg006912l,589509,589809,300,EVM,mRNA,174219,867460,300,1.00
ptg006915l,540197,540517,320,EVM,mRNA,421210,1594137,320,1.00
ptg006915l,787127,787391,264,EVM,mRNA,421210,1594137,264,1.00
ptg006917l,461507,461782,275,EVM,mRNA,301806,1155628,275,1.00
ptg006917l,486016,486294,278,EVM,mRNA,301806,1155628,278,1.00
ptg006917l,897239,897539,300,EVM,mRNA,301806,1155628,300,1.00
ptg006921l,1668770,1669066,296,EVM,mRNA,1577803,1988558,296,1.00
ptg006921l,1872464,1872794,330,EVM,mRNA,1577803,1988558,330,1.00
ptg006922l,3482999,3483277,278,EVM,mRNA,3298320,3714839,278,1.00
ptg006923l,611810,612109,299,EVM,mRNA,237784,775123,299,1.00
ptg006928l,156259,156522,263,EVM,mRNA,593,609697,263,1.00
ptg006928l,461067,461389,322,EVM,mRNA,593,609697,322,1.00
ptg006929l,737261,737551,290,EVM,mRNA,11205,925339,290,1.00
ptg006932l,1490653,1490971,318,EVM,mRNA,859999,1730721,318,1.00
ptg006933l,3660489,3660776,287,EVM,mRNA,3494417,3734820,287,1.00
ptg006935l,2079493,2079795,302,EVM,mRNA,570907,2540988,302,1.00
ptg006935l,3046865,3047145,280,EVM,mRNA,2889175,3395923,280,1.00
ptg006936l,1236315,1236613,298,EVM,mRNA,1123657,1335150,298,1.00
ptg006937l,1005785,1006102,317,EVM,mRNA,56494,1420849,317,1.00
ptg006937l,1267384,1267675,291,EVM,mRNA,56494,1420849,291,1.00
ptg006939l,1013938,1014238,300,EVM,mRNA,452508,1238186,300,1.00
ptg006939l,1168205,1168500,295,EVM,mRNA,452508,1238186,295,1.00
ptg006939l,1184409,1184692,283,EVM,mRNA,452508,1238186,283,1.00
ptg006939l,1934722,1934994,272,EVM,mRNA,1495891,2315858,272,1.00
ptg006942l,3249476,3249768,292,EVM,mRNA,3099805,3278887,292,1.00
ptg006943l,412876,413181,305,EVM,mRNA,5523,660308,305,1.00
ptg006943l,547659,547958,299,EVM,mRNA,5523,660308,299,1.00
ptg006944l,273076,273403,327,EVM,mRNA,33382,477302,327,1.00
ptg006944l,1194164,1194492,328,EVM,mRNA,853564,1451081,328,1.00
ptg006944l,1710205,1710494,289,EVM,mRNA,1637264,3956272,289,1.00
ptg006945l,1122965,1123280,315,EVM,mRNA,1109980,1359030,315,1.00
ptg006945l,1190319,1190603,284,EVM,mRNA,1109980,1359030,284,1.00
ptg006948l,454412,454676,264,EVM,mRNA,294539,1463998,264,1.00
ptg006949l,1854075,1854353,278,EVM,mRNA,1813836,1952184,278,1.00
ptg006950l,1544861,1545175,314,EVM,mRNA,1192052,1567617,314,1.00
ptg006952l,625186,625502,316,EVM,mRNA,459260,3565629,316,1.00
ptg006952l,1181798,1182110,312,EVM,mRNA,459260,3565629,312,1.00
ptg006952l,1431896,1432216,320,EVM,mRNA,459260,3565629,320,1.00
ptg006952l,3284011,3284314,303,EVM,mRNA,459260,3565629,303,1.00
ptg006956l,531617,531941,324,EVM,mRNA,508275,532639,324,1.00
ptg006960l,564554,564855,301,EVM,mRNA,331899,995111,301,1.00
ptg006964l,111226,111512,286,EVM,mRNA,16242,996727,286,1.00
ptg006964l,334064,334375,311,EVM,mRNA,16242,996727,311,1.00
ptg006964l,672671,672953,282,EVM,mRNA,16242,996727,282,1.00
ptg006970l,617392,617725,333,EVM,mRNA,595318,743683,333,1.00
ptg006974l,1003370,1003689,319,EVM,mRNA,709439,1109978,319,1.00
ptg006974l,1172735,1173035,300,EVM,mRNA,1118572,1235014,300,1.00
ptg006981l,521971,522242,271,EVM,mRNA,173606,569996,271,1.00
ptg006981l,773991,774318,327,EVM,mRNA,642413,985377,327,1.00
ptg006981l,822025,822342,317,EVM,mRNA,642413,985377,317,1.00
ptg006984l,674844,675108,264,EVM,mRNA,640497,683777,264,1.00
ptg006988l,88662,88953,291,EVM,mRNA,65090,478231,291,1.00
ptg006988l,1194535,1194850,315,EVM,mRNA,908443,1207944,315,1.00
ptg006992l,577482,577792,310,EVM,mRNA,66075,756287,310,1.00
ptg006993l,530823,531135,312,EVM,mRNA,282671,635406,312,1.00
ptg006993l,1114350,1114615,265,EVM,mRNA,825081,1119817,265,1.00
ptg006994l,1377849,1378102,253,EVM,mRNA,1037601,1768143,253,1.00
ptg006994l,1647675,1647980,305,EVM,mRNA,1037601,1768143,305,1.00
ptg006998l,287080,287394,314,EVM,mRNA,275007,486664,314,1.00
ptg007002l,125092,125407,315,EVM,mRNA,20036,1282825,315,1.00
ptg007002l,644083,644379,296,EVM,mRNA,20036,1282825,296,1.00
ptg007002l,827350,827646,296,EVM,mRNA,20036,1282825,296,1.00
ptg007004l,50787,51107,320,EVM,mRNA,502,503953,320,1.00
ptg007004l,3686575,3686892,317,EVM,mRNA,3675398,3957123,317,1.00
ptg007004l,4664364,4664637,273,EVM,mRNA,4439857,4990676,273,1.00
ptg007004l,4930851,4931133,282,EVM,mRNA,4439857,4990676,282,1.00
ptg007005l,2219289,2219609,320,EVM,mRNA,2210407,2352748,320,1.00
ptg007014l,1618722,1619014,292,EVM,mRNA,1286932,1623770,292,1.00
ptg007017l,1980814,1981096,282,EVM,mRNA,1927926,1991830,282,1.00
ptg007019l,329607,329891,284,EVM,mRNA,7944,339605,284,1.00
ptg007019l,335516,335835,319,EVM,mRNA,7944,339605,319,1.00
ptg007020l,1269072,1269356,284,EVM,mRNA,259877,3963614,284,1.00
ptg007020l,3099667,3099976,309,EVM,mRNA,259877,3963614,309,1.00
ptg007020l,3132241,3132557,316,EVM,mRNA,259877,3963614,316,1.00
ptg007020l,3486021,3486300,279,EVM,mRNA,259877,3963614,279,1.00
ptg007021l,2818561,2818870,309,EVM,mRNA,2694464,2930480,309,1.00
ptg007021l,4163820,4164087,267,EVM,mRNA,3828521,5838566,267,1.00
ptg007021l,4644245,4644540,295,EVM,mRNA,3828521,5838566,295,1.00
ptg007021l,5322205,5322512,307,EVM,mRNA,3828521,5838566,307,1.00
ptg007024l,45898,46205,307,EVM,mRNA,25838,2817322,307,1.00
ptg007024l,197835,198122,287,EVM,mRNA,25838,2817322,287,1.00
ptg007024l,515720,515992,272,EVM,mRNA,25838,2817322,272,1.00
ptg007028l,373537,373834,297,EVM,mRNA,370511,398882,297,1.00
ptg007036l,446172,446475,303,EVM,mRNA,18632,1459584,303,1.00
ptg007036l,554160,554474,314,EVM,mRNA,18632,1459584,314,1.00
ptg007037l,691349,691638,289,EVM,mRNA,597957,2811367,289,1.00
ptg007037l,867162,867471,309,EVM,mRNA,597957,2811367,309,1.00
ptg007040l,165148,165426,278,EVM,mRNA,151707,303536,278,1.00
ptg007040l,176858,177158,300,EVM,mRNA,151707,303536,300,1.00
ptg007040l,1127738,1128028,290,EVM,mRNA,351375,1986074,290,1.00
ptg007040l,4938626,4938943,317,EVM,mRNA,4937219,5114885,317,1.00
ptg007044l,2127638,2127914,276,EVM,mRNA,1863504,2477948,276,1.00
ptg007049l,1181815,1182128,313,EVM,mRNA,1100103,1771581,313,1.00
ptg007053l,2249776,2250105,329,EVM,mRNA,2173380,3169689,329,1.00
ptg007053l,2764397,2764715,318,EVM,mRNA,2173380,3169689,318,1.00
ptg007057l,246941,247249,308,EVM,mRNA,116809,370297,308,1.00
ptg007060l,177269,177563,294,EVM,mRNA,115456,329406,294,1.00
ptg007060l,313437,313748,311,EVM,mRNA,115456,329406,311,1.00
ptg007060l,2449090,2449389,299,EVM,mRNA,1974821,2576081,299,1.00
ptg007061l,188327,188649,322,EVM,mRNA,56919,1557942,322,1.00
ptg007065l,1231297,1231612,315,EVM,mRNA,1033990,2896894,315,1.00
ptg007065l,1378254,1378550,296,EVM,mRNA,1033990,2896894,296,1.00
ptg007065l,1714080,1714376,296,EVM,mRNA,1033990,2896894,296,1.00
ptg007065l,2060833,2061162,329,EVM,mRNA,1033990,2896894,329,1.00
ptg007065l,2837044,2837343,299,EVM,mRNA,1033990,2896894,299,1.00
ptg007068l,1970335,1970644,309,EVM,mRNA,1644845,1996141,309,1.00
ptg007073l,128401,128720,319,EVM,mRNA,57780,180433,319,1.00
ptg007078l,464843,465140,297,EVM,mRNA,189238,803354,297,1.00
ptg007078l,785323,785638,315,EVM,mRNA,189238,803354,315,1.00
ptg007078l,1449684,1449975,291,EVM,mRNA,851913,1541779,291,1.00
ptg007081l,783326,783648,322,EVM,mRNA,24447,1317531,322,1.00
ptg007086l,426940,427238,298,EVM,mRNA,358823,1367569,298,1.00
ptg007086l,711032,711324,292,EVM,mRNA,358823,1367569,292,1.00
ptg007086l,1177509,1177824,315,EVM,mRNA,358823,1367569,315,1.00
ptg007086l,2809581,2809873,292,EVM,mRNA,2770091,3496576,292,1.00
ptg007086l,3531803,3532071,268,EVM,mRNA,3531959,3820060,113,0.42
ptg007087l,111410,111721,311,EVM,mRNA,36070,734592,311,1.00
ptg007088l,2896446,2896730,284,EVM,mRNA,2221706,3088801,284,1.00
ptg007094l,147942,148257,315,EVM,mRNA,14511,806805,315,1.00
ptg007097l,221003,221321,318,EVM,mRNA,117229,746383,318,1.00
ptg007097l,502210,502517,307,EVM,mRNA,117229,746383,307,1.00
ptg007098l,76090,76397,307,EVM,mRNA,57651,515896,307,1.00
ptg007099l,639521,639776,255,EVM,mRNA,458450,4532142,255,1.00
ptg007099l,2534843,2535158,315,EVM,mRNA,458450,4532142,315,1.00
ptg007099l,3404820,3405115,295,EVM,mRNA,458450,4532142,295,1.00
ptg007100l,338768,339059,291,EVM,mRNA,113019,419820,291,1.00
ptg007100l,356532,356828,296,EVM,mRNA,113019,419820,296,1.00
ptg007101l,185526,185843,317,EVM,mRNA,110789,1148740,317,1.00
ptg007101l,431535,431832,297,EVM,mRNA,110789,1148740,297,1.00
ptg007101l,1433093,1433404,311,EVM,mRNA,1245547,2828538,311,1.00
ptg007101l,1770836,1771137,301,EVM,mRNA,1245547,2828538,301,1.00
ptg007102l,479477,479768,291,EVM,mRNA,154012,910318,291,1.00
ptg007102l,872540,872824,284,EVM,mRNA,154012,910318,284,1.00
ptg007107l,1175103,1175388,285,EVM,mRNA,203900,1490725,285,1.00
ptg007112l,776823,777121,298,EVM,mRNA,14491,1097930,298,1.00
ptg007114l,312918,313233,315,EVM,mRNA,132718,610483,315,1.00
ptg007114l,599697,600006,309,EVM,mRNA,132718,610483,309,1.00
ptg007114l,793035,793334,299,EVM,mRNA,670730,834137,299,1.00
ptg007116l,1555171,1555462,291,EVM,mRNA,232704,1791658,291,1.00
ptg007119l,696802,697114,312,EVM,mRNA,556884,1885659,312,1.00
ptg007119l,1383528,1383842,314,EVM,mRNA,556884,1885659,314,1.00
ptg007119l,1748936,1749230,294,EVM,mRNA,556884,1885659,294,1.00
ptg007120l,2064015,2064283,268,EVM,mRNA,1015556,2186219,268,1.00
ptg007125l,218219,218528,309,EVM,mRNA,103246,889037,309,1.00
ptg007131l,4163059,4163375,316,EVM,mRNA,3561815,4218807,316,1.00
ptg007138l,1034965,1035286,321,EVM,mRNA,970766,1332253,321,1.00
ptg007143l,2138843,2139129,286,EVM,mRNA,2067150,2364148,286,1.00
ptg007143l,2557875,2558179,304,EVM,mRNA,2539720,2937601,304,1.00
ptg007143l,3841910,3842209,299,EVM,mRNA,3486615,4093684,299,1.00
ptg007143l,6276947,6277241,294,EVM,mRNA,4721229,6421696,294,1.00
ptg007148l,1448144,1448460,316,EVM,mRNA,1273988,1573341,316,1.00
ptg007148l,1898645,1898960,315,EVM,mRNA,1894461,2189370,315,1.00
ptg007148l,3170625,3170912,287,EVM,mRNA,2429652,3371324,287,1.00
ptg007148l,3287915,3288202,287,EVM,mRNA,2429652,3371324,287,1.00
ptg007152l,446179,446476,297,EVM,mRNA,429229,1821574,297,1.00
ptg007152l,447164,447485,321,EVM,mRNA,429229,1821574,321,1.00
ptg007162l,541192,541489,297,EVM,mRNA,396568,541888,297,1.00
ptg007162l,2972581,2972866,285,EVM,mRNA,2869949,2984451,285,1.00
ptg007168l,285436,285730,294,EVM,mRNA,11830,369692,294,1.00
ptg007169l,85748,86063,315,EVM,mRNA,61368,846722,315,1.00
ptg007171l,1148855,1149176,321,EVM,mRNA,188742,1302745,321,1.00
ptg007171l,1810922,1811218,296,EVM,mRNA,1658222,1957945,296,1.00
ptg007171l,1818081,1818362,281,EVM,mRNA,1658222,1957945,281,1.00
ptg007171l,2644317,2644597,280,EVM,mRNA,2299489,3372710,280,1.00
ptg007172l,903270,903571,301,EVM,mRNA,887012,937156,301,1.00
ptg007175l,635644,635956,312,EVM,mRNA,157792,945708,312,1.00
ptg007178l,615270,615569,299,EVM,mRNA,6886,835907,299,1.00
ptg007178l,657914,658207,293,EVM,mRNA,6886,835907,293,1.00
ptg007180l,335931,336247,316,EVM,mRNA,272799,503030,316,1.00
ptg007181l,3850891,3851144,253,EVM,mRNA,3708307,4195804,253,1.00
ptg007182l,998328,998601,273,EVM,mRNA,994394,1160299,273,1.00
ptg007187l,2492070,2492408,338,EVM,mRNA,1930096,2535440,338,1.00
ptg007189l,955321,955605,284,EVM,mRNA,121001,1299267,284,1.00
ptg007190l,1316025,1316320,295,EVM,mRNA,661330,1503846,295,1.00
ptg007190l,1743856,1744163,307,EVM,mRNA,1698936,2277302,307,1.00
ptg007198l,972968,973288,320,EVM,mRNA,492856,2902987,320,1.00
ptg007198l,1972796,1973086,290,EVM,mRNA,492856,2902987,290,1.00
ptg007200l,369001,369336,335,EVM,mRNA,64971,433794,335,1.00
ptg007204l,2436837,2437130,293,EVM,mRNA,2190891,2694987,293,1.00
ptg007204l,2595942,2596257,315,EVM,mRNA,2190891,2694987,315,1.00
ptg007205l,513206,513536,330,EVM,mRNA,416329,724581,330,1.00
ptg007207l,584152,584447,295,EVM,mRNA,224,903365,295,1.00
ptg007207l,686122,686425,303,EVM,mRNA,224,903365,303,1.00
ptg007211l,2052051,2052367,316,EVM,mRNA,1926730,2118573,316,1.00
ptg007212l,646144,646479,335,EVM,mRNA,341286,1564489,335,1.00
ptg007216l,1535316,1535644,328,EVM,mRNA,1510779,1584902,328,1.00
ptg007218l,221452,221749,297,EVM,mRNA,61783,3536657,297,1.00
ptg007218l,1029822,1030125,303,EVM,mRNA,61783,3536657,303,1.00
ptg007218l,1374880,1375209,329,EVM,mRNA,61783,3536657,329,1.00
ptg007218l,2710961,2711246,285,EVM,mRNA,61783,3536657,285,1.00
ptg007218l,2721240,2721538,298,EVM,mRNA,61783,3536657,298,1.00
ptg007218l,3339472,3339763,291,EVM,mRNA,61783,3536657,291,1.00
ptg007219l,767168,767467,299,EVM,mRNA,29595,2377573,299,1.00
ptg007219l,1353289,1353588,299,EVM,mRNA,29595,2377573,299,1.00
ptg007221l,377070,377357,287,EVM,mRNA,365708,447782,287,1.00
ptg007228l,1736966,1737295,329,EVM,mRNA,1678398,1770410,329,1.00
ptg007228l,3154025,3154324,299,EVM,mRNA,1787568,3506757,299,1.00
ptg007228l,3436356,3436655,299,EVM,mRNA,1787568,3506757,299,1.00
ptg007229l,2423391,2423678,287,EVM,mRNA,1794824,3098413,287,1.00
ptg007238l,783519,783810,291,EVM,mRNA,744910,784610,291,1.00
ptg007238l,1752732,1753038,306,EVM,mRNA,1580917,2150658,306,1.00
ptg007241l,1122083,1122370,287,EVM,mRNA,702762,1210564,287,1.00
ptg007243l,315021,315316,295,EVM,mRNA,164707,416047,295,1.00
ptg007243l,868181,868473,292,EVM,mRNA,520108,1104703,292,1.00
ptg007243l,1478876,1479176,300,EVM,mRNA,1458671,1592690,300,1.00
ptg007243l,1543864,1544164,300,EVM,mRNA,1458671,1592690,300,1.00
ptg007243l,1586339,1586638,299,EVM,mRNA,1458671,1592690,299,1.00
ptg007244l,410184,410492,308,EVM,mRNA,300198,771820,308,1.00
ptg007250l,1228469,1228780,311,EVM,mRNA,67007,1903025,311,1.00
ptg007250l,1510504,1510789,285,EVM,mRNA,67007,1903025,285,1.00
ptg007260l,1386426,1386727,301,EVM,mRNA,72926,1932081,301,1.00
ptg007267l,897729,898021,292,EVM,mRNA,532,1092559,292,1.00
ptg007269l,270948,271246,298,EVM,mRNA,173,884710,298,1.00
ptg007273l,3204262,3204561,299,EVM,mRNA,2985793,3516946,299,1.00
ptg007273l,3340834,3341118,284,EVM,mRNA,2985793,3516946,284,1.00
ptg007276l,213203,213499,296,EVM,mRNA,72920,1673094,296,1.00
ptg007276l,3002199,3002478,279,EVM,mRNA,2680286,4322517,279,1.00
ptg007276l,3186859,3187188,329,EVM,mRNA,2680286,4322517,329,1.00
ptg007276l,3805490,3805781,291,EVM,mRNA,2680286,4322517,291,1.00
ptg007276l,4284409,4284683,274,EVM,mRNA,2680286,4322517,274,1.00
ptg007277l,1432751,1433042,291,EVM,mRNA,1312730,1661238,291,1.00
ptg007279l,365512,365821,309,EVM,mRNA,161198,480946,309,1.00
ptg007280l,602904,603201,297,EVM,mRNA,582870,639572,297,1.00
ptg007281l,198473,198792,319,EVM,mRNA,7622,277903,319,1.00
ptg007285l,333465,333774,309,EVM,mRNA,290135,521950,309,1.00
ptg007287l,1374288,1374615,327,EVM,mRNA,1168741,1462249,327,1.00
ptg007287l,1437191,1437463,272,EVM,mRNA,1168741,1462249,272,1.00
ptg007287l,1446531,1446842,311,EVM,mRNA,1168741,1462249,311,1.00
ptg007288l,193185,193483,298,EVM,mRNA,5380,1340378,298,1.00
ptg007290l,630825,631133,308,EVM,mRNA,15769,730770,308,1.00
ptg007292l,663285,663597,312,EVM,mRNA,606995,842708,312,1.00
ptg007295l,2460763,2461066,303,EVM,mRNA,2250269,2609446,303,1.00
ptg007301l,2585579,2585874,295,EVM,mRNA,530379,3684962,295,1.00
ptg007302l,2037674,2037969,295,EVM,mRNA,735578,2537950,295,1.00
ptg007309l,227102,227396,294,EVM,mRNA,109364,1536727,294,1.00
ptg007313l,586707,586999,292,EVM,mRNA,485842,715195,292,1.00
ptg007313l,673850,674158,308,EVM,mRNA,485842,715195,308,1.00
ptg007315l,596389,596705,316,EVM,mRNA,64350,2306724,316,1.00
ptg007316l,1587152,1587450,298,EVM,mRNA,1268660,3493616,298,1.00
ptg007316l,2766698,2766986,288,EVM,mRNA,1268660,3493616,288,1.00
ptg007316l,3356187,3356468,281,EVM,mRNA,1268660,3493616,281,1.00
ptg007317l,362095,362399,304,EVM,mRNA,361848,458103,304,1.00
ptg007319l,345188,345473,285,EVM,mRNA,325817,742472,285,1.00
ptg007319l,1037818,1038129,311,EVM,mRNA,953505,1090460,311,1.00
ptg007321l,804834,805111,277,EVM,mRNA,178530,864492,277,1.00
ptg007327l,927436,927748,312,EVM,mRNA,8781,1108706,312,1.00
ptg007327l,1258719,1259008,289,EVM,mRNA,1227094,1329193,289,1.00
ptg007332l,673270,673585,315,EVM,mRNA,257506,2718371,315,1.00
ptg007332l,1008152,1008454,302,EVM,mRNA,257506,2718371,302,1.00
ptg007332l,2093389,2093655,266,EVM,mRNA,257506,2718371,266,1.00
ptg007332l,2587002,2587283,281,EVM,mRNA,257506,2718371,281,1.00
ptg007334l,1005351,1005634,283,EVM,mRNA,173392,1654833,283,1.00
ptg007337l,78777,79082,305,EVM,mRNA,834,1881121,305,1.00
ptg007337l,325129,325440,311,EVM,mRNA,834,1881121,311,1.00
ptg007337l,579351,579641,290,EVM,mRNA,834,1881121,290,1.00
ptg007337l,625426,625726,300,EVM,mRNA,834,1881121,300,1.00
ptg007337l,780732,781046,314,EVM,mRNA,834,1881121,314,1.00
ptg007337l,1625009,1625328,319,EVM,mRNA,834,1881121,319,1.00
ptg007338l,112848,113172,324,EVM,mRNA,29883,302820,324,1.00
ptg007341l,1147681,1147976,295,EVM,mRNA,1110685,1169483,295,1.00
ptg007343l,692596,692906,310,EVM,mRNA,684315,1008489,310,1.00
ptg007349l,850177,850497,320,EVM,mRNA,347959,2515571,320,1.00
ptg007349l,1115941,1116268,327,EVM,mRNA,347959,2515571,327,1.00
ptg007349l,1550727,1551052,325,EVM,mRNA,347959,2515571,325,1.00
ptg007349l,2109183,2109437,254,EVM,mRNA,347959,2515571,254,1.00
ptg007349l,3138803,3139105,302,EVM,mRNA,3138183,3140423,302,1.00
ptg007355l,2566183,2566511,328,EVM,mRNA,887809,2696542,328,1.00
ptg007355l,3660382,3660690,308,EVM,mRNA,3580522,3783320,308,1.00
ptg007356l,551730,551992,262,EVM,mRNA,60005,689234,262,1.00
ptg007356l,588180,588491,311,EVM,mRNA,60005,689234,311,1.00
ptg007356l,3133196,3133495,299,EVM,mRNA,2435953,3289649,299,1.00
ptg007357l,368864,369159,295,EVM,mRNA,181268,730934,295,1.00
ptg007359l,785694,785978,284,EVM,mRNA,536620,827921,284,1.00
ptg007359l,1173899,1174198,299,EVM,mRNA,1137254,1570490,299,1.00
ptg007359l,1454031,1454318,287,EVM,mRNA,1137254,1570490,287,1.00
ptg007360l,1000392,1000707,315,EVM,mRNA,996424,1343385,315,1.00
ptg007361l,50360,50642,282,EVM,mRNA,40552,2098628,282,1.00
ptg007362l,1971632,1971957,325,EVM,mRNA,494866,2738122,325,1.00
ptg007362l,2526481,2526778,297,EVM,mRNA,494866,2738122,297,1.00
ptg007368l,187744,188054,310,EVM,mRNA,60775,489471,310,1.00
ptg007369l,1411052,1411374,322,EVM,mRNA,750420,1889040,322,1.00
ptg007375l,4088663,4088929,266,EVM,mRNA,3338749,5491145,266,1.00
ptg007375l,4458402,4458696,294,EVM,mRNA,3338749,5491145,294,1.00
ptg007375l,6900512,6900823,311,EVM,mRNA,6543867,7549624,311,1.00
ptg007376l,611970,612285,315,EVM,mRNA,472795,905960,315,1.00
ptg007376l,1943980,1944310,330,EVM,mRNA,1282544,1973392,330,1.00
ptg007376l,2472773,2473084,311,EVM,mRNA,2238396,3854956,311,1.00
ptg007376l,2649076,2649380,304,EVM,mRNA,2238396,3854956,304,1.00
ptg007376l,2787990,2788320,330,EVM,mRNA,2238396,3854956,330,1.00
ptg007376l,3031402,3031690,288,EVM,mRNA,2238396,3854956,288,1.00
ptg007376l,3632280,3632572,292,EVM,mRNA,2238396,3854956,292,1.00
ptg007388l,1535622,1535909,287,EVM,mRNA,200403,1743631,287,1.00
ptg007390l,1048173,1048459,286,EVM,mRNA,689125,1126479,286,1.00
ptg007390l,2059514,2059827,313,EVM,mRNA,2008866,2090981,313,1.00
ptg007395l,1189701,1190027,326,EVM,mRNA,184381,1759834,326,1.00
ptg007395l,1360970,1361287,317,EVM,mRNA,184381,1759834,317,1.00
ptg007396l,1795841,1796137,296,EVM,mRNA,1458768,2553954,296,1.00
ptg007397l,3629812,3630108,296,EVM,mRNA,3020635,4991737,296,1.00
ptg007397l,4185184,4185443,259,EVM,mRNA,3020635,4991737,259,1.00
ptg007400l,771605,771885,280,EVM,mRNA,632157,1077809,280,1.00
ptg007400l,788251,788536,285,EVM,mRNA,632157,1077809,285,1.00
ptg007402l,556574,556892,318,EVM,mRNA,501068,644196,318,1.00
ptg007403l,1266,1565,299,EVM,mRNA,376,772637,299,1.00
ptg007403l,1152659,1152961,302,EVM,mRNA,1151308,1153482,302,1.00
ptg007406l,524968,525247,279,EVM,mRNA,374831,1265331,279,1.00
ptg007406l,730898,731177,279,EVM,mRNA,374831,1265331,279,1.00
ptg007406l,969086,969394,308,EVM,mRNA,374831,1265331,308,1.00
ptg007410l,741774,742074,300,EVM,mRNA,97260,1116850,300,1.00
ptg007410l,3117123,3117405,282,EVM,mRNA,2906193,3119383,282,1.00
ptg007411l,401467,401744,277,EVM,mRNA,198441,529703,277,1.00
ptg007421l,156494,156827,333,EVM,mRNA,10997,415197,333,1.00
ptg007421l,2112942,2113257,315,EVM,mRNA,666838,2316646,315,1.00
ptg007421l,2257653,2257932,279,EVM,mRNA,666838,2316646,279,1.00
ptg007424l,384875,385142,267,EVM,mRNA,50,1028641,267,1.00
ptg007424l,582363,582673,310,EVM,mRNA,50,1028641,310,1.00
ptg007424l,758002,758276,274,EVM,mRNA,50,1028641,274,1.00
ptg007424l,886731,887052,321,EVM,mRNA,50,1028641,321,1.00
ptg007424l,891890,892179,289,EVM,mRNA,50,1028641,289,1.00
ptg007424l,902410,902708,298,EVM,mRNA,50,1028641,298,1.00
ptg007424l,970609,970926,317,EVM,mRNA,50,1028641,317,1.00
ptg007433l,149715,150029,314,EVM,mRNA,73599,221142,314,1.00
ptg007436l,591356,591656,300,EVM,mRNA,284495,686725,300,1.00
ptg007436l,1281681,1281977,296,EVM,mRNA,829268,1345438,296,1.00
ptg007436l,2110744,2111053,309,GeneWise,mRNA,1893108,2156519,309,1.00
ptg007437l,497711,498010,299,EVM,mRNA,332180,1507373,299,1.00
ptg007437l,634651,634966,315,EVM,mRNA,332180,1507373,315,1.00
ptg007437l,649506,649821,315,EVM,mRNA,332180,1507373,315,1.00
ptg007437l,852753,853052,299,EVM,mRNA,332180,1507373,299,1.00
ptg007439l,6728086,6728418,332,EVM,mRNA,4308874,7143874,332,1.00
ptg007439l,7881665,7881964,299,EVM,mRNA,7496640,8159654,299,1.00
ptg007439l,8043135,8043449,314,EVM,mRNA,7496640,8159654,314,1.00
ptg007439l,10341030,10341361,331,EVM,mRNA,10153590,10344184,331,1.00
ptg007440l,280349,280664,315,EVM,mRNA,172177,452602,315,1.00
ptg007440l,404928,405247,319,EVM,mRNA,172177,452602,319,1.00
ptg007441l,350823,351097,274,EVM,mRNA,22649,904957,274,1.00
ptg007441l,708993,709315,322,EVM,mRNA,22649,904957,322,1.00
ptg007442l,83913,84208,295,EVM,mRNA,24043,366971,295,1.00
ptg007442l,111080,111377,297,EVM,mRNA,24043,366971,297,1.00
ptg007442l,1026728,1027035,307,EVM,mRNA,1023448,1588137,307,1.00
ptg007442l,1508865,1509178,313,EVM,mRNA,1023448,1588137,313,1.00
ptg007451l,658030,658324,294,EVM,mRNA,16162,871354,294,1.00
ptg007455l,638712,638993,281,EVM,mRNA,559138,825280,281,1.00
ptg007458l,150576,150863,287,EVM,mRNA,64683,182030,287,1.00
ptg007461l,3465829,3466145,316,EVM,mRNA,3414182,3968788,316,1.00
ptg007461l,3773761,3774073,312,EVM,mRNA,3414182,3968788,312,1.00
ptg007464l,280826,281132,306,EVM,mRNA,72522,324266,306,1.00
ptg007465l,1252136,1252450,314,EVM,mRNA,524316,1274897,314,1.00
ptg007471l,1195923,1196239,316,EVM,mRNA,444657,1322750,316,1.00
ptg007472l,538359,538679,320,EVM,mRNA,448453,1087746,320,1.00
ptg007472l,641863,642152,289,EVM,mRNA,448453,1087746,289,1.00
ptg007472l,3620323,3620616,293,EVM,mRNA,1976426,5132636,293,1.00
ptg007472l,4161227,4161538,311,EVM,mRNA,1976426,5132636,311,1.00
ptg007473l,3385818,3386114,296,EVM,mRNA,3252659,5112004,296,1.00
ptg007473l,4256626,4256906,280,EVM,mRNA,3252659,5112004,280,1.00
ptg007474l,760039,760344,305,EVM,mRNA,426679,1690838,305,1.00
ptg007476l,197334,197639,305,EVM,mRNA,118588,558182,305,1.00
ptg007479l,100530,100778,248,EVM,mRNA,3004,798528,248,1.00
ptg007479l,360429,360723,294,EVM,mRNA,3004,798528,294,1.00
ptg007479l,572987,573296,309,EVM,mRNA,3004,798528,309,1.00
ptg007479l,650863,651173,310,EVM,mRNA,3004,798528,310,1.00
ptg007483l,2273148,2273421,273,EVM,mRNA,1799528,2503368,273,1.00
ptg007488l,1488219,1488553,334,EVM,mRNA,329038,2888122,334,1.00
ptg007488l,2685465,2685766,301,EVM,mRNA,329038,2888122,301,1.00
ptg007488l,4033541,4033830,289,EVM,mRNA,3964973,4132138,289,1.00
ptg007497l,1362580,1362879,299,EVM,mRNA,1035370,2674366,299,1.00
ptg007497l,2188575,2188874,299,EVM,mRNA,1035370,2674366,299,1.00
ptg007497l,2554709,2555004,295,EVM,mRNA,1035370,2674366,295,1.00
ptg007501l,1109222,1109521,299,EVM,mRNA,840637,1458592,299,1.00
ptg007501l,1257266,1257565,299,EVM,mRNA,840637,1458592,299,1.00
ptg007502l,1600835,1601150,315,EVM,mRNA,2941,2329266,315,1.00
ptg007502l,1847503,1847817,314,EVM,mRNA,2941,2329266,314,1.00
ptg007504l,1993558,1993882,324,EVM,mRNA,1856366,2092706,324,1.00
ptg007504l,2048392,2048691,299,EVM,mRNA,1856366,2092706,299,1.00
ptg007505l,537633,537928,295,EVM,mRNA,492843,1527297,295,1.00
ptg007506l,105228,105528,300,EVM,mRNA,81312,147854,300,1.00
ptg007506l,1227342,1227635,293,EVM,mRNA,1174600,1287258,293,1.00
ptg007506l,1266163,1266451,288,EVM,mRNA,1174600,1287258,288,1.00
ptg007509l,639964,640245,281,EVM,mRNA,550169,1130708,281,1.00
ptg007509l,700836,701152,316,EVM,mRNA,550169,1130708,316,1.00
ptg007509l,2173373,2173682,309,EVM,mRNA,1352796,2518118,309,1.00
ptg007509l,2276449,2276772,323,EVM,mRNA,1352796,2518118,323,1.00
ptg007513l,2139139,2139447,308,EVM,mRNA,1761572,2142567,308,1.00
ptg007515l,1277243,1277547,304,EVM,mRNA,14094,1692572,304,1.00
ptg007515l,1357720,1358040,320,EVM,mRNA,14094,1692572,320,1.00
ptg007516l,505601,505924,323,EVM,mRNA,183883,3013695,323,1.00
ptg007516l,1807143,1807456,313,EVM,mRNA,183883,3013695,313,1.00
ptg007516l,2886492,2886779,287,EVM,mRNA,183883,3013695,287,1.00
ptg007517l,542504,542800,296,EVM,mRNA,474968,596556,296,1.00
ptg007521l,294397,294687,290,EVM,mRNA,120399,2997484,290,1.00
ptg007521l,507761,508072,311,EVM,mRNA,120399,2997484,311,1.00
ptg007526l,55428,55743,315,EVM,mRNA,5731,131515,315,1.00
ptg007526l,593604,593904,300,EVM,mRNA,578832,697927,300,1.00
ptg007526l,1205610,1205905,295,EVM,mRNA,1176843,1216113,295,1.00
ptg007528l,870507,870801,294,EVM,mRNA,9380,965043,294,1.00
ptg007529l,346314,346603,289,EVM,mRNA,10075,1719427,289,1.00
ptg007529l,2171194,2171494,300,EVM,mRNA,1929242,2238524,300,1.00
ptg007530l,568437,568718,281,EVM,mRNA,90126,649055,281,1.00
ptg007530l,602489,602773,284,EVM,mRNA,90126,649055,284,1.00
ptg007534l,1763433,1763736,303,EVM,mRNA,1654720,1855055,303,1.00
ptg007535l,136455,136736,281,EVM,mRNA,1586,153720,281,1.00
ptg007540l,534837,535097,260,EVM,mRNA,1077,623307,260,1.00
ptg007541l,1126747,1127024,277,EVM,mRNA,1030301,1146811,277,1.00
ptg007543l,2972093,2972416,323,EVM,mRNA,2960325,3447377,323,1.00
ptg007545l,2186383,2186678,295,EVM,mRNA,2135557,3361272,295,1.00
ptg007545l,2955350,2955663,313,EVM,mRNA,2135557,3361272,313,1.00
ptg007545l,3093692,3093934,242,EVM,mRNA,2135557,3361272,242,1.00
ptg007545l,4022411,4022718,307,EVM,mRNA,3766964,4777817,307,1.00
ptg007545l,4378769,4379083,314,EVM,mRNA,3766964,4777817,314,1.00
ptg007545l,5204600,5204946,346,EVM,mRNA,5125289,5400995,346,1.00
ptg007550l,848348,848670,322,EVM,mRNA,406960,1078047,322,1.00
ptg007555l,718676,718992,316,EVM,mRNA,88941,750864,316,1.00
ptg007556l,136668,136949,281,EVM,mRNA,35571,207094,281,1.00
ptg007557l,878928,879210,282,EVM,mRNA,500601,1078963,282,1.00
ptg007557l,2153591,2153878,287,EVM,mRNA,1908383,3476245,287,1.00
ptg007557l,2350980,2351280,300,EVM,mRNA,1908383,3476245,300,1.00
ptg007561l,483455,483759,304,EVM,mRNA,321366,592012,304,1.00
ptg007562l,511308,511612,304,EVM,mRNA,431569,621885,304,1.00
ptg007562l,586878,587156,278,EVM,mRNA,431569,621885,278,1.00
ptg007563l,4604640,4604963,323,EVM,mRNA,4152637,4693395,323,1.00
ptg007563l,4997728,4998019,291,EVM,mRNA,4830263,5352181,291,1.00
ptg007566l,1502275,1502572,297,EVM,mRNA,1489258,2431716,297,1.00
ptg007566l,1604252,1604527,275,EVM,mRNA,1489258,2431716,275,1.00
ptg007566l,1930452,1930740,288,EVM,mRNA,1489258,2431716,288,1.00
ptg007566l,2086137,2086436,299,EVM,mRNA,1489258,2431716,299,1.00
ptg007569l,505786,506068,282,EVM,mRNA,3,686760,282,1.00
ptg007570l,448058,448370,312,EVM,mRNA,38691,1250535,312,1.00
ptg007570l,476962,477286,324,EVM,mRNA,38691,1250535,324,1.00
ptg007570l,545769,546083,314,EVM,mRNA,38691,1250535,314,1.00
ptg007573l,453756,454074,318,EVM,mRNA,82198,662325,318,1.00
ptg007573l,569645,569963,318,EVM,mRNA,82198,662325,318,1.00
ptg007573l,971375,971696,321,EVM,mRNA,732573,997663,321,1.00
ptg007576l,741715,742017,302,EVM,mRNA,344692,2193236,302,1.00
ptg007576l,1212326,1212645,319,EVM,mRNA,344692,2193236,319,1.00
ptg007576l,1488178,1488487,309,EVM,mRNA,344692,2193236,309,1.00
ptg007586l,754863,755152,289,EVM,mRNA,444786,989325,289,1.00
ptg007586l,1595807,1596129,322,EVM,mRNA,1553770,1926435,322,1.00
ptg007598l,1304529,1304828,299,EVM,mRNA,1125463,1788320,299,1.00
ptg007598l,1419379,1419685,306,EVM,mRNA,1125463,1788320,306,1.00
ptg007603l,622137,622481,344,EVM,mRNA,90059,1061775,344,1.00
ptg007606l,1251475,1251752,277,EVM,mRNA,1227697,1367346,277,1.00
ptg007606l,1354943,1355262,319,EVM,mRNA,1227697,1367346,319,1.00
ptg007608l,454347,454644,297,EVM,mRNA,364346,694713,297,1.00
ptg007608l,674661,674982,321,EVM,mRNA,364346,694713,321,1.00
ptg007608l,874302,874614,312,EVM,mRNA,741201,1056774,312,1.00
ptg007608l,1189043,1189342,299,EVM,mRNA,1178245,1282283,299,1.00
ptg007613l,4668099,4668372,273,EVM,mRNA,4656432,4791702,273,1.00
ptg007613l,4683617,4683913,296,EVM,mRNA,4656432,4791702,296,1.00
ptg007617l,450779,451063,284,EVM,mRNA,183120,1943017,284,1.00
ptg007617l,2451764,2452057,293,EVM,mRNA,2441563,2620320,293,1.00
ptg007618l,1653717,1654024,307,EVM,mRNA,1493634,2205832,307,1.00
ptg007621l,1839238,1839559,321,EVM,mRNA,1724508,1871756,321,1.00
ptg007621l,2473069,2473334,265,EVM,mRNA,2407833,2594697,265,1.00
ptg007623l,1371930,1372228,298,EVM,mRNA,1326653,2713605,298,1.00
ptg007624l,598348,598665,317,EVM,mRNA,44876,612475,317,1.00
ptg007624l,1508246,1508543,297,EVM,mRNA,1156233,2014077,297,1.00
ptg007624l,1572421,1572703,282,EVM,mRNA,1156233,2014077,282,1.00
ptg007624l,1862676,1862975,299,EVM,mRNA,1156233,2014077,299,1.00
ptg007624l,2258125,2258407,282,EVM,mRNA,2191781,2576555,282,1.00
ptg007626l,62839,63147,308,EVM,mRNA,55457,266936,308,1.00
ptg007626l,482891,483172,281,EVM,mRNA,289033,498080,281,1.00
ptg007633l,3338337,3338656,319,EVM,mRNA,3010790,4251231,319,1.00
ptg007633l,3803058,3803383,325,EVM,mRNA,3010790,4251231,325,1.00
ptg007635l,2042090,2042420,330,EVM,mRNA,1996039,2169151,330,1.00
ptg007635l,2052829,2053121,292,EVM,mRNA,1996039,2169151,292,1.00
ptg007636l,328705,329032,327,EVM,mRNA,322128,564198,327,1.00
ptg007643l,100732,101034,302,EVM,mRNA,37837,1186659,302,1.00
ptg007662l,120020,120324,304,EVM,mRNA,45259,387682,304,1.00
ptg007664l,2158174,2158461,287,EVM,mRNA,2158266,3066176,196,0.68
ptg007666l,112581,112864,283,EVM,mRNA,69390,294039,283,1.00
ptg007667l,35063,35387,324,EVM,mRNA,2457,39892,324,1.00
ptg007668l,2863776,2864099,323,EVM,mRNA,854230,3770148,323,1.00
ptg007668l,3023182,3023456,274,EVM,mRNA,854230,3770148,274,1.00
ptg007668l,3199507,3199810,303,EVM,mRNA,854230,3770148,303,1.00
ptg007668l,3565001,3565305,304,EVM,mRNA,854230,3770148,304,1.00
ptg007668l,4206124,4206438,314,EVM,mRNA,3944572,4858952,314,1.00
ptg007668l,4677234,4677553,319,EVM,mRNA,3944572,4858952,319,1.00
ptg007673l,599344,599650,306,EVM,mRNA,87460,739739,306,1.00
ptg007674l,256474,256754,280,EVM,mRNA,179068,769417,280,1.00
ptg007674l,1303967,1304275,308,EVM,mRNA,1104671,1637293,308,1.00
ptg007674l,1535976,1536274,298,EVM,mRNA,1104671,1637293,298,1.00
ptg007674l,1732345,1732643,298,EVM,mRNA,1681279,1847495,298,1.00
ptg007675l,1918587,1918872,285,EVM,mRNA,1684575,3915774,285,1.00
ptg007677l,163565,163862,297,EVM,mRNA,96096,910695,297,1.00
ptg007678l,1964379,1964673,294,EVM,mRNA,1590198,2297864,294,1.00
ptg007678l,4562540,4562866,326,EVM,mRNA,2541791,4895695,326,1.00
ptg007687l,2249295,2249613,318,EVM,mRNA,1928463,2457585,318,1.00
ptg007692l,1220692,1220983,291,EVM,mRNA,1219086,1300056,291,1.00
ptg007696l,1410510,1410795,285,EVM,mRNA,1377421,1441286,285,1.00
ptg007696l,1570387,1570675,288,EVM,mRNA,1566208,1627046,288,1.00
ptg007698l,754903,755179,276,EVM,mRNA,311322,2005386,276,1.00
ptg007698l,856469,856782,313,EVM,mRNA,311322,2005386,313,1.00
ptg007706l,1352992,1353274,282,EVM,mRNA,1319949,1553174,282,1.00
ptg007711l,157524,157841,317,EVM,mRNA,3143,428589,317,1.00
ptg007711l,232196,232478,282,EVM,mRNA,3143,428589,282,1.00
ptg007718l,1506463,1506748,285,EVM,mRNA,1339173,2653800,285,1.00
ptg007718l,1777801,1778090,289,EVM,mRNA,1339173,2653800,289,1.00
ptg007718l,2330840,2331149,309,EVM,mRNA,1339173,2653800,309,1.00
ptg007718l,2941533,2941842,309,EVM,mRNA,2877761,3171958,309,1.00
ptg007718l,3106516,3106782,266,EVM,mRNA,2877761,3171958,266,1.00
ptg007719l,793545,793884,339,EVM,mRNA,790110,912288,339,1.00
ptg007729l,455013,455272,259,EVM,mRNA,40434,2072225,259,1.00
ptg007729l,637160,637476,316,EVM,mRNA,40434,2072225,316,1.00
ptg007729l,860787,861110,323,EVM,mRNA,40434,2072225,323,1.00
ptg007729l,1197827,1198105,278,EVM,mRNA,40434,2072225,278,1.00
ptg007732l,238127,238419,292,EVM,mRNA,136328,2583463,292,1.00
ptg007732l,1604410,1604717,307,EVM,mRNA,136328,2583463,307,1.00
ptg007732l,2475988,2476286,298,EVM,mRNA,136328,2583463,298,1.00
ptg007732l,4587222,4587517,295,EVM,mRNA,4332323,4684043,295,1.00
ptg007739l,2294286,2294588,302,EVM,mRNA,2041898,2515631,302,1.00
ptg007739l,2354113,2354411,298,EVM,mRNA,2041898,2515631,298,1.00
ptg007739l,2359122,2359406,284,EVM,mRNA,2041898,2515631,284,1.00
ptg007740l,165513,165792,279,EVM,mRNA,118756,265971,279,1.00
ptg007740l,1637450,1637762,312,EVM,mRNA,746517,2353362,312,1.00
ptg007741l,991525,991841,316,EVM,mRNA,935808,1448107,316,1.00
ptg007742l,2311642,2311921,279,EVM,mRNA,1966748,2451185,279,1.00
ptg007742l,2337926,2338242,316,EVM,mRNA,1966748,2451185,316,1.00
ptg007754l,1386240,1386535,295,EVM,mRNA,1009936,1647044,295,1.00
ptg007754l,1491841,1492134,293,EVM,mRNA,1009936,1647044,293,1.00
ptg007758l,558542,558829,287,EVM,mRNA,463003,1323660,287,1.00
ptg007758l,748938,749235,297,EVM,mRNA,463003,1323660,297,1.00
ptg007763l,1389580,1389887,307,EVM,mRNA,23719,3084891,307,1.00
ptg007763l,1648073,1648362,289,EVM,mRNA,23719,3084891,289,1.00
ptg007763l,2476702,2477014,312,EVM,mRNA,23719,3084891,312,1.00
ptg007763l,2816758,2817057,299,EVM,mRNA,23719,3084891,299,1.00
ptg007763l,3851229,3851540,311,EVM,mRNA,3772065,3902070,311,1.00
ptg007763l,5093289,5093567,278,EVM,mRNA,4960508,7949377,278,1.00
ptg007763l,6015294,6015571,277,EVM,mRNA,4960508,7949377,277,1.00
ptg007763l,7240115,7240397,282,EVM,mRNA,4960508,7949377,282,1.00
ptg007763l,7365335,7365659,324,EVM,mRNA,4960508,7949377,324,1.00
ptg007767l,479884,480184,300,EVM,mRNA,136227,1224496,300,1.00
ptg007767l,684492,684817,325,EVM,mRNA,136227,1224496,325,1.00
ptg007767l,1157702,1158009,307,EVM,mRNA,136227,1224496,307,1.00
ptg007767l,1445691,1445968,277,EVM,mRNA,1375197,1759319,277,1.00
ptg007767l,2156966,2157282,316,EVM,mRNA,1798948,2365012,316,1.00
ptg007770l,2335091,2335355,264,EVM,mRNA,1740734,2738373,264,1.00
ptg007774l,1540934,1541194,260,EVM,mRNA,866773,2023752,260,1.00
ptg007778l,182894,183205,311,EVM,mRNA,50724,188170,311,1.00
ptg007781l,661504,661797,293,EVM,mRNA,299391,1316757,293,1.00
ptg007784l,4576563,4576874,311,EVM,mRNA,4293099,4810384,311,1.00
ptg007784l,5321048,5321322,274,EVM,mRNA,5241431,5816574,274,1.00
ptg007787l,172706,173025,319,EVM,mRNA,71089,305443,319,1.00
ptg007787l,233625,233900,275,EVM,mRNA,71089,305443,275,1.00
ptg007787l,239026,239332,306,EVM,mRNA,71089,305443,306,1.00
ptg007792l,1623489,1623802,313,EVM,mRNA,14309,1626603,313,1.00
ptg007792l,2806152,2806454,302,EVM,mRNA,2393962,3097837,302,1.00
ptg007798l,1422303,1422582,279,EVM,mRNA,90868,1931626,279,1.00
ptg007804l,313519,313822,303,EVM,mRNA,301169,320281,303,1.00
ptg007807l,933933,934256,323,EVM,mRNA,229335,1763594,323,1.00
ptg007807l,2664004,2664301,297,EVM,mRNA,2474020,3468293,297,1.00
ptg007810l,62038,62341,303,EVM,mRNA,2744,484730,303,1.00
ptg007820l,221357,221652,295,EVM,mRNA,7691,409939,295,1.00
ptg007821l,996848,997144,296,EVM,mRNA,363296,2258356,296,1.00
ptg007821l,1543871,1544174,303,EVM,mRNA,363296,2258356,303,1.00
ptg007821l,1995252,1995559,307,EVM,mRNA,363296,2258356,307,1.00
ptg007821l,4407803,4408129,326,EVM,mRNA,3524065,4844646,326,1.00
ptg007824l,2892825,2893105,280,EVM,mRNA,2379346,3164219,280,1.00
ptg007827l,351844,352139,295,EVM,mRNA,207375,922918,295,1.00
ptg007827l,1362722,1363033,311,EVM,mRNA,1244211,1602710,311,1.00
ptg007827l,1971882,1972176,294,EVM,mRNA,1828634,2288152,294,1.00
ptg007828l,2844096,2844419,323,EVM,mRNA,2268395,3432940,323,1.00
ptg007832l,1525367,1525666,299,EVM,mRNA,626297,2225687,299,1.00
ptg007834l,184952,185279,327,EVM,mRNA,51315,199426,327,1.00
ptg007844l,1709038,1709342,304,EVM,mRNA,1477810,1847594,304,1.00
ptg007855l,1949977,1950285,308,EVM,mRNA,1070624,2382554,308,1.00
ptg007856l,855251,855576,325,EVM,mRNA,46617,1006430,325,1.00
ptg007856l,1592863,1593191,328,EVM,mRNA,1029703,3970477,328,1.00
ptg007856l,2681138,2681404,266,EVM,mRNA,1029703,3970477,266,1.00
ptg007859l,435441,435755,314,EVM,mRNA,432233,592225,314,1.00
ptg007859l,769868,770145,277,EVM,mRNA,602094,1751706,277,1.00
ptg007861l,699810,700103,293,EVM,mRNA,84619,952668,293,1.00
ptg007865l,834769,835039,270,EVM,mRNA,69225,2726822,270,1.00
ptg007865l,1562893,1563183,290,EVM,mRNA,69225,2726822,290,1.00
ptg007869l,1204518,1204829,311,EVM,mRNA,758166,1425566,311,1.00
ptg007870l,448043,448336,293,EVM,mRNA,233545,664864,293,1.00
ptg007883l,434467,434783,316,EVM,mRNA,96281,3295638,316,1.00
ptg007883l,1201753,1202037,284,EVM,mRNA,96281,3295638,284,1.00
ptg007883l,2623778,2624098,320,EVM,mRNA,96281,3295638,320,1.00
ptg007883l,2922093,2922427,334,EVM,mRNA,96281,3295638,334,1.00
ptg007884l,561955,562250,295,EVM,mRNA,42396,1467890,295,1.00
ptg007884l,1318749,1319049,300,EVM,mRNA,42396,1467890,300,1.00
ptg007884l,1380794,1381112,318,EVM,mRNA,42396,1467890,318,1.00
ptg007886l,372727,373063,336,EVM,mRNA,283834,436566,336,1.00
ptg007894l,490777,491094,317,EVM,mRNA,398259,886907,317,1.00
ptg007897l,1310838,1311094,256,EVM,mRNA,1310089,1822334,256,1.00
ptg007898l,3963302,3963623,321,EVM,mRNA,2850167,4931623,321,1.00
ptg007900l,97115,97384,269,EVM,mRNA,50106,2567625,269,1.00
ptg007900l,749776,750076,300,EVM,mRNA,50106,2567625,300,1.00
ptg007902l,199558,199877,319,EVM,mRNA,199807,371475,71,0.22
ptg007902l,1719505,1719833,328,EVM,mRNA,855710,1979931,328,1.00
ptg007903l,2633435,2633751,316,EVM,mRNA,2427956,2968682,316,1.00
ptg007906l,672779,673075,296,EVM,mRNA,522375,1642423,296,1.00
ptg007909l,249126,249440,314,EVM,mRNA,17089,295159,314,1.00
ptg007910l,929779,930062,283,EVM,mRNA,201644,1043425,283,1.00
ptg007921l,192793,193098,305,EVM,mRNA,93970,267939,305,1.00
ptg007924l,104769,105069,300,EVM,mRNA,39870,1112984,300,1.00
ptg007924l,518699,519003,304,EVM,mRNA,39870,1112984,304,1.00
ptg007925l,218255,218570,315,EVM,mRNA,212209,788993,315,1.00
ptg007925l,1488793,1489110,317,EVM,mRNA,893827,1682716,317,1.00
ptg007925l,2112193,2112499,306,EVM,mRNA,2100806,2383019,306,1.00
ptg007925l,2318020,2318288,268,EVM,mRNA,2100806,2383019,268,1.00
ptg007929l,214011,214325,314,EVM,mRNA,13136,488713,314,1.00
ptg007930l,2300125,2300416,291,EVM,mRNA,1795262,3107027,291,1.00
ptg007940l,505920,506245,325,EVM,mRNA,124428,1378590,325,1.00
ptg007940l,1165554,1165844,290,EVM,mRNA,124428,1378590,290,1.00
ptg007940l,1241811,1242095,284,EVM,mRNA,124428,1378590,284,1.00
ptg007940l,3301090,3301414,324,EVM,mRNA,1789078,3585284,324,1.00
ptg007945l,1441396,1441688,292,EVM,mRNA,608776,2839786,292,1.00
ptg007949l,924345,924676,331,EVM,mRNA,808030,938358,331,1.00
ptg007953l,1257208,1257509,301,EVM,mRNA,885981,3254205,301,1.00
ptg007953l,2303407,2303713,306,EVM,mRNA,885981,3254205,306,1.00
ptg007953l,2776785,2777103,318,EVM,mRNA,885981,3254205,318,1.00
ptg007953l,4124782,4125073,291,EVM,mRNA,3838547,4414347,291,1.00
ptg007956l,2111542,2111831,289,EVM,mRNA,2036626,2201065,289,1.00
ptg007958l,736422,736704,282,EVM,mRNA,692737,1255232,282,1.00
ptg007961l,1721594,1721906,312,EVM,mRNA,1628381,2047435,312,1.00
ptg007966l,1825557,1825858,301,EVM,mRNA,190624,2847384,301,1.00
ptg007967l,341111,341403,292,EVM,mRNA,316393,637008,292,1.00
ptg007969l,395762,396047,285,EVM,mRNA,223326,2566356,285,1.00
ptg007969l,868285,868569,284,EVM,mRNA,223326,2566356,284,1.00
ptg007969l,1584080,1584358,278,EVM,mRNA,223326,2566356,278,1.00
ptg007969l,2538876,2539156,280,EVM,mRNA,223326,2566356,280,1.00
ptg007979l,1149408,1149705,297,EVM,mRNA,1113004,1359613,297,1.00
ptg007981l,810701,810987,286,EVM,mRNA,59809,2685789,286,1.00
ptg007981l,998655,998947,292,EVM,mRNA,59809,2685789,292,1.00
ptg007981l,2383127,2383440,313,EVM,mRNA,59809,2685789,313,1.00
ptg007982l,44043,44336,293,EVM,mRNA,325,448258,293,1.00
ptg007982l,57879,58178,299,EVM,mRNA,325,448258,299,1.00
ptg007982l,294827,295131,304,EVM,mRNA,325,448258,304,1.00
ptg007982l,1733553,1733887,334,EVM,mRNA,448994,1956968,334,1.00
ptg007983l,796220,796518,298,EVM,mRNA,742878,902642,298,1.00
ptg007983l,1240603,1240889,286,EVM,mRNA,1142666,1901713,286,1.00
ptg007983l,1680557,1680840,283,EVM,mRNA,1142666,1901713,283,1.00
ptg007984l,955025,955341,316,EVM,mRNA,741300,2064008,316,1.00
ptg007984l,965061,965354,293,EVM,mRNA,741300,2064008,293,1.00
ptg007984l,997931,998196,265,EVM,mRNA,741300,2064008,265,1.00
ptg007984l,2596344,2596635,291,EVM,mRNA,2392518,2983876,291,1.00
ptg007984l,2667310,2667575,265,EVM,mRNA,2392518,2983876,265,1.00
ptg007986l,672303,672630,327,EVM,mRNA,248654,678107,327,1.00
ptg007986l,1978799,1979093,294,EVM,mRNA,1911236,2534838,294,1.00
ptg007986l,2215478,2215759,281,EVM,mRNA,1911236,2534838,281,1.00
ptg007986l,2509270,2509596,326,EVM,mRNA,1911236,2534838,326,1.00
ptg007988l,1194017,1194302,285,EVM,mRNA,608891,1704385,285,1.00
ptg007989l,2125921,2126229,308,EVM,mRNA,1967212,2915019,308,1.00
ptg007989l,2503602,2503887,285,EVM,mRNA,1967212,2915019,285,1.00
ptg007992l,664688,664987,299,EVM,mRNA,146741,677665,299,1.00
ptg007993l,1751596,1751927,331,EVM,mRNA,295164,2176426,331,1.00
ptg008006l,787099,787428,329,EVM,mRNA,622586,1747960,329,1.00
ptg008009l,2276737,2277015,278,EVM,mRNA,2095780,2621912,278,1.00
ptg008010l,1350279,1350555,276,EVM,mRNA,221180,2626976,276,1.00
ptg008010l,1800084,1800386,302,EVM,mRNA,221180,2626976,302,1.00
ptg008011l,1233147,1233444,297,EVM,mRNA,1099867,1344519,297,1.00
ptg008017l,627885,628185,300,EVM,mRNA,430528,863908,300,1.00
ptg008017l,800239,800517,278,EVM,mRNA,430528,863908,278,1.00
ptg008023l,944614,944909,295,EVM,mRNA,930455,1514793,295,1.00
ptg008026l,919712,920005,293,EVM,mRNA,589112,1309798,293,1.00
ptg008026l,1486338,1486640,302,EVM,mRNA,1402774,1858382,302,1.00
ptg008026l,4500474,4500785,311,EVM,mRNA,4475042,4532610,311,1.00
ptg008030l,480593,480888,295,EVM,mRNA,266340,1994052,295,1.00
ptg008030l,1137446,1137728,282,EVM,mRNA,266340,1994052,282,1.00
ptg008030l,1139546,1139834,288,EVM,mRNA,266340,1994052,288,1.00
ptg008030l,1769509,1769835,326,EVM,mRNA,266340,1994052,326,1.00
ptg008031l,1942056,1942370,314,EVM,mRNA,847979,2258487,314,1.00
ptg008032l,2276663,2276978,315,EVM,mRNA,1139578,2500375,315,1.00
ptg008035l,1693333,1693602,269,EVM,mRNA,1581112,2754830,269,1.00
ptg008035l,1869383,1869689,306,EVM,mRNA,1581112,2754830,306,1.00
ptg008035l,3023123,3023453,330,EVM,mRNA,2979067,3433183,330,1.00
ptg008036l,449367,449642,275,EVM,mRNA,287896,456439,275,1.00
ptg008037l,238076,238368,292,EVM,mRNA,237672,238190,114,0.39
ptg008039l,1221391,1221690,299,EVM,mRNA,1079483,1237714,299,1.00
ptg008043l,470243,470563,320,EVM,mRNA,366547,946745,320,1.00
ptg008043l,1449718,1450007,289,EVM,mRNA,1099153,1723414,289,1.00
ptg008043l,2210918,2211207,289,EVM,mRNA,1934723,2363162,289,1.00
ptg008044l,991558,991850,292,EVM,mRNA,3060,1412864,292,1.00
ptg008044l,1137460,1137776,316,EVM,mRNA,3060,1412864,316,1.00
ptg008044l,1334759,1335086,327,EVM,mRNA,3060,1412864,327,1.00
ptg008048l,2057738,2058046,308,EVM,mRNA,1556658,2780061,308,1.00
ptg008048l,2263599,2263879,280,EVM,mRNA,1556658,2780061,280,1.00
ptg008053l,444724,445039,315,EVM,mRNA,7648,794029,315,1.00
ptg008062l,810417,810685,268,EVM,mRNA,737933,823993,268,1.00
ptg008063l,3742765,3743072,307,EVM,mRNA,2444166,4415934,307,1.00
ptg008063l,3844213,3844506,293,EVM,mRNA,2444166,4415934,293,1.00
ptg008063l,3874175,3874491,316,EVM,mRNA,2444166,4415934,316,1.00
ptg008063l,3960980,3961274,294,EVM,mRNA,2444166,4415934,294,1.00
ptg008065l,762536,762834,298,EVM,mRNA,748840,1029920,298,1.00
ptg008067l,76310,76576,266,EVM,mRNA,43354,378546,266,1.00
ptg008067l,1357364,1357666,302,EVM,mRNA,1117205,1446210,302,1.00
ptg008075l,1992822,1993144,322,EVM,mRNA,1429413,2211583,322,1.00
ptg008079l,208494,208804,310,EVM,mRNA,167581,1314770,310,1.00
ptg008084l,1677748,1678071,323,EVM,mRNA,1501602,1880082,323,1.00
ptg008088l,173015,173345,330,EVM,mRNA,23285,175973,330,1.00
ptg008088l,403085,403372,287,EVM,mRNA,346242,661539,287,1.00
ptg008088l,1333432,1333746,314,EVM,mRNA,1240040,1368774,314,1.00
ptg008090l,3877215,3877511,296,EVM,mRNA,2646803,4139411,296,1.00
ptg008090l,4027222,4027521,299,EVM,mRNA,2646803,4139411,299,1.00
ptg008090l,4074784,4075034,250,EVM,mRNA,2646803,4139411,250,1.00
ptg008091l,3578234,3578531,297,EVM,mRNA,3519490,3691568,297,1.00
ptg008093l,213372,213669,297,EVM,mRNA,18070,1153990,297,1.00
ptg008093l,956652,956965,313,EVM,mRNA,18070,1153990,313,1.00
ptg008102l,1193832,1194143,311,EVM,mRNA,1118427,1505639,311,1.00
ptg008102l,1349166,1349497,331,EVM,mRNA,1118427,1505639,331,1.00
ptg008102l,3283002,3283310,308,EVM,mRNA,3249490,3471507,308,1.00
ptg008103l,1923809,1924113,304,EVM,mRNA,132016,2054195,304,1.00
ptg008107l,158750,159067,317,EVM,mRNA,147287,552828,317,1.00
ptg008107l,496964,497274,310,EVM,mRNA,147287,552828,310,1.00
ptg008107l,1621238,1621545,307,EVM,mRNA,1480274,1854077,307,1.00
ptg008110l,1579814,1580128,314,EVM,mRNA,1264727,2106058,314,1.00
ptg008112l,2663362,2663658,296,EVM,mRNA,2484279,5327098,296,1.00
ptg008112l,2673038,2673356,318,EVM,mRNA,2484279,5327098,318,1.00
ptg008112l,3393153,3393432,279,EVM,mRNA,2484279,5327098,279,1.00
ptg008112l,4919314,4919594,280,EVM,mRNA,2484279,5327098,280,1.00
ptg008113l,692285,692575,290,EVM,mRNA,320632,1966612,290,1.00
ptg008113l,747473,747755,282,EVM,mRNA,320632,1966612,282,1.00
ptg008113l,768726,769006,280,EVM,mRNA,320632,1966612,280,1.00
ptg008113l,1723234,1723515,281,EVM,mRNA,320632,1966612,281,1.00
ptg008113l,1880310,1880612,302,EVM,mRNA,320632,1966612,302,1.00
ptg008116l,1300484,1300770,286,EVM,mRNA,1285695,1575230,286,1.00
ptg008116l,2539236,2539562,326,EVM,mRNA,2502204,2873246,326,1.00
ptg008121l,2059680,2059996,316,EVM,mRNA,1650924,3044557,316,1.00
ptg008122l,552079,552385,306,EVM,mRNA,8900,1466671,306,1.00
ptg008122l,1222775,1223091,316,EVM,mRNA,8900,1466671,316,1.00
ptg008127l,665616,665915,299,EVM,mRNA,352193,1215431,299,1.00
ptg008127l,731626,731933,307,EVM,mRNA,352193,1215431,307,1.00
ptg008127l,1753919,1754227,308,EVM,mRNA,1523719,2147003,308,1.00
ptg008132l,2563639,2563973,334,EVM,mRNA,2394989,2592983,334,1.00
ptg008137l,2499537,2499814,277,EVM,mRNA,2156780,2700090,277,1.00
ptg008139l,1021863,1022133,270,EVM,mRNA,784293,1600030,270,1.00
ptg008144l,445244,445540,296,EVM,mRNA,158440,1535157,296,1.00
ptg008144l,488949,489252,303,EVM,mRNA,158440,1535157,303,1.00
ptg008144l,522435,522760,325,EVM,mRNA,158440,1535157,325,1.00
ptg008147l,1277807,1278108,301,EVM,mRNA,1216534,1365683,301,1.00
ptg008147l,2223899,2224209,310,EVM,mRNA,1435212,3819518,310,1.00
ptg008150l,261176,261463,287,EVM,mRNA,24459,672099,287,1.00
ptg008151l,464096,464396,300,EVM,mRNA,464112,844519,285,0.95
ptg008151l,644149,644438,289,EVM,mRNA,464112,844519,289,1.00
ptg008153l,1118792,1119108,316,EVM,mRNA,1079529,1316477,316,1.00
ptg008154l,944675,944965,290,EVM,mRNA,882386,2268616,290,1.00
ptg008154l,1864618,1864900,282,EVM,mRNA,882386,2268616,282,1.00
ptg008167l,310839,311130,291,EVM,mRNA,310629,382317,291,1.00
ptg008167l,335292,335587,295,EVM,mRNA,310629,382317,295,1.00
ptg008169l,854910,855245,335,EVM,mRNA,658049,1565963,335,1.00
ptg008169l,1753090,1753413,323,EVM,mRNA,1624392,1760609,323,1.00
ptg008171l,926079,926357,278,EVM,mRNA,845679,1110958,278,1.00
ptg008172l,337665,337953,288,EVM,mRNA,257078,415313,288,1.00
ptg008179l,989554,989845,291,EVM,mRNA,926205,1551465,291,1.00
ptg008181l,313161,313463,302,EVM,mRNA,58051,1242041,302,1.00
ptg008181l,442992,443270,278,EVM,mRNA,58051,1242041,278,1.00
ptg008181l,1038514,1038782,268,EVM,mRNA,58051,1242041,268,1.00
ptg008181l,1204800,1205132,332,EVM,mRNA,58051,1242041,332,1.00
ptg008181l,1205403,1205714,311,EVM,mRNA,58051,1242041,311,1.00
ptg008189l,193887,194198,311,EVM,mRNA,33076,961233,311,1.00
ptg008196l,664478,664786,308,EVM,mRNA,116902,761380,308,1.00
ptg008196l,1125368,1125655,287,EVM,mRNA,982997,1436509,287,1.00
ptg008196l,1149788,1150119,331,EVM,mRNA,982997,1436509,331,1.00
ptg008196l,1290170,1290456,286,EVM,mRNA,982997,1436509,286,1.00
ptg008196l,1407643,1407939,296,EVM,mRNA,982997,1436509,296,1.00
ptg008199l,439458,439771,313,EVM,mRNA,404500,1242702,313,1.00
ptg008202l,1062367,1062625,258,EVM,mRNA,933,1667211,258,1.00
ptg008202l,1178631,1178924,293,EVM,mRNA,933,1667211,293,1.00
ptg008202l,1258486,1258808,322,EVM,mRNA,933,1667211,322,1.00
ptg008203l,104422,104737,315,EVM,mRNA,4116,3349780,315,1.00
ptg008203l,227756,228056,300,EVM,mRNA,4116,3349780,300,1.00
ptg008203l,879878,880199,321,EVM,mRNA,4116,3349780,321,1.00
ptg008203l,929936,930229,293,EVM,mRNA,4116,3349780,293,1.00
ptg008203l,2032929,2033246,317,EVM,mRNA,4116,3349780,317,1.00
ptg008203l,2054433,2054758,325,EVM,mRNA,4116,3349780,325,1.00
ptg008203l,2113462,2113750,288,EVM,mRNA,4116,3349780,288,1.00
ptg008203l,2617872,2618171,299,EVM,mRNA,4116,3349780,299,1.00
ptg008203l,2775259,2775552,293,EVM,mRNA,4116,3349780,293,1.00
ptg008203l,2782666,2782957,291,EVM,mRNA,4116,3349780,291,1.00
ptg008203l,3325109,3325406,297,EVM,mRNA,4116,3349780,297,1.00
ptg008204l,1457376,1457693,317,EVM,mRNA,110143,3568606,317,1.00
ptg008204l,2119306,2119600,294,EVM,mRNA,110143,3568606,294,1.00
ptg008204l,2120618,2120918,300,EVM,mRNA,110143,3568606,300,1.00
ptg008204l,2480976,2481278,302,EVM,mRNA,110143,3568606,302,1.00
ptg008204l,2705132,2705424,292,EVM,mRNA,110143,3568606,292,1.00
ptg008204l,3109092,3109393,301,EVM,mRNA,110143,3568606,301,1.00
ptg008204l,3337531,3337844,313,EVM,mRNA,110143,3568606,313,1.00
ptg008204l,3383953,3384234,281,EVM,mRNA,110143,3568606,281,1.00
ptg008213l,496004,496327,323,EVM,mRNA,416020,926532,323,1.00
ptg008214l,2306028,2306306,278,EVM,mRNA,1706763,2655386,278,1.00
ptg008215l,1045872,1046144,272,EVM,mRNA,64667,1899342,272,1.00
ptg008215l,1133487,1133759,272,EVM,mRNA,64667,1899342,272,1.00
ptg008217l,308674,308967,293,EVM,mRNA,6028,794602,293,1.00
ptg008217l,363113,363435,322,EVM,mRNA,6028,794602,322,1.00
ptg008221l,2227561,2227884,323,EVM,mRNA,2197937,2292451,323,1.00
ptg008223l,221925,222238,313,EVM,mRNA,194521,325032,313,1.00
ptg008226l,934481,934793,312,EVM,mRNA,740241,1093355,312,1.00
ptg008231l,926322,926602,280,EVM,mRNA,707985,1030364,280,1.00
ptg008233l,845189,845454,265,EVM,mRNA,9093,883297,265,1.00
ptg008239l,736294,736575,281,EVM,mRNA,494774,1537547,281,1.00
ptg008239l,828559,828884,325,EVM,mRNA,494774,1537547,325,1.00
ptg008239l,967619,967934,315,EVM,mRNA,494774,1537547,315,1.00
ptg008239l,1796449,1796734,285,EVM,mRNA,1586503,2162072,285,1.00
ptg008239l,1799187,1799503,316,EVM,mRNA,1586503,2162072,316,1.00
ptg008241l,854320,854628,308,EVM,mRNA,125600,1373093,308,1.00
ptg008252l,910514,910830,316,EVM,mRNA,835631,1811778,316,1.00
ptg008252l,1096131,1096418,287,EVM,mRNA,835631,1811778,287,1.00
ptg008252l,1101684,1101982,298,EVM,mRNA,835631,1811778,298,1.00
ptg008252l,1223559,1223876,317,EVM,mRNA,835631,1811778,317,1.00
ptg008252l,1662812,1663114,302,EVM,mRNA,835631,1811778,302,1.00
ptg008253l,163630,163940,310,EVM,mRNA,114337,354947,310,1.00
ptg008253l,205919,206182,263,EVM,mRNA,114337,354947,263,1.00
ptg008253l,630857,631136,279,EVM,mRNA,482576,970244,279,1.00
ptg008253l,849313,849628,315,EVM,mRNA,482576,970244,315,1.00
ptg008255l,3215858,3216148,290,EVM,mRNA,3027911,3591406,290,1.00
ptg008256l,93354,93622,268,EVM,mRNA,78416,270782,268,1.00
ptg008256l,96368,96670,302,EVM,mRNA,78416,270782,302,1.00
ptg008256l,224673,224970,297,EVM,mRNA,78416,270782,297,1.00
ptg008258l,768328,768651,323,EVM,mRNA,533184,1652229,323,1.00
ptg008260l,1897198,1897485,287,EVM,mRNA,1521023,1945350,287,1.00
ptg008272l,33741,34028,287,EVM,mRNA,1449,401538,287,1.00
ptg008272l,75651,75896,245,EVM,mRNA,1449,401538,245,1.00
ptg008272l,206169,206454,285,EVM,mRNA,1449,401538,285,1.00
ptg008272l,2756407,2756690,283,EVM,mRNA,2712287,2860351,283,1.00
ptg008273l,403357,403644,287,EVM,mRNA,295746,1435311,287,1.00
ptg008273l,726761,727057,296,EVM,mRNA,295746,1435311,296,1.00
ptg008273l,1364874,1365175,301,EVM,mRNA,295746,1435311,301,1.00
ptg008273l,1736523,1736813,290,EVM,mRNA,1680853,1834433,290,1.00
ptg008273l,1761212,1761535,323,EVM,mRNA,1680853,1834433,323,1.00
ptg008273l,2241325,2241624,299,EVM,mRNA,1864843,3576026,299,1.00
ptg008273l,3127427,3127740,313,EVM,mRNA,1864843,3576026,313,1.00
ptg008273l,3269643,3269935,292,EVM,mRNA,1864843,3576026,292,1.00
ptg008275l,1033697,1034009,312,EVM,mRNA,1015388,1096781,312,1.00
ptg008276l,1095610,1095903,293,EVM,mRNA,629131,1162444,293,1.00
ptg008278l,631096,631408,312,EVM,mRNA,158447,677578,312,1.00
ptg008278l,1723848,1724127,279,EVM,mRNA,1689600,1802387,279,1.00
ptg008278l,2041912,2042228,316,EVM,mRNA,1959393,2215038,316,1.00
ptg008278l,2933260,2933572,312,EVM,mRNA,2717139,3005502,312,1.00
ptg008280l,1080270,1080600,330,EVM,mRNA,1010445,1116500,330,1.00
ptg008280l,1270347,1270625,278,EVM,mRNA,1243767,2547465,278,1.00
ptg008280l,1698933,1699265,332,EVM,mRNA,1243767,2547465,332,1.00
ptg008280l,2741760,2742056,296,EVM,mRNA,2726665,3688742,296,1.00
ptg008288l,295447,295775,328,EVM,mRNA,201491,1032431,328,1.00
ptg008288l,682901,683223,322,EVM,mRNA,201491,1032431,322,1.00
ptg008288l,1238735,1239055,320,EVM,mRNA,1161309,2303025,320,1.00
ptg008288l,1876782,1877070,288,EVM,mRNA,1161309,2303025,288,1.00
ptg008294l,455335,455640,305,EVM,mRNA,327129,457787,305,1.00
ptg008296l,946248,946560,312,EVM,mRNA,431795,3439309,312,1.00
ptg008297l,1051498,1051813,315,EVM,mRNA,934162,2335951,315,1.00
ptg008297l,1947904,1948198,294,EVM,mRNA,934162,2335951,294,1.00
ptg008297l,2078989,2079313,324,EVM,mRNA,934162,2335951,324,1.00
ptg008297l,2095132,2095438,306,EVM,mRNA,934162,2335951,306,1.00
ptg008298l,853376,853670,294,EVM,mRNA,497277,1644707,294,1.00
ptg008305l,838296,838587,291,EVM,mRNA,95412,3405853,291,1.00
ptg008305l,2203456,2203731,275,EVM,mRNA,95412,3405853,275,1.00
ptg008305l,2252723,2253038,315,EVM,mRNA,95412,3405853,315,1.00
ptg008305l,2371047,2371342,295,EVM,mRNA,95412,3405853,295,1.00
ptg008305l,2489634,2489932,298,EVM,mRNA,95412,3405853,298,1.00
ptg008305l,2551073,2551399,326,EVM,mRNA,95412,3405853,326,1.00
ptg008305l,2851657,2851951,294,EVM,mRNA,95412,3405853,294,1.00
ptg008305l,2888663,2888970,307,EVM,mRNA,95412,3405853,307,1.00
ptg008305l,3317902,3318215,313,EVM,mRNA,95412,3405853,313,1.00
ptg008311l,2230264,2230572,308,EVM,mRNA,2130920,3449394,308,1.00
ptg008311l,2272417,2272695,278,EVM,mRNA,2130920,3449394,278,1.00
ptg008311l,2777539,2777820,281,EVM,mRNA,2130920,3449394,281,1.00
ptg008316l,66547,66868,321,EVM,mRNA,21852,169591,321,1.00
ptg008318l,505789,506094,305,EVM,mRNA,277294,727567,305,1.00
ptg008319l,230186,230482,296,EVM,mRNA,108914,242077,296,1.00
ptg008319l,519832,520128,296,EVM,mRNA,452589,834969,296,1.00
ptg008319l,682238,682537,299,EVM,mRNA,452589,834969,299,1.00
ptg008335l,4227266,4227555,289,EVM,mRNA,3303865,4580885,289,1.00
ptg008337l,506997,507280,283,EVM,mRNA,489031,1076317,283,1.00
ptg008337l,547804,548134,330,EVM,mRNA,489031,1076317,330,1.00
ptg008337l,756198,756498,300,EVM,mRNA,489031,1076317,300,1.00
ptg008337l,1036057,1036377,320,EVM,mRNA,489031,1076317,320,1.00
ptg008337l,3449732,3450027,295,EVM,mRNA,3260094,3507997,295,1.00
ptg008338l,539335,539638,303,EVM,mRNA,453593,1867606,303,1.00
ptg008338l,1433004,1433312,308,EVM,mRNA,453593,1867606,308,1.00
ptg008339l,491997,492286,289,EVM,mRNA,142818,2582522,289,1.00
ptg008339l,1367222,1367500,278,EVM,mRNA,142818,2582522,278,1.00
ptg008339l,1416437,1416736,299,EVM,mRNA,142818,2582522,299,1.00
ptg008339l,1882080,1882376,296,EVM,mRNA,142818,2582522,296,1.00
ptg008339l,2007407,2007702,295,EVM,mRNA,142818,2582522,295,1.00
ptg008339l,2563761,2564036,275,EVM,mRNA,142818,2582522,275,1.00
ptg008346l,852326,852594,268,EVM,mRNA,86410,2982043,268,1.00
ptg008346l,2408953,2409275,322,EVM,mRNA,86410,2982043,322,1.00
ptg008346l,2952485,2952804,319,EVM,mRNA,86410,2982043,319,1.00
ptg008348l,1192729,1193047,318,EVM,mRNA,1125986,1752477,318,1.00
ptg008348l,1394629,1394891,262,EVM,mRNA,1125986,1752477,262,1.00
ptg008350l,389783,390098,315,EVM,mRNA,378346,520513,315,1.00
ptg008353l,854380,854700,320,EVM,mRNA,800699,1001721,320,1.00
ptg008353l,1825505,1825761,256,EVM,mRNA,1784784,2003693,256,1.00
ptg008355l,430546,430827,281,EVM,mRNA,231427,625190,281,1.00
ptg008358l,91002,91315,313,EVM,mRNA,87675,264210,313,1.00
ptg008358l,1168266,1168560,294,EVM,mRNA,681982,2074638,294,1.00
ptg008366l,1628788,1629106,318,EVM,mRNA,1289309,1813514,318,1.00
ptg008378l,742011,742290,279,EVM,mRNA,376974,1514396,279,1.00
ptg008378l,1253800,1254092,292,EVM,mRNA,376974,1514396,292,1.00
ptg008378l,1362475,1362801,326,EVM,mRNA,376974,1514396,326,1.00
ptg008378l,1481557,1481847,290,EVM,mRNA,376974,1514396,290,1.00
ptg008379l,576744,577047,303,EVM,mRNA,493004,661273,303,1.00
ptg008383l,1354157,1354458,301,EVM,mRNA,874348,1997898,301,1.00
ptg008383l,2742106,2742399,293,EVM,mRNA,2338613,2879384,293,1.00
ptg008387l,587147,587458,311,EVM,mRNA,494405,827021,311,1.00
ptg008393l,1004710,1005025,315,EVM,mRNA,908004,2235279,315,1.00
ptg008393l,1241217,1241523,306,EVM,mRNA,908004,2235279,306,1.00
ptg008393l,1322051,1322378,327,EVM,mRNA,908004,2235279,327,1.00
ptg008395l,875656,875981,325,EVM,mRNA,24189,1550083,325,1.00
ptg008400l,1535753,1536064,311,EVM,mRNA,846584,2470627,311,1.00
ptg008400l,2399670,2399959,289,EVM,mRNA,846584,2470627,289,1.00
ptg008402l,17623,17929,306,EVM,mRNA,11613,947271,306,1.00
ptg008403l,753940,754227,287,EVM,mRNA,21607,3135153,287,1.00
ptg008403l,2522039,2522321,282,EVM,mRNA,21607,3135153,282,1.00
ptg008403l,2721142,2721424,282,EVM,mRNA,21607,3135153,282,1.00
ptg008404l,147089,147382,293,EVM,mRNA,10051,470846,293,1.00
ptg008404l,3216565,3216827,262,EVM,mRNA,2747323,3235545,262,1.00
ptg008413l,4376909,4377203,294,EVM,mRNA,3887005,4793441,294,1.00
ptg008413l,6202400,6202716,316,EVM,mRNA,5426446,6262156,316,1.00
ptg008417l,3102556,3102860,304,EVM,mRNA,1557157,3677208,304,1.00
ptg008418l,268009,268309,300,EVM,mRNA,4546,2231783,300,1.00
ptg008418l,422644,422947,303,EVM,mRNA,4546,2231783,303,1.00
ptg008422l,218211,218524,313,EVM,mRNA,89117,557051,313,1.00
ptg008422l,340298,340635,337,EVM,mRNA,89117,557051,337,1.00
ptg008425l,1983277,1983587,310,EVM,mRNA,802968,2001474,310,1.00
ptg008433l,285004,285294,290,EVM,mRNA,92677,1133404,290,1.00
ptg008435l,990658,990966,308,EVM,mRNA,827634,2581773,308,1.00
ptg008435l,1838540,1838832,292,EVM,mRNA,827634,2581773,292,1.00
ptg008435l,2138943,2139248,305,EVM,mRNA,827634,2581773,305,1.00
ptg008436l,327404,327732,328,EVM,mRNA,307014,353629,328,1.00
ptg008438l,584524,584797,273,EVM,mRNA,582652,973711,273,1.00
ptg008439l,909218,909506,288,EVM,mRNA,737808,1722450,288,1.00
ptg008440l,1388731,1389048,317,EVM,mRNA,1244962,1771560,317,1.00
ptg008440l,1551373,1551646,273,EVM,mRNA,1244962,1771560,273,1.00
ptg008440l,3386882,3387210,328,EVM,mRNA,3387159,3420631,52,0.16
ptg008440l,4085461,4085731,270,EVM,mRNA,4012467,4475606,270,1.00
ptg008442l,302657,302947,290,EVM,mRNA,214742,334234,290,1.00
ptg008446l,1078198,1078497,299,EVM,mRNA,102999,1521300,299,1.00
ptg008447l,71688,72014,326,EVM,mRNA,22653,183680,326,1.00
ptg008447l,812180,812474,294,EVM,mRNA,258123,883318,294,1.00
ptg008448l,296085,296344,259,EVM,mRNA,289223,737220,259,1.00
ptg008449l,641785,642096,311,EVM,mRNA,615792,642498,311,1.00
ptg008449l,1421000,1421302,302,EVM,mRNA,965409,1486165,302,1.00
ptg008452l,1193715,1194026,311,EVM,mRNA,1170308,1252849,311,1.00
ptg008454l,1447946,1448221,275,EVM,mRNA,677303,1597444,275,1.00
ptg008454l,1583430,1583750,320,EVM,mRNA,677303,1597444,320,1.00
ptg008454l,2302788,2303075,287,EVM,mRNA,1799070,2630101,287,1.00
ptg008459l,77636,77928,292,EVM,mRNA,2914,394870,292,1.00
ptg008459l,740394,740703,309,EVM,mRNA,697574,830559,309,1.00
ptg008461l,1290213,1290513,300,EVM,mRNA,283192,1784771,300,1.00
ptg008462l,159497,159797,300,EVM,mRNA,100819,1007337,300,1.00
ptg008464l,46551,46881,330,EVM,mRNA,37078,977066,330,1.00
ptg008464l,282834,283149,315,EVM,mRNA,37078,977066,315,1.00
ptg008464l,600225,600553,328,EVM,mRNA,37078,977066,328,1.00
ptg008464l,955310,955599,289,EVM,mRNA,37078,977066,289,1.00
ptg008465l,1739715,1740028,313,EVM,mRNA,907436,2001879,313,1.00
ptg008467l,1287461,1287761,300,EVM,mRNA,1195617,1781442,300,1.00
ptg008472l,992209,992526,317,EVM,mRNA,102264,3038341,317,1.00
ptg008472l,1972032,1972322,290,EVM,mRNA,102264,3038341,290,1.00
ptg008473l,2026314,2026626,312,EVM,mRNA,1873712,2669575,312,1.00
ptg008475l,394523,394821,298,EVM,mRNA,209,1758570,298,1.00
ptg008475l,1080812,1081108,296,EVM,mRNA,209,1758570,296,1.00
ptg008479l,554052,554371,319,EVM,mRNA,495268,614749,319,1.00
ptg008479l,1104144,1104453,309,EVM,mRNA,1033156,1272234,309,1.00
ptg008481l,197795,198103,308,EVM,mRNA,20512,316115,308,1.00
ptg008482l,176929,177237,308,EVM,mRNA,14407,1602615,308,1.00
ptg008482l,692839,693144,305,EVM,mRNA,14407,1602615,305,1.00
ptg008482l,893566,893845,279,EVM,mRNA,14407,1602615,279,1.00
ptg008482l,1327554,1327880,326,EVM,mRNA,14407,1602615,326,1.00
ptg008490l,1554879,1555167,288,EVM,mRNA,150181,1829326,288,1.00
ptg008491l,1543546,1543845,299,EVM,mRNA,1263486,1663163,299,1.00
ptg008496l,172472,172786,314,EVM,mRNA,4196,1330704,314,1.00
ptg008502l,294619,294930,311,EVM,mRNA,27924,1393625,311,1.00
ptg008502l,1292010,1292305,295,EVM,mRNA,27924,1393625,295,1.00
ptg008507l,2840267,2840566,299,EVM,mRNA,1512383,3583327,299,1.00
ptg008507l,3459785,3460072,287,EVM,mRNA,1512383,3583327,287,1.00
ptg008509l,398308,398628,320,EVM,mRNA,356083,1602222,320,1.00
ptg008509l,535432,535692,260,EVM,mRNA,356083,1602222,260,1.00
ptg008515l,331126,331411,285,EVM,mRNA,225873,717002,285,1.00
ptg008515l,400336,400633,297,EVM,mRNA,225873,717002,297,1.00
ptg008515l,674972,675246,274,EVM,mRNA,225873,717002,274,1.00
ptg008519l,1341369,1341678,309,EVM,mRNA,388018,1860701,309,1.00
ptg008520l,595391,595648,257,EVM,mRNA,513338,1019699,257,1.00
ptg008526l,642292,642567,275,EVM,mRNA,225185,1676011,275,1.00
ptg008526l,750048,750372,324,EVM,mRNA,225185,1676011,324,1.00
ptg008528l,574818,575098,280,EVM,mRNA,183591,696940,280,1.00
ptg008534l,1150434,1150722,288,EVM,mRNA,73818,1271247,288,1.00
ptg008535l,669049,669354,305,EVM,mRNA,530504,872231,305,1.00
ptg008539l,1667397,1667654,257,EVM,mRNA,1599384,2082186,257,1.00
ptg008539l,1938446,1938749,303,EVM,mRNA,1599384,2082186,303,1.00
ptg008544l,978487,978815,328,EVM,mRNA,594225,2843007,328,1.00
ptg008544l,1576335,1576636,301,EVM,mRNA,594225,2843007,301,1.00
ptg008545l,996683,997004,321,EVM,mRNA,38853,1424802,321,1.00
ptg008547l,195106,195419,313,EVM,mRNA,47169,1230603,313,1.00
ptg008547l,2206437,2206706,269,EVM,mRNA,2190304,2809131,269,1.00
ptg008547l,2306700,2306982,282,EVM,mRNA,2190304,2809131,282,1.00
ptg008547l,2416908,2417196,288,EVM,mRNA,2190304,2809131,288,1.00
ptg008547l,2547461,2547760,299,EVM,mRNA,2190304,2809131,299,1.00
ptg008547l,2598556,2598839,283,EVM,mRNA,2190304,2809131,283,1.00
ptg008547l,2759119,2759412,293,EVM,mRNA,2190304,2809131,293,1.00
ptg008550l,509654,509944,290,EVM,mRNA,131458,1101240,290,1.00
ptg008552l,499662,499967,305,EVM,mRNA,490163,501167,305,1.00
ptg008552l,1139714,1140026,312,EVM,mRNA,690388,1339874,312,1.00
ptg008553l,478103,478399,296,EVM,mRNA,466576,608282,296,1.00
ptg008553l,1153259,1153587,328,EVM,mRNA,823608,1380157,328,1.00
ptg008554l,2042691,2042974,283,EVM,mRNA,1219337,2862960,283,1.00
ptg008554l,2401405,2401702,297,EVM,mRNA,1219337,2862960,297,1.00
ptg008554l,2408578,2408877,299,EVM,mRNA,1219337,2862960,299,1.00
ptg008554l,3509490,3509791,301,EVM,mRNA,2866353,3703910,301,1.00
ptg008556l,1139635,1139953,318,EVM,mRNA,1129982,1276535,318,1.00
ptg008559l,5689667,5689959,292,EVM,mRNA,5102975,6026352,292,1.00
ptg008559l,6007513,6007791,278,EVM,mRNA,5102975,6026352,278,1.00
ptg008560l,194340,194635,295,EVM,mRNA,58437,825653,295,1.00
ptg008561l,564853,565137,284,EVM,mRNA,102461,993000,284,1.00
ptg008562l,68932,69260,328,EVM,mRNA,22278,156700,328,1.00
ptg008562l,1018318,1018637,319,EVM,mRNA,508903,1064753,319,1.00
ptg008563l,253912,254210,298,EVM,mRNA,138841,637876,298,1.00
ptg008563l,330213,330505,292,EVM,mRNA,138841,637876,292,1.00
ptg008565l,481562,481839,277,EVM,mRNA,105382,501800,277,1.00
ptg008569l,420639,420964,325,EVM,mRNA,343327,670260,325,1.00
ptg008573l,1110711,1111008,297,EVM,mRNA,1028083,1334472,297,1.00
ptg008579l,601879,602189,310,EVM,mRNA,366585,1365437,310,1.00
ptg008579l,1020973,1021268,295,EVM,mRNA,366585,1365437,295,1.00
ptg008579l,1121391,1121684,293,EVM,mRNA,366585,1365437,293,1.00
ptg008579l,2863650,2863978,328,EVM,mRNA,2789858,3062729,328,1.00
ptg008579l,3657072,3657381,309,EVM,mRNA,3464888,3667562,309,1.00
ptg008581l,405531,405836,305,EVM,mRNA,390485,418237,305,1.00
ptg008588l,771073,771378,305,EVM,mRNA,654791,1051651,305,1.00
ptg008590l,972528,972868,340,EVM,mRNA,420498,2036027,340,1.00
ptg008590l,1513559,1513907,348,EVM,mRNA,420498,2036027,348,1.00
ptg008590l,1726388,1726663,275,EVM,mRNA,420498,2036027,275,1.00
ptg008592l,4896837,4897122,285,EVM,mRNA,3532209,5269412,285,1.00
ptg008593l,802455,802736,281,EVM,mRNA,455452,928021,281,1.00
ptg008598l,951238,951519,281,EVM,mRNA,937815,1583397,281,1.00
ptg008598l,1865807,1866118,311,EVM,mRNA,1731058,2387081,311,1.00
ptg008598l,1882179,1882496,317,EVM,mRNA,1731058,2387081,317,1.00
ptg008601l,867599,867911,312,EVM,mRNA,715008,921319,312,1.00
ptg008601l,1592740,1593052,312,EVM,mRNA,1518908,1690367,312,1.00
ptg008604l,175281,175593,312,EVM,mRNA,11575,808598,312,1.00
ptg008604l,598256,598567,311,EVM,mRNA,11575,808598,311,1.00
ptg008606l,184175,184490,315,EVM,mRNA,47771,942864,315,1.00
ptg008606l,184175,184490,315,GeneWise,mRNA,78259,942861,315,1.00
ptg008606l,890247,890543,296,EVM,mRNA,47771,942864,296,1.00
ptg008606l,890247,890543,296,GeneWise,mRNA,78259,942861,296,1.00
ptg008610l,2872905,2873170,265,EVM,mRNA,2408788,2873073,168,0.63
ptg008610l,3220892,3221174,282,EVM,mRNA,3084357,3338080,282,1.00
ptg008619l,1803265,1803548,283,EVM,mRNA,1411276,1851320,283,1.00
ptg008619l,3548457,3548735,278,EVM,mRNA,3478811,3800955,278,1.00
ptg008631l,1483522,1483836,314,EVM,mRNA,165965,2206123,314,1.00
ptg008632l,1231587,1231876,289,EVM,mRNA,844393,2203937,289,1.00
ptg008645l,1366920,1367193,273,EVM,mRNA,1097358,1499377,273,1.00
ptg008651l,2949771,2950092,321,EVM,mRNA,2344661,3559162,321,1.00
ptg008652l,406071,406392,321,EVM,mRNA,379757,408527,321,1.00
ptg008652l,2783325,2783613,288,EVM,mRNA,2714290,2976259,288,1.00
ptg008661l,574086,574401,315,EVM,mRNA,130476,684503,315,1.00
ptg008661l,972679,972975,296,EVM,mRNA,890038,1302917,296,1.00
ptg008661l,1295741,1296024,283,EVM,mRNA,890038,1302917,283,1.00
ptg008665l,762581,762887,306,EVM,mRNA,700655,791203,306,1.00
ptg008679l,690133,690446,313,EVM,mRNA,517114,908897,313,1.00
ptg008679l,2717940,2718236,296,EVM,mRNA,1232383,2937566,296,1.00
ptg008679l,3633520,3633813,293,EVM,mRNA,3610699,3994481,293,1.00
ptg008679l,3675271,3675554,283,EVM,mRNA,3610699,3994481,283,1.00
ptg008681l,1298137,1298412,275,EVM,mRNA,1109865,1992216,275,1.00
ptg008681l,1901714,1902029,315,EVM,mRNA,1109865,1992216,315,1.00
ptg008681l,2418919,2419234,315,EVM,mRNA,2273359,2436859,315,1.00
ptg008682l,659946,660224,278,EVM,mRNA,79733,1433224,278,1.00
ptg008682l,1100643,1100914,271,EVM,mRNA,79733,1433224,271,1.00
ptg008683l,665556,665870,314,EVM,mRNA,226876,1291341,314,1.00
ptg008683l,1042381,1042674,293,EVM,mRNA,226876,1291341,293,1.00
ptg008687l,2317082,2317361,279,EVM,mRNA,1939027,2500578,279,1.00
ptg008691l,655561,655842,281,EVM,mRNA,636846,850250,281,1.00
ptg008693l,233615,233882,267,EVM,mRNA,132019,596925,267,1.00
ptg008693l,263087,263406,319,EVM,mRNA,132019,596925,319,1.00
ptg008700l,2924618,2924927,309,EVM,mRNA,1773026,3886539,309,1.00
ptg008700l,2987015,2987312,297,EVM,mRNA,1773026,3886539,297,1.00
ptg008700l,3285422,3285731,309,EVM,mRNA,1773026,3886539,309,1.00
ptg008700l,3501986,3502259,273,EVM,mRNA,1773026,3886539,273,1.00
ptg008706l,170234,170529,295,EVM,mRNA,31969,631308,295,1.00
ptg008707l,763533,763815,282,EVM,mRNA,294508,1510117,282,1.00
ptg008707l,795254,795519,265,EVM,mRNA,294508,1510117,265,1.00
ptg008707l,1305323,1305613,290,EVM,mRNA,294508,1510117,290,1.00
ptg008708l,843329,843619,290,EVM,mRNA,519660,923154,290,1.00
ptg008712l,926852,927145,293,EVM,mRNA,876282,1234119,293,1.00
ptg008714l,646426,646729,303,EVM,mRNA,596899,647575,303,1.00
ptg008716l,1763718,1764045,327,EVM,mRNA,1275930,3605647,327,1.00
ptg008716l,2001426,2001726,300,EVM,mRNA,1275930,3605647,300,1.00
ptg008716l,2143666,2144019,353,EVM,mRNA,1275930,3605647,353,1.00
ptg008716l,2291354,2291665,311,EVM,mRNA,1275930,3605647,311,1.00
ptg008716l,2867709,2868031,322,EVM,mRNA,1275930,3605647,322,1.00
ptg008718l,249589,249892,303,EVM,mRNA,240269,261985,303,1.00
ptg008721l,1640836,1641105,269,EVM,mRNA,1511172,3344773,269,1.00
ptg008721l,2811387,2811693,306,EVM,mRNA,1511172,3344773,306,1.00
ptg008723l,1070410,1070723,313,EVM,mRNA,1034598,1086050,313,1.00
ptg008727l,1152067,1152389,322,EVM,mRNA,1149025,1211994,322,1.00
ptg008727l,2225860,2226176,316,EVM,mRNA,1992485,2579919,316,1.00
ptg008727l,3445585,3445903,318,EVM,mRNA,2952328,4120218,318,1.00
ptg008729l,2981704,2981978,274,EVM,mRNA,2670161,3343939,274,1.00
ptg008729l,3071759,3072079,320,EVM,mRNA,2670161,3343939,320,1.00
ptg008729l,4425404,4425720,316,EVM,mRNA,3861508,4803596,316,1.00
ptg008731l,5109883,5110208,325,EVM,mRNA,3200600,5868714,325,1.00
ptg008736l,1802714,1803029,315,EVM,mRNA,1056892,1905037,315,1.00
ptg008736l,1823025,1823315,290,EVM,mRNA,1056892,1905037,290,1.00
ptg008736l,1853030,1853319,289,EVM,mRNA,1056892,1905037,289,1.00
ptg008737l,1162433,1162700,267,EVM,mRNA,224811,1174172,267,1.00
ptg008740l,995045,995350,305,EVM,mRNA,841933,1515246,305,1.00
ptg008740l,2042869,2043175,306,EVM,mRNA,1791089,2189674,306,1.00
ptg008741l,751423,751750,327,EVM,mRNA,739918,922121,327,1.00
ptg008741l,1533496,1533797,301,EVM,mRNA,1532762,1534171,301,1.00
ptg008741l,3156146,3156428,282,EVM,mRNA,3037705,3972879,282,1.00
ptg008741l,3697179,3697483,304,EVM,mRNA,3037705,3972879,304,1.00
ptg008746l,223040,223349,309,EVM,mRNA,198428,443754,309,1.00
ptg008746l,371285,371583,298,EVM,mRNA,198428,443754,298,1.00
ptg008749l,322926,323238,312,EVM,mRNA,182110,528661,312,1.00
ptg008749l,2281632,2281937,305,EVM,mRNA,1938750,2873326,305,1.00
ptg008755l,407703,408000,297,EVM,mRNA,327198,692262,297,1.00
ptg008760l,1668707,1669029,322,EVM,mRNA,219499,2204699,322,1.00
ptg008760l,1679081,1679403,322,EVM,mRNA,219499,2204699,322,1.00
ptg008760l,1718246,1718528,282,EVM,mRNA,219499,2204699,282,1.00
ptg008760l,2037443,2037757,314,EVM,mRNA,219499,2204699,314,1.00
ptg008762l,257503,257785,282,EVM,mRNA,207381,719747,282,1.00
ptg008764l,437626,437952,326,EVM,mRNA,365691,883502,326,1.00
ptg008764l,872471,872754,283,EVM,mRNA,365691,883502,283,1.00
ptg008765l,785485,785762,277,EVM,mRNA,577193,1569772,277,1.00
ptg008765l,1062361,1062687,326,EVM,mRNA,577193,1569772,326,1.00
ptg008765l,1540649,1540932,283,EVM,mRNA,577193,1569772,283,1.00
ptg008777l,1013308,1013606,298,EVM,mRNA,1012280,1079545,298,1.00
ptg008778l,615749,616048,299,EVM,mRNA,151826,1017586,299,1.00
ptg008778l,1018964,1019227,263,EVM,mRNA,1018514,1587073,263,1.00
ptg008784l,1184208,1184516,308,EVM,mRNA,408011,1455883,308,1.00
ptg008784l,1242064,1242358,294,EVM,mRNA,408011,1455883,294,1.00
ptg008787l,2188669,2188968,299,EVM,mRNA,1421268,3581424,299,1.00
ptg008787l,2520270,2520546,276,EVM,mRNA,1421268,3581424,276,1.00
ptg008787l,2622692,2622987,295,EVM,mRNA,1421268,3581424,295,1.00
ptg008787l,3379549,3379864,315,EVM,mRNA,1421268,3581424,315,1.00
ptg008789l,592560,592853,293,EVM,mRNA,30348,1556978,293,1.00
ptg008789l,688435,688749,314,EVM,mRNA,30348,1556978,314,1.00
ptg008789l,861872,862182,310,EVM,mRNA,30348,1556978,310,1.00
ptg008790l,497902,498221,319,EVM,mRNA,469818,720282,319,1.00
ptg008790l,3308525,3308837,312,EVM,mRNA,3023997,3368275,312,1.00
ptg008795l,1137389,1137699,310,EVM,mRNA,951762,2325291,310,1.00
ptg008795l,1243170,1243479,309,EVM,mRNA,951762,2325291,309,1.00
ptg008795l,1961245,1961564,319,EVM,mRNA,951762,2325291,319,1.00
ptg008798l,505937,506195,258,EVM,mRNA,247049,730572,258,1.00
ptg008798l,615145,615467,322,EVM,mRNA,247049,730572,322,1.00
ptg008802l,548194,548497,303,EVM,mRNA,222260,909983,303,1.00
ptg008802l,619232,619559,327,EVM,mRNA,222260,909983,327,1.00
ptg008813l,652135,652447,312,EVM,mRNA,120199,929442,312,1.00
ptg008813l,780822,781141,319,EVM,mRNA,120199,929442,319,1.00
ptg008818l,243258,243570,312,EVM,mRNA,175794,1669723,312,1.00
ptg008818l,285588,285876,288,EVM,mRNA,175794,1669723,288,1.00
ptg008818l,730048,730340,292,EVM,mRNA,175794,1669723,292,1.00
ptg008818l,950452,950735,283,EVM,mRNA,175794,1669723,283,1.00
ptg008818l,1362805,1363086,281,EVM,mRNA,175794,1669723,281,1.00
ptg008822l,484437,484759,322,EVM,mRNA,65082,490848,322,1.00
ptg008825l,84088,84406,318,EVM,mRNA,17311,263158,318,1.00
ptg008830l,431501,431819,318,EVM,mRNA,10997,477311,318,1.00
ptg008830l,1447726,1448043,317,EVM,mRNA,706296,1476521,317,1.00
ptg008832l,489733,490028,295,EVM,mRNA,329734,1248080,295,1.00
ptg008838l,272853,273133,280,EVM,mRNA,12096,3687058,280,1.00
ptg008838l,424260,424572,312,EVM,mRNA,12096,3687058,312,1.00
ptg008838l,882123,882458,335,EVM,mRNA,12096,3687058,335,1.00
ptg008838l,2966040,2966343,303,EVM,mRNA,12096,3687058,303,1.00
ptg008838l,3080535,3080815,280,EVM,mRNA,12096,3687058,280,1.00
ptg008841l,456577,456854,277,EVM,mRNA,421706,515296,277,1.00
ptg008842l,817434,817733,299,EVM,mRNA,614227,977717,299,1.00
ptg008843l,371453,371755,302,EVM,mRNA,20965,1058332,302,1.00
ptg008843l,428247,428563,316,EVM,mRNA,20965,1058332,316,1.00
ptg008843l,612590,612865,275,EVM,mRNA,20965,1058332,275,1.00
ptg008843l,717071,717396,325,EVM,mRNA,20965,1058332,325,1.00
ptg008845l,1746045,1746333,288,EVM,mRNA,1445627,1810630,288,1.00
ptg008845l,2178075,2178363,288,EVM,mRNA,1848015,2779715,288,1.00
ptg008845l,3579072,3579379,307,EVM,mRNA,3017774,3602572,307,1.00
ptg008845l,3895368,3895668,300,EVM,mRNA,3735131,4163545,300,1.00
ptg008854l,726293,726589,296,EVM,mRNA,709350,1095256,296,1.00
ptg008854l,1235662,1235932,270,EVM,mRNA,1153241,1581106,270,1.00
ptg008854l,1718751,1719010,259,EVM,mRNA,1653698,1827939,259,1.00
ptg008854l,1742202,1742503,301,EVM,mRNA,1653698,1827939,301,1.00
ptg008854l,2203405,2203713,308,EVM,mRNA,2145840,2643136,308,1.00
ptg008856l,256532,256843,311,EVM,mRNA,241846,318135,311,1.00
ptg008856l,392526,392800,274,EVM,mRNA,387521,1143790,274,1.00
ptg008856l,624320,624579,259,EVM,mRNA,387521,1143790,259,1.00
ptg008856l,2125738,2126028,290,EVM,mRNA,1852354,2640403,290,1.00
ptg008861l,141758,142072,314,EVM,mRNA,79068,178242,314,1.00
ptg008870l,919,1226,307,EVM,mRNA,781,246464,307,1.00
ptg008877l,647277,647585,308,EVM,mRNA,32944,1133828,308,1.00
ptg008877l,775460,775718,258,EVM,mRNA,32944,1133828,258,1.00
ptg008877l,796036,796314,278,EVM,mRNA,32944,1133828,278,1.00
ptg008877l,989052,989333,281,EVM,mRNA,32944,1133828,281,1.00
ptg008877l,1931819,1932126,307,EVM,mRNA,1928039,2076990,307,1.00
ptg008879l,1129687,1129989,302,EVM,mRNA,1110326,1328780,302,1.00
ptg008881l,279865,280166,301,EVM,mRNA,218883,536802,301,1.00
ptg008884l,1127620,1127916,296,EVM,mRNA,1081360,1254459,296,1.00
ptg008886l,634742,635049,307,EVM,mRNA,634133,1117604,307,1.00
ptg008886l,1004578,1004863,285,EVM,mRNA,634133,1117604,285,1.00
ptg008887l,754272,754414,142,EVM,mRNA,751375,809236,142,1.00
ptg008890l,981943,982225,282,EVM,mRNA,930142,1606943,282,1.00
ptg008890l,1565728,1566010,282,EVM,mRNA,930142,1606943,282,1.00
ptg008890l,2020719,2021031,312,EVM,mRNA,1955612,2187297,312,1.00
ptg008893l,1033269,1033567,298,EVM,mRNA,1010203,1249160,298,1.00
ptg008908l,418631,418932,301,EVM,mRNA,400692,545786,301,1.00
ptg008909l,551688,551998,310,EVM,mRNA,272951,1397023,310,1.00
ptg008911l,206688,206966,278,EVM,mRNA,5235,990915,278,1.00
ptg008912l,289418,289720,302,EVM,mRNA,209635,364826,302,1.00
ptg008916l,610975,611280,305,EVM,mRNA,303139,769847,305,1.00
ptg008917l,908666,908994,328,EVM,mRNA,852779,1711767,328,1.00
ptg008917l,1573444,1573772,328,EVM,mRNA,852779,1711767,328,1.00
ptg008928l,807518,807809,291,EVM,mRNA,713289,1245904,291,1.00
ptg008928l,1949971,1950303,332,EVM,mRNA,1621629,2794891,332,1.00
ptg008928l,2238767,2239070,303,EVM,mRNA,1621629,2794891,303,1.00
ptg008928l,3397706,3398040,334,EVM,mRNA,3276996,4104564,334,1.00
ptg008934l,73378,73708,330,EVM,mRNA,72295,92046,330,1.00
ptg008937l,1559450,1559751,301,EVM,mRNA,1212135,1818995,301,1.00
ptg008937l,1637527,1637786,259,EVM,mRNA,1212135,1818995,259,1.00
ptg008940l,2061287,2061609,322,EVM,mRNA,1540385,2803344,322,1.00
ptg008940l,2757901,2758225,324,EVM,mRNA,1540385,2803344,324,1.00
ptg008944l,599228,599547,319,EVM,mRNA,487852,886422,319,1.00
ptg008944l,848454,848748,294,EVM,mRNA,487852,886422,294,1.00
ptg008945l,749827,750112,285,EVM,mRNA,614379,841543,285,1.00
ptg008963l,300152,300477,325,EVM,mRNA,205764,927986,325,1.00
ptg008963l,827276,827577,301,EVM,mRNA,205764,927986,301,1.00
ptg008963l,1079602,1079938,336,EVM,mRNA,968472,1301038,336,1.00
ptg008963l,1471474,1471790,316,EVM,mRNA,1454473,2108874,316,1.00
ptg008964l,482824,483102,278,EVM,mRNA,12355,1061118,278,1.00
ptg008964l,1060642,1060968,326,EVM,mRNA,12355,1061118,326,1.00
ptg008967l,494286,494585,299,EVM,mRNA,169160,1044727,299,1.00
ptg008969l,2727427,2727743,316,EVM,mRNA,2707029,3992610,316,1.00
ptg008969l,3060004,3060303,299,EVM,mRNA,2707029,3992610,299,1.00
ptg008972l,271026,271345,319,EVM,mRNA,245986,915459,319,1.00
ptg008974l,468612,468898,286,EVM,mRNA,86606,531179,286,1.00
ptg008977l,1298459,1298759,300,EVM,mRNA,909782,1353123,300,1.00
ptg008982l,3636626,3636940,314,EVM,mRNA,3489551,4114046,314,1.00
ptg008983l,44477,44764,287,EVM,mRNA,37452,217625,287,1.00
ptg008990l,216504,216769,265,EVM,mRNA,193245,1343395,265,1.00
ptg008990l,688444,688737,293,EVM,mRNA,193245,1343395,293,1.00
ptg008990l,1882608,1882908,300,EVM,mRNA,1548516,2618543,300,1.00
ptg008990l,2525815,2526108,293,EVM,mRNA,1548516,2618543,293,1.00
ptg008992l,3200373,3200662,289,EVM,mRNA,2404247,3502103,289,1.00
ptg008999l,946093,946386,293,EVM,mRNA,212359,1059362,293,1.00
ptg008999l,992574,992717,143,EVM,mRNA,212359,1059362,143,1.00
ptg008999l,1371202,1371493,291,EVM,mRNA,1333273,1424511,291,1.00
ptg009002l,555914,556236,322,EVM,mRNA,481597,580808,322,1.00
ptg009011l,298362,298661,299,EVM,mRNA,30818,310883,299,1.00
ptg009012l,1541887,1542164,277,EVM,mRNA,919829,2711017,277,1.00
ptg009012l,2554278,2554575,297,EVM,mRNA,919829,2711017,297,1.00
ptg009020l,1607321,1607643,322,EVM,mRNA,583212,1691112,322,1.00
ptg009022l,110060,110379,319,EVM,mRNA,105677,1514942,319,1.00
ptg009022l,653960,654264,304,EVM,mRNA,105677,1514942,304,1.00
ptg009022l,1778546,1778850,304,EVM,mRNA,1732551,1945888,304,1.00
ptg009026l,332342,332665,323,EVM,mRNA,16092,430793,323,1.00
ptg009028l,417240,417576,336,EVM,mRNA,125489,713497,336,1.00
ptg009028l,1826800,1827114,314,EVM,mRNA,1762739,2352244,314,1.00
ptg009029l,864956,865255,299,EVM,mRNA,689773,5012560,299,1.00
ptg009029l,1161070,1161375,305,EVM,mRNA,689773,5012560,305,1.00
ptg009029l,1255808,1256134,326,EVM,mRNA,689773,5012560,326,1.00
ptg009029l,1293573,1293900,327,EVM,mRNA,689773,5012560,327,1.00
ptg009029l,1788791,1789116,325,EVM,mRNA,689773,5012560,325,1.00
ptg009029l,1885637,1885945,308,EVM,mRNA,689773,5012560,308,1.00
ptg009029l,3212844,3213132,288,EVM,mRNA,689773,5012560,288,1.00
ptg009029l,3212844,3213138,294,EVM,mRNA,689773,5012560,294,1.00
ptg009029l,3303852,3304148,296,EVM,mRNA,689773,5012560,296,1.00
ptg009029l,4346147,4346459,312,EVM,mRNA,689773,5012560,312,1.00
ptg009029l,4421974,4422289,315,EVM,mRNA,689773,5012560,315,1.00
ptg009029l,4802726,4802999,273,EVM,mRNA,689773,5012560,273,1.00
ptg009035l,1098727,1099010,283,EVM,mRNA,1040863,1451007,283,1.00
ptg009038l,762001,762301,300,EVM,mRNA,106634,767463,300,1.00
ptg009039l,409499,409792,293,EVM,mRNA,17320,505443,293,1.00
ptg009039l,1509974,1510289,315,EVM,mRNA,579350,1768165,315,1.00
ptg009047l,351590,351872,282,EVM,mRNA,98123,1346565,282,1.00
ptg009047l,466862,467199,337,EVM,mRNA,98123,1346565,337,1.00
ptg009047l,1180053,1180328,275,EVM,mRNA,98123,1346565,275,1.00
ptg009048l,464371,464661,290,EVM,mRNA,124249,1609524,290,1.00
ptg009048l,675168,675447,279,EVM,mRNA,124249,1609524,279,1.00
ptg009048l,2632693,2632973,280,EVM,mRNA,2422353,2937370,280,1.00
ptg009048l,2890647,2890936,289,EVM,mRNA,2422353,2937370,289,1.00
ptg009052l,488181,488502,321,EVM,mRNA,408462,524499,321,1.00
ptg009062l,1130577,1130887,310,EVM,mRNA,516312,1251697,310,1.00
ptg009064l,420825,421148,323,EVM,mRNA,225025,3017806,323,1.00
ptg009064l,680033,680335,302,EVM,mRNA,225025,3017806,302,1.00
ptg009064l,850530,850820,290,EVM,mRNA,225025,3017806,290,1.00
ptg009064l,1194104,1194385,281,EVM,mRNA,225025,3017806,281,1.00
ptg009064l,1389855,1390170,315,EVM,mRNA,225025,3017806,315,1.00
ptg009064l,1566913,1567207,294,EVM,mRNA,225025,3017806,294,1.00
ptg009064l,2369683,2370021,338,EVM,mRNA,225025,3017806,338,1.00
ptg009064l,2988335,2988650,315,EVM,mRNA,225025,3017806,315,1.00
ptg009064l,3015577,3015856,279,EVM,mRNA,225025,3017806,279,1.00
ptg009065l,519722,520043,321,EVM,mRNA,383135,832365,321,1.00
ptg009072l,58896,59203,307,EVM,mRNA,8586,154175,307,1.00
ptg009083l,874528,874851,323,EVM,mRNA,380605,940627,323,1.00
ptg009085l,1134187,1134495,308,EVM,mRNA,852870,1270941,308,1.00
ptg009088l,1258268,1258532,264,EVM,mRNA,1245868,1306044,264,1.00
ptg009101l,1843805,1844130,325,EVM,mRNA,31594,1951755,325,1.00
ptg009101l,3133705,3134022,317,EVM,mRNA,2881505,3212852,317,1.00
ptg009107l,1617815,1618129,314,EVM,mRNA,985970,2209200,314,1.00
ptg009107l,1833049,1833381,332,EVM,mRNA,985970,2209200,332,1.00
ptg009109l,377208,377536,328,EVM,mRNA,281616,574345,328,1.00
ptg009113l,243249,243539,290,EVM,mRNA,111446,1012046,290,1.00
ptg009116l,269932,270231,299,EVM,mRNA,4691,281577,299,1.00
ptg009120l,651075,651380,305,EVM,mRNA,405066,1070996,305,1.00
ptg009121l,277441,277727,286,EVM,mRNA,214562,316733,286,1.00
ptg009124l,1407646,1407946,300,EVM,mRNA,1285145,1905302,300,1.00
ptg009124l,1720787,1721073,286,EVM,mRNA,1285145,1905302,286,1.00
ptg009127l,415635,415958,323,EVM,mRNA,161955,775293,323,1.00
ptg009127l,435008,435307,299,EVM,mRNA,161955,775293,299,1.00
ptg009130l,505322,505598,276,EVM,mRNA,487552,1004527,276,1.00
ptg009131l,77971,78284,313,EVM,mRNA,63805,2474673,313,1.00
ptg009131l,1925125,1925405,280,EVM,mRNA,63805,2474673,280,1.00
ptg009142l,229425,229705,280,EVM,mRNA,43521,259485,280,1.00
ptg009143l,1519321,1519622,301,EVM,mRNA,1314354,1586968,301,1.00
ptg009147l,1123738,1124018,280,EVM,mRNA,1001663,1273225,280,1.00
ptg009151l,664344,664631,287,EVM,mRNA,633701,699402,287,1.00
ptg009161l,1556614,1556913,299,EVM,mRNA,1550590,2432540,299,1.00
ptg009161l,1643772,1644088,316,EVM,mRNA,1550590,2432540,316,1.00
ptg009161l,2294316,2294610,294,EVM,mRNA,1550590,2432540,294,1.00
ptg009162l,2787138,2787447,309,EVM,mRNA,1785461,3050727,309,1.00
ptg009169l,707171,707451,280,EVM,mRNA,525883,873399,280,1.00
ptg009171l,524234,524545,311,EVM,mRNA,47152,710830,311,1.00
ptg009171l,1178433,1178765,332,EVM,mRNA,1172682,1272641,332,1.00
ptg009171l,1492506,1492806,300,EVM,mRNA,1442599,1706812,300,1.00
ptg009172l,47765,48030,265,EVM,mRNA,26813,309252,265,1.00
ptg009172l,86187,86511,324,EVM,mRNA,26813,309252,324,1.00
ptg009173l,199085,199411,326,EVM,mRNA,2854,375115,326,1.00
ptg009173l,281400,281722,322,EVM,mRNA,2854,375115,322,1.00
ptg009178l,2004453,2004772,319,EVM,mRNA,1335491,2276322,319,1.00
ptg009179l,238484,238763,279,EVM,mRNA,52408,1091700,279,1.00
ptg009179l,797922,798201,279,EVM,mRNA,52408,1091700,279,1.00
ptg009179l,994927,995216,289,EVM,mRNA,52408,1091700,289,1.00
ptg009179l,1838684,1838989,305,EVM,mRNA,1132190,2994991,305,1.00
ptg009179l,2788571,2788833,262,EVM,mRNA,1132190,2994991,262,1.00
ptg009182l,120032,120341,309,EVM,mRNA,1252,718877,309,1.00
ptg009182l,194409,194698,289,EVM,mRNA,1252,718877,289,1.00
ptg009182l,350061,350349,288,EVM,mRNA,1252,718877,288,1.00
ptg009187l,785248,785570,322,EVM,mRNA,135550,978830,322,1.00
ptg009188l,1079817,1080115,298,EVM,mRNA,543352,1926973,298,1.00
ptg009190l,1070874,1071160,286,EVM,mRNA,178531,2270480,286,1.00
ptg009193l,781650,781945,295,EVM,mRNA,500805,993461,295,1.00
ptg009197l,1061804,1062062,258,EVM,mRNA,877958,1497780,258,1.00
ptg009197l,1401138,1401427,289,EVM,mRNA,877958,1497780,289,1.00
ptg009202l,266663,266963,300,EVM,mRNA,33956,715836,300,1.00
ptg009206l,1514416,1514692,276,EVM,mRNA,1431370,2164430,276,1.00
ptg009206l,1722515,1722820,305,EVM,mRNA,1431370,2164430,305,1.00
ptg009208l,677264,677565,301,EVM,mRNA,658273,1304853,301,1.00
ptg009219l,1566266,1566577,311,EVM,mRNA,526582,2436565,311,1.00
ptg009221l,2279489,2279794,305,EVM,mRNA,2030250,2283044,305,1.00
ptg009222l,794219,794547,328,EVM,mRNA,613083,1461645,328,1.00
ptg009222l,896282,896566,284,EVM,mRNA,613083,1461645,284,1.00
ptg009224l,1620979,1621295,316,EVM,mRNA,860577,5408342,316,1.00
ptg009224l,2032246,2032522,276,EVM,mRNA,860577,5408342,276,1.00
ptg009224l,2122624,2122926,302,EVM,mRNA,860577,5408342,302,1.00
ptg009224l,3730248,3730541,293,EVM,mRNA,860577,5408342,293,1.00
ptg009224l,3928313,3928625,312,EVM,mRNA,860577,5408342,312,1.00
ptg009225l,1500038,1500330,292,EVM,mRNA,698103,1834906,292,1.00
ptg009227l,175165,175477,312,EVM,mRNA,61780,192003,312,1.00
ptg009229l,425039,425355,316,EVM,mRNA,225483,870924,316,1.00
ptg009230l,449076,449360,284,EVM,mRNA,306476,535498,284,1.00
ptg009235l,553877,554172,295,EVM,mRNA,173469,1241156,295,1.00
ptg009235l,1013025,1013326,301,EVM,mRNA,173469,1241156,301,1.00
ptg009238l,548806,549130,324,EVM,mRNA,384207,632950,324,1.00
ptg009250l,1891415,1891728,313,EVM,mRNA,783781,2311816,313,1.00
ptg009255l,1067982,1068254,272,EVM,mRNA,384483,4004544,272,1.00
ptg009255l,1182214,1182505,291,EVM,mRNA,384483,4004544,291,1.00
ptg009255l,1417086,1417410,324,EVM,mRNA,384483,4004544,324,1.00
ptg009255l,1783866,1784194,328,EVM,mRNA,384483,4004544,328,1.00
ptg009255l,3271661,3271980,319,EVM,mRNA,384483,4004544,319,1.00
ptg009255l,3931254,3931531,277,EVM,mRNA,384483,4004544,277,1.00
ptg009258l,1091138,1091446,308,EVM,mRNA,940408,1214754,308,1.00
ptg009262l,94887,95181,294,EVM,mRNA,308,719589,294,1.00
ptg009262l,1629517,1629798,281,EVM,mRNA,1298197,2402159,281,1.00
ptg009262l,2343945,2344255,310,EVM,mRNA,1298197,2402159,310,1.00
ptg009262l,3474639,3474894,255,EVM,mRNA,3149785,3721721,255,1.00
ptg009271l,926432,926747,315,EVM,mRNA,85186,1316289,315,1.00
ptg009271l,3996701,3996999,298,EVM,mRNA,3541721,4866154,298,1.00
ptg009271l,5769442,5769744,302,EVM,mRNA,5267542,5981860,302,1.00
ptg009276l,433973,434250,277,EVM,mRNA,326405,934530,277,1.00
ptg009276l,865928,866220,292,EVM,mRNA,326405,934530,292,1.00
ptg009278l,787638,787937,299,EVM,mRNA,695944,1612821,299,1.00
ptg009278l,1179004,1179304,300,EVM,mRNA,695944,1612821,300,1.00
ptg009282l,424983,425261,278,EVM,mRNA,290817,583102,278,1.00
ptg009285l,435891,436176,285,EVM,mRNA,389287,464503,285,1.00
ptg009285l,1375494,1375784,290,EVM,mRNA,1043056,1751281,290,1.00
ptg009286l,737972,738276,304,EVM,mRNA,353544,1628420,304,1.00
ptg009286l,1103605,1103934,329,EVM,mRNA,353544,1628420,329,1.00
ptg009287l,307895,308186,291,EVM,mRNA,134304,353700,291,1.00
ptg009287l,1043450,1043779,329,EVM,mRNA,909763,1182450,329,1.00
ptg009287l,1074126,1074421,295,EVM,mRNA,909763,1182450,295,1.00
ptg009288l,276244,276550,306,EVM,mRNA,37186,306530,306,1.00
ptg009288l,1013693,1013955,262,EVM,mRNA,562389,1648314,262,1.00
ptg009288l,1190578,1190873,295,EVM,mRNA,562389,1648314,295,1.00
ptg009288l,1630756,1631069,313,EVM,mRNA,562389,1648314,313,1.00
ptg009288l,1694636,1694949,313,EVM,mRNA,1676578,1816717,313,1.00
ptg009292l,575039,575355,316,EVM,mRNA,500210,706061,316,1.00
ptg009300l,1228838,1229126,288,EVM,mRNA,859281,1949201,288,1.00
ptg009300l,1563782,1564072,290,EVM,mRNA,859281,1949201,290,1.00
ptg009300l,2158898,2159179,281,EVM,mRNA,2104672,2275163,281,1.00
ptg009300l,2268266,2268584,318,EVM,mRNA,2104672,2275163,318,1.00
ptg009307l,488379,488686,307,EVM,mRNA,103996,731849,307,1.00
ptg009307l,643149,643476,327,EVM,mRNA,103996,731849,327,1.00
ptg009312l,224016,224298,282,EVM,mRNA,11929,224060,44,0.16
ptg009318l,1895861,1896172,311,EVM,mRNA,1701467,2447385,311,1.00
ptg009318l,2974219,2974528,309,EVM,mRNA,2940656,3410798,309,1.00
ptg009318l,3434902,3435197,295,EVM,mRNA,3411052,3463357,295,1.00
ptg009322l,585150,585461,311,EVM,mRNA,230819,1793370,311,1.00
ptg009322l,1540597,1540904,307,EVM,mRNA,230819,1793370,307,1.00
ptg009323l,1160012,1160314,302,EVM,mRNA,356224,1564519,302,1.00
ptg009323l,1290910,1291220,310,EVM,mRNA,356224,1564519,310,1.00
ptg009325l,969861,970168,307,EVM,mRNA,622465,1044524,307,1.00
ptg009331l,575164,575478,314,EVM,mRNA,64676,2521865,314,1.00
ptg009331l,1362572,1362888,316,EVM,mRNA,64676,2521865,316,1.00
ptg009331l,2257344,2257656,312,EVM,mRNA,64676,2521865,312,1.00
ptg009336l,1443317,1443607,290,EVM,mRNA,1090324,1801514,290,1.00
ptg009336l,1545933,1546233,300,EVM,mRNA,1090324,1801514,300,1.00
ptg009342l,306132,306419,287,EVM,mRNA,165378,660351,287,1.00
ptg009353l,23381,23685,304,EVM,mRNA,21777,101457,304,1.00
ptg009353l,2405837,2406166,329,EVM,mRNA,2374780,2703250,329,1.00
ptg009358l,127054,127360,306,EVM,mRNA,96854,139330,306,1.00
ptg009361l,517645,517966,321,EVM,mRNA,450168,562698,321,1.00
ptg009361l,851896,852199,303,EVM,mRNA,849735,1196063,303,1.00
ptg009361l,1687530,1687841,311,EVM,mRNA,1676134,1810345,311,1.00
ptg009362l,1449704,1449990,286,EVM,mRNA,1390937,1535376,286,1.00
ptg009367l,358871,359166,295,EVM,mRNA,15080,779294,295,1.00
ptg009370l,1427283,1427582,299,EVM,mRNA,995855,5551067,299,1.00
ptg009370l,2661722,2662020,298,EVM,mRNA,995855,5551067,298,1.00
ptg009370l,5524121,5524440,319,EVM,mRNA,995855,5551067,319,1.00
ptg009378l,1429155,1429464,309,EVM,mRNA,256294,1701389,309,1.00
ptg009381l,445090,445387,297,EVM,mRNA,288711,556670,297,1.00
ptg009385l,690474,690795,321,EVM,mRNA,534656,1234683,321,1.00
ptg009385l,1049450,1049763,313,EVM,mRNA,534656,1234683,313,1.00
ptg009385l,1899474,1899797,323,EVM,mRNA,1688887,2829259,323,1.00
ptg009387l,957240,957558,318,EVM,mRNA,70,1244700,318,1.00
ptg009387l,2022031,2022348,317,EVM,mRNA,1245858,3743518,317,1.00
ptg009393l,1303619,1303913,294,EVM,mRNA,98599,2629256,294,1.00
ptg009393l,1982178,1982480,302,EVM,mRNA,98599,2629256,302,1.00
ptg009393l,3367906,3368213,307,EVM,mRNA,2793877,3386920,307,1.00
ptg009396l,343422,343698,276,EVM,mRNA,302039,375484,276,1.00
ptg009403l,241995,242309,314,EVM,mRNA,10553,363945,314,1.00
ptg009403l,1064800,1065111,311,EVM,mRNA,1059348,1699017,311,1.00
ptg009404l,850543,850872,329,EVM,mRNA,679907,1527394,329,1.00
ptg009404l,1271369,1271654,285,EVM,mRNA,679907,1527394,285,1.00
ptg009405l,90899,91213,314,EVM,mRNA,84804,230101,314,1.00
ptg009405l,845034,845327,293,EVM,mRNA,834847,856232,293,1.00
ptg009405l,1507351,1507650,299,EVM,mRNA,1143484,1584463,299,1.00
ptg009409l,3540476,3540786,310,EVM,mRNA,3225859,3645599,310,1.00
ptg009423l,11665,11964,299,EVM,mRNA,1643,285733,299,1.00
ptg009428l,386968,387270,302,EVM,mRNA,291594,633384,302,1.00
ptg009429l,2081278,2081603,325,EVM,mRNA,29177,2135835,325,1.00
ptg009433l,893771,894067,296,EVM,mRNA,679450,1158404,296,1.00
ptg009441l,789757,790075,318,EVM,mRNA,770270,1608303,318,1.00
ptg009441l,1037314,1037640,326,EVM,mRNA,770270,1608303,326,1.00
ptg009441l,1360914,1361226,312,EVM,mRNA,770270,1608303,312,1.00
ptg009441l,1459090,1459374,284,EVM,mRNA,770270,1608303,284,1.00
ptg009441l,1469864,1470160,296,EVM,mRNA,770270,1608303,296,1.00
ptg009443l,622971,623271,300,EVM,mRNA,460728,857721,300,1.00
ptg009445l,2201449,2201735,286,EVM,mRNA,1993034,2246025,286,1.00
ptg009447l,470270,470536,266,EVM,mRNA,252402,572536,266,1.00
ptg009447l,480460,480711,251,EVM,mRNA,252402,572536,251,1.00
ptg009447l,1664130,1664414,284,EVM,mRNA,734027,1863029,284,1.00
ptg009448l,1670784,1671108,324,EVM,mRNA,1623967,2136503,324,1.00
ptg009451l,1460106,1460408,302,EVM,mRNA,1457335,1504666,302,1.00
ptg009452l,1233275,1233584,309,EVM,mRNA,657331,1350658,309,1.00
ptg009452l,2625502,2625783,281,EVM,mRNA,2598739,2749415,281,1.00
ptg009453l,543676,543968,292,EVM,mRNA,471137,740344,292,1.00
ptg009459l,458071,458370,299,EVM,mRNA,43472,545397,299,1.00
ptg009460l,763860,764162,302,EVM,mRNA,20205,853170,302,1.00
ptg009465l,335129,335429,300,EVM,mRNA,312573,533793,300,1.00
ptg009465l,1074695,1074977,282,EVM,mRNA,743686,1374151,282,1.00
ptg009465l,2798130,2798417,287,EVM,mRNA,2131972,2840392,287,1.00
ptg009469l,1621043,1621341,298,EVM,mRNA,248530,1632744,298,1.00
ptg009471l,1486804,1487106,302,EVM,mRNA,1390430,1774726,302,1.00
ptg009471l,1547332,1547647,315,EVM,mRNA,1390430,1774726,315,1.00
ptg009474l,215510,215793,283,EVM,mRNA,37663,299257,283,1.00
ptg009476l,677932,678248,316,EVM,mRNA,430453,1022777,316,1.00
ptg009476l,713288,713574,286,EVM,mRNA,430453,1022777,286,1.00
ptg009478l,1678941,1679255,314,EVM,mRNA,1610191,2010005,314,1.00
ptg009490l,1104436,1104750,314,EVM,mRNA,3858,1317857,314,1.00
ptg009492l,2123399,2123695,296,EVM,mRNA,1649956,3003720,296,1.00
ptg009499l,314878,315190,312,EVM,mRNA,285070,342505,312,1.00
ptg009499l,1974860,1975163,303,EVM,mRNA,1926190,1979990,303,1.00
ptg009499l,2086587,2086887,300,EVM,mRNA,2034579,2384385,300,1.00
ptg009504l,598050,598377,327,EVM,mRNA,44584,944834,327,1.00
ptg009504l,909828,910142,314,EVM,mRNA,44584,944834,314,1.00
ptg009514l,633734,634048,314,EVM,mRNA,390682,701998,314,1.00
ptg009516l,4015115,4015402,287,EVM,mRNA,1955040,5211251,287,1.00
ptg009516l,4521254,4521561,307,EVM,mRNA,1955040,5211251,307,1.00
ptg009516l,4646048,4646348,300,EVM,mRNA,1955040,5211251,300,1.00
ptg009519l,1666241,1666558,317,EVM,mRNA,730213,1704603,317,1.00
ptg009524l,76655,76932,277,EVM,mRNA,60322,990338,277,1.00
ptg009524l,348846,349156,310,EVM,mRNA,60322,990338,310,1.00
ptg009527l,2044546,2044865,319,EVM,mRNA,1730781,2129579,319,1.00
ptg009528l,881165,881457,292,EVM,mRNA,742373,1253547,292,1.00
ptg009529l,734734,735054,320,EVM,mRNA,206608,737551,320,1.00
ptg009531l,192538,192821,283,EVM,mRNA,79255,850834,283,1.00
ptg009531l,583582,583891,309,EVM,mRNA,79255,850834,309,1.00
ptg009534l,710580,710871,291,EVM,mRNA,704706,855966,291,1.00
ptg009534l,837144,837415,271,EVM,mRNA,704706,855966,271,1.00
ptg009535l,1813049,1813334,285,EVM,mRNA,885298,2886362,285,1.00
ptg009535l,2832855,2833172,317,EVM,mRNA,885298,2886362,317,1.00
ptg009535l,2870467,2870784,317,EVM,mRNA,885298,2886362,317,1.00
ptg009536l,616359,616663,304,EVM,mRNA,556443,702158,304,1.00
ptg009536l,897041,897370,329,EVM,mRNA,827024,1333551,329,1.00
ptg009544l,870103,870413,310,EVM,mRNA,795182,1379528,310,1.00
ptg009546l,1631040,1631351,311,EVM,mRNA,1280554,1973631,311,1.00
ptg009548l,253375,253660,285,EVM,mRNA,39892,635821,285,1.00
ptg009549l,22493,22775,282,EVM,mRNA,48,89536,282,1.00
ptg009551l,698378,698686,308,EVM,mRNA,13414,1581626,308,1.00
ptg009551l,1062990,1063285,295,EVM,mRNA,13414,1581626,295,1.00
ptg009554l,259351,259632,281,EVM,mRNA,210859,513574,281,1.00
ptg009554l,497147,497435,288,EVM,mRNA,210859,513574,288,1.00
ptg009559l,819302,819610,308,EVM,mRNA,752796,912775,308,1.00
ptg009563l,146154,146451,297,EVM,mRNA,126935,340778,297,1.00
ptg009568l,1062789,1063109,320,EVM,mRNA,46739,1976090,320,1.00
ptg009578l,584496,584793,297,EVM,mRNA,1220,635775,297,1.00
ptg009579l,143491,143790,299,EVM,mRNA,68980,210752,299,1.00
ptg009582l,80696,80980,284,EVM,mRNA,2747,166326,284,1.00
ptg009586l,1407537,1407817,280,EVM,mRNA,1112121,1641342,280,1.00
ptg009589l,214574,214862,288,EVM,mRNA,114580,1394505,288,1.00
ptg009592l,1877951,1878250,299,EVM,mRNA,1852597,2235602,299,1.00
ptg009592l,1999025,1999315,290,EVM,mRNA,1852597,2235602,290,1.00
ptg009592l,2024684,2024989,305,EVM,mRNA,1852597,2235602,305,1.00
ptg009592l,2047309,2047624,315,EVM,mRNA,1852597,2235602,315,1.00
ptg009592l,2089467,2089740,273,EVM,mRNA,1852597,2235602,273,1.00
ptg009598l,3146141,3146415,274,EVM,mRNA,3125012,4064949,274,1.00
ptg009599l,651663,651921,258,EVM,mRNA,645589,954921,258,1.00
ptg009600l,2002301,2002620,319,EVM,mRNA,1863123,2025664,319,1.00
ptg009600l,2509317,2509639,322,EVM,mRNA,2348640,2655288,322,1.00
ptg009607l,407132,407451,319,EVM,mRNA,272572,812312,319,1.00
ptg009607l,477705,477989,284,EVM,mRNA,272572,812312,284,1.00
ptg009607l,645857,646137,280,EVM,mRNA,272572,812312,280,1.00
ptg009614l,469562,469874,312,EVM,mRNA,14875,665430,312,1.00
ptg009619l,83026,83343,317,EVM,mRNA,29164,187164,317,1.00
ptg009619l,659355,659598,243,EVM,mRNA,345951,1063396,243,1.00
ptg009621l,334903,335185,282,EVM,mRNA,240105,447956,282,1.00
ptg009621l,815442,815722,280,EVM,mRNA,573128,1063676,280,1.00
ptg009626l,970049,970366,317,EVM,mRNA,19747,1213690,317,1.00
ptg009626l,1190548,1190864,316,EVM,mRNA,19747,1213690,316,1.00
ptg009629l,222422,222719,297,EVM,mRNA,2915,2001779,297,1.00
ptg009629l,500239,500564,325,EVM,mRNA,2915,2001779,325,1.00
ptg009629l,1734589,1734896,307,EVM,mRNA,2915,2001779,307,1.00
ptg009633l,2301503,2301771,268,EVM,mRNA,2028389,2494210,268,1.00
ptg009643l,398999,399317,318,EVM,mRNA,38976,425534,318,1.00
ptg009643l,2273929,2274256,327,EVM,mRNA,2060813,2408833,327,1.00
ptg009643l,2937834,2938153,319,EVM,mRNA,2587419,3235117,319,1.00
ptg009645l,795601,795881,280,EVM,mRNA,661098,852946,280,1.00
ptg009646l,7513930,7514225,295,EVM,mRNA,6063915,7823754,295,1.00
ptg009648l,222826,223127,301,EVM,mRNA,1282,649234,301,1.00
ptg009649l,2000905,2001208,303,EVM,mRNA,1142119,2295706,303,1.00
ptg009652l,737361,737688,327,EVM,mRNA,387461,2311190,327,1.00
ptg009653l,696181,696444,263,EVM,mRNA,163576,1271483,263,1.00
ptg009657l,54694,54985,291,EVM,mRNA,1090,499937,291,1.00
ptg009660l,1116768,1117050,282,EVM,mRNA,736353,1906347,282,1.00
ptg009660l,1354605,1354876,271,EVM,mRNA,736353,1906347,271,1.00
ptg009660l,1484101,1484369,268,EVM,mRNA,736353,1906347,268,1.00
ptg009664l,3180569,3180868,299,EVM,mRNA,2942186,5130463,299,1.00
ptg009664l,3338606,3338888,282,EVM,mRNA,2942186,5130463,282,1.00
ptg009664l,4214698,4215013,315,EVM,mRNA,2942186,5130463,315,1.00
ptg009664l,4761199,4761487,288,EVM,mRNA,2942186,5130463,288,1.00
ptg009667l,585578,585852,274,EVM,mRNA,388866,1008256,274,1.00
ptg009685l,1786626,1786919,293,EVM,mRNA,1504310,2402917,293,1.00
ptg009686l,254649,254969,320,EVM,mRNA,77198,623678,320,1.00
ptg009686l,484737,485059,322,EVM,mRNA,77198,623678,322,1.00
ptg009693l,230891,231188,297,EVM,mRNA,195280,1934623,297,1.00
ptg009693l,863119,863398,279,EVM,mRNA,195280,1934623,279,1.00
ptg009694l,940477,940797,320,EVM,mRNA,320970,1281964,320,1.00
ptg009694l,1270551,1270871,320,EVM,mRNA,320970,1281964,320,1.00
ptg009698l,1095551,1095855,304,EVM,mRNA,555738,1177426,304,1.00
ptg009698l,1946611,1946883,272,EVM,mRNA,1621789,2139800,272,1.00
ptg009698l,1968005,1968300,295,EVM,mRNA,1621789,2139800,295,1.00
ptg009698l,3028728,3029053,325,EVM,mRNA,2241793,3071950,325,1.00
ptg009700l,1718715,1719035,320,EVM,mRNA,1381276,2036116,320,1.00
ptg009701l,49748,50060,312,EVM,mRNA,221,69451,312,1.00
ptg009701l,1336092,1336383,291,EVM,mRNA,673806,1486685,291,1.00
ptg009701l,1344093,1344366,273,EVM,mRNA,673806,1486685,273,1.00
ptg009705l,413109,413390,281,EVM,mRNA,259446,657585,281,1.00
ptg009705l,558599,558891,292,EVM,mRNA,259446,657585,292,1.00
ptg009705l,1611180,1611468,288,EVM,mRNA,1571187,1804697,288,1.00
ptg009705l,1756885,1757178,293,EVM,mRNA,1571187,1804697,293,1.00
ptg009706l,222304,222619,315,EVM,mRNA,139158,234734,315,1.00
ptg009711l,512177,512478,301,EVM,mRNA,451494,599335,301,1.00
ptg009711l,3201077,3201371,294,EVM,mRNA,3183828,3486014,294,1.00
ptg009713l,1007136,1007430,294,EVM,mRNA,279367,1928021,294,1.00
ptg009714l,333179,333502,323,EVM,mRNA,31476,455509,323,1.00
ptg009714l,1462086,1462388,302,EVM,mRNA,1327998,1771665,302,1.00
ptg009718l,3228344,3228647,303,EVM,mRNA,3207312,3274919,303,1.00
ptg009721l,461989,462263,274,EVM,mRNA,134,646311,274,1.00
ptg009721l,1008437,1008752,315,EVM,mRNA,966693,1101371,315,1.00
ptg009721l,1358689,1359016,327,EVM,mRNA,1255107,2881232,327,1.00
ptg009721l,2792636,2792951,315,EVM,mRNA,1255107,2881232,315,1.00
ptg009728l,1297810,1298111,301,EVM,mRNA,286659,1548294,301,1.00
ptg009731l,1183409,1183683,274,EVM,mRNA,1037030,1243895,274,1.00
ptg009733l,272315,272629,314,EVM,mRNA,193007,2156574,314,1.00
ptg009733l,827758,828074,316,EVM,mRNA,193007,2156574,316,1.00
ptg009734l,1626818,1627091,273,EVM,mRNA,535261,1802218,273,1.00
ptg009736l,227303,227597,294,EVM,mRNA,171868,2007614,294,1.00
ptg009736l,561255,561551,296,EVM,mRNA,171868,2007614,296,1.00
ptg009736l,1055493,1055792,299,EVM,mRNA,171868,2007614,299,1.00
ptg009736l,1075023,1075322,299,EVM,mRNA,171868,2007614,299,1.00
ptg009736l,1102746,1103045,299,EVM,mRNA,171868,2007614,299,1.00
ptg009736l,1220286,1220581,295,EVM,mRNA,171868,2007614,295,1.00
ptg009736l,1677386,1677681,295,EVM,mRNA,171868,2007614,295,1.00
ptg009736l,1999103,1999400,297,EVM,mRNA,171868,2007614,297,1.00
ptg009737l,28096,28406,310,EVM,mRNA,4746,1211067,310,1.00
ptg009738l,67138,67450,312,EVM,mRNA,42211,193869,312,1.00
ptg009747l,577057,577382,325,EVM,mRNA,247998,1206324,325,1.00
ptg009748l,1285178,1285479,301,EVM,mRNA,963345,3825977,301,1.00
ptg009748l,2708326,2708654,328,EVM,mRNA,963345,3825977,328,1.00
ptg009749l,201215,201513,298,EVM,mRNA,2312,902794,298,1.00
ptg009749l,813056,813362,306,EVM,mRNA,2312,902794,306,1.00
ptg009758l,146339,146647,308,EVM,mRNA,48403,827838,308,1.00
ptg009758l,753307,753611,304,EVM,mRNA,48403,827838,304,1.00
ptg009758l,1821342,1821622,280,EVM,mRNA,1480030,2968232,280,1.00
ptg009758l,1828542,1828823,281,EVM,mRNA,1480030,2968232,281,1.00
ptg009758l,4633911,4634198,287,EVM,mRNA,3914134,4918776,287,1.00
ptg009758l,4677806,4678105,299,EVM,mRNA,3914134,4918776,299,1.00
ptg009762l,518042,518339,297,EVM,mRNA,175363,2597567,297,1.00
ptg009762l,781126,781423,297,EVM,mRNA,175363,2597567,297,1.00
ptg009762l,1949342,1949639,297,EVM,mRNA,175363,2597567,297,1.00
ptg009763l,524147,524467,320,EVM,mRNA,490217,862991,320,1.00
ptg009769l,334394,334696,302,EVM,mRNA,25383,2119124,302,1.00
ptg009769l,773970,774283,313,EVM,mRNA,25383,2119124,313,1.00
ptg009769l,873740,874059,319,EVM,mRNA,25383,2119124,319,1.00
ptg009773l,178832,179127,295,EVM,mRNA,11654,942895,295,1.00
ptg009775l,287911,288205,294,EVM,mRNA,46294,339979,294,1.00
ptg009777l,374557,374874,317,EVM,mRNA,199780,679630,317,1.00
ptg009777l,586896,587181,285,EVM,mRNA,199780,679630,285,1.00
ptg009778l,218976,219302,326,EVM,mRNA,962,874098,326,1.00
ptg009778l,532838,533131,293,EVM,mRNA,962,874098,293,1.00
ptg009778l,592573,592896,323,EVM,mRNA,962,874098,323,1.00
ptg009779l,1133461,1133738,277,EVM,mRNA,947824,1289630,277,1.00
ptg009782l,371695,371968,273,EVM,mRNA,338500,504243,273,1.00
ptg009791l,1222193,1222487,294,EVM,mRNA,580816,2246825,294,1.00
ptg009791l,1851976,1852299,323,EVM,mRNA,580816,2246825,323,1.00
ptg009793l,2696470,2696784,314,EVM,mRNA,121677,3119890,314,1.00
ptg009797l,2900260,2900577,317,EVM,mRNA,2660205,3027800,317,1.00
ptg009807l,30754,31055,301,EVM,mRNA,9868,576872,301,1.00
ptg009811l,1396573,1396859,286,EVM,mRNA,1340324,2086077,286,1.00
ptg009816l,3012245,3012532,287,EVM,mRNA,2056542,3927770,287,1.00
ptg009817l,1089399,1089667,268,EVM,mRNA,996675,1758800,268,1.00
ptg009819l,418434,418722,288,EVM,mRNA,196254,788203,288,1.00
ptg009831l,755127,755426,299,EVM,mRNA,406361,1480170,299,1.00
ptg009831l,1032656,1032964,308,EVM,mRNA,406361,1480170,308,1.00
ptg009831l,1135211,1135506,295,EVM,mRNA,406361,1480170,295,1.00
ptg009841l,137257,137567,310,EVM,mRNA,19163,447854,310,1.00
ptg009841l,1180169,1180473,304,EVM,mRNA,863395,2435912,304,1.00
ptg009841l,1793230,1793547,317,EVM,mRNA,863395,2435912,317,1.00
ptg009842l,372966,373269,303,EVM,mRNA,8480,923914,303,1.00
ptg009842l,722361,722682,321,EVM,mRNA,8480,923914,321,1.00
ptg009844l,105057,105387,330,EVM,mRNA,63281,359533,330,1.00
ptg009844l,1073038,1073346,308,EVM,mRNA,995991,1114603,308,1.00
ptg009846l,158805,159120,315,EVM,mRNA,39812,360684,315,1.00
ptg009847l,285059,285390,331,EVM,mRNA,257234,1042798,331,1.00
ptg009847l,408359,408649,290,EVM,mRNA,257234,1042798,290,1.00
ptg009847l,459437,459724,287,EVM,mRNA,257234,1042798,287,1.00
ptg009847l,682591,682885,294,EVM,mRNA,257234,1042798,294,1.00
ptg009847l,823256,823563,307,EVM,mRNA,257234,1042798,307,1.00
ptg009852l,408666,408962,296,EVM,mRNA,207259,1677241,296,1.00
ptg009852l,1193768,1194099,331,EVM,mRNA,207259,1677241,331,1.00
ptg009852l,1432773,1433083,310,EVM,mRNA,207259,1677241,310,1.00
ptg009852l,2172386,2172664,278,EVM,mRNA,2057891,2199581,278,1.00
ptg009854l,340126,340430,304,EVM,mRNA,4789,931801,304,1.00
ptg009854l,639797,640088,291,EVM,mRNA,4789,931801,291,1.00
ptg009854l,664859,665185,326,EVM,mRNA,4789,931801,326,1.00
ptg009854l,822915,823224,309,EVM,mRNA,4789,931801,309,1.00
ptg009854l,898754,899072,318,EVM,mRNA,4789,931801,318,1.00
ptg009854l,1587096,1587373,277,EVM,mRNA,1492746,2524790,277,1.00
ptg009854l,1656207,1656524,317,EVM,mRNA,1492746,2524790,317,1.00
ptg009855l,1697368,1697695,327,EVM,mRNA,914454,2174373,327,1.00
ptg009855l,1748867,1749176,309,EVM,mRNA,914454,2174373,309,1.00
ptg009855l,1769021,1769312,291,EVM,mRNA,914454,2174373,291,1.00
ptg009858l,515754,516074,320,EVM,mRNA,90631,650839,320,1.00
ptg009859l,463904,464222,318,EVM,mRNA,77997,464983,318,1.00
ptg009860l,475621,475937,316,EVM,mRNA,217,507930,316,1.00
ptg009861l,648964,649276,312,EVM,mRNA,59895,914486,312,1.00
ptg009862l,1178254,1178582,328,EVM,mRNA,1078487,1497049,328,1.00
ptg009862l,1208969,1209252,283,EVM,mRNA,1078487,1497049,283,1.00
ptg009862l,1831511,1831795,284,EVM,mRNA,1636282,1921350,284,1.00
ptg009864l,1126890,1127217,327,EVM,mRNA,832641,1376910,327,1.00
ptg009869l,228119,228427,308,EVM,mRNA,77563,1097297,308,1.00
ptg009872l,1107987,1108281,294,EVM,mRNA,684899,1816755,294,1.00
ptg009872l,1573070,1573383,313,EVM,mRNA,684899,1816755,313,1.00
ptg009872l,1730096,1730438,342,EVM,mRNA,684899,1816755,342,1.00
ptg009872l,2281531,2281819,288,EVM,mRNA,2113147,2337553,288,1.00
ptg009877l,1520812,1521110,298,EVM,mRNA,1391697,1730865,298,1.00
ptg009879l,449513,449799,286,EVM,mRNA,375508,2137700,286,1.00
ptg009881l,1575240,1575541,301,EVM,mRNA,207828,1882306,301,1.00
ptg009882l,1017654,1017953,299,EVM,mRNA,631240,1202333,299,1.00
ptg009887l,2431396,2431691,295,EVM,mRNA,2143800,2446015,295,1.00
ptg009893l,1942823,1943148,325,EVM,mRNA,46933,2111595,325,1.00
ptg009894l,748745,749076,331,EVM,mRNA,659051,1148476,331,1.00
ptg009894l,2346405,2346699,294,EVM,mRNA,2310734,2581915,294,1.00
ptg009894l,3078970,3079299,329,EVM,mRNA,2825913,3397030,329,1.00
ptg009898l,50538,50817,279,EVM,mRNA,48920,209413,279,1.00
ptg009898l,2258619,2258923,304,EVM,mRNA,1641128,2364038,304,1.00
ptg009898l,2272470,2272786,316,EVM,mRNA,1641128,2364038,316,1.00
ptg009898l,3522830,3523146,316,EVM,mRNA,3057026,3660526,316,1.00
ptg009913l,731067,731382,315,EVM,mRNA,709342,914343,315,1.00
ptg009913l,955590,955876,286,EVM,mRNA,950323,1026787,286,1.00
ptg009915l,512965,513265,300,EVM,mRNA,327757,1082890,300,1.00
ptg009918l,388157,388458,301,EVM,mRNA,342494,408808,301,1.00
ptg009918l,948633,948937,304,EVM,mRNA,879852,1444190,304,1.00
ptg009918l,1245282,1245553,271,EVM,mRNA,879852,1444190,271,1.00
ptg009918l,2176277,2176531,254,EVM,mRNA,1992712,2193104,254,1.00
ptg009919l,3131839,3132140,301,EVM,mRNA,2879692,3702136,301,1.00
ptg009919l,3362684,3362997,313,EVM,mRNA,2879692,3702136,313,1.00
ptg009927l,503328,503618,290,EVM,mRNA,54564,994603,290,1.00
ptg009927l,958447,958763,316,EVM,mRNA,54564,994603,316,1.00
ptg009928l,850526,850839,313,EVM,mRNA,17703,1311994,313,1.00
ptg009928l,941674,941951,277,EVM,mRNA,17703,1311994,277,1.00
ptg009929l,219368,219692,324,EVM,mRNA,14745,1156402,324,1.00
ptg009929l,411069,411396,327,EVM,mRNA,14745,1156402,327,1.00
ptg009930l,1242012,1242318,306,EVM,mRNA,1123484,1333885,306,1.00
ptg009931l,2080167,2080444,277,EVM,mRNA,163013,2842330,277,1.00
ptg009943l,2696989,2697323,334,EVM,mRNA,1581565,3398586,334,1.00
ptg009945l,1813480,1813793,313,EVM,mRNA,1753297,2071390,313,1.00
ptg009954l,1293953,1294267,314,EVM,mRNA,22753,1360250,314,1.00
ptg009957l,45223,45524,301,EVM,mRNA,22201,85471,301,1.00
ptg009958l,483308,483600,292,EVM,mRNA,23230,689649,292,1.00
ptg009958l,1092540,1092829,289,EVM,mRNA,1028975,2119570,289,1.00
ptg009958l,2084547,2084825,278,EVM,mRNA,1028975,2119570,278,1.00
ptg009961l,154958,155257,299,EVM,mRNA,52393,293769,299,1.00
ptg009969l,33024,33335,311,EVM,mRNA,29283,1528872,311,1.00
ptg009970l,339100,339399,299,EVM,mRNA,38872,607336,299,1.00
ptg009976l,776030,776353,323,EVM,mRNA,465973,1332298,323,1.00
ptg009979l,361710,361980,270,EVM,mRNA,346084,1031398,270,1.00
ptg009984l,3716198,3716523,325,EVM,mRNA,1866363,3983525,325,1.00
ptg009984l,3902863,3903147,284,EVM,mRNA,1866363,3983525,284,1.00
ptg009989l,593809,594111,302,EVM,mRNA,229339,1094359,302,1.00
ptg009995l,1290279,1290555,276,EVM,mRNA,950484,2064810,276,1.00
ptg009995l,1335238,1335541,303,EVM,mRNA,950484,2064810,303,1.00
ptg009995l,2062486,2062774,288,EVM,mRNA,950484,2064810,288,1.00
ptg010001l,1834592,1834905,313,EVM,mRNA,1656402,2919580,313,1.00
ptg010001l,1922715,1922993,278,EVM,mRNA,1656402,2919580,278,1.00
ptg010001l,2057861,2058190,329,EVM,mRNA,1656402,2919580,329,1.00
ptg010001l,2452642,2452928,286,EVM,mRNA,1656402,2919580,286,1.00
ptg010001l,2666540,2666833,293,EVM,mRNA,1656402,2919580,293,1.00
ptg010002l,179670,179980,310,EVM,mRNA,42840,406333,310,1.00
ptg010002l,240725,241043,318,EVM,mRNA,42840,406333,318,1.00
ptg010010l,357592,357879,287,EVM,mRNA,67,470443,287,1.00
ptg010010l,469356,469653,297,EVM,mRNA,67,470443,297,1.00
ptg010010l,2992665,2992964,299,EVM,mRNA,2957503,3764800,299,1.00
ptg010011l,569627,569920,293,EVM,mRNA,492657,1062783,293,1.00
ptg010013l,991652,991980,328,EVM,mRNA,122863,1013305,328,1.00
ptg010027l,431087,431404,317,EVM,mRNA,197488,685895,317,1.00
ptg010028l,828306,828637,331,EVM,mRNA,677941,899468,331,1.00
ptg010028l,1077968,1078268,300,EVM,mRNA,1049858,1115842,300,1.00
ptg010028l,1112166,1112470,304,EVM,mRNA,1049858,1115842,304,1.00
ptg010028l,1255099,1255387,288,EVM,mRNA,1160624,1640221,288,1.00
ptg010028l,1411816,1412115,299,EVM,mRNA,1160624,1640221,299,1.00
ptg010038l,517762,518095,333,EVM,mRNA,449515,588172,333,1.00
ptg010040l,410566,410823,257,EVM,mRNA,16136,578701,257,1.00
ptg010040l,567663,567997,334,EVM,mRNA,16136,578701,334,1.00
ptg010042l,1047527,1047827,300,EVM,mRNA,2389,1854470,300,1.00
ptg010042l,1799332,1799617,285,EVM,mRNA,2389,1854470,285,1.00
ptg010053l,144667,144998,331,EVM,mRNA,95337,240332,331,1.00
ptg010061l,518738,519041,303,EVM,mRNA,457298,661147,303,1.00
ptg010061l,570764,571044,280,EVM,mRNA,457298,661147,280,1.00
ptg010067l,374384,374681,297,EVM,mRNA,217985,477024,297,1.00
ptg010077l,1069485,1069761,276,EVM,mRNA,531435,1272475,276,1.00
ptg010080l,378856,379138,282,EVM,mRNA,225589,441392,282,1.00
ptg010085l,2419736,2420029,293,EVM,mRNA,2410507,2426066,293,1.00
ptg010085l,2794430,2794719,289,EVM,mRNA,2477844,3203496,289,1.00
ptg010086l,1055782,1056073,291,EVM,mRNA,198855,2324396,291,1.00
ptg010086l,1125290,1125617,327,EVM,mRNA,198855,2324396,327,1.00
ptg010086l,3236225,3236548,323,EVM,mRNA,2691629,3587786,323,1.00
ptg010088l,1257807,1258112,305,EVM,mRNA,1118026,1642449,305,1.00
ptg010088l,1484689,1484972,283,EVM,mRNA,1118026,1642449,283,1.00
ptg010088l,1546430,1546730,300,EVM,mRNA,1118026,1642449,300,1.00
ptg010088l,3452389,3452706,317,EVM,mRNA,3371243,3547809,317,1.00
ptg010088l,3526722,3527041,319,EVM,mRNA,3371243,3547809,319,1.00
ptg010088l,5207371,5207675,304,EVM,mRNA,5039412,5337213,304,1.00
ptg010092l,625349,625616,267,EVM,mRNA,601896,1158797,267,1.00
ptg010092l,1528805,1529090,285,EVM,mRNA,1356831,1830752,285,1.00
ptg010094l,575299,575590,291,EVM,mRNA,45800,639674,291,1.00
ptg010094l,751424,751719,295,EVM,mRNA,704666,967314,295,1.00
ptg010095l,240452,240732,280,EVM,mRNA,47907,1038512,280,1.00
ptg010096l,168829,169116,287,EVM,mRNA,53097,2226623,287,1.00
ptg010096l,696262,696561,299,EVM,mRNA,53097,2226623,299,1.00
ptg010097l,544790,545101,311,EVM,mRNA,164931,1158487,311,1.00
ptg010097l,682869,683225,356,EVM,mRNA,164931,1158487,356,1.00
ptg010102l,1085814,1086115,301,EVM,mRNA,757258,1105150,301,1.00
ptg010106l,1373852,1374146,294,EVM,mRNA,1258259,1952708,294,1.00
ptg010111l,812934,813221,287,EVM,mRNA,716967,1643339,287,1.00
ptg010111l,1256596,1256879,283,EVM,mRNA,716967,1643339,283,1.00
ptg010118l,150088,150403,315,EVM,mRNA,35288,631041,315,1.00
ptg010118l,283733,284008,275,EVM,mRNA,35288,631041,275,1.00
ptg010124l,109084,109371,287,EVM,mRNA,13036,174836,287,1.00
ptg010125l,1276413,1276727,314,EVM,mRNA,822037,1832674,314,1.00
ptg010125l,1450592,1450885,293,EVM,mRNA,822037,1832674,293,1.00
ptg010125l,1495438,1495714,276,EVM,mRNA,822037,1832674,276,1.00
ptg010129l,571714,572006,292,EVM,mRNA,291149,1138386,292,1.00
ptg010129l,1469120,1469448,328,EVM,mRNA,1424591,2170700,328,1.00
ptg010129l,1484692,1485019,327,EVM,mRNA,1424591,2170700,327,1.00
ptg010130l,2273966,2274239,273,EVM,mRNA,1017477,2380207,273,1.00
ptg010139l,1727695,1727995,300,EVM,mRNA,1182819,2710381,300,1.00
ptg010139l,2065159,2065475,316,EVM,mRNA,1182819,2710381,316,1.00
ptg010141l,3870237,3870559,322,EVM,mRNA,3840722,4658078,322,1.00
ptg010141l,4291489,4291772,283,EVM,mRNA,3840722,4658078,283,1.00
ptg010141l,4632950,4633258,308,EVM,mRNA,3840722,4658078,308,1.00
ptg010144l,624297,624613,316,EVM,mRNA,562799,664111,316,1.00
ptg010145l,1428529,1428832,303,EVM,mRNA,1358550,1591696,303,1.00
ptg010149l,310470,310783,313,EVM,mRNA,57673,490639,313,1.00
ptg010158l,524206,524505,299,EVM,mRNA,274831,804376,299,1.00
ptg010171l,612767,613074,307,EVM,mRNA,293373,853067,307,1.00
ptg010174l,92286,92572,286,EVM,mRNA,69230,315022,286,1.00
ptg010174l,655208,655507,299,EVM,mRNA,485438,695848,299,1.00
ptg010175l,202174,202460,286,EVM,mRNA,127627,907821,286,1.00
ptg010175l,461106,461386,280,EVM,mRNA,127627,907821,280,1.00
ptg010176l,1452503,1452787,284,EVM,mRNA,258830,2936995,284,1.00
ptg010176l,1533780,1534068,288,EVM,mRNA,258830,2936995,288,1.00
ptg010181l,336594,336909,315,EVM,mRNA,249099,1205414,315,1.00
ptg010181l,663120,663399,279,EVM,mRNA,249099,1205414,279,1.00
ptg010181l,705804,706095,291,EVM,mRNA,249099,1205414,291,1.00
ptg010184l,284306,284593,287,EVM,mRNA,193663,426610,287,1.00
ptg010191l,894975,895255,280,EVM,mRNA,872669,1079222,280,1.00
ptg010193l,430513,430831,318,EVM,mRNA,278566,996023,318,1.00
ptg010197l,1115656,1115937,281,EVM,mRNA,242786,1210895,281,1.00
ptg010197l,1607055,1607371,316,EVM,mRNA,1398746,1765116,316,1.00
ptg010202l,673946,674246,300,EVM,mRNA,563626,1197160,300,1.00
ptg010202l,739308,739602,294,EVM,mRNA,563626,1197160,294,1.00
ptg010204l,349448,349730,282,EVM,mRNA,303537,644009,282,1.00
ptg010204l,1102225,1102545,320,EVM,mRNA,854021,1407125,320,1.00
ptg010210l,710820,711118,298,EVM,mRNA,592605,1930857,298,1.00
ptg010210l,1304647,1304946,299,EVM,mRNA,592605,1930857,299,1.00
ptg010210l,1572498,1572794,296,EVM,mRNA,592605,1930857,296,1.00
ptg010210l,1911507,1911823,316,EVM,mRNA,592605,1930857,316,1.00
ptg010213l,1052915,1053198,283,EVM,mRNA,598676,1536482,283,1.00
ptg010213l,1224263,1224572,309,EVM,mRNA,598676,1536482,309,1.00
ptg010213l,1344004,1344310,306,EVM,mRNA,598676,1536482,306,1.00
ptg010226l,285670,285977,307,EVM,mRNA,15135,659855,307,1.00
ptg010226l,349583,349876,293,EVM,mRNA,15135,659855,293,1.00
ptg010226l,395642,395953,311,EVM,mRNA,15135,659855,311,1.00
ptg010226l,1191994,1192325,331,EVM,mRNA,946516,1244113,331,1.00
ptg010227l,1388348,1388628,280,EVM,mRNA,1141329,1684623,280,1.00
ptg010230l,204310,204586,276,EVM,mRNA,1147,305150,276,1.00
ptg010230l,238852,239118,266,EVM,mRNA,1147,305150,266,1.00
ptg010230l,2641811,2642126,315,EVM,mRNA,2332983,2645144,315,1.00
ptg010230l,3234299,3234584,285,EVM,mRNA,2686449,3366412,285,1.00
ptg010230l,3273236,3273515,279,EVM,mRNA,2686449,3366412,279,1.00
ptg010235l,496413,496709,296,EVM,mRNA,336875,804011,296,1.00
ptg010242l,93452,93729,277,EVM,mRNA,61339,186767,277,1.00
ptg010242l,1383757,1384060,303,EVM,mRNA,1146305,1834506,303,1.00
ptg010246l,106293,106617,324,EVM,mRNA,54337,247945,324,1.00
ptg010246l,141796,142077,281,EVM,mRNA,54337,247945,281,1.00
ptg010246l,225860,226187,327,EVM,mRNA,54337,247945,327,1.00
ptg010248l,1708547,1708822,275,EVM,mRNA,1311583,1736767,275,1.00
ptg010249l,211703,211990,287,EVM,mRNA,170462,762916,287,1.00
ptg010249l,1641852,1642147,295,EVM,mRNA,921332,1909843,295,1.00
ptg010251l,1805541,1805825,284,EVM,mRNA,1444348,1835681,284,1.00
ptg010254l,804758,805049,291,EVM,mRNA,219477,810437,291,1.00
ptg010258l,305790,306109,319,EVM,mRNA,108555,612317,319,1.00
ptg010269l,669873,670168,295,EVM,mRNA,634693,765677,295,1.00
ptg010269l,754723,755011,288,EVM,mRNA,634693,765677,288,1.00
ptg010269l,756457,756772,315,EVM,mRNA,634693,765677,315,1.00
ptg010271l,139858,140155,297,EVM,mRNA,53991,516090,297,1.00
ptg010271l,515525,515804,279,EVM,mRNA,53991,516090,279,1.00
ptg010272l,895980,896265,285,EVM,mRNA,855639,1076998,285,1.00
ptg010272l,3557534,3557870,336,EVM,mRNA,3556625,3570000,336,1.00
ptg010284l,386458,386747,289,EVM,mRNA,185117,752806,289,1.00
ptg010284l,533167,533464,297,EVM,mRNA,185117,752806,297,1.00
ptg010285l,524531,524817,286,EVM,mRNA,27141,1061383,286,1.00
ptg010285l,1049283,1049597,314,EVM,mRNA,27141,1061383,314,1.00
ptg010286l,397448,397746,298,EVM,mRNA,287843,538137,298,1.00
ptg010292l,228000,228320,320,EVM,mRNA,39607,228675,320,1.00
ptg010297l,117992,118289,297,EVM,mRNA,52,677422,297,1.00
ptg010305l,153889,154201,312,EVM,mRNA,53830,441962,312,1.00
ptg010315l,886792,887112,320,EVM,mRNA,862991,1063396,320,1.00
ptg010322l,1493931,1494208,277,EVM,mRNA,656944,2048003,277,1.00
ptg010322l,1857319,1857619,300,EVM,mRNA,656944,2048003,300,1.00
ptg010324l,364890,365207,317,EVM,mRNA,325822,401438,317,1.00
ptg010325l,408631,408929,298,EVM,mRNA,408241,482150,298,1.00
ptg010325l,1478752,1479043,291,EVM,mRNA,774535,4537136,291,1.00
ptg010329l,209063,209343,280,EVM,mRNA,24925,329252,280,1.00
ptg010335l,830974,831275,301,EVM,mRNA,819016,1028003,301,1.00
ptg010339l,423312,423636,324,EVM,mRNA,418276,602636,324,1.00
ptg010340l,1702997,1703300,303,EVM,mRNA,1526713,2404662,303,1.00
ptg010343l,223604,223919,315,EVM,mRNA,30561,960341,315,1.00
ptg010343l,811250,811563,313,EVM,mRNA,30561,960341,313,1.00
ptg010349l,210086,210396,310,EVM,mRNA,16,580092,310,1.00
ptg010350l,442821,443121,300,EVM,mRNA,264718,443404,300,1.00
ptg010354l,974386,974685,299,EVM,mRNA,194054,1232003,299,1.00
ptg010357l,372806,373101,295,EVM,mRNA,139880,428516,295,1.00
ptg010361l,1188427,1188718,291,EVM,mRNA,1168288,1344458,291,1.00
ptg010361l,1239387,1239665,278,EVM,mRNA,1168288,1344458,278,1.00
ptg010361l,1739837,1740139,302,EVM,mRNA,1684904,1811013,302,1.00
ptg010363l,150966,151246,280,EVM,mRNA,141079,325428,280,1.00
ptg010368l,243809,244131,322,EVM,mRNA,81144,315635,322,1.00
ptg010370l,967416,967733,317,EVM,mRNA,919112,1102811,317,1.00
ptg010380l,1119499,1119780,281,EVM,mRNA,3423,1135430,281,1.00
ptg010380l,2664994,2665309,315,EVM,mRNA,2575824,2690013,315,1.00
ptg010382l,2672564,2672852,288,EVM,mRNA,269515,4295384,288,1.00
ptg010382l,3130406,3130723,317,EVM,mRNA,269515,4295384,317,1.00
ptg010383l,1124529,1124856,327,EVM,mRNA,916767,1986531,327,1.00
ptg010383l,2339603,2339872,269,EVM,mRNA,2273595,2488482,269,1.00
ptg010392l,758756,759089,333,EVM,mRNA,687090,1042802,333,1.00
ptg010396l,1166187,1166495,308,EVM,mRNA,1146217,1243592,308,1.00
ptg010397l,338262,338572,310,EVM,mRNA,295639,507527,310,1.00
ptg010398l,946676,946968,292,EVM,mRNA,658727,1105700,292,1.00
ptg010404l,3333126,3333432,306,EVM,mRNA,1561692,3786634,306,1.00
ptg010405l,238901,239157,256,EVM,mRNA,236859,598136,256,1.00
ptg010410l,453578,453863,285,EVM,mRNA,79371,503314,285,1.00
ptg010410l,586206,586501,295,EVM,mRNA,524208,819626,295,1.00
ptg010410l,601812,602121,309,EVM,mRNA,524208,819626,309,1.00
ptg010411l,1068995,1069285,290,EVM,mRNA,715384,1468410,290,1.00
ptg010411l,1440404,1440739,335,EVM,mRNA,715384,1468410,335,1.00
ptg010415l,395457,395783,326,EVM,mRNA,96225,2947826,326,1.00
ptg010415l,1543275,1543592,317,EVM,mRNA,96225,2947826,317,1.00
ptg010415l,4466630,4466941,311,EVM,mRNA,4234026,5045656,311,1.00
ptg010415l,4533597,4533889,292,EVM,mRNA,4234026,5045656,292,1.00
ptg010415l,4628871,4629148,277,EVM,mRNA,4234026,5045656,277,1.00
ptg010416l,1839629,1839939,310,EVM,mRNA,1643007,2640213,310,1.00
ptg010416l,2218206,2218502,296,EVM,mRNA,1643007,2640213,296,1.00
ptg010420l,98692,98972,280,EVM,mRNA,15470,100751,280,1.00
ptg010426l,374244,374533,289,EVM,mRNA,11219,444057,289,1.00
ptg010427l,1902671,1902947,276,EVM,mRNA,1861385,2092739,276,1.00
ptg010431l,68704,68993,289,EVM,mRNA,60691,315271,289,1.00
ptg010431l,186046,186328,282,EVM,mRNA,60691,315271,282,1.00
ptg010432l,452322,452599,277,EVM,mRNA,66632,872248,277,1.00
ptg010432l,2223519,2223805,286,EVM,mRNA,1963472,3959879,286,1.00
ptg010432l,2651547,2651860,313,EVM,mRNA,1963472,3959879,313,1.00
ptg010435l,1887151,1887437,286,EVM,mRNA,1834856,2149194,286,1.00
ptg010435l,1893099,1893388,289,EVM,mRNA,1834856,2149194,289,1.00
ptg010443l,830136,830434,298,EVM,mRNA,85096,917145,298,1.00
ptg010446l,70500,70811,311,EVM,mRNA,58734,127925,311,1.00
ptg010449l,168305,168622,317,EVM,mRNA,133693,299275,317,1.00
ptg010449l,710882,711174,292,EVM,mRNA,323140,959899,292,1.00
ptg010449l,959289,959584,295,EVM,mRNA,323140,959899,295,1.00
ptg010450l,296773,297072,299,EVM,mRNA,58294,484382,299,1.00
ptg010450l,368596,368899,303,EVM,mRNA,58294,484382,303,1.00
ptg010459l,342344,342625,281,EVM,mRNA,119033,1032340,281,1.00
ptg010460l,1698532,1698851,319,EVM,mRNA,1660344,1804538,319,1.00
ptg010461l,117474,117805,331,EVM,mRNA,68752,601288,331,1.00
ptg010461l,963192,963484,292,EVM,mRNA,945512,1141347,292,1.00
ptg010464l,1762614,1762877,263,EVM,mRNA,265300,2349540,263,1.00
ptg010464l,1995652,1995958,306,EVM,mRNA,265300,2349540,306,1.00
ptg010472l,1151621,1151928,307,EVM,mRNA,1149747,1443370,307,1.00
ptg010472l,2140762,2141079,317,EVM,mRNA,1522401,2282442,317,1.00
ptg010472l,2638337,2638645,308,EVM,mRNA,2426706,2734972,308,1.00
ptg010472l,3017389,3017684,295,EVM,mRNA,2893673,3094303,295,1.00
ptg010484l,1606380,1606640,260,EVM,mRNA,1284295,1986505,260,1.00
ptg010485l,388245,388564,319,EVM,mRNA,209830,874149,319,1.00
ptg010486l,12888,13160,272,EVM,mRNA,89,353156,272,1.00
ptg010493l,2167046,2167362,316,EVM,mRNA,1933701,2912469,316,1.00
ptg010495l,896920,897225,305,EVM,mRNA,875675,1244102,305,1.00
ptg010496l,53328,53634,306,EVM,mRNA,50600,861303,306,1.00
ptg010509l,502367,502681,314,EVM,mRNA,211358,613065,314,1.00
ptg010514l,502311,502604,293,EVM,mRNA,170941,654889,293,1.00
ptg010517l,1597921,1598220,299,EVM,mRNA,63587,1626945,299,1.00
ptg010518l,1720486,1720793,307,EVM,mRNA,1716479,3490280,307,1.00
ptg010518l,1815703,1815993,290,EVM,mRNA,1716479,3490280,290,1.00
ptg010519l,269647,269947,300,EVM,mRNA,183416,1240255,300,1.00
ptg010519l,547527,547826,299,EVM,mRNA,183416,1240255,299,1.00
ptg010528l,3002339,3002635,296,EVM,mRNA,2465296,3459204,296,1.00
ptg010531l,958419,958714,295,EVM,mRNA,849202,1024827,295,1.00
ptg010535l,354997,355330,333,EVM,mRNA,48785,764183,333,1.00
ptg010537l,365998,366300,302,EVM,mRNA,278532,417333,302,1.00
ptg010544l,270081,270381,300,EVM,mRNA,178384,1267525,300,1.00
ptg010548l,2275308,2275624,316,EVM,mRNA,1371744,3698796,316,1.00
ptg010548l,3125971,3126261,290,EVM,mRNA,1371744,3698796,290,1.00
ptg010548l,3199295,3199599,304,EVM,mRNA,1371744,3698796,304,1.00
ptg010550l,637741,638049,308,EVM,mRNA,536338,777056,308,1.00
ptg010552l,728633,728952,319,EVM,mRNA,11530,2976067,319,1.00
ptg010552l,1013197,1013511,314,EVM,mRNA,11530,2976067,314,1.00
ptg010552l,1970974,1971289,315,EVM,mRNA,11530,2976067,315,1.00
ptg010552l,2048541,2048835,294,EVM,mRNA,11530,2976067,294,1.00
ptg010552l,2241520,2241829,309,EVM,mRNA,11530,2976067,309,1.00
ptg010552l,2269481,2269777,296,EVM,mRNA,11530,2976067,296,1.00
ptg010552l,2766244,2766552,308,EVM,mRNA,11530,2976067,308,1.00
ptg010556l,108393,108692,299,EVM,mRNA,16250,273863,299,1.00
ptg010570l,321093,321370,277,EVM,mRNA,315459,427564,277,1.00
ptg010573l,1860548,1860845,297,EVM,mRNA,1702115,2235381,297,1.00
ptg010573l,2200345,2200616,271,EVM,mRNA,1702115,2235381,271,1.00
ptg010573l,2499326,2499625,299,EVM,mRNA,2346008,2936301,299,1.00
ptg010573l,2710758,2711050,292,EVM,mRNA,2346008,2936301,292,1.00
ptg010573l,3846716,3847026,310,EVM,mRNA,3692490,4042437,310,1.00
ptg010574l,2290490,2290767,277,EVM,mRNA,129988,2435507,277,1.00
ptg010576l,169351,169671,320,EVM,mRNA,1397,495461,320,1.00
ptg010576l,366644,366949,305,EVM,mRNA,1397,495461,305,1.00
ptg010577l,528908,529189,281,EVM,mRNA,279300,620449,281,1.00
ptg010581l,865830,866115,285,EVM,mRNA,848856,1133164,285,1.00
ptg010581l,912881,913173,292,EVM,mRNA,848856,1133164,292,1.00
ptg010584l,1517006,1517297,291,EVM,mRNA,1430786,1554604,291,1.00
ptg010584l,2822163,2822432,269,EVM,mRNA,2552100,2853454,269,1.00
ptg010588l,1869023,1869328,305,EVM,mRNA,1833660,2745871,305,1.00
ptg010588l,2015018,2015302,284,EVM,mRNA,1833660,2745871,284,1.00
ptg010588l,2213051,2213359,308,EVM,mRNA,1833660,2745871,308,1.00
ptg010588l,2592959,2593253,294,EVM,mRNA,1833660,2745871,294,1.00
ptg010593l,209936,210224,288,EVM,mRNA,136929,859648,288,1.00
ptg010597l,796670,796985,315,EVM,mRNA,331101,959176,315,1.00
ptg010602l,162895,163181,286,EVM,mRNA,145814,261604,286,1.00
ptg010605l,529583,529887,304,EVM,mRNA,291649,1821871,304,1.00
ptg010605l,1174739,1175043,304,EVM,mRNA,291649,1821871,304,1.00
ptg010605l,1177009,1177310,301,EVM,mRNA,291649,1821871,301,1.00
ptg010605l,1299820,1300110,290,EVM,mRNA,291649,1821871,290,1.00
ptg010605l,1661595,1661911,316,EVM,mRNA,291649,1821871,316,1.00
ptg010613l,971234,971548,314,EVM,mRNA,2617,2647361,314,1.00
ptg010621l,977217,977539,322,EVM,mRNA,19959,1847668,322,1.00
ptg010621l,1831631,1831940,309,EVM,mRNA,19959,1847668,309,1.00
ptg010623l,14428,14706,278,EVM,mRNA,5325,16835,278,1.00
ptg010624l,267460,267770,310,EVM,mRNA,142671,604461,310,1.00
ptg010624l,415380,415661,281,EVM,mRNA,142671,604461,281,1.00
ptg010624l,422193,422492,299,EVM,mRNA,142671,604461,299,1.00
ptg010624l,422584,422865,281,EVM,mRNA,142671,604461,281,1.00
ptg010625l,2043871,2044200,329,EVM,mRNA,1191022,2639095,329,1.00
ptg010627l,1005183,1005490,307,EVM,mRNA,43796,2265568,307,1.00
ptg010638l,388607,388911,304,EVM,mRNA,2057,661460,304,1.00
ptg010638l,592544,592842,298,EVM,mRNA,2057,661460,298,1.00
ptg010639l,54161,54476,315,EVM,mRNA,9939,314556,315,1.00
ptg010642l,2004651,2004926,275,EVM,mRNA,1655236,2082660,275,1.00
ptg010642l,2215711,2216001,290,EVM,mRNA,2099916,2246882,290,1.00
ptg010643l,865144,865428,284,EVM,mRNA,826649,1436710,284,1.00
ptg010643l,1297253,1297565,312,EVM,mRNA,826649,1436710,312,1.00
ptg010646l,1405819,1406093,274,EVM,mRNA,1313330,1456631,274,1.00
ptg010647l,1037490,1037769,279,EVM,mRNA,918930,1434005,279,1.00
ptg010647l,1123001,1123310,309,EVM,mRNA,918930,1434005,309,1.00
ptg010647l,1179221,1179510,289,EVM,mRNA,918930,1434005,289,1.00
ptg010649l,341873,342173,300,EVM,mRNA,315653,666643,300,1.00
ptg010651l,25915,26205,290,EVM,mRNA,19703,289980,290,1.00
ptg010651l,163729,164004,275,EVM,mRNA,19703,289980,275,1.00
ptg010654l,356826,357126,300,EVM,mRNA,244378,715534,300,1.00
ptg010654l,854877,855170,293,EVM,mRNA,824468,938163,293,1.00
ptg010659l,405888,406188,300,EVM,mRNA,233008,587421,300,1.00
ptg010659l,1757438,1757728,290,EVM,mRNA,1540665,2102687,290,1.00
ptg010659l,2100580,2100894,314,EVM,mRNA,1540665,2102687,314,1.00
ptg010660l,440994,441288,294,EVM,mRNA,251751,523820,294,1.00
ptg010662l,1057719,1058028,309,EVM,mRNA,249183,1078063,309,1.00
ptg010665l,1349195,1349524,329,EVM,mRNA,35763,2046470,329,1.00
ptg010678l,1458686,1458962,276,EVM,mRNA,464751,1850185,276,1.00
ptg010678l,2529497,2529783,286,EVM,mRNA,2447867,4246698,286,1.00
ptg010678l,3379840,3380131,291,EVM,mRNA,2447867,4246698,291,1.00
ptg010678l,4191392,4191690,298,EVM,mRNA,2447867,4246698,298,1.00
ptg010681l,1383686,1384004,318,EVM,mRNA,964049,1774105,318,1.00
ptg010681l,2488553,2488860,307,EVM,mRNA,2289854,2535466,307,1.00
ptg010682l,553547,553851,304,EVM,mRNA,20976,1430870,304,1.00
ptg010688l,521044,521321,277,EVM,mRNA,4501,1240995,277,1.00
ptg010688l,727742,728024,282,EVM,mRNA,4501,1240995,282,1.00
ptg010688l,729074,729399,325,EVM,mRNA,4501,1240995,325,1.00
ptg010698l,438118,438420,302,EVM,mRNA,225538,739577,302,1.00
ptg010698l,3454528,3454855,327,EVM,mRNA,3236609,4047546,327,1.00
ptg010706l,529493,529795,302,EVM,mRNA,1899,843392,302,1.00
ptg010710l,429611,429929,318,EVM,mRNA,10578,1198278,318,1.00
ptg010710l,590874,591181,307,EVM,mRNA,10578,1198278,307,1.00
ptg010711l,352289,352613,324,EVM,mRNA,330441,889109,324,1.00
ptg010711l,646101,646413,312,EVM,mRNA,330441,889109,312,1.00
ptg010711l,687488,687818,330,EVM,mRNA,330441,889109,330,1.00
ptg010711l,2120945,2121250,305,EVM,mRNA,1806034,2767079,305,1.00
ptg010711l,3808729,3809027,298,EVM,mRNA,3464589,3938117,298,1.00
ptg010714l,462767,463060,293,EVM,mRNA,211254,1046043,293,1.00
ptg010719l,913985,914258,273,EVM,mRNA,426067,1101778,273,1.00
ptg010728l,1338527,1338819,292,EVM,mRNA,1153442,1384896,292,1.00
ptg010733l,651794,652099,305,EVM,mRNA,4346,652134,305,1.00
ptg010737l,148867,149163,296,EVM,mRNA,148888,822336,276,0.93
ptg010737l,1512164,1512456,292,EVM,mRNA,1314627,1822671,292,1.00
ptg010739l,1704383,1704691,308,EVM,mRNA,1594171,1916578,308,1.00
ptg010741l,2412813,2413134,321,EVM,mRNA,2122091,2996246,321,1.00
ptg010741l,2550564,2550866,302,EVM,mRNA,2122091,2996246,302,1.00
ptg010748l,384523,384817,294,EVM,mRNA,137813,923623,294,1.00
ptg010748l,650170,650439,269,EVM,mRNA,137813,923623,269,1.00
ptg010749l,99506,99806,300,EVM,mRNA,88880,916648,300,1.00
ptg010749l,947117,947440,323,EVM,mRNA,942770,1207797,323,1.00
ptg010752l,572192,572510,318,EVM,mRNA,48639,2545661,318,1.00
ptg010753l,100024,100319,295,EVM,mRNA,84239,228042,295,1.00
ptg010761l,1120621,1120894,273,EVM,mRNA,542448,1356678,273,1.00
ptg010761l,1157601,1157890,289,EVM,mRNA,542448,1356678,289,1.00
ptg010767l,1534369,1534684,315,EVM,mRNA,60927,3164976,315,1.00
ptg010773l,558566,558836,270,EVM,mRNA,334590,946688,270,1.00
ptg010773l,744867,745145,278,EVM,mRNA,334590,946688,278,1.00
ptg010773l,3789309,3789638,329,EVM,mRNA,3469418,4381209,329,1.00
ptg010773l,4091610,4091918,308,EVM,mRNA,3469418,4381209,308,1.00
ptg010773l,5009480,5009751,271,EVM,mRNA,4687290,5143167,271,1.00
ptg010778l,33798,34129,331,EVM,mRNA,8326,875060,331,1.00
ptg010778l,339981,340261,280,EVM,mRNA,8326,875060,280,1.00
ptg010781l,1909283,1909572,289,EVM,mRNA,1863467,2118906,289,1.00
ptg010787l,735123,735428,305,EVM,mRNA,343536,1362396,305,1.00
ptg010787l,1074972,1075291,319,EVM,mRNA,343536,1362396,319,1.00
ptg010787l,1939692,1940004,312,EVM,mRNA,1777253,2599419,312,1.00
ptg010790l,125650,125948,298,EVM,mRNA,47006,126314,298,1.00
ptg010793l,802753,803071,318,EVM,mRNA,329919,1131173,318,1.00
ptg010793l,2540742,2541026,284,EVM,mRNA,2235385,2731093,284,1.00
ptg010796l,388565,388884,319,EVM,mRNA,277248,448855,319,1.00
ptg010796l,1029595,1029907,312,EVM,mRNA,784877,1242025,312,1.00
ptg010798l,903758,904119,361,EVM,mRNA,838485,974137,361,1.00
ptg010802l,1099396,1099724,328,EVM,mRNA,1096274,1782604,328,1.00
ptg010802l,1401682,1401982,300,EVM,mRNA,1096274,1782604,300,1.00
ptg010808l,1344568,1344855,287,EVM,mRNA,1052007,1958368,287,1.00
ptg010809l,806851,807141,290,EVM,mRNA,685345,909647,290,1.00
ptg010812l,1047379,1047686,307,EVM,mRNA,303219,1168036,307,1.00
ptg010814l,336962,337227,265,EVM,mRNA,66506,1189794,265,1.00
ptg010821l,494573,494869,296,EVM,mRNA,412832,605498,296,1.00
ptg010822l,12450,12755,305,EVM,mRNA,11783,664276,305,1.00
ptg010826l,837437,837735,298,EVM,mRNA,220263,2496558,298,1.00
ptg010826l,1321058,1321389,331,EVM,mRNA,220263,2496558,331,1.00
ptg010826l,1746506,1746788,282,EVM,mRNA,220263,2496558,282,1.00
ptg010827l,221282,221595,313,EVM,mRNA,15331,351093,313,1.00
ptg010832l,1594814,1595131,317,EVM,mRNA,944198,2148590,317,1.00
ptg010832l,1633860,1634154,294,EVM,mRNA,944198,2148590,294,1.00
ptg010832l,1760798,1761105,307,EVM,mRNA,944198,2148590,307,1.00
ptg010834l,470745,471053,308,EVM,mRNA,399006,1246442,308,1.00
ptg010834l,482187,482468,281,EVM,mRNA,399006,1246442,281,1.00
ptg010843l,1364475,1364794,319,EVM,mRNA,211278,1827099,319,1.00
ptg010844l,1685468,1685763,295,EVM,mRNA,670876,3123905,295,1.00
ptg010849l,999242,999551,309,EVM,mRNA,916679,1145706,309,1.00
ptg010849l,2277242,2277523,281,EVM,mRNA,2004805,3058981,281,1.00
ptg010850l,1527885,1528175,290,EVM,mRNA,1141747,1530726,290,1.00
ptg010857l,328990,329298,308,EVM,mRNA,122524,578067,308,1.00
ptg010859l,415607,415901,294,EVM,mRNA,26129,1787985,294,1.00
ptg010869l,903537,903857,320,EVM,mRNA,303475,1498752,320,1.00
ptg010875l,499058,499355,297,EVM,mRNA,1052,1576396,297,1.00
ptg010879l,3349992,3350293,301,EVM,mRNA,3266467,5714017,301,1.00
ptg010879l,3968790,3969071,281,EVM,mRNA,3266467,5714017,281,1.00
ptg010879l,4291890,4292179,289,EVM,mRNA,3266467,5714017,289,1.00
ptg010879l,4419317,4419585,268,EVM,mRNA,3266467,5714017,268,1.00
ptg010879l,4591444,4591774,330,EVM,mRNA,3266467,5714017,330,1.00
ptg010879l,4641646,4641960,314,EVM,mRNA,3266467,5714017,314,1.00
ptg010879l,4826335,4826619,284,EVM,mRNA,3266467,5714017,284,1.00
ptg010879l,4973930,4974241,311,EVM,mRNA,3266467,5714017,311,1.00
ptg010879l,5459725,5460005,280,EVM,mRNA,3266467,5714017,280,1.00
ptg010883l,328593,328892,299,EVM,mRNA,4636,403137,299,1.00
ptg010889l,46458,46775,317,EVM,mRNA,12364,345241,317,1.00
ptg010891l,171703,172029,326,EVM,mRNA,91098,215984,326,1.00
ptg010896l,2855059,2855350,291,EVM,mRNA,2521210,3819819,291,1.00
ptg010898l,870502,870792,290,EVM,mRNA,794899,2012432,290,1.00
ptg010899l,531123,531446,323,EVM,mRNA,181751,1160250,323,1.00
ptg010899l,574571,574894,323,EVM,mRNA,181751,1160250,323,1.00
ptg010899l,575872,576172,300,EVM,mRNA,181751,1160250,300,1.00
ptg010899l,1088301,1088611,310,EVM,mRNA,181751,1160250,310,1.00
ptg010899l,1116836,1117149,313,EVM,mRNA,181751,1160250,313,1.00
ptg010899l,1638338,1638634,296,EVM,mRNA,1615874,2150315,296,1.00
ptg010899l,1956097,1956406,309,EVM,mRNA,1615874,2150315,309,1.00
ptg010905l,1300933,1301229,296,EVM,mRNA,1036560,1417534,296,1.00
ptg010905l,1366603,1366908,305,EVM,mRNA,1036560,1417534,305,1.00
ptg010906l,589816,590132,316,EVM,mRNA,15,1359791,316,1.00
ptg010929l,169886,170156,270,EVM,mRNA,120632,342283,270,1.00
ptg010930l,509322,509638,316,EVM,mRNA,146536,724642,316,1.00
ptg010937l,567677,567951,274,EVM,mRNA,473382,878593,274,1.00
ptg010938l,3513514,3513840,326,EVM,mRNA,1638530,3756297,326,1.00
ptg010945l,489318,489618,300,EVM,mRNA,14906,1201028,300,1.00
ptg010945l,548606,548915,309,EVM,mRNA,14906,1201028,309,1.00
ptg010945l,555832,556115,283,EVM,mRNA,14906,1201028,283,1.00
ptg010945l,629813,630112,299,EVM,mRNA,14906,1201028,299,1.00
ptg010945l,661076,661363,287,EVM,mRNA,14906,1201028,287,1.00
ptg010945l,822233,822532,299,EVM,mRNA,14906,1201028,299,1.00
ptg010945l,1014899,1015178,279,EVM,mRNA,14906,1201028,279,1.00
ptg010947l,228644,228939,295,EVM,mRNA,147692,331122,295,1.00
ptg010949l,1074557,1074856,299,EVM,mRNA,394672,1490633,299,1.00
ptg010950l,307978,308310,332,EVM,mRNA,219208,537118,332,1.00
ptg010950l,472192,472496,304,EVM,mRNA,219208,537118,304,1.00
ptg010950l,485168,485469,301,EVM,mRNA,219208,537118,301,1.00
ptg010951l,276961,277269,308,EVM,mRNA,656,565779,308,1.00
ptg010952l,1123813,1124114,301,EVM,mRNA,107839,1296821,301,1.00
ptg010952l,1290843,1291138,295,EVM,mRNA,107839,1296821,295,1.00
ptg010953l,326169,326477,308,EVM,mRNA,35594,1208645,308,1.00
ptg010959l,498808,499131,323,EVM,mRNA,392797,1482544,323,1.00
ptg010959l,1088984,1089276,292,EVM,mRNA,392797,1482544,292,1.00
ptg010960l,759878,760157,279,EVM,mRNA,228311,834477,279,1.00
ptg010960l,779541,779870,329,EVM,mRNA,228311,834477,329,1.00
ptg010962l,807904,808202,298,EVM,mRNA,580092,847444,298,1.00
ptg010966l,1358015,1358314,299,EVM,mRNA,538629,1374311,299,1.00
ptg010969l,364779,365055,276,EVM,mRNA,57037,1014841,276,1.00
ptg010969l,880492,880803,311,EVM,mRNA,57037,1014841,311,1.00
ptg010972l,450726,451031,305,EVM,mRNA,396889,936455,305,1.00
ptg010973l,1145780,1146087,307,EVM,mRNA,1117095,1827893,307,1.00
ptg010973l,1613533,1613848,315,EVM,mRNA,1117095,1827893,315,1.00
ptg010976l,233759,234046,287,EVM,mRNA,129811,589061,287,1.00
ptg010976l,881601,881893,292,EVM,mRNA,709708,1699347,292,1.00
ptg010977l,47782,48100,318,EVM,mRNA,8323,468082,318,1.00
ptg010977l,92754,93054,300,EVM,mRNA,8323,468082,300,1.00
ptg010977l,3164860,3165175,315,EVM,mRNA,2722918,3440339,315,1.00
ptg010977l,3668280,3668589,309,EVM,mRNA,3484421,3697482,309,1.00
ptg010978l,101926,102208,282,EVM,mRNA,98984,454429,282,1.00
ptg010983l,1819326,1819593,267,EVM,mRNA,733670,2891218,267,1.00
ptg010986l,544116,544436,320,EVM,mRNA,74676,1486709,320,1.00
ptg010993l,395334,395650,316,EVM,mRNA,35998,395998,316,1.00
ptg010996l,719872,720172,300,EVM,mRNA,258,936894,300,1.00
ptg010996l,915736,916045,309,EVM,mRNA,258,936894,309,1.00
ptg010997l,629304,629605,301,EVM,mRNA,608519,841564,301,1.00
ptg010997l,726728,727017,289,EVM,mRNA,608519,841564,289,1.00
ptg010997l,742455,742743,288,EVM,mRNA,608519,841564,288,1.00
ptg010998l,1624184,1624495,311,EVM,mRNA,924663,1984671,311,1.00
ptg011001l,36569,36886,317,EVM,mRNA,19952,333708,317,1.00
ptg011001l,137108,137434,326,EVM,mRNA,19952,333708,326,1.00
ptg011001l,856442,856727,285,EVM,mRNA,604401,996250,285,1.00
ptg011001l,1475882,1476172,290,EVM,mRNA,1389726,1811109,290,1.00
ptg011009l,195585,195890,305,EVM,mRNA,2400,766630,305,1.00
ptg011009l,505321,505618,297,EVM,mRNA,2400,766630,297,1.00
ptg011009l,707381,707695,314,EVM,mRNA,2400,766630,314,1.00
ptg011011l,1185856,1186152,296,EVM,mRNA,391468,2827346,296,1.00
ptg011011l,2286315,2286600,285,EVM,mRNA,391468,2827346,285,1.00
ptg011011l,2293621,2293910,289,EVM,mRNA,391468,2827346,289,1.00
ptg011011l,2336910,2337218,308,EVM,mRNA,391468,2827346,308,1.00
ptg011011l,2488466,2488779,313,EVM,mRNA,391468,2827346,313,1.00
ptg011011l,2779764,2780056,292,EVM,mRNA,391468,2827346,292,1.00
ptg011012l,778054,778358,304,EVM,mRNA,245150,1040265,304,1.00
ptg011019l,420454,420752,298,EVM,mRNA,343541,1754840,298,1.00
ptg011029l,364387,364687,300,EVM,mRNA,80171,678299,300,1.00
ptg011034l,1052249,1052537,288,EVM,mRNA,3072,1700992,288,1.00
ptg011034l,1686912,1687221,309,EVM,mRNA,3072,1700992,309,1.00
ptg011036l,886917,887216,299,EVM,mRNA,78331,1093115,299,1.00
ptg011039l,70779,71079,300,EVM,mRNA,47021,626494,300,1.00
ptg011039l,603781,604111,330,EVM,mRNA,47021,626494,330,1.00
ptg011040l,1568651,1568947,296,EVM,mRNA,1239987,1638722,296,1.00
ptg011040l,1589717,1590030,313,EVM,mRNA,1239987,1638722,313,1.00
ptg011040l,1606829,1607127,298,EVM,mRNA,1239987,1638722,298,1.00
ptg011043l,1185065,1185337,272,EVM,mRNA,238132,2079176,272,1.00
ptg011054l,384046,384346,300,EVM,mRNA,131192,1610209,300,1.00
ptg011054l,998586,998894,308,EVM,mRNA,131192,1610209,308,1.00
ptg011062l,1525550,1525876,326,EVM,mRNA,1392360,1695011,326,1.00
ptg011063l,963924,964210,286,EVM,mRNA,131174,975606,286,1.00
ptg011064l,290525,290816,291,EVM,mRNA,146808,334619,291,1.00
ptg011068l,1751090,1751361,271,EVM,mRNA,1500577,1752069,271,1.00
ptg011068l,2620442,2620721,279,EVM,mRNA,2445394,4573255,279,1.00
ptg011068l,3052134,3052440,306,EVM,mRNA,2445394,4573255,306,1.00
ptg011068l,4399732,4400013,281,EVM,mRNA,2445394,4573255,281,1.00
ptg011072l,394692,394971,279,EVM,mRNA,362367,488457,279,1.00
ptg011077l,215425,215674,249,EVM,mRNA,57714,509203,249,1.00
ptg011082l,729086,729402,316,EVM,mRNA,570974,1088941,316,1.00
ptg011082l,975091,975370,279,EVM,mRNA,570974,1088941,279,1.00
ptg011087l,1756303,1756590,287,EVM,mRNA,919910,3969077,287,1.00
ptg011087l,1877138,1877450,312,EVM,mRNA,919910,3969077,312,1.00
ptg011087l,1882006,1882295,289,EVM,mRNA,919910,3969077,289,1.00
ptg011087l,2917241,2917542,301,EVM,mRNA,919910,3969077,301,1.00
ptg011087l,3852592,3852889,297,EVM,mRNA,919910,3969077,297,1.00
ptg011091l,473892,474216,324,EVM,mRNA,383757,571363,324,1.00
ptg011092l,1194063,1194373,310,EVM,mRNA,734897,1633704,310,1.00
ptg011092l,2223565,2223864,299,EVM,mRNA,1791837,3697893,299,1.00
ptg011092l,2601408,2601717,309,EVM,mRNA,1791837,3697893,309,1.00
ptg011092l,2872188,2872469,281,EVM,mRNA,1791837,3697893,281,1.00
ptg011092l,3061737,3062042,305,EVM,mRNA,1791837,3697893,305,1.00
ptg011092l,3336115,3336414,299,EVM,mRNA,1791837,3697893,299,1.00
ptg011093l,872336,872628,292,EVM,mRNA,182126,1198983,292,1.00
ptg011093l,971159,971482,323,EVM,mRNA,182126,1198983,323,1.00
ptg011093l,1019794,1020153,359,EVM,mRNA,182126,1198983,359,1.00
ptg011097l,864477,864788,311,EVM,mRNA,1301,2700134,311,1.00
ptg011097l,2693544,2693823,279,EVM,mRNA,1301,2700134,279,1.00
ptg011100l,188189,188480,291,EVM,mRNA,690,201963,291,1.00
ptg011102l,739681,739985,304,EVM,mRNA,174478,1252472,304,1.00
ptg011102l,1901492,1901787,295,EVM,mRNA,1546938,2103842,295,1.00
ptg011102l,1901492,1901787,295,GeneWise,mRNA,1526202,2103839,295,1.00
ptg011102l,2412373,2412689,316,EVM,mRNA,2409593,2426404,316,1.00
ptg011102l,3011564,3011855,291,EVM,mRNA,2850660,3128268,291,1.00
ptg011103l,765418,765697,279,EVM,mRNA,264857,1742540,279,1.00
ptg011105l,754055,754362,307,EVM,mRNA,609817,1163370,307,1.00
ptg011106l,311633,311952,319,EVM,mRNA,57305,2606507,319,1.00
ptg011106l,833086,833378,292,EVM,mRNA,57305,2606507,292,1.00
ptg011106l,2486671,2486969,298,EVM,mRNA,57305,2606507,298,1.00
ptg011108l,1595794,1596125,331,EVM,mRNA,392364,1917464,331,1.00
ptg011108l,1844412,1844688,276,EVM,mRNA,392364,1917464,276,1.00
ptg011112l,813802,814123,321,EVM,mRNA,29220,837431,321,1.00
ptg011112l,1937408,1937717,309,EVM,mRNA,1598569,1948858,309,1.00
ptg011118l,1816556,1816856,300,EVM,mRNA,1757652,2110980,300,1.00
ptg011120l,257188,257474,286,EVM,mRNA,251635,421785,286,1.00
ptg011122l,367792,368125,333,EVM,mRNA,43041,463570,333,1.00
ptg011123l,429717,430025,308,EVM,mRNA,46772,901337,308,1.00
ptg011123l,517875,518174,299,EVM,mRNA,46772,901337,299,1.00
ptg011123l,753047,753299,252,EVM,mRNA,46772,901337,252,1.00
ptg011127l,739945,740256,311,EVM,mRNA,154523,795457,311,1.00
ptg011127l,1147021,1147332,311,EVM,mRNA,832007,1496391,311,1.00
ptg011127l,1298236,1298493,257,EVM,mRNA,832007,1496391,257,1.00
ptg011132l,1027862,1028176,314,EVM,mRNA,7053,1848898,314,1.00
ptg011132l,1185117,1185404,287,EVM,mRNA,7053,1848898,287,1.00
ptg011132l,2101883,2102170,287,EVM,mRNA,2100483,2479362,287,1.00
ptg011134l,543181,543471,290,EVM,mRNA,110,1597474,290,1.00
ptg011134l,1245511,1245814,303,EVM,mRNA,110,1597474,303,1.00
ptg011136l,483107,483420,313,EVM,mRNA,102196,662612,313,1.00
ptg011136l,545855,546164,309,EVM,mRNA,102196,662612,309,1.00
ptg011139l,1347442,1347725,283,EVM,mRNA,807095,1351461,283,1.00
ptg011144l,239622,239924,302,EVM,mRNA,144868,340217,302,1.00
ptg011151l,1912714,1913011,297,EVM,mRNA,1702576,2180899,297,1.00
ptg011152l,683132,683427,295,EVM,mRNA,9355,1243530,295,1.00
ptg011152l,759027,759307,280,EVM,mRNA,9355,1243530,280,1.00
ptg011152l,799316,799615,299,EVM,mRNA,9355,1243530,299,1.00
ptg011152l,1180481,1180778,297,EVM,mRNA,9355,1243530,297,1.00
ptg011157l,496752,497054,302,EVM,mRNA,445413,587724,302,1.00
ptg011164l,427632,427913,281,EVM,mRNA,240465,433967,281,1.00
ptg011165l,617115,617417,302,EVM,mRNA,200119,790118,302,1.00
ptg011165l,749000,749290,290,EVM,mRNA,200119,790118,290,1.00
ptg011166l,507658,507968,310,EVM,mRNA,354193,515793,310,1.00
ptg011176l,504400,504697,297,EVM,mRNA,502591,505185,297,1.00
ptg011187l,512789,513102,313,EVM,mRNA,11951,855010,313,1.00
ptg011194l,316064,316346,282,EVM,mRNA,7566,861014,282,1.00
ptg011194l,2583759,2584070,311,EVM,mRNA,1244609,3115720,311,1.00
ptg011200l,972031,972345,314,EVM,mRNA,814911,1708974,314,1.00
ptg011200l,1063168,1063460,292,EVM,mRNA,814911,1708974,292,1.00
ptg011200l,1581734,1582045,311,EVM,mRNA,814911,1708974,311,1.00
ptg011216l,791365,791685,320,EVM,mRNA,692182,902385,320,1.00
ptg011219l,240847,241142,295,EVM,mRNA,74871,247253,295,1.00
ptg011222l,2772508,2772823,315,EVM,mRNA,2758025,3046998,315,1.00
ptg011224l,385371,385652,281,EVM,mRNA,175533,1107119,281,1.00
ptg011224l,547330,547617,287,EVM,mRNA,175533,1107119,287,1.00
ptg011232l,1852212,1852525,313,EVM,mRNA,1645200,2067899,313,1.00
ptg011232l,2214929,2215203,274,EVM,mRNA,2206584,2312777,274,1.00
ptg011234l,200478,200813,335,EVM,mRNA,43824,200542,64,0.19
ptg011235l,656298,656630,332,EVM,mRNA,123425,1213134,332,1.00
ptg011236l,838912,839189,277,EVM,mRNA,837977,901349,277,1.00
ptg011236l,872852,873170,318,EVM,mRNA,837977,901349,318,1.00
ptg011237l,714548,714850,302,EVM,mRNA,347436,1023090,302,1.00
ptg011238l,483242,483570,328,EVM,mRNA,7809,761317,328,1.00
ptg011238l,1291436,1291721,285,EVM,mRNA,958720,2027537,285,1.00
ptg011238l,1863507,1863816,309,EVM,mRNA,958720,2027537,309,1.00
ptg011242l,240877,241202,325,EVM,mRNA,117672,241954,325,1.00
ptg011252l,3178519,3178834,315,EVM,mRNA,3093972,3216600,315,1.00
ptg011256l,64019,64285,266,EVM,mRNA,29318,159976,266,1.00
ptg011256l,3992791,3993094,303,EVM,mRNA,3393273,4519568,303,1.00
ptg011256l,4151075,4151380,305,EVM,mRNA,3393273,4519568,305,1.00
ptg011258l,868210,868494,284,EVM,mRNA,397638,909549,284,1.00
ptg011258l,1721471,1721770,299,EVM,mRNA,1565114,2231627,299,1.00
ptg011263l,1108529,1108850,321,EVM,mRNA,446833,1121493,321,1.00
ptg011263l,1741536,1741832,296,EVM,mRNA,1192143,2089494,296,1.00
ptg011263l,1824149,1824431,282,EVM,mRNA,1192143,2089494,282,1.00
ptg011263l,1934687,1935005,318,EVM,mRNA,1192143,2089494,318,1.00
ptg011263l,1973306,1973569,263,EVM,mRNA,1192143,2089494,263,1.00
ptg011268l,300923,301234,311,EVM,mRNA,227811,546204,311,1.00
ptg011270l,2497901,2498201,300,EVM,mRNA,2147292,3137176,300,1.00
ptg011272l,1529061,1529356,295,EVM,mRNA,711425,1682953,295,1.00
ptg011275l,773728,774022,294,EVM,mRNA,762813,1506359,294,1.00
ptg011279l,17653,17945,292,EVM,mRNA,37,2480320,292,1.00
ptg011279l,1382503,1382829,326,EVM,mRNA,37,2480320,326,1.00
ptg011280l,646482,646789,307,EVM,mRNA,639677,668967,307,1.00
ptg011281l,709233,709540,307,EVM,mRNA,489650,821279,307,1.00
ptg011282l,770994,771275,281,EVM,mRNA,230463,1285731,281,1.00
ptg011282l,2120767,2121038,271,EVM,mRNA,1534670,3229348,271,1.00
ptg011282l,3123990,3124294,304,EVM,mRNA,1534670,3229348,304,1.00
ptg011282l,3184827,3185158,331,EVM,mRNA,1534670,3229348,331,1.00
ptg011284l,559769,560077,308,EVM,mRNA,141301,758028,308,1.00
ptg011294l,2462339,2462627,288,EVM,mRNA,2033840,5507627,288,1.00
ptg011294l,4160094,4160373,279,EVM,mRNA,2033840,5507627,279,1.00
ptg011294l,4333099,4333406,307,EVM,mRNA,2033840,5507627,307,1.00
ptg011299l,1097334,1097633,299,EVM,mRNA,201510,1357978,299,1.00
ptg011299l,1344979,1345273,294,EVM,mRNA,201510,1357978,294,1.00
ptg011305l,1309707,1310006,299,EVM,mRNA,1309310,1321051,299,1.00
ptg011307l,917927,918218,291,EVM,mRNA,114296,1551534,291,1.00
ptg011308l,261024,261306,282,EVM,mRNA,107900,1046057,282,1.00
ptg011311l,2173357,2173646,289,EVM,mRNA,2093421,2174919,289,1.00
ptg011318l,134130,134394,264,EVM,mRNA,11643,267664,264,1.00
ptg011323l,234225,234501,276,EVM,mRNA,61477,371743,276,1.00
ptg011330l,1202995,1203295,300,EVM,mRNA,807675,1309313,300,1.00
ptg011331l,681521,681846,325,EVM,mRNA,643798,692007,325,1.00
ptg011332l,1207155,1207471,316,EVM,mRNA,947913,1254453,316,1.00
ptg011338l,139332,139666,334,EVM,mRNA,24410,179071,334,1.00
ptg011339l,244882,245181,299,EVM,mRNA,164144,355188,299,1.00
ptg011343l,820264,820532,268,EVM,mRNA,540742,1523886,268,1.00
ptg011348l,1804950,1805280,330,EVM,mRNA,1154445,2586538,330,1.00
ptg011348l,2181375,2181674,299,EVM,mRNA,1154445,2586538,299,1.00
ptg011350l,2974215,2974498,283,EVM,mRNA,2925795,3158197,283,1.00
ptg011357l,912048,912346,298,EVM,mRNA,11783,1580511,298,1.00
ptg011357l,1515072,1515386,314,EVM,mRNA,11783,1580511,314,1.00
ptg011357l,1520892,1521208,316,EVM,mRNA,11783,1580511,316,1.00
ptg011359l,713114,713380,266,EVM,mRNA,583456,2620012,266,1.00
ptg011359l,872342,872642,300,EVM,mRNA,583456,2620012,300,1.00
ptg011359l,882474,882780,306,EVM,mRNA,583456,2620012,306,1.00
ptg011359l,961760,962068,308,EVM,mRNA,583456,2620012,308,1.00
ptg011364l,111841,112179,338,EVM,mRNA,62936,189180,338,1.00
ptg011367l,1479830,1480140,310,EVM,mRNA,1406976,1784412,310,1.00
ptg011369l,54120,54439,319,EVM,mRNA,17486,203646,319,1.00
ptg011373l,649309,649596,287,EVM,mRNA,631309,669792,287,1.00
ptg011376l,19293,19614,321,EVM,mRNA,2290,191395,321,1.00
ptg011376l,136142,136434,292,EVM,mRNA,2290,191395,292,1.00
ptg011378l,590418,590713,295,EVM,mRNA,563690,1321499,295,1.00
ptg011378l,1871751,1872046,295,EVM,mRNA,1429952,1878568,295,1.00
ptg011379l,108016,108309,293,EVM,mRNA,51356,1057173,293,1.00
ptg011379l,1282836,1283167,331,EVM,mRNA,1279997,2489456,331,1.00
ptg011379l,2355104,2355383,279,EVM,mRNA,1279997,2489456,279,1.00
ptg011384l,237253,237568,315,EVM,mRNA,84181,413735,315,1.00
ptg011384l,1698063,1698382,319,EVM,mRNA,1592730,2117309,319,1.00
ptg011387l,161033,161348,315,EVM,mRNA,132162,219499,315,1.00
ptg011391l,811924,812251,327,EVM,mRNA,694444,984755,327,1.00
ptg011394l,541145,541435,290,EVM,mRNA,472716,1527925,290,1.00
ptg011394l,1454926,1455248,322,EVM,mRNA,472716,1527925,322,1.00
ptg011397l,667869,668194,325,EVM,mRNA,574123,713927,325,1.00
ptg011397l,1340852,1341133,281,EVM,mRNA,940579,1575890,281,1.00
ptg011397l,1879716,1880002,286,EVM,mRNA,1658580,1884426,286,1.00
ptg011397l,3307768,3308096,328,EVM,mRNA,3112269,3425071,328,1.00
ptg011400l,371882,372188,306,EVM,mRNA,80892,2276505,306,1.00
ptg011404l,1093201,1093497,296,EVM,mRNA,940696,1346567,296,1.00
ptg011408l,905058,905332,274,EVM,mRNA,772633,1599416,274,1.00
ptg011409l,1455685,1455992,307,EVM,mRNA,295604,1965442,307,1.00
ptg011409l,1470764,1471022,258,EVM,mRNA,295604,1965442,258,1.00
ptg011411l,1720127,1720411,284,EVM,mRNA,1661648,1864642,284,1.00
ptg011413l,314455,314764,309,EVM,mRNA,263807,459985,309,1.00
ptg011413l,368785,369133,348,EVM,mRNA,263807,459985,348,1.00
ptg011418l,1204133,1204433,300,EVM,mRNA,1132292,1282356,300,1.00
ptg011425l,2085946,2086228,282,EVM,mRNA,1597148,2239167,282,1.00
ptg011427l,1150206,1150497,291,EVM,mRNA,1108139,1221277,291,1.00
ptg011428l,167365,167678,313,EVM,mRNA,89201,431493,313,1.00
ptg011431l,252789,253106,317,EVM,mRNA,237989,393404,317,1.00
ptg011431l,996660,996966,306,EVM,mRNA,723562,1233112,306,1.00
ptg011431l,3479896,3480176,280,EVM,mRNA,3184013,3587895,280,1.00
ptg011440l,240990,241274,284,EVM,mRNA,219560,474514,284,1.00
ptg011442l,334639,334948,309,EVM,mRNA,172892,3052680,309,1.00
ptg011442l,878794,879108,314,EVM,mRNA,172892,3052680,314,1.00
ptg011442l,997447,997766,319,EVM,mRNA,172892,3052680,319,1.00
ptg011442l,2011268,2011570,302,EVM,mRNA,172892,3052680,302,1.00
ptg011442l,2990021,2990322,301,EVM,mRNA,172892,3052680,301,1.00
ptg011449l,844434,844757,323,EVM,mRNA,819929,909325,323,1.00
ptg011450l,975087,975406,319,EVM,mRNA,64588,1230661,319,1.00
ptg011457l,1601839,1602140,301,EVM,mRNA,1464895,2125572,301,1.00
ptg011463l,978524,978829,305,EVM,mRNA,35042,1880178,305,1.00
ptg011463l,1001934,1002230,296,EVM,mRNA,35042,1880178,296,1.00
ptg011465l,1085205,1085504,299,EVM,mRNA,970080,1416312,299,1.00
ptg011468l,615300,615590,290,EVM,mRNA,264785,734180,290,1.00
ptg011469l,278152,278488,336,EVM,mRNA,140954,439904,336,1.00
ptg011469l,367284,367590,306,EVM,mRNA,140954,439904,306,1.00
ptg011474l,1796942,1797229,287,EVM,mRNA,1516146,2753811,287,1.00
ptg011476l,120152,120469,317,EVM,mRNA,103517,220645,317,1.00
ptg011479l,1759177,1759492,315,EVM,mRNA,954338,1963644,315,1.00
ptg011480l,460025,460339,314,EVM,mRNA,94319,639872,314,1.00
ptg011485l,433839,434128,289,EVM,mRNA,69534,648388,289,1.00
ptg011489l,1188850,1189130,280,EVM,mRNA,350468,2806381,280,1.00
ptg011489l,2047039,2047338,299,EVM,mRNA,350468,2806381,299,1.00
ptg011520l,121020,121313,293,EVM,mRNA,2320,353970,293,1.00
ptg011525l,133102,133428,326,EVM,mRNA,7318,552562,326,1.00
ptg011525l,355495,355828,333,EVM,mRNA,7318,552562,333,1.00
ptg011531l,900701,900986,285,EVM,mRNA,898041,902834,285,1.00
ptg011531l,1126705,1127006,301,EVM,mRNA,967273,1436516,301,1.00
ptg011531l,2904674,2904969,295,EVM,mRNA,1995094,3857858,295,1.00
ptg011531l,2961310,2961596,286,EVM,mRNA,1995094,3857858,286,1.00
ptg011531l,3329086,3329375,289,EVM,mRNA,1995094,3857858,289,1.00
ptg011536l,60160,60491,331,EVM,mRNA,24411,858845,331,1.00
ptg011536l,573816,574085,269,EVM,mRNA,24411,858845,269,1.00
ptg011537l,1186135,1186437,302,EVM,mRNA,792913,1439630,302,1.00
ptg011537l,1942321,1942606,285,EVM,mRNA,1832491,2330188,285,1.00
ptg011539l,1214493,1214802,309,EVM,mRNA,849461,1495119,309,1.00
ptg011543l,1480599,1480897,298,EVM,mRNA,1115154,1656072,298,1.00
ptg011544l,636403,636674,271,EVM,mRNA,531129,642168,271,1.00
ptg011546l,153756,154037,281,EVM,mRNA,89188,2560630,281,1.00
ptg011546l,705104,705401,297,EVM,mRNA,89188,2560630,297,1.00
ptg011546l,858095,858429,334,EVM,mRNA,89188,2560630,334,1.00
ptg011546l,1079604,1079923,319,EVM,mRNA,89188,2560630,319,1.00
ptg011546l,1146649,1146946,297,EVM,mRNA,89188,2560630,297,1.00
ptg011546l,1205300,1205593,293,EVM,mRNA,89188,2560630,293,1.00
ptg011546l,1462260,1462553,293,EVM,mRNA,89188,2560630,293,1.00
ptg011546l,1468363,1468684,321,EVM,mRNA,89188,2560630,321,1.00
ptg011546l,1584096,1584387,291,EVM,mRNA,89188,2560630,291,1.00
ptg011546l,1718280,1718606,326,EVM,mRNA,89188,2560630,326,1.00
ptg011546l,1920041,1920350,309,EVM,mRNA,89188,2560630,309,1.00
ptg011546l,1991614,1991907,293,EVM,mRNA,89188,2560630,293,1.00
ptg011546l,2008912,2009205,293,EVM,mRNA,89188,2560630,293,1.00
ptg011546l,2042993,2043283,290,EVM,mRNA,89188,2560630,290,1.00
ptg011546l,2131774,2132069,295,EVM,mRNA,89188,2560630,295,1.00
ptg011546l,2139531,2139825,294,EVM,mRNA,89188,2560630,294,1.00
ptg011547l,1776076,1776341,265,EVM,mRNA,1386736,2467936,265,1.00
ptg011549l,125735,126024,289,EVM,mRNA,13077,1240904,289,1.00
ptg011549l,599742,600057,315,EVM,mRNA,13077,1240904,315,1.00
ptg011549l,779963,780299,336,EVM,mRNA,13077,1240904,336,1.00
ptg011549l,1060015,1060322,307,EVM,mRNA,13077,1240904,307,1.00
ptg011558l,1283817,1284116,299,EVM,mRNA,21309,1489286,299,1.00
ptg011559l,208232,208513,281,EVM,mRNA,30885,1363725,281,1.00
ptg011562l,1270754,1271053,299,EVM,mRNA,1068493,1721918,299,1.00
ptg011562l,1652066,1652395,329,EVM,mRNA,1068493,1721918,329,1.00
ptg011568l,1566063,1566391,328,EVM,mRNA,723381,2408286,328,1.00
ptg011568l,2325278,2325587,309,EVM,mRNA,723381,2408286,309,1.00
ptg011570l,457174,457448,274,EVM,mRNA,158081,463021,274,1.00
ptg011575l,971724,972053,329,EVM,mRNA,780496,981867,329,1.00
ptg011576l,265703,265955,252,EVM,mRNA,261699,762549,252,1.00
ptg011583l,995228,995529,301,EVM,mRNA,261752,1374555,301,1.00
ptg011588l,631097,631369,272,EVM,mRNA,27188,694263,272,1.00
ptg011588l,953945,954258,313,EVM,mRNA,904600,967205,313,1.00
ptg011589l,1060114,1060453,339,EVM,mRNA,998768,1667230,339,1.00
ptg011589l,1251631,1251912,281,EVM,mRNA,998768,1667230,281,1.00
ptg011592l,562461,562782,321,EVM,mRNA,154493,640514,321,1.00
ptg011600l,1482416,1482723,307,EVM,mRNA,1482530,1728174,194,0.63
ptg011602l,177435,177704,269,EVM,mRNA,116732,1627638,269,1.00
ptg011602l,644159,644460,301,EVM,mRNA,116732,1627638,301,1.00
ptg011602l,823979,824291,312,EVM,mRNA,116732,1627638,312,1.00
ptg011602l,1022494,1022772,278,EVM,mRNA,116732,1627638,278,1.00
ptg011602l,1027366,1027666,300,EVM,mRNA,116732,1627638,300,1.00
ptg011602l,4030990,4031283,293,EVM,mRNA,3812181,4475118,293,1.00
ptg011602l,4341702,4342021,319,EVM,mRNA,3812181,4475118,319,1.00
ptg011608l,103726,104012,286,EVM,mRNA,27530,166292,286,1.00
ptg011608l,132449,132730,281,EVM,mRNA,27530,166292,281,1.00
ptg011608l,1042656,1042959,303,EVM,mRNA,185600,1235976,303,1.00
ptg011618l,637786,638103,317,EVM,mRNA,8669,1025823,317,1.00
ptg011621l,729213,729534,321,EVM,mRNA,729151,918638,321,1.00
ptg011622l,1343194,1343519,325,EVM,mRNA,134839,2596791,325,1.00
ptg011622l,1988620,1988936,316,EVM,mRNA,134839,2596791,316,1.00
ptg011636l,70780,71113,333,EVM,mRNA,6884,92976,333,1.00
ptg011638l,721610,721897,287,EVM,mRNA,150398,1169338,287,1.00
ptg011638l,1100187,1100487,300,EVM,mRNA,150398,1169338,300,1.00
ptg011638l,1417845,1418162,317,EVM,mRNA,1195773,1668110,317,1.00
ptg011642l,1657089,1657392,303,EVM,mRNA,1637179,1808437,303,1.00
ptg011642l,2236688,2237001,313,EVM,mRNA,2124286,2317441,313,1.00
ptg011642l,2479231,2479567,336,EVM,mRNA,2417982,2500997,336,1.00
ptg011644l,13112,13437,325,EVM,mRNA,11068,596717,325,1.00
ptg011646l,1055645,1055965,320,EVM,mRNA,289585,1606243,320,1.00
ptg011646l,1416098,1416433,335,EVM,mRNA,289585,1606243,335,1.00
ptg011646l,1467840,1468088,248,EVM,mRNA,289585,1606243,248,1.00
ptg011663l,146269,146565,296,EVM,mRNA,130023,581246,296,1.00
ptg011667l,241842,242129,287,EVM,mRNA,179772,275174,287,1.00
ptg011681l,246211,246529,318,EVM,mRNA,61490,266992,318,1.00
ptg011686l,974184,974509,325,EVM,mRNA,449955,1182903,325,1.00
ptg011687l,1464720,1465006,286,EVM,mRNA,1365550,1532604,286,1.00
ptg011690l,342219,342503,284,EVM,mRNA,79633,705408,284,1.00
ptg011696l,416416,416700,284,EVM,mRNA,365230,1709366,284,1.00
ptg011696l,2454385,2454675,290,EVM,mRNA,2104372,2547325,290,1.00
ptg011697l,3612203,3612462,259,EVM,mRNA,2869374,4046194,259,1.00
ptg011708l,215341,215623,282,EVM,mRNA,197810,366194,282,1.00
ptg011709l,902613,902918,305,EVM,mRNA,667,1502881,305,1.00
ptg011709l,1988557,1988871,314,EVM,mRNA,1767479,2079390,314,1.00
ptg011716l,658802,659104,302,EVM,mRNA,544613,1203272,302,1.00
ptg011721l,697807,698097,290,EVM,mRNA,686683,758631,290,1.00
ptg011721l,1149004,1149299,295,EVM,mRNA,978221,1176149,295,1.00
ptg011722l,144305,144566,261,EVM,mRNA,12660,222594,261,1.00
ptg011729l,228817,229108,291,EVM,mRNA,12116,329394,291,1.00
ptg011735l,887234,887564,330,EVM,mRNA,692269,2098445,330,1.00
ptg011735l,1877053,1877366,313,EVM,mRNA,692269,2098445,313,1.00
ptg011736l,1560505,1560821,316,EVM,mRNA,1488856,1624826,316,1.00
ptg011739l,1353606,1353932,326,EVM,mRNA,1290324,1430207,326,1.00
ptg011742l,794355,794654,299,EVM,mRNA,144290,1476744,299,1.00
ptg011744l,304953,305248,295,EVM,mRNA,281161,338035,295,1.00
ptg011746l,281756,282067,311,EVM,mRNA,281925,282503,143,0.46
ptg011748l,1286079,1286379,300,EVM,mRNA,1260894,1389709,300,1.00
ptg011754l,466378,466653,275,EVM,mRNA,126229,1100921,275,1.00
ptg011754l,1014648,1014929,281,EVM,mRNA,126229,1100921,281,1.00
ptg011755l,416987,417270,283,EVM,mRNA,39705,1374272,283,1.00
ptg011757l,495419,495700,281,EVM,mRNA,136076,506729,281,1.00
ptg011761l,604578,604882,304,EVM,mRNA,380466,914860,304,1.00
ptg011765l,1201428,1201733,305,EVM,mRNA,13497,1280027,305,1.00
ptg011765l,1349430,1349750,320,EVM,mRNA,1321916,1560907,320,1.00
ptg011773l,118543,118844,301,EVM,mRNA,26829,211863,301,1.00
ptg011784l,274222,274538,316,EVM,mRNA,189254,1391810,316,1.00
ptg011784l,289941,290243,302,EVM,mRNA,189254,1391810,302,1.00
ptg011784l,1237246,1237571,325,EVM,mRNA,189254,1391810,325,1.00
ptg011791l,442746,443033,287,EVM,mRNA,23306,1209490,287,1.00
ptg011791l,630977,631309,332,EVM,mRNA,23306,1209490,332,1.00
ptg011799l,338704,339003,299,EVM,mRNA,474,1036638,299,1.00
ptg011799l,829405,829688,283,EVM,mRNA,474,1036638,283,1.00
ptg011800l,477774,478103,329,EVM,mRNA,134301,626940,329,1.00
ptg011814l,230131,230410,279,EVM,mRNA,113981,438628,279,1.00
ptg011816l,434376,434659,283,EVM,mRNA,432772,874188,283,1.00
ptg011818l,981498,981816,318,EVM,mRNA,9848,1147583,318,1.00
ptg011821l,234004,234300,296,EVM,mRNA,182408,1238430,296,1.00
ptg011821l,402412,402714,302,EVM,mRNA,182408,1238430,302,1.00
ptg011823l,2032806,2033063,257,EVM,mRNA,1941480,2198837,257,1.00
ptg011823l,2159096,2159365,269,EVM,mRNA,1941480,2198837,269,1.00
ptg011828l,877487,877771,284,EVM,mRNA,853874,1142429,284,1.00
ptg011829l,102594,102903,309,EVM,mRNA,3042,161246,309,1.00
ptg011829l,402025,402307,282,EVM,mRNA,325181,470849,282,1.00
ptg011830l,404385,404702,317,EVM,mRNA,361076,441446,317,1.00
ptg011831l,1088414,1088728,314,EVM,mRNA,103989,1394253,314,1.00
ptg011831l,1305999,1306297,298,EVM,mRNA,103989,1394253,298,1.00
ptg011832l,494581,494880,299,EVM,mRNA,389555,789441,299,1.00
ptg011850l,1217496,1217791,295,EVM,mRNA,1153619,1239786,295,1.00
ptg011856l,1242732,1243019,287,EVM,mRNA,1233104,1323618,287,1.00
ptg011861l,178057,178354,297,EVM,mRNA,40043,453687,297,1.00
ptg011861l,1596615,1596922,307,EVM,mRNA,1583916,1726593,307,1.00
ptg011862l,447089,447393,304,EVM,mRNA,359718,793400,304,1.00
ptg011863l,1285478,1285807,329,EVM,mRNA,989039,1425997,329,1.00
ptg011870l,299952,300257,305,EVM,mRNA,58288,413941,305,1.00
ptg011881l,1644456,1644751,295,EVM,mRNA,1040119,1667495,295,1.00
ptg011883l,234290,234586,296,EVM,mRNA,18247,831222,296,1.00
ptg011885l,1069342,1069645,303,EVM,mRNA,237140,1223953,303,1.00
ptg011888l,1140235,1140522,287,EVM,mRNA,898675,1604101,287,1.00
ptg011888l,2930330,2930618,288,EVM,mRNA,2588435,3081815,288,1.00
ptg011891l,117657,117989,332,EVM,mRNA,3817,425112,332,1.00
ptg011891l,239381,239709,328,EVM,mRNA,3817,425112,328,1.00
ptg011891l,681724,682027,303,EVM,mRNA,456236,770919,303,1.00
ptg011897l,876255,876560,305,EVM,mRNA,288593,1240461,305,1.00
ptg011903l,2818895,2819224,329,EVM,mRNA,1204595,3190624,329,1.00
ptg011906l,403392,403677,285,EVM,mRNA,148011,450232,285,1.00
ptg011907l,1466207,1466544,337,EVM,mRNA,1452430,1721108,337,1.00
ptg011920l,931815,932142,327,EVM,mRNA,132325,1017150,327,1.00
ptg011923l,624704,624964,260,EVM,mRNA,24245,818843,260,1.00
ptg011925l,447819,448123,304,EVM,mRNA,235465,1745000,304,1.00
ptg011925l,1101451,1101745,294,EVM,mRNA,235465,1745000,294,1.00
ptg011927l,471492,471823,331,EVM,mRNA,233260,526388,331,1.00
ptg011928l,350542,350854,312,EVM,mRNA,234960,532652,312,1.00
ptg011940l,946926,947236,310,EVM,mRNA,413749,1321366,310,1.00
ptg011940l,983509,983827,318,EVM,mRNA,413749,1321366,318,1.00
ptg011940l,1082842,1083103,261,EVM,mRNA,413749,1321366,261,1.00
ptg011945l,141502,141801,299,EVM,mRNA,79380,159045,299,1.00
ptg011955l,556823,557134,311,EVM,mRNA,355,588442,311,1.00
ptg011955l,2015429,2015748,319,EVM,mRNA,1635923,2038041,319,1.00
ptg011959l,460188,460488,300,EVM,mRNA,419077,1018630,300,1.00
ptg011959l,879590,879894,304,EVM,mRNA,419077,1018630,304,1.00
ptg011963l,179022,179333,311,EVM,mRNA,174051,779146,311,1.00
ptg011963l,263799,264085,286,EVM,mRNA,174051,779146,286,1.00
ptg011973l,311089,311382,293,EVM,mRNA,205938,372458,293,1.00
ptg011977l,4423487,4423798,311,EVM,mRNA,4423122,6617971,311,1.00
ptg011977l,6372807,6373089,282,EVM,mRNA,4423122,6617971,282,1.00
ptg011978l,2659827,2660143,316,EVM,mRNA,2531134,6749144,316,1.00
ptg011978l,3879115,3879424,309,EVM,mRNA,2531134,6749144,309,1.00
ptg011978l,4063076,4063378,302,EVM,mRNA,2531134,6749144,302,1.00
ptg011978l,6007231,6007517,286,EVM,mRNA,2531134,6749144,286,1.00
ptg011978l,6027563,6027863,300,EVM,mRNA,2531134,6749144,300,1.00
ptg011978l,6282614,6282937,323,EVM,mRNA,2531134,6749144,323,1.00
ptg011978l,7475953,7476270,317,EVM,mRNA,7338791,8126259,317,1.00
ptg011978l,7709335,7709621,286,EVM,mRNA,7338791,8126259,286,1.00
ptg011979l,705262,705578,316,EVM,mRNA,366684,728173,316,1.00
ptg011983l,908606,908886,280,EVM,mRNA,834928,1093452,280,1.00
ptg011984l,406258,406546,288,EVM,mRNA,369291,601676,288,1.00
ptg011986l,1778481,1778793,312,EVM,mRNA,1562519,1821039,312,1.00
ptg011994l,817163,817435,272,EVM,mRNA,760089,1017804,272,1.00
ptg011996l,1356787,1357049,262,EVM,mRNA,794163,1552247,262,1.00
ptg012002l,453542,453841,299,EVM,mRNA,7010,976868,299,1.00
ptg012002l,892905,893204,299,EVM,mRNA,7010,976868,299,1.00
ptg012008l,333100,333406,306,EVM,mRNA,323169,338469,306,1.00
ptg012019l,469344,469638,294,EVM,mRNA,374643,1087137,294,1.00
ptg012019l,479099,479428,329,EVM,mRNA,374643,1087137,329,1.00
ptg012019l,624996,625267,271,EVM,mRNA,374643,1087137,271,1.00
ptg012019l,940763,941057,294,EVM,mRNA,374643,1087137,294,1.00
ptg012029l,740858,741132,274,EVM,mRNA,12854,870069,274,1.00
ptg012031l,1211281,1211574,293,EVM,mRNA,853774,1524646,293,1.00
ptg012031l,1278059,1278350,291,EVM,mRNA,853774,1524646,291,1.00
ptg012040l,1096749,1097030,281,EVM,mRNA,123646,1976574,281,1.00
ptg012047l,181973,182280,307,EVM,mRNA,9299,231629,307,1.00
ptg012048l,1412678,1412942,264,EVM,mRNA,360355,1625869,264,1.00
ptg012048l,1415197,1415477,280,EVM,mRNA,360355,1625869,280,1.00
ptg012048l,1525273,1525555,282,EVM,mRNA,360355,1625869,282,1.00
ptg012049l,865950,866227,277,EVM,mRNA,613122,1110482,277,1.00
ptg012058l,2044588,2044885,297,EVM,mRNA,2038893,4125713,297,1.00
ptg012058l,3373996,3374284,288,EVM,mRNA,2038893,4125713,288,1.00
ptg012058l,3748275,3748598,323,EVM,mRNA,2038893,4125713,323,1.00
ptg012059l,255066,255375,309,EVM,mRNA,107285,530409,309,1.00
ptg012061l,919916,920218,302,EVM,mRNA,712338,1069725,302,1.00
ptg012063l,179870,180174,304,EVM,mRNA,143101,261132,304,1.00
ptg012065l,661337,661628,291,EVM,mRNA,272312,746291,291,1.00
ptg012065l,712687,712981,294,EVM,mRNA,272312,746291,294,1.00
ptg012068l,204648,204934,286,EVM,mRNA,201841,215945,286,1.00
ptg012070l,374372,374684,312,EVM,mRNA,11245,1329183,312,1.00
ptg012070l,379768,380077,309,EVM,mRNA,11245,1329183,309,1.00
ptg012070l,2263598,2263865,267,EVM,mRNA,1856053,2931463,267,1.00
ptg012070l,2361086,2361381,295,EVM,mRNA,1856053,2931463,295,1.00
ptg012070l,2429380,2429687,307,EVM,mRNA,1856053,2931463,307,1.00
ptg012070l,3474604,3474887,283,EVM,mRNA,3469756,3620284,283,1.00
ptg012070l,3608454,3608782,328,EVM,mRNA,3469756,3620284,328,1.00
ptg012072l,980211,980529,318,EVM,mRNA,400409,1686585,318,1.00
ptg012073l,2208983,2209259,276,EVM,mRNA,1202154,2486925,276,1.00
ptg012075l,336614,336913,299,EVM,mRNA,6255,610889,299,1.00
ptg012075l,341797,342084,287,EVM,mRNA,6255,610889,287,1.00
ptg012076l,932558,932853,295,EVM,mRNA,932000,932758,200,0.68
ptg012081l,239551,239824,273,EVM,mRNA,231466,1938011,273,1.00
ptg012081l,1498754,1499061,307,EVM,mRNA,231466,1938011,307,1.00
ptg012086l,279319,279628,309,EVM,mRNA,1827,906475,309,1.00
ptg012089l,230174,230508,334,EVM,mRNA,138080,467959,334,1.00
ptg012089l,316495,316808,313,EVM,mRNA,138080,467959,313,1.00
ptg012091l,1233373,1233668,295,EVM,mRNA,629449,1249023,295,1.00
ptg012093l,295126,295433,307,EVM,mRNA,219767,316932,307,1.00
ptg012095l,531780,532098,318,EVM,mRNA,514076,549642,318,1.00
ptg012096l,1190261,1190553,292,EVM,mRNA,796689,2223749,292,1.00
ptg012098l,1157216,1157552,336,EVM,mRNA,906400,1173448,336,1.00
ptg012101l,911429,911744,315,EVM,mRNA,2441,1706756,315,1.00
ptg012101l,1294953,1295251,298,EVM,mRNA,2441,1706756,298,1.00
ptg012102l,170505,170795,290,EVM,mRNA,85574,503947,290,1.00
ptg012102l,571697,572017,320,EVM,mRNA,559682,611794,320,1.00
ptg012102l,1138617,1138897,280,EVM,mRNA,787488,1152070,280,1.00
ptg012105l,349959,350219,260,EVM,mRNA,243439,359301,260,1.00
ptg012116l,828482,828771,289,EVM,mRNA,785339,2344304,289,1.00
ptg012116l,844637,844912,275,EVM,mRNA,785339,2344304,275,1.00
ptg012116l,2106201,2106532,331,EVM,mRNA,785339,2344304,331,1.00
ptg012116l,2224537,2224799,262,EVM,mRNA,785339,2344304,262,1.00
ptg012117l,1393341,1393626,285,EVM,mRNA,314802,1505369,285,1.00
ptg012117l,1911728,1912050,322,EVM,mRNA,1885781,4200355,322,1.00
ptg012117l,2689941,2690240,299,EVM,mRNA,1885781,4200355,299,1.00
ptg012126l,304208,304525,317,EVM,mRNA,169211,360289,317,1.00
ptg012129l,636131,636443,312,EVM,mRNA,493444,941812,312,1.00
ptg012129l,817373,817688,315,EVM,mRNA,493444,941812,315,1.00
ptg012134l,213925,214223,298,EVM,mRNA,78467,712718,298,1.00
ptg012135l,982877,983165,288,EVM,mRNA,424385,1234411,288,1.00
ptg012139l,804708,805024,316,EVM,mRNA,631477,931893,316,1.00
ptg012141l,90996,91330,334,EVM,mRNA,60921,259868,334,1.00
ptg012144l,138894,139220,326,EVM,mRNA,44530,354602,326,1.00
ptg012171l,1026089,1026403,314,EVM,mRNA,808430,1984369,314,1.00
ptg012171l,1213838,1214133,295,EVM,mRNA,808430,1984369,295,1.00
ptg012171l,1416046,1416334,288,EVM,mRNA,808430,1984369,288,1.00
ptg012171l,1493108,1493409,301,EVM,mRNA,808430,1984369,301,1.00
ptg012174l,232003,232295,292,EVM,mRNA,48669,302121,292,1.00
ptg012175l,1220257,1220557,300,EVM,mRNA,906756,1626244,300,1.00
ptg012181l,37916,38230,314,EVM,mRNA,13867,140021,314,1.00
ptg012187l,204959,205267,308,EVM,mRNA,204165,1092176,308,1.00
ptg012187l,773753,774047,294,EVM,mRNA,204165,1092176,294,1.00
ptg012190l,1178320,1178631,311,EVM,mRNA,873894,1228280,311,1.00
ptg012191l,1943642,1943937,295,EVM,mRNA,122483,2309691,295,1.00
ptg012197l,1202412,1202707,295,EVM,mRNA,618768,1269652,295,1.00
ptg012197l,3902392,3902677,285,EVM,mRNA,3179048,4663514,285,1.00
ptg012198l,689040,689339,299,EVM,mRNA,103420,1422786,299,1.00
ptg012198l,851157,851456,299,EVM,mRNA,103420,1422786,299,1.00
ptg012198l,1061399,1061698,299,EVM,mRNA,103420,1422786,299,1.00
ptg012198l,1080397,1080696,299,EVM,mRNA,103420,1422786,299,1.00
ptg012198l,1257974,1258304,330,EVM,mRNA,103420,1422786,330,1.00
ptg012204l,137981,138278,297,EVM,mRNA,30877,187375,297,1.00
ptg012205l,171757,172056,299,EVM,mRNA,21193,722952,299,1.00
ptg012205l,327299,327589,290,EVM,mRNA,21193,722952,290,1.00
ptg012205l,465298,465611,313,EVM,mRNA,21193,722952,313,1.00
ptg012205l,1495521,1495798,277,EVM,mRNA,1153545,2237020,277,1.00
ptg012205l,1891670,1891978,308,EVM,mRNA,1153545,2237020,308,1.00
ptg012213l,938134,938449,315,EVM,mRNA,602305,1830335,315,1.00
ptg012213l,1625033,1625351,318,EVM,mRNA,602305,1830335,318,1.00
ptg012220l,593292,593621,329,EVM,mRNA,289870,639603,329,1.00
ptg012227l,35733,36052,319,EVM,mRNA,4741,269881,319,1.00
ptg012228l,435547,435875,328,EVM,mRNA,356165,798128,328,1.00
ptg012228l,614220,614545,325,EVM,mRNA,356165,798128,325,1.00
ptg012236l,202046,202367,321,EVM,mRNA,16260,1178329,321,1.00
ptg012236l,429689,429978,289,EVM,mRNA,16260,1178329,289,1.00
ptg012236l,475288,475616,328,EVM,mRNA,16260,1178329,328,1.00
ptg012239l,189805,190112,307,EVM,mRNA,69113,1318251,307,1.00
ptg012242l,877073,877393,320,EVM,mRNA,812499,1118168,320,1.00
ptg012242l,930936,931223,287,EVM,mRNA,812499,1118168,287,1.00
ptg012250l,900379,900683,304,EVM,mRNA,755446,1043963,304,1.00
ptg012265l,84106,84404,298,EVM,mRNA,81407,193710,298,1.00
ptg012265l,652663,652950,287,EVM,mRNA,630302,688265,287,1.00
ptg012273l,151660,151957,297,EVM,mRNA,55963,311734,297,1.00
ptg012277l,173231,173533,302,EVM,mRNA,41419,774910,302,1.00
ptg012290l,1431203,1431511,308,EVM,mRNA,1409287,1531399,308,1.00
ptg012290l,1466135,1466440,305,EVM,mRNA,1409287,1531399,305,1.00
ptg012291l,1173239,1173535,296,EVM,mRNA,1050721,1569554,296,1.00
ptg012291l,2175606,2175904,298,EVM,mRNA,2151949,2292938,298,1.00
ptg012294l,1726014,1726317,303,EVM,mRNA,92591,2323678,303,1.00
ptg012294l,1909722,1910016,294,EVM,mRNA,92591,2323678,294,1.00
ptg012300l,220794,221093,299,EVM,mRNA,106690,227938,299,1.00
ptg012306l,2329105,2329407,302,EVM,mRNA,98829,2506574,302,1.00
ptg012315l,416456,416739,283,EVM,mRNA,245193,940890,283,1.00
ptg012315l,533721,534016,295,EVM,mRNA,245193,940890,295,1.00
ptg012328l,299381,299703,322,EVM,mRNA,223180,800517,322,1.00
ptg012333l,1394666,1394966,300,EVM,mRNA,48559,1417302,300,1.00
ptg012334l,564824,565122,298,EVM,mRNA,16504,710211,298,1.00
ptg012341l,601813,602081,268,EVM,mRNA,21929,691170,268,1.00
ptg012344l,868627,868952,325,EVM,mRNA,697074,1459723,325,1.00
ptg012356l,526352,526680,328,EVM,mRNA,126339,1658166,328,1.00
ptg012359l,200032,200352,320,EVM,mRNA,5320,384065,320,1.00
ptg012359l,227303,227596,293,EVM,mRNA,5320,384065,293,1.00
ptg012359l,1230897,1231196,299,EVM,mRNA,1218707,1344047,299,1.00
ptg012372l,177414,177697,283,EVM,mRNA,186,311330,283,1.00
ptg012375l,421127,421452,325,EVM,mRNA,347252,570676,325,1.00
ptg012375l,1955499,1955781,282,EVM,mRNA,1164908,3110162,282,1.00
ptg012375l,2170526,2170801,275,EVM,mRNA,1164908,3110162,275,1.00
ptg012375l,2208954,2209286,332,EVM,mRNA,1164908,3110162,332,1.00
ptg012375l,2724817,2725111,294,EVM,mRNA,1164908,3110162,294,1.00
ptg012375l,2745417,2745700,283,EVM,mRNA,1164908,3110162,283,1.00
ptg012375l,3317484,3317812,328,EVM,mRNA,3135350,3480391,328,1.00
ptg012376l,1244624,1244938,314,EVM,mRNA,907136,1414472,314,1.00
ptg012388l,784211,784529,318,EVM,mRNA,515562,2265902,318,1.00
ptg012395l,145620,145950,330,EVM,mRNA,92705,173869,330,1.00
ptg012403l,1489528,1489827,299,EVM,mRNA,1253528,1611162,299,1.00
ptg012409l,543979,544263,284,EVM,mRNA,516537,795320,284,1.00
ptg012410l,145163,145454,291,EVM,mRNA,101348,227379,291,1.00
ptg012410l,949114,949442,328,EVM,mRNA,697045,1010152,328,1.00
ptg012414l,2094264,2094600,336,EVM,mRNA,776668,3118387,336,1.00
ptg012414l,2480723,2481014,291,EVM,mRNA,776668,3118387,291,1.00
ptg012417l,190031,190329,298,EVM,mRNA,27206,246877,298,1.00
ptg012417l,297650,297951,301,EVM,mRNA,261936,535865,301,1.00
ptg012420l,2178762,2179076,314,EVM,mRNA,2113747,2476358,314,1.00
ptg012421l,317806,318123,317,EVM,mRNA,272912,349146,317,1.00
ptg012434l,1989784,1990068,284,EVM,mRNA,558559,3978078,284,1.00
ptg012434l,3056089,3056350,261,EVM,mRNA,558559,3978078,261,1.00
ptg012434l,3454222,3454520,298,EVM,mRNA,558559,3978078,298,1.00
ptg012439l,1834564,1834873,309,EVM,mRNA,1692617,2121409,309,1.00
ptg012449l,1013042,1013341,299,EVM,mRNA,925264,1153193,299,1.00
ptg012456l,1535546,1535864,318,EVM,mRNA,1112062,1547367,318,1.00
ptg012456l,2130700,2131000,300,EVM,mRNA,1740787,2256932,300,1.00
ptg012456l,2720741,2721047,306,EVM,mRNA,2596148,3077094,306,1.00
ptg012461l,1002254,1002544,290,EVM,mRNA,574895,1144365,290,1.00
ptg012466l,1085790,1086107,317,EVM,mRNA,527892,1188000,317,1.00
ptg012469l,751850,752179,329,EVM,mRNA,364099,849241,329,1.00
ptg012469l,1409704,1410001,297,EVM,mRNA,1401113,2106496,297,1.00
ptg012470l,654745,655045,300,EVM,mRNA,546267,961012,300,1.00
ptg012470l,773011,773297,286,EVM,mRNA,546267,961012,286,1.00
ptg012470l,1178334,1178662,328,EVM,mRNA,965181,2383157,328,1.00
ptg012470l,1245840,1246124,284,EVM,mRNA,965181,2383157,284,1.00
ptg012470l,1261378,1261681,303,EVM,mRNA,965181,2383157,303,1.00
ptg012470l,1292754,1293046,292,EVM,mRNA,965181,2383157,292,1.00
ptg012470l,1683160,1683477,317,EVM,mRNA,965181,2383157,317,1.00
ptg012470l,1753230,1753529,299,EVM,mRNA,965181,2383157,299,1.00
ptg012477l,512988,513304,316,EVM,mRNA,297566,895208,316,1.00
ptg012477l,1783855,1784180,325,EVM,mRNA,1737924,2070122,325,1.00
ptg012479l,381622,381922,300,EVM,mRNA,116605,477365,300,1.00
ptg012479l,1062067,1062363,296,EVM,mRNA,857005,1073411,296,1.00
ptg012482l,57829,58133,304,EVM,mRNA,42148,222955,304,1.00
ptg012493l,1447170,1447482,312,EVM,mRNA,196352,1761229,312,1.00
ptg012498l,199098,199414,316,EVM,mRNA,632,566739,316,1.00
ptg012498l,437565,437888,323,EVM,mRNA,632,566739,323,1.00
ptg012500l,1238638,1238903,265,EVM,mRNA,729279,1240050,265,1.00
ptg012500l,1523993,1524273,280,EVM,mRNA,1447288,1587852,280,1.00
ptg012508l,1398639,1398945,306,EVM,mRNA,1139408,1494998,306,1.00
ptg012513l,407264,407562,298,EVM,mRNA,79252,566935,298,1.00
ptg012514l,1199311,1199635,324,EVM,mRNA,594436,1225730,324,1.00
ptg012516l,474497,474803,306,EVM,mRNA,411949,681710,306,1.00
ptg012516l,1511870,1512162,292,EVM,mRNA,1247461,2039380,292,1.00
ptg012520l,980171,980447,276,EVM,mRNA,599798,1855185,276,1.00
ptg012521l,652435,652730,295,EVM,mRNA,205504,1159873,295,1.00
ptg012523l,1012766,1013097,331,EVM,mRNA,79859,1473321,331,1.00
ptg012529l,1337418,1337717,299,EVM,mRNA,868488,1341639,299,1.00
ptg012531l,712306,712598,292,EVM,mRNA,303992,814883,292,1.00
ptg012531l,782152,782477,325,EVM,mRNA,303992,814883,325,1.00
ptg012533l,288558,288850,292,EVM,mRNA,70940,725807,292,1.00
ptg012535l,719424,719699,275,EVM,mRNA,712664,924668,275,1.00
ptg012536l,413501,413822,321,EVM,mRNA,42149,1085339,321,1.00
ptg012536l,619534,619836,302,EVM,mRNA,42149,1085339,302,1.00
ptg012544l,391949,392266,317,EVM,mRNA,329196,1545185,317,1.00
ptg012544l,540053,540368,315,EVM,mRNA,329196,1545185,315,1.00
ptg012544l,1198319,1198611,292,EVM,mRNA,329196,1545185,292,1.00
ptg012547l,1215630,1215941,311,EVM,mRNA,642045,1219373,311,1.00
ptg012555l,183502,183819,317,EVM,mRNA,54448,394012,317,1.00
ptg012555l,270657,270981,324,EVM,mRNA,54448,394012,324,1.00
ptg012559l,1740978,1741305,327,EVM,mRNA,1697571,2243485,327,1.00
ptg012563l,335611,335911,300,EVM,mRNA,93459,439987,300,1.00
ptg012563l,699045,699349,304,EVM,mRNA,500938,801668,304,1.00
ptg012568l,1084772,1085071,299,EVM,mRNA,75367,1099689,299,1.00
ptg012573l,1250717,1251042,325,EVM,mRNA,984210,1255754,325,1.00
ptg012576l,987032,987350,318,EVM,mRNA,881191,1305748,318,1.00
ptg012577l,268085,268369,284,EVM,mRNA,142225,285167,284,1.00
ptg012579l,255467,255786,319,EVM,mRNA,107694,448466,319,1.00
ptg012579l,1866726,1867001,275,EVM,mRNA,1428414,2388364,275,1.00
ptg012579l,1939275,1939596,321,EVM,mRNA,1428414,2388364,321,1.00
ptg012582l,558354,558640,286,EVM,mRNA,409273,675516,286,1.00
ptg012586l,273079,273360,281,EVM,mRNA,26688,555092,281,1.00
ptg012588l,716616,716909,293,EVM,mRNA,433231,898276,293,1.00
ptg012594l,602585,602885,300,EVM,mRNA,562386,3333134,300,1.00
ptg012594l,940493,940797,304,EVM,mRNA,562386,3333134,304,1.00
ptg012594l,1039309,1039627,318,EVM,mRNA,562386,3333134,318,1.00
ptg012594l,2787599,2787911,312,EVM,mRNA,562386,3333134,312,1.00
ptg012598l,842624,842904,280,EVM,mRNA,766075,921506,280,1.00
ptg012601l,228711,228998,287,EVM,mRNA,115804,940640,287,1.00
ptg012601l,286160,286478,318,EVM,mRNA,115804,940640,318,1.00
ptg012602l,2643479,2643801,322,EVM,mRNA,1982780,2673059,322,1.00
ptg012603l,1899676,1899989,313,EVM,mRNA,1581775,1946950,313,1.00
ptg012604l,405865,406183,318,EVM,mRNA,361591,602150,318,1.00
ptg012605l,84231,84534,303,EVM,mRNA,23805,164806,303,1.00
ptg012609l,739374,739652,278,EVM,mRNA,189143,761139,278,1.00
ptg012609l,2060662,2060954,292,EVM,mRNA,1337089,3024039,292,1.00
ptg012612l,54760,55031,271,EVM,mRNA,194,1528064,271,1.00
ptg012612l,1439698,1440026,328,EVM,mRNA,194,1528064,328,1.00
ptg012612l,1495453,1495755,302,EVM,mRNA,194,1528064,302,1.00
ptg012614l,427015,427307,292,EVM,mRNA,184,720025,292,1.00
ptg012616l,23058,23375,317,EVM,mRNA,22809,832537,317,1.00
ptg012616l,665886,666166,280,EVM,mRNA,22809,832537,280,1.00
ptg012623l,128676,128935,259,EVM,mRNA,3845,965002,259,1.00
ptg012623l,139835,140104,269,EVM,mRNA,3845,965002,269,1.00
ptg012623l,797470,797769,299,EVM,mRNA,3845,965002,299,1.00
ptg012625l,1807168,1807471,303,EVM,mRNA,1588723,2636927,303,1.00
ptg012625l,3792942,3793249,307,EVM,mRNA,2938442,4029348,307,1.00
ptg012628l,812229,812508,279,EVM,mRNA,753516,893723,279,1.00
ptg012628l,1823302,1823633,331,EVM,mRNA,1797662,2028542,331,1.00
ptg012630l,741972,742288,316,EVM,mRNA,582587,951619,316,1.00
ptg012630l,2060135,2060436,301,EVM,mRNA,1919480,2147115,301,1.00
ptg012632l,481278,481579,301,EVM,mRNA,274324,709952,301,1.00
ptg012634l,2213893,2214197,304,EVM,mRNA,22218,2703574,304,1.00
ptg012634l,2392829,2393139,310,EVM,mRNA,22218,2703574,310,1.00
ptg012646l,2916285,2916556,271,EVM,mRNA,1470837,3088379,271,1.00
ptg012647l,474000,474321,321,EVM,mRNA,305422,628854,321,1.00
ptg012653l,215939,216259,320,EVM,mRNA,166206,358722,320,1.00
ptg012653l,252890,253161,271,EVM,mRNA,166206,358722,271,1.00
ptg012655l,338764,339037,273,EVM,mRNA,267781,343970,273,1.00
ptg012660l,698412,698692,280,EVM,mRNA,614068,1118376,280,1.00
ptg012660l,764059,764320,261,EVM,mRNA,614068,1118376,261,1.00
ptg012661l,1069391,1069714,323,EVM,mRNA,879102,1152484,323,1.00
ptg012670l,101284,101566,282,EVM,mRNA,31280,276024,282,1.00
ptg012671l,482967,483254,287,EVM,mRNA,418239,517074,287,1.00
ptg012672l,67687,67968,281,EVM,mRNA,5939,458600,281,1.00
ptg012672l,305164,305433,269,EVM,mRNA,5939,458600,269,1.00
ptg012672l,524359,524645,286,EVM,mRNA,502588,633859,286,1.00
ptg012676l,204203,204486,283,EVM,mRNA,204392,584425,95,0.34
ptg012676l,493923,494230,307,EVM,mRNA,204392,584425,307,1.00
ptg012677l,83740,84076,336,EVM,mRNA,4420,780511,336,1.00
ptg012677l,513387,513705,318,EVM,mRNA,4420,780511,318,1.00
ptg012677l,598060,598350,290,EVM,mRNA,4420,780511,290,1.00
ptg012679l,794117,794435,318,EVM,mRNA,558786,2085748,318,1.00
ptg012679l,1159086,1159402,316,EVM,mRNA,558786,2085748,316,1.00
ptg012679l,1343528,1343842,314,EVM,mRNA,558786,2085748,314,1.00
ptg012679l,1785963,1786244,281,EVM,mRNA,558786,2085748,281,1.00
ptg012679l,1896989,1897298,309,EVM,mRNA,558786,2085748,309,1.00
ptg012679l,2063725,2064011,286,EVM,mRNA,558786,2085748,286,1.00
ptg012698l,697941,698254,313,EVM,mRNA,193679,1322463,313,1.00
ptg012698l,792213,792517,304,EVM,mRNA,193679,1322463,304,1.00
ptg012698l,1010527,1010828,301,EVM,mRNA,193679,1322463,301,1.00
ptg012698l,1658538,1658850,312,EVM,mRNA,1419875,1798117,312,1.00
ptg012698l,2348101,2348376,275,EVM,mRNA,2299310,2350579,275,1.00
ptg012699l,381518,381816,298,EVM,mRNA,360039,438584,298,1.00
ptg012700l,203105,203396,291,EVM,mRNA,178843,240775,291,1.00
ptg012701l,975894,976194,300,EVM,mRNA,789185,1010008,300,1.00
ptg012701l,1659930,1660209,279,EVM,mRNA,1558412,2231932,279,1.00
ptg012704l,243177,243449,272,EVM,mRNA,26384,291855,272,1.00
ptg012711l,92595,92885,290,EVM,mRNA,72024,194831,290,1.00
ptg012714l,400124,400427,303,EVM,mRNA,198861,494420,303,1.00
ptg012716l,328168,328481,313,EVM,mRNA,293701,542915,313,1.00
ptg012717l,557949,558249,300,EVM,mRNA,444852,945003,300,1.00
ptg012718l,153550,153853,303,EVM,mRNA,88679,235866,303,1.00
ptg012721l,2231155,2231445,290,EVM,mRNA,2173092,2302510,290,1.00
ptg012733l,180492,180815,323,EVM,mRNA,158460,320154,323,1.00
ptg012733l,1812894,1813179,285,EVM,mRNA,1585002,1950519,285,1.00
ptg012734l,1372440,1372734,294,EVM,mRNA,1032709,1587613,294,1.00
ptg012735l,700510,700812,302,EVM,mRNA,595941,961496,302,1.00
ptg012749l,1095728,1096000,272,EVM,mRNA,959877,2140883,272,1.00
ptg012749l,1185079,1185346,267,EVM,mRNA,959877,2140883,267,1.00
ptg012751l,2213424,2213743,319,EVM,mRNA,2139766,2297517,319,1.00
ptg012758l,1426140,1426460,320,EVM,mRNA,905050,1982673,320,1.00
ptg012762l,294277,294578,301,EVM,mRNA,233454,647335,301,1.00
ptg012765l,31500,31807,307,EVM,mRNA,19097,242476,307,1.00
ptg012765l,645733,646030,297,EVM,mRNA,547719,1398713,297,1.00
ptg012767l,627979,628267,288,EVM,mRNA,591145,872354,288,1.00
ptg012767l,760625,760939,314,EVM,mRNA,591145,872354,314,1.00
ptg012767l,821942,822230,288,EVM,mRNA,591145,872354,288,1.00
ptg012768l,1357527,1357864,337,EVM,mRNA,1185979,2331975,337,1.00
ptg012768l,1465768,1466083,315,EVM,mRNA,1185979,2331975,315,1.00
ptg012773l,1208194,1208475,281,EVM,mRNA,218124,1893268,281,1.00
ptg012773l,1641812,1642121,309,EVM,mRNA,218124,1893268,309,1.00
ptg012781l,380116,380404,288,EVM,mRNA,86517,429063,288,1.00
ptg012783l,501540,501822,282,EVM,mRNA,256310,817231,282,1.00
ptg012785l,531719,532000,281,EVM,mRNA,494179,551542,281,1.00
ptg012786l,234022,234274,252,EVM,mRNA,162094,394315,252,1.00
ptg012786l,303883,304195,312,EVM,mRNA,162094,394315,312,1.00
ptg012788l,1246035,1246314,279,EVM,mRNA,667035,1962772,279,1.00
ptg012788l,1760692,1760990,298,EVM,mRNA,667035,1962772,298,1.00
ptg012789l,1084883,1085199,316,EVM,mRNA,986964,1126880,316,1.00
ptg012790l,437015,437319,304,EVM,mRNA,211726,752344,304,1.00
ptg012796l,496195,496498,303,EVM,mRNA,400475,498341,303,1.00
ptg012800l,1525787,1526076,289,EVM,mRNA,881165,1910057,289,1.00
ptg012818l,816567,816860,293,EVM,mRNA,750302,953450,293,1.00
ptg012818l,868266,868561,295,EVM,mRNA,750302,953450,295,1.00
ptg012821l,1769676,1769979,303,EVM,mRNA,1552209,2348624,303,1.00
ptg012824l,1665738,1666061,323,EVM,mRNA,629993,3473323,323,1.00
ptg012824l,2019385,2019687,302,EVM,mRNA,629993,3473323,302,1.00
ptg012824l,5588747,5589032,285,EVM,mRNA,3755851,5601817,285,1.00
ptg012826l,794119,794418,299,EVM,mRNA,462909,1321634,299,1.00
ptg012826l,802654,802971,317,EVM,mRNA,462909,1321634,317,1.00
ptg012826l,1045219,1045518,299,EVM,mRNA,462909,1321634,299,1.00
ptg012826l,1293662,1293957,295,EVM,mRNA,462909,1321634,295,1.00
ptg012828l,79875,80190,315,EVM,mRNA,59016,95470,315,1.00
ptg012834l,619748,620061,313,EVM,mRNA,2622,706320,313,1.00
ptg012835l,571392,571731,339,EVM,mRNA,413045,2093597,339,1.00
ptg012835l,650122,650441,319,EVM,mRNA,413045,2093597,319,1.00
ptg012835l,965845,966148,303,EVM,mRNA,413045,2093597,303,1.00
ptg012835l,988317,988595,278,EVM,mRNA,413045,2093597,278,1.00
ptg012835l,1242293,1242602,309,EVM,mRNA,413045,2093597,309,1.00
ptg012835l,1697290,1697624,334,EVM,mRNA,413045,2093597,334,1.00
ptg012844l,291640,291946,306,EVM,mRNA,1350,533579,306,1.00
ptg012854l,952764,953076,312,EVM,mRNA,376954,1480722,312,1.00
ptg012854l,1063294,1063602,308,EVM,mRNA,376954,1480722,308,1.00
ptg012854l,1150482,1150762,280,EVM,mRNA,376954,1480722,280,1.00
ptg012854l,1227323,1227650,327,EVM,mRNA,376954,1480722,327,1.00
ptg012858l,399857,400151,294,EVM,mRNA,363825,1263115,294,1.00
ptg012861l,1655434,1655730,296,EVM,mRNA,1359699,1680304,296,1.00
ptg012863l,586248,586523,275,EVM,mRNA,512020,897829,275,1.00
ptg012867l,444993,445288,295,EVM,mRNA,294868,588594,295,1.00
ptg012867l,1745865,1746181,316,EVM,mRNA,858081,3401309,316,1.00
ptg012867l,2906797,2907083,286,EVM,mRNA,858081,3401309,286,1.00
ptg012870l,118302,118577,275,EVM,mRNA,106948,2417495,275,1.00
ptg012870l,2036421,2036701,280,EVM,mRNA,106948,2417495,280,1.00
ptg012874l,209986,210295,309,EVM,mRNA,118672,1360944,309,1.00
ptg012878l,546377,546700,323,EVM,mRNA,539175,1190634,323,1.00
ptg012878l,889134,889449,315,EVM,mRNA,539175,1190634,315,1.00
ptg012880l,762333,762653,320,EVM,mRNA,591256,878491,320,1.00
ptg012884l,294689,294965,276,EVM,mRNA,43720,3389543,276,1.00
ptg012884l,672292,672591,299,EVM,mRNA,43720,3389543,299,1.00
ptg012884l,960144,960438,294,EVM,mRNA,43720,3389543,294,1.00
ptg012884l,1134785,1135084,299,EVM,mRNA,43720,3389543,299,1.00
ptg012884l,1400451,1400768,317,EVM,mRNA,43720,3389543,317,1.00
ptg012884l,1721529,1721829,300,EVM,mRNA,43720,3389543,300,1.00
ptg012884l,2017493,2017791,298,EVM,mRNA,43720,3389543,298,1.00
ptg012884l,2093868,2094166,298,EVM,mRNA,43720,3389543,298,1.00
ptg012884l,2126791,2127097,306,EVM,mRNA,43720,3389543,306,1.00
ptg012884l,2768272,2768569,297,EVM,mRNA,43720,3389543,297,1.00
ptg012893l,628178,628473,295,EVM,mRNA,567547,1088877,295,1.00
ptg012897l,309212,309504,292,EVM,mRNA,21602,904866,292,1.00
ptg012897l,751963,752243,280,EVM,mRNA,21602,904866,280,1.00
ptg012902l,114186,114516,330,EVM,mRNA,54104,199646,330,1.00
ptg012902l,140333,140621,288,EVM,mRNA,54104,199646,288,1.00
ptg012913l,609363,609702,339,EVM,mRNA,483709,1672857,339,1.00
ptg012913l,825142,825453,311,EVM,mRNA,483709,1672857,311,1.00
ptg012913l,1280780,1281084,304,EVM,mRNA,483709,1672857,304,1.00
ptg012919l,257324,257629,305,EVM,mRNA,137587,972796,305,1.00
ptg012919l,405067,405363,296,EVM,mRNA,137587,972796,296,1.00
ptg012927l,763443,763714,271,EVM,mRNA,459342,1389383,271,1.00
ptg012930l,375304,375601,297,EVM,mRNA,61953,628793,297,1.00
ptg012935l,765050,765355,305,EVM,mRNA,480215,897111,305,1.00
ptg012951l,252767,253059,292,EVM,mRNA,246933,301769,292,1.00
ptg012951l,813998,814316,318,EVM,mRNA,358702,1088707,318,1.00
ptg012954l,1343397,1343690,293,EVM,mRNA,719315,1584100,293,1.00
ptg012957l,981032,981308,276,EVM,mRNA,628391,1041671,276,1.00
ptg012961l,524943,525230,287,EVM,mRNA,294369,1017184,287,1.00
ptg012966l,1122701,1123016,315,EVM,mRNA,147380,1168084,315,1.00
ptg012968l,269111,269403,292,EVM,mRNA,269385,269825,19,0.07
ptg012969l,1561271,1561595,324,EVM,mRNA,435641,3769116,324,1.00
ptg012969l,1595683,1596010,327,EVM,mRNA,435641,3769116,327,1.00
ptg012969l,3361110,3361402,292,EVM,mRNA,435641,3769116,292,1.00
ptg012969l,3364611,3364908,297,EVM,mRNA,435641,3769116,297,1.00
ptg012969l,3643448,3643724,276,EVM,mRNA,435641,3769116,276,1.00
ptg012970l,22292,22616,324,EVM,mRNA,3889,142561,324,1.00
ptg012993l,196037,196346,309,EVM,mRNA,131808,507389,309,1.00
ptg012994l,2568250,2568575,325,EVM,mRNA,2372852,2621554,325,1.00
ptg013002l,283227,283545,318,EVM,mRNA,93097,1384451,318,1.00
ptg013002l,678652,678983,331,EVM,mRNA,93097,1384451,331,1.00
ptg013002l,848599,848885,286,EVM,mRNA,93097,1384451,286,1.00
ptg013002l,1177844,1178161,317,EVM,mRNA,93097,1384451,317,1.00
ptg013004l,42128,42398,270,EVM,mRNA,20047,108218,270,1.00
ptg013006l,839129,839422,293,EVM,mRNA,719514,929244,293,1.00
ptg013014l,531020,531308,288,EVM,mRNA,450526,827983,288,1.00
ptg013015l,461709,462003,294,EVM,mRNA,375061,501718,294,1.00
ptg013020l,1917213,1917532,319,EVM,mRNA,1814155,2759674,319,1.00
ptg013024l,1342208,1342479,271,EVM,mRNA,1341076,1355264,271,1.00
ptg013027l,509701,509993,292,EVM,mRNA,382433,587517,292,1.00
ptg013031l,1688255,1688546,291,EVM,mRNA,1632372,1901000,291,1.00
ptg013036l,1522892,1523160,268,EVM,mRNA,1490367,1583773,268,1.00
ptg013044l,321532,321846,314,EVM,mRNA,81643,567231,314,1.00
ptg013045l,280439,280715,276,EVM,mRNA,60838,716240,276,1.00
ptg013045l,2956771,2957066,295,EVM,mRNA,2917278,3064529,295,1.00
ptg013045l,2968503,2968793,290,EVM,mRNA,2917278,3064529,290,1.00
ptg013047l,654433,654719,286,EVM,mRNA,427733,943379,286,1.00
ptg013057l,347875,348187,312,EVM,mRNA,306712,375908,312,1.00
ptg013062l,591151,591440,289,EVM,mRNA,563855,1374792,289,1.00
ptg013062l,721766,722049,283,EVM,mRNA,563855,1374792,283,1.00
ptg013062l,810542,810838,296,EVM,mRNA,563855,1374792,296,1.00
ptg013062l,1052986,1053278,292,EVM,mRNA,563855,1374792,292,1.00
ptg013068l,1877093,1877404,311,EVM,mRNA,1471995,2043613,311,1.00
ptg013068l,2013533,2013829,296,EVM,mRNA,1471995,2043613,296,1.00
ptg013081l,80400,80698,298,EVM,mRNA,2508,431931,298,1.00
ptg013081l,106670,106974,304,EVM,mRNA,2508,431931,304,1.00
ptg013082l,1097038,1097347,309,EVM,mRNA,276857,1652918,309,1.00
ptg013088l,2814929,2815255,326,EVM,mRNA,2698435,3509329,326,1.00
ptg013090l,333696,334013,317,EVM,mRNA,272177,581378,317,1.00
ptg013092l,272342,272623,281,EVM,mRNA,181287,358524,281,1.00
ptg013097l,123302,123607,305,EVM,mRNA,123534,817904,74,0.24
ptg013097l,1314478,1314758,280,EVM,mRNA,874690,2536588,280,1.00
ptg013097l,1329757,1330037,280,EVM,mRNA,874690,2536588,280,1.00
ptg013097l,5131082,5131375,293,EVM,mRNA,4988840,5285141,293,1.00
ptg013097l,5241330,5241597,267,EVM,mRNA,4988840,5285141,267,1.00
ptg013112l,365464,365765,301,EVM,mRNA,246596,454707,301,1.00
ptg013112l,1222125,1222424,299,EVM,mRNA,927033,1428603,299,1.00
ptg013113l,1034031,1034357,326,EVM,mRNA,83479,1456819,326,1.00
ptg013113l,1173091,1173425,334,EVM,mRNA,83479,1456819,334,1.00
ptg013117l,947128,947458,330,EVM,mRNA,284777,2891690,330,1.00
ptg013117l,2469383,2469685,302,EVM,mRNA,284777,2891690,302,1.00
ptg013117l,2733919,2734219,300,EVM,mRNA,284777,2891690,300,1.00
ptg013126l,995291,995602,311,EVM,mRNA,170132,1350466,311,1.00
ptg013133l,90561,90849,288,EVM,mRNA,32574,1875452,288,1.00
ptg013134l,2727444,2727725,281,EVM,mRNA,2556565,2755385,281,1.00
ptg013134l,2734596,2734877,281,EVM,mRNA,2556565,2755385,281,1.00
ptg013144l,258919,259231,312,EVM,mRNA,180812,872040,312,1.00
ptg013148l,462129,462430,301,EVM,mRNA,65925,777145,301,1.00
ptg013148l,482931,483230,299,EVM,mRNA,65925,777145,299,1.00
ptg013148l,499009,499304,295,EVM,mRNA,65925,777145,295,1.00
ptg013148l,683288,683587,299,EVM,mRNA,65925,777145,299,1.00
ptg013152l,948905,949243,338,EVM,mRNA,623853,1086196,338,1.00
ptg013160l,143210,143503,293,EVM,mRNA,113327,694948,293,1.00
ptg013173l,681658,681957,299,EVM,mRNA,149929,1252685,299,1.00
ptg013183l,477194,477502,308,EVM,mRNA,113917,1034848,308,1.00
ptg013190l,1126868,1127155,287,EVM,mRNA,1117471,1211383,287,1.00
ptg013193l,2703620,2703928,308,EVM,mRNA,2554652,2804709,308,1.00
ptg013201l,192142,192456,314,EVM,mRNA,187370,973656,314,1.00
ptg013201l,808578,808911,333,EVM,mRNA,187370,973656,333,1.00
ptg013202l,1227487,1227771,284,EVM,mRNA,922400,1397439,284,1.00
ptg013203l,1021062,1021375,313,EVM,mRNA,447573,1183058,313,1.00
ptg013204l,456465,456780,315,EVM,mRNA,147097,536483,315,1.00
ptg013205l,326535,326864,329,EVM,mRNA,13110,787883,329,1.00
ptg013213l,670401,670690,289,EVM,mRNA,611809,701067,289,1.00
ptg013215l,243655,243969,314,EVM,mRNA,233175,263668,314,1.00
ptg013216l,645761,646051,290,EVM,mRNA,627117,830473,290,1.00
ptg013216l,1300363,1300658,295,EVM,mRNA,1201795,1490247,295,1.00
ptg013217l,750936,751238,302,EVM,mRNA,541653,849068,302,1.00
ptg013221l,163197,163492,295,EVM,mRNA,151959,425004,295,1.00
ptg013221l,168074,168369,295,EVM,mRNA,151959,425004,295,1.00
ptg013221l,399078,399332,254,EVM,mRNA,151959,425004,254,1.00
ptg013221l,5927299,5927590,291,EVM,mRNA,5722384,6164170,291,1.00
ptg013223l,134797,135127,330,EVM,mRNA,36135,305478,330,1.00
ptg013223l,292843,293122,279,EVM,mRNA,36135,305478,279,1.00
ptg013226l,1199595,1199927,332,EVM,mRNA,1191100,1320691,332,1.00
ptg013233l,1015350,1015665,315,EVM,mRNA,1002839,1081175,315,1.00
ptg013234l,265201,265500,299,EVM,mRNA,15,1239668,299,1.00
ptg013234l,341384,341693,309,EVM,mRNA,15,1239668,309,1.00
ptg013234l,1021501,1021820,319,EVM,mRNA,15,1239668,319,1.00
ptg013236l,187937,188217,280,EVM,mRNA,88283,225980,280,1.00
ptg013236l,745231,745546,315,EVM,mRNA,278362,877240,315,1.00
ptg013251l,290974,291258,284,EVM,mRNA,201335,610147,284,1.00
ptg013251l,877869,878168,299,EVM,mRNA,851582,1624692,299,1.00
ptg013251l,1231202,1231495,293,EVM,mRNA,851582,1624692,293,1.00
ptg013252l,1110977,1111273,296,EVM,mRNA,485499,2230695,296,1.00
ptg013254l,842167,842476,309,EVM,mRNA,71767,1797303,309,1.00
ptg013257l,23716,23991,275,EVM,mRNA,1513,103864,275,1.00
ptg013257l,39258,39559,301,EVM,mRNA,1513,103864,301,1.00
ptg013257l,1204525,1204797,272,EVM,mRNA,396556,1850134,272,1.00
ptg013258l,1414413,1414718,305,EVM,mRNA,1206516,1647327,305,1.00
ptg013258l,1608814,1609126,312,EVM,mRNA,1206516,1647327,312,1.00
ptg013267l,328462,328761,299,EVM,mRNA,2748,996903,299,1.00
ptg013267l,469007,469302,295,EVM,mRNA,2748,996903,295,1.00
ptg013275l,445839,446125,286,EVM,mRNA,140732,735631,286,1.00
ptg013282l,2026866,2027178,312,EVM,mRNA,655978,2855956,312,1.00
ptg013282l,2123139,2123443,304,EVM,mRNA,655978,2855956,304,1.00
ptg013282l,2576889,2577211,322,EVM,mRNA,655978,2855956,322,1.00
ptg013282l,2615748,2616032,284,EVM,mRNA,655978,2855956,284,1.00
ptg013284l,2273304,2273616,312,EVM,mRNA,2031993,2497250,312,1.00
ptg013294l,399994,400297,303,EVM,mRNA,209880,658235,303,1.00
ptg013294l,407666,407963,297,EVM,mRNA,209880,658235,297,1.00
ptg013311l,52246,52517,271,EVM,mRNA,20724,528711,271,1.00
ptg013311l,1684030,1684308,278,EVM,mRNA,1665607,1799141,278,1.00
ptg013313l,678933,679236,303,EVM,mRNA,469887,920457,303,1.00
ptg013315l,1335581,1335892,311,EVM,mRNA,625250,1479655,311,1.00
ptg013317l,218333,218617,284,EVM,mRNA,55416,586160,284,1.00
ptg013317l,389201,389526,325,EVM,mRNA,55416,586160,325,1.00
ptg013320l,100939,101221,282,EVM,mRNA,24151,978773,282,1.00
ptg013320l,526993,527298,305,EVM,mRNA,24151,978773,305,1.00
ptg013323l,127939,128264,325,EVM,mRNA,6000,224266,325,1.00
ptg013323l,535102,535420,318,EVM,mRNA,329813,712800,318,1.00
ptg013332l,1833431,1833704,273,EVM,mRNA,754831,3344645,273,1.00
ptg013332l,2090660,2090919,259,EVM,mRNA,754831,3344645,259,1.00
ptg013338l,389147,389474,327,EVM,mRNA,341008,506233,327,1.00
ptg013353l,878618,878919,301,EVM,mRNA,608273,960624,301,1.00
ptg013357l,171141,171438,297,EVM,mRNA,53948,183933,297,1.00
ptg013362l,1062610,1062890,280,EVM,mRNA,535907,1229061,280,1.00
ptg013365l,50589,50887,298,EVM,mRNA,216,584465,298,1.00
ptg013374l,1097385,1097679,294,EVM,mRNA,1086681,1107236,294,1.00
ptg013375l,2688946,2689263,317,EVM,mRNA,811197,2747461,317,1.00
ptg013382l,741119,741416,297,EVM,mRNA,545757,2445568,297,1.00
ptg013393l,795709,796008,299,EVM,mRNA,675784,1622038,299,1.00
ptg013399l,2224828,2225137,309,EVM,mRNA,2014721,2271641,309,1.00
ptg013417l,516493,516799,306,EVM,mRNA,381790,959074,306,1.00
ptg013417l,3067293,3067579,286,EVM,mRNA,2969298,3251888,286,1.00
ptg013421l,235977,236289,312,EVM,mRNA,26096,752243,312,1.00
ptg013438l,859996,860296,300,EVM,mRNA,626073,1478667,300,1.00
ptg013451l,1071228,1071510,282,EVM,mRNA,231382,1755517,282,1.00
ptg013451l,1073017,1073293,276,EVM,mRNA,231382,1755517,276,1.00
ptg013465l,322455,322745,290,EVM,mRNA,33725,400131,290,1.00
ptg013466l,928301,928589,288,EVM,mRNA,25895,971014,288,1.00
ptg013468l,429426,429738,312,EVM,mRNA,366602,571974,312,1.00
ptg013469l,495709,496030,321,EVM,mRNA,77285,1047929,321,1.00
ptg013469l,578396,578690,294,EVM,mRNA,77285,1047929,294,1.00
ptg013473l,3278884,3279197,313,EVM,mRNA,2887311,3610627,313,1.00
ptg013473l,3408566,3408837,271,EVM,mRNA,2887311,3610627,271,1.00
ptg013477l,242548,242860,312,EVM,mRNA,124794,332431,312,1.00
ptg013491l,535468,535796,328,EVM,mRNA,198036,4239427,328,1.00
ptg013491l,1694214,1694506,292,EVM,mRNA,198036,4239427,292,1.00
ptg013491l,2854370,2854681,311,EVM,mRNA,198036,4239427,311,1.00
ptg013497l,441390,441678,288,EVM,mRNA,306060,590036,288,1.00
ptg013497l,833243,833572,329,EVM,mRNA,795985,837316,329,1.00
ptg013497l,837171,837461,290,EVM,mRNA,795985,837316,145,0.50
ptg013500l,275745,276049,304,EVM,mRNA,51448,373542,304,1.00
ptg013502l,1844822,1845143,321,EVM,mRNA,1043034,2064707,321,1.00
ptg013502l,4763345,4763623,278,EVM,mRNA,4284862,4812516,278,1.00
ptg013504l,151003,151325,322,EVM,mRNA,7274,201538,322,1.00
ptg013505l,177443,177732,289,EVM,mRNA,153018,849415,289,1.00
ptg013506l,725257,725575,318,EVM,mRNA,287673,1183178,318,1.00
ptg013506l,1751785,1752085,300,EVM,mRNA,1722403,1936129,300,1.00
ptg013512l,719623,719940,317,EVM,mRNA,4988,830625,317,1.00
ptg013513l,1592123,1592447,324,EVM,mRNA,1304207,2548918,324,1.00
ptg013513l,1826371,1826678,307,EVM,mRNA,1304207,2548918,307,1.00
ptg013513l,1981420,1981699,279,EVM,mRNA,1304207,2548918,279,1.00
ptg013519l,234485,234782,297,EVM,mRNA,29668,261977,297,1.00
ptg013522l,48127,48435,308,EVM,mRNA,44339,75640,308,1.00
ptg013522l,54019,54326,307,EVM,mRNA,44339,75640,307,1.00
ptg013526l,2374259,2374551,292,EVM,mRNA,1511814,2551562,292,1.00
ptg013526l,2550705,2550978,273,EVM,mRNA,1511814,2551562,273,1.00
ptg013528l,67891,68185,294,EVM,mRNA,25108,1926472,294,1.00
ptg013528l,366918,367223,305,EVM,mRNA,25108,1926472,305,1.00
ptg013528l,838580,838896,316,EVM,mRNA,25108,1926472,316,1.00
ptg013528l,1252468,1252774,306,EVM,mRNA,25108,1926472,306,1.00
ptg013528l,1541710,1541995,285,EVM,mRNA,25108,1926472,285,1.00
ptg013532l,131013,131312,299,EVM,mRNA,1854,1447741,299,1.00
ptg013532l,309888,310181,293,EVM,mRNA,1854,1447741,293,1.00
ptg013532l,1347852,1348153,301,EVM,mRNA,1854,1447741,301,1.00
ptg013535l,193583,193896,313,EVM,mRNA,107116,587416,313,1.00
ptg013541l,2199680,2199997,317,EVM,mRNA,1881285,2409915,317,1.00
ptg013543l,65288,65588,300,EVM,mRNA,31319,696616,300,1.00
ptg013545l,83697,83982,285,EVM,mRNA,919,412440,285,1.00
ptg013546l,780916,781179,263,EVM,mRNA,228436,1124159,263,1.00
ptg013552l,3306683,3306979,296,EVM,mRNA,2897446,3545936,296,1.00
ptg013570l,755583,755872,289,EVM,mRNA,57670,884527,289,1.00
ptg013575l,255224,255553,329,EVM,mRNA,222483,347093,329,1.00
ptg013579l,569021,569349,328,EVM,mRNA,200218,615814,328,1.00
ptg013579l,767660,767990,330,EVM,mRNA,707519,794155,330,1.00
ptg013583l,2001209,2001525,316,EVM,mRNA,1249308,2125959,316,1.00
ptg013583l,2007984,2008290,306,EVM,mRNA,1249308,2125959,306,1.00
ptg013583l,2120189,2120471,282,EVM,mRNA,1249308,2125959,282,1.00
ptg013584l,76337,76625,288,EVM,mRNA,27159,139714,288,1.00
ptg013591l,476110,476423,313,EVM,mRNA,204355,2525815,313,1.00
ptg013591l,1530900,1531220,320,EVM,mRNA,204355,2525815,320,1.00
ptg013591l,2041083,2041361,278,EVM,mRNA,204355,2525815,278,1.00
ptg013591l,2455296,2455633,337,EVM,mRNA,204355,2525815,337,1.00
ptg013599l,526478,526799,321,EVM,mRNA,454856,1009626,321,1.00
ptg013601l,1947495,1947811,316,EVM,mRNA,1496992,2431555,316,1.00
ptg013604l,857761,858029,268,EVM,mRNA,214072,1730223,268,1.00
ptg013610l,1429846,1430174,328,EVM,mRNA,1151978,1476393,328,1.00
ptg013611l,459420,459747,327,EVM,mRNA,320750,650053,327,1.00
ptg013613l,867866,868150,284,EVM,mRNA,368172,1705590,284,1.00
ptg013614l,352923,353247,324,EVM,mRNA,243436,2549273,324,1.00
ptg013614l,924907,925221,314,EVM,mRNA,243436,2549273,314,1.00
ptg013614l,1121813,1122112,299,EVM,mRNA,243436,2549273,299,1.00
ptg013614l,2239157,2239465,308,EVM,mRNA,243436,2549273,308,1.00
ptg013617l,532214,532512,298,EVM,mRNA,501319,602445,298,1.00
ptg013617l,545410,545709,299,EVM,mRNA,501319,602445,299,1.00
ptg013642l,872076,872384,308,EVM,mRNA,442727,1315379,308,1.00
ptg013648l,56579,56871,292,EVM,mRNA,3186,70345,292,1.00
ptg013648l,153294,153627,333,EVM,mRNA,78523,191188,333,1.00
ptg013660l,243922,244220,298,EVM,mRNA,159868,423443,298,1.00
ptg013661l,1210127,1210401,274,EVM,mRNA,392105,2863690,274,1.00
ptg013661l,1303437,1303719,282,EVM,mRNA,392105,2863690,282,1.00
ptg013661l,1768002,1768293,291,EVM,mRNA,392105,2863690,291,1.00
ptg013661l,1813999,1814281,282,EVM,mRNA,392105,2863690,282,1.00
ptg013663l,135223,135550,327,EVM,mRNA,104420,407085,327,1.00
ptg013663l,628742,629073,331,EVM,mRNA,593036,809430,331,1.00
ptg013670l,198356,198685,329,EVM,mRNA,73305,326165,329,1.00
ptg013670l,554343,554624,281,EVM,mRNA,552501,814866,281,1.00
ptg013670l,776371,776707,336,EVM,mRNA,552501,814866,336,1.00
ptg013670l,1394803,1395119,316,EVM,mRNA,1368366,1522028,316,1.00
ptg013674l,2230121,2230437,316,EVM,mRNA,1958636,2384199,316,1.00
ptg013678l,503888,504167,279,EVM,mRNA,8636,912035,279,1.00
ptg013678l,1431151,1431465,314,EVM,mRNA,1231108,1520790,314,1.00
ptg013682l,378828,379137,309,EVM,mRNA,360035,1153951,309,1.00
ptg013691l,773825,774103,278,EVM,mRNA,669866,853033,278,1.00
ptg013699l,638717,639016,299,EVM,mRNA,488281,1063560,299,1.00
ptg013701l,679980,680245,265,EVM,mRNA,673142,1038436,265,1.00
ptg013706l,328071,328385,314,EVM,mRNA,311373,548667,314,1.00
ptg013706l,469310,469625,315,EVM,mRNA,311373,548667,315,1.00
ptg013706l,1294153,1294483,330,EVM,mRNA,906611,1295673,330,1.00
ptg013708l,777113,777414,301,EVM,mRNA,7139,1209425,301,1.00
ptg013708l,1175314,1175602,288,EVM,mRNA,7139,1209425,288,1.00
ptg013710l,870166,870484,318,EVM,mRNA,31835,2136472,318,1.00
ptg013714l,138063,138367,304,EVM,mRNA,97092,326687,304,1.00
ptg013714l,156922,157207,285,EVM,mRNA,97092,326687,285,1.00
ptg013717l,670707,671007,300,EVM,mRNA,639125,884967,300,1.00
ptg013721l,2049287,2049608,321,EVM,mRNA,1668178,2241946,321,1.00
ptg013727l,745751,746062,311,EVM,mRNA,286647,1016979,311,1.00
ptg013728l,1478034,1478329,295,EVM,mRNA,1373486,1761275,295,1.00
ptg013729l,145992,146294,302,EVM,mRNA,5054,203600,302,1.00
ptg013731l,2522781,2523087,306,EVM,mRNA,1494287,2557937,306,1.00
ptg013744l,3100596,3100894,298,EVM,mRNA,3074402,3186771,298,1.00
ptg013747l,536360,536665,305,EVM,mRNA,340985,1352190,305,1.00
ptg013747l,840012,840286,274,EVM,mRNA,340985,1352190,274,1.00
ptg013748l,510538,510817,279,EVM,mRNA,463795,1186897,279,1.00
ptg013748l,837800,838094,294,EVM,mRNA,463795,1186897,294,1.00
ptg013770l,677144,677458,314,EVM,mRNA,84214,740953,314,1.00
ptg013771l,1635121,1635416,295,EVM,mRNA,1579012,1889188,295,1.00
ptg013776l,751923,752246,323,EVM,mRNA,726694,914187,323,1.00
ptg013776l,862571,862867,296,EVM,mRNA,726694,914187,296,1.00
ptg013778l,469340,469670,330,EVM,mRNA,101595,1029874,330,1.00
ptg013783l,403201,403494,293,EVM,mRNA,263979,486962,293,1.00
ptg013783l,943041,943338,297,EVM,mRNA,671017,1220186,297,1.00
ptg013783l,1200704,1201006,302,EVM,mRNA,671017,1220186,302,1.00
ptg013784l,967848,968126,278,EVM,mRNA,413810,1796502,278,1.00
ptg013787l,192407,192698,291,EVM,mRNA,104797,280237,291,1.00
ptg013787l,525686,525994,308,EVM,mRNA,391765,2060252,308,1.00
ptg013787l,1796286,1796607,321,EVM,mRNA,391765,2060252,321,1.00
ptg013789l,2990230,2990546,316,EVM,mRNA,2893142,3043183,316,1.00
ptg013791l,793548,793847,299,EVM,mRNA,164086,863612,299,1.00
ptg013793l,884576,884879,303,EVM,mRNA,746836,967537,303,1.00
ptg013800l,187163,187486,323,EVM,mRNA,238,272153,323,1.00
ptg013807l,49221,49488,267,EVM,mRNA,14971,89116,267,1.00
ptg013810l,1898076,1898390,314,EVM,mRNA,1788351,2093109,314,1.00
ptg013817l,253574,253863,289,EVM,mRNA,21279,1220618,289,1.00
ptg013817l,453940,454239,299,EVM,mRNA,21279,1220618,299,1.00
ptg013817l,721534,721852,318,EVM,mRNA,21279,1220618,318,1.00
ptg013820l,620774,621054,280,EVM,mRNA,371171,709425,280,1.00
ptg013820l,691070,691341,271,EVM,mRNA,371171,709425,271,1.00
ptg013829l,652298,652589,291,EVM,mRNA,538389,684074,291,1.00
ptg013831l,84328,84615,287,EVM,mRNA,16749,138546,287,1.00
ptg013831l,91416,91703,287,EVM,mRNA,16749,138546,287,1.00
ptg013833l,170237,170520,283,EVM,mRNA,901,270668,283,1.00
ptg013833l,954816,955108,292,EVM,mRNA,689388,1501223,292,1.00
ptg013843l,249528,249837,309,EVM,mRNA,53244,264895,309,1.00
ptg013855l,344341,344668,327,EVM,mRNA,206004,364706,327,1.00
ptg013855l,358443,358745,302,EVM,mRNA,206004,364706,302,1.00
ptg013866l,792338,792659,321,EVM,mRNA,2206,1165787,321,1.00
ptg013866l,936338,936626,288,EVM,mRNA,2206,1165787,288,1.00
ptg013870l,993778,994052,274,EVM,mRNA,737746,1052642,274,1.00
ptg013872l,417979,418233,254,EVM,mRNA,312465,497014,254,1.00
ptg013877l,185079,185355,276,EVM,mRNA,169136,355543,276,1.00
ptg013877l,1102788,1103101,313,EVM,mRNA,1041601,1127572,313,1.00
ptg013877l,1874680,1874998,318,EVM,mRNA,1857232,1943706,318,1.00
ptg013882l,177460,177788,328,EVM,mRNA,1084,552576,328,1.00
ptg013890l,2449874,2450186,312,EVM,mRNA,2186713,2605269,312,1.00
ptg013890l,2572346,2572665,319,EVM,mRNA,2186713,2605269,319,1.00
ptg013900l,466215,466538,323,EVM,mRNA,200518,519105,323,1.00
ptg013902l,381037,381328,291,EVM,mRNA,8669,403189,291,1.00
ptg013902l,401493,401789,296,EVM,mRNA,8669,403189,296,1.00
ptg013905l,835754,836039,285,EVM,mRNA,13026,3214366,285,1.00
ptg013905l,1378269,1378568,299,EVM,mRNA,13026,3214366,299,1.00
ptg013905l,1764469,1764783,314,EVM,mRNA,13026,3214366,314,1.00
ptg013910l,482476,482756,280,EVM,mRNA,423881,489148,280,1.00
ptg013913l,913844,914161,317,EVM,mRNA,757863,1232598,317,1.00
ptg013913l,1026213,1026528,315,EVM,mRNA,757863,1232598,315,1.00
ptg013913l,1082244,1082531,287,EVM,mRNA,757863,1232598,287,1.00
ptg013914l,959733,960062,329,EVM,mRNA,557403,1362848,329,1.00
ptg013915l,382194,382475,281,EVM,mRNA,165826,501606,281,1.00
ptg013922l,923043,923343,300,EVM,mRNA,348888,942818,300,1.00
ptg013927l,687923,688226,303,EVM,mRNA,228129,745042,303,1.00
ptg013930l,628651,628953,302,EVM,mRNA,611369,902876,302,1.00
ptg013935l,249894,250191,297,EVM,mRNA,5776,311023,297,1.00
ptg013936l,118953,119262,309,EVM,mRNA,1836,398481,309,1.00
ptg013936l,176746,177014,268,EVM,mRNA,1836,398481,268,1.00
ptg013936l,209385,209707,322,EVM,mRNA,1836,398481,322,1.00
ptg013944l,741718,742044,326,EVM,mRNA,546675,1283310,326,1.00
ptg013944l,1021270,1021609,339,EVM,mRNA,546675,1283310,339,1.00
ptg013948l,1294213,1294529,316,EVM,mRNA,945203,1595208,316,1.00
ptg013948l,1331221,1331524,303,EVM,mRNA,945203,1595208,303,1.00
ptg013948l,1433751,1434063,312,EVM,mRNA,945203,1595208,312,1.00
ptg013953l,754105,754404,299,EVM,mRNA,522703,1075428,299,1.00
ptg013953l,1031243,1031529,286,EVM,mRNA,522703,1075428,286,1.00
ptg013954l,154371,154688,317,EVM,mRNA,101893,374285,317,1.00
ptg013954l,298228,298508,280,EVM,mRNA,101893,374285,280,1.00
ptg013956l,1312191,1312505,314,EVM,mRNA,1127569,1678065,314,1.00
ptg013956l,1491114,1491438,324,EVM,mRNA,1127569,1678065,324,1.00
ptg013960l,473363,473662,299,EVM,mRNA,462917,545651,299,1.00
ptg013960l,481353,481628,275,EVM,mRNA,462917,545651,275,1.00
ptg013964l,32764,33049,285,EVM,mRNA,4494,510742,285,1.00
ptg013965l,421037,421306,269,EVM,mRNA,381392,1237271,269,1.00
ptg013965l,673834,674098,264,EVM,mRNA,381392,1237271,264,1.00
ptg013965l,802887,803188,301,EVM,mRNA,381392,1237271,301,1.00
ptg013968l,1000668,1000968,300,EVM,mRNA,870049,1403419,300,1.00
ptg013968l,1223784,1224102,318,EVM,mRNA,870049,1403419,318,1.00
ptg013969l,737138,737420,282,EVM,mRNA,11356,1495197,282,1.00
ptg013972l,367051,367336,285,EVM,mRNA,355143,501458,285,1.00
ptg013972l,367390,367676,286,EVM,mRNA,355143,501458,286,1.00
ptg013977l,590361,590689,328,EVM,mRNA,73185,898760,328,1.00
ptg013981l,48736,49042,306,EVM,mRNA,32492,438900,306,1.00
ptg013982l,91884,92179,295,EVM,mRNA,2243,127726,295,1.00
ptg013982l,316532,316815,283,EVM,mRNA,238380,1094332,283,1.00
ptg013982l,1574796,1575104,308,EVM,mRNA,1454258,1612938,308,1.00
ptg013990l,944305,944614,309,EVM,mRNA,690395,1057471,309,1.00
ptg013997l,1676883,1677199,316,EVM,mRNA,1550911,1810058,316,1.00
ptg014007l,462396,462695,299,EVM,mRNA,196789,764202,299,1.00
ptg014008l,953680,953978,298,EVM,mRNA,369410,1242730,298,1.00
ptg014021l,306632,306953,321,EVM,mRNA,87486,961608,321,1.00
ptg014021l,917307,917580,273,EVM,mRNA,87486,961608,273,1.00
ptg014021l,1384912,1385240,328,EVM,mRNA,1313854,1892683,328,1.00
ptg014024l,463411,463690,279,EVM,mRNA,21993,942063,279,1.00
ptg014041l,418411,418730,319,EVM,mRNA,3765,1501388,319,1.00
ptg014048l,1016713,1017047,334,EVM,mRNA,33631,1106434,334,1.00
ptg014053l,1354405,1354705,300,EVM,mRNA,373852,1456090,300,1.00
ptg014054l,316961,317241,280,EVM,mRNA,7154,527598,280,1.00
ptg014061l,1123709,1124038,329,EVM,mRNA,770710,1131839,329,1.00
ptg014061l,1127331,1127603,272,EVM,mRNA,770710,1131839,272,1.00
ptg014062l,1161333,1161660,327,EVM,mRNA,764437,1360800,327,1.00
ptg014062l,1237641,1237945,304,EVM,mRNA,764437,1360800,304,1.00
ptg014065l,285056,285346,290,EVM,mRNA,264027,1898139,290,1.00
ptg014065l,521806,522138,332,EVM,mRNA,264027,1898139,332,1.00
ptg014065l,575561,575866,305,EVM,mRNA,264027,1898139,305,1.00
ptg014068l,283221,283501,280,EVM,mRNA,45481,945665,280,1.00
ptg014072l,393134,393438,304,EVM,mRNA,381209,1993064,304,1.00
ptg014076l,2081525,2081809,284,EVM,mRNA,150186,2649636,284,1.00
ptg014081l,637414,637711,297,EVM,mRNA,40485,792996,297,1.00
ptg014085l,189748,190060,312,EVM,mRNA,12335,510454,312,1.00
ptg014092l,379426,379738,312,EVM,mRNA,12775,1247270,312,1.00
ptg014092l,571247,571541,294,EVM,mRNA,12775,1247270,294,1.00
ptg014093l,497172,497459,287,EVM,mRNA,429098,668726,287,1.00
ptg014095l,525567,525875,308,EVM,mRNA,10038,764209,308,1.00
ptg014095l,529882,530168,286,EVM,mRNA,10038,764209,286,1.00
ptg014095l,633598,633900,302,EVM,mRNA,10038,764209,302,1.00
ptg014095l,763671,763978,307,EVM,mRNA,10038,764209,307,1.00
ptg014100l,130014,130309,295,EVM,mRNA,19069,385736,295,1.00
ptg014102l,751932,752225,293,EVM,mRNA,143536,1218565,293,1.00
ptg014102l,1635597,1635896,299,EVM,mRNA,1372292,1650950,299,1.00
ptg014104l,346538,346835,297,EVM,mRNA,2843,778488,297,1.00
ptg014104l,412480,412794,314,EVM,mRNA,2843,778488,314,1.00
ptg014108l,788260,788573,313,EVM,mRNA,84912,1203701,313,1.00
ptg014128l,1202100,1202405,305,EVM,mRNA,1154697,1315243,305,1.00
ptg014128l,1225726,1226026,300,EVM,mRNA,1154697,1315243,300,1.00
ptg014128l,1886427,1886736,309,EVM,mRNA,1490774,1896113,309,1.00
ptg014129l,607903,608214,311,EVM,mRNA,220978,1163255,311,1.00
ptg014133l,510384,510699,315,EVM,mRNA,137598,563824,315,1.00
ptg014133l,2664568,2664879,311,EVM,mRNA,2576083,2676528,311,1.00
ptg014135l,54433,54697,264,EVM,mRNA,1555,430624,264,1.00
ptg014141l,1382174,1382466,292,EVM,mRNA,1343588,1426217,292,1.00
ptg014144l,456326,456618,292,EVM,mRNA,380521,709673,292,1.00
ptg014156l,582053,582356,303,EVM,mRNA,541492,622846,303,1.00
ptg014164l,248917,249232,315,EVM,mRNA,72074,918703,315,1.00
ptg014165l,190665,190989,324,EVM,mRNA,107381,222021,324,1.00
ptg014167l,514168,514490,322,EVM,mRNA,463052,583718,322,1.00
ptg014171l,180710,180997,287,EVM,mRNA,157610,210210,287,1.00
ptg014172l,986369,986681,312,EVM,mRNA,673610,3244746,312,1.00
ptg014172l,1417430,1417729,299,EVM,mRNA,673610,3244746,299,1.00
ptg014172l,1612970,1613270,300,EVM,mRNA,673610,3244746,300,1.00
ptg014172l,1650249,1650581,332,EVM,mRNA,673610,3244746,332,1.00
ptg014172l,1745050,1745349,299,EVM,mRNA,673610,3244746,299,1.00
ptg014179l,765660,765925,265,EVM,mRNA,36418,2445916,265,1.00
ptg014183l,457788,458067,279,EVM,mRNA,7248,1132679,279,1.00
ptg014184l,1354103,1354419,316,EVM,mRNA,534013,1466209,316,1.00
ptg014185l,589611,589870,259,EVM,mRNA,385935,1130936,259,1.00
ptg014201l,1347807,1348115,308,EVM,mRNA,1196399,2038362,308,1.00
ptg014209l,430426,430704,278,EVM,mRNA,34300,956116,278,1.00
ptg014209l,502169,502469,300,EVM,mRNA,34300,956116,300,1.00
ptg014209l,626790,627094,304,EVM,mRNA,34300,956116,304,1.00
ptg014209l,862645,862929,284,EVM,mRNA,34300,956116,284,1.00
ptg014209l,867666,867928,262,EVM,mRNA,34300,956116,262,1.00
ptg014211l,231485,231745,260,EVM,mRNA,56087,293852,260,1.00
ptg014213l,715099,715376,277,EVM,mRNA,665707,1562660,277,1.00
ptg014213l,919871,920155,284,EVM,mRNA,665707,1562660,284,1.00
ptg014213l,1043233,1043520,287,EVM,mRNA,665707,1562660,287,1.00
ptg014214l,985629,985912,283,EVM,mRNA,689293,1016853,283,1.00
ptg014216l,902021,902296,275,EVM,mRNA,834951,1381100,275,1.00
ptg014216l,1259416,1259689,273,EVM,mRNA,834951,1381100,273,1.00
ptg014216l,1360055,1360363,308,EVM,mRNA,834951,1381100,308,1.00
ptg014231l,1262314,1262606,292,EVM,mRNA,579502,2412989,292,1.00
ptg014231l,2247883,2248179,296,EVM,mRNA,579502,2412989,296,1.00
ptg014236l,2102207,2102495,288,EVM,mRNA,1883380,2124616,288,1.00
ptg014238l,977700,978016,316,EVM,mRNA,856869,1266328,316,1.00
ptg014238l,1229813,1230130,317,EVM,mRNA,856869,1266328,317,1.00
ptg014239l,545972,546260,288,EVM,mRNA,19114,839289,288,1.00
ptg014244l,190281,190597,316,EVM,mRNA,87100,205859,316,1.00
ptg014248l,703628,703941,313,EVM,mRNA,220744,808945,313,1.00
ptg014249l,202331,202638,307,EVM,mRNA,189863,211096,307,1.00
ptg014250l,305324,305611,287,EVM,mRNA,187189,917167,287,1.00
ptg014250l,503623,503906,283,EVM,mRNA,187189,917167,283,1.00
ptg014251l,153394,153720,326,EVM,mRNA,62557,1719880,326,1.00
ptg014251l,247011,247277,266,EVM,mRNA,62557,1719880,266,1.00
ptg014251l,669587,669857,270,EVM,mRNA,62557,1719880,270,1.00
ptg014251l,699010,699309,299,EVM,mRNA,62557,1719880,299,1.00
ptg014251l,1316040,1316338,298,EVM,mRNA,62557,1719880,298,1.00
ptg014251l,1394011,1394310,299,EVM,mRNA,62557,1719880,299,1.00
ptg014268l,195191,195472,281,EVM,mRNA,160244,1160075,281,1.00
ptg014268l,345447,345736,289,EVM,mRNA,160244,1160075,289,1.00
ptg014268l,442622,442889,267,EVM,mRNA,160244,1160075,267,1.00
ptg014268l,762331,762621,290,EVM,mRNA,160244,1160075,290,1.00
ptg014281l,211304,211565,261,EVM,mRNA,78261,212032,261,1.00
ptg014296l,672810,673111,301,EVM,mRNA,312382,1598788,301,1.00
ptg014296l,1032850,1033158,308,EVM,mRNA,312382,1598788,308,1.00
ptg014305l,331908,332217,309,EVM,mRNA,260269,595638,309,1.00
ptg014305l,518039,518341,302,EVM,mRNA,260269,595638,302,1.00
ptg014313l,32526,32891,365,EVM,mRNA,11863,223701,365,1.00
ptg014325l,618777,619091,314,EVM,mRNA,395982,1184019,314,1.00
ptg014335l,383415,383714,299,EVM,mRNA,375901,469410,299,1.00
ptg014337l,286859,287166,307,EVM,mRNA,118636,337664,307,1.00
ptg014342l,2481044,2481346,302,EVM,mRNA,2125994,3135032,302,1.00
ptg014342l,3006292,3006594,302,EVM,mRNA,2125994,3135032,302,1.00
ptg014342l,3068369,3068677,308,EVM,mRNA,2125994,3135032,308,1.00
ptg014352l,2617494,2617805,311,EVM,mRNA,939244,3315313,311,1.00
ptg014353l,637779,638047,268,EVM,mRNA,11391,1181661,268,1.00
ptg014355l,1340241,1340552,311,EVM,mRNA,1118209,1513747,311,1.00
ptg014355l,2905992,2906300,308,EVM,mRNA,2873768,2977251,308,1.00
ptg014371l,14610,14900,290,EVM,mRNA,1376,362622,290,1.00
ptg014371l,235705,236015,310,EVM,mRNA,1376,362622,310,1.00
ptg014375l,607430,607748,318,EVM,mRNA,489705,1067997,318,1.00
ptg014376l,251029,251346,317,EVM,mRNA,48654,1271998,317,1.00
ptg014376l,479283,479619,336,EVM,mRNA,48654,1271998,336,1.00
ptg014380l,1206461,1206731,270,EVM,mRNA,846827,1448349,270,1.00
ptg014384l,295189,295488,299,EVM,mRNA,45139,983234,299,1.00
ptg014384l,657840,658159,319,EVM,mRNA,45139,983234,319,1.00
ptg014384l,939915,940242,327,EVM,mRNA,45139,983234,327,1.00
ptg014390l,463978,464289,311,EVM,mRNA,9544,507107,311,1.00
ptg014396l,256738,257037,299,EVM,mRNA,15900,786278,299,1.00
ptg014396l,456542,456839,297,EVM,mRNA,15900,786278,297,1.00
ptg014400l,326979,327292,313,EVM,mRNA,69487,544825,313,1.00
ptg014404l,130574,130867,293,EVM,mRNA,2497,307870,293,1.00
ptg014406l,271834,272114,280,EVM,mRNA,270770,582871,280,1.00
ptg014406l,1255058,1255343,285,EVM,mRNA,858413,2657881,285,1.00
ptg014406l,1391080,1391395,315,EVM,mRNA,858413,2657881,315,1.00
ptg014406l,2892492,2892773,281,EVM,mRNA,2797705,2946642,281,1.00
ptg014440l,386944,387260,316,EVM,mRNA,104473,455576,316,1.00
ptg014444l,1244557,1244864,307,EVM,mRNA,1230563,1379288,307,1.00
ptg014445l,266606,266925,319,EVM,mRNA,191631,315711,319,1.00
ptg014456l,751362,751660,298,EVM,mRNA,13359,1222538,298,1.00
ptg014456l,1522960,1523259,299,EVM,mRNA,1222746,1759397,299,1.00
ptg014458l,1113677,1113971,294,EVM,mRNA,841304,1646788,294,1.00
ptg014458l,1221788,1222106,318,EVM,mRNA,841304,1646788,318,1.00
ptg014458l,1414509,1414821,312,EVM,mRNA,841304,1646788,312,1.00
ptg014459l,184008,184308,300,EVM,mRNA,132553,345556,300,1.00
ptg014460l,443797,444090,293,EVM,mRNA,61960,454640,293,1.00
ptg014461l,55126,55460,334,EVM,mRNA,41936,583577,334,1.00
ptg014464l,366964,367244,280,EVM,mRNA,103561,682525,280,1.00
ptg014466l,479454,479761,307,EVM,mRNA,173984,855566,307,1.00
ptg014467l,515697,515950,253,EVM,mRNA,70089,3079893,253,1.00
ptg014467l,625935,626236,301,EVM,mRNA,70089,3079893,301,1.00
ptg014467l,1107429,1107714,285,EVM,mRNA,70089,3079893,285,1.00
ptg014471l,1103778,1104064,286,EVM,mRNA,915593,1445473,286,1.00
ptg014473l,163313,163627,314,EVM,mRNA,119664,1012774,314,1.00
ptg014473l,226656,226986,330,EVM,mRNA,119664,1012774,330,1.00
ptg014473l,423674,423972,298,EVM,mRNA,119664,1012774,298,1.00
ptg014473l,754400,754682,282,EVM,mRNA,119664,1012774,282,1.00
ptg014476l,461990,462313,323,EVM,mRNA,88067,1900758,323,1.00
ptg014476l,613058,613383,325,EVM,mRNA,88067,1900758,325,1.00
ptg014476l,1889174,1889493,319,EVM,mRNA,88067,1900758,319,1.00
ptg014478l,158968,159282,314,EVM,mRNA,33498,442895,314,1.00
ptg014484l,195739,196047,308,EVM,mRNA,160506,253996,308,1.00
ptg014491l,93888,94215,327,EVM,mRNA,40589,888720,327,1.00
ptg014502l,53871,54196,325,EVM,mRNA,21516,137650,325,1.00
ptg014507l,1082042,1082347,305,EVM,mRNA,5968,1372984,305,1.00
ptg014507l,1323833,1324136,303,EVM,mRNA,5968,1372984,303,1.00
ptg014519l,1220437,1220746,309,EVM,mRNA,395482,1290931,309,1.00
ptg014535l,230036,230364,328,EVM,mRNA,160714,1004700,328,1.00
ptg014538l,810667,810968,301,EVM,mRNA,10402,1111656,301,1.00
ptg014538l,927763,928068,305,EVM,mRNA,10402,1111656,305,1.00
ptg014546l,249754,250027,273,EVM,mRNA,177329,391713,273,1.00
ptg014551l,1131863,1132140,277,EVM,mRNA,463956,1637058,277,1.00
ptg014551l,2062912,2063208,296,EVM,mRNA,1767106,2442058,296,1.00
ptg014553l,1367415,1367714,299,EVM,mRNA,1018163,1488219,299,1.00
ptg014557l,1043005,1043286,281,EVM,mRNA,689875,1360492,281,1.00
ptg014557l,2443861,2444158,297,EVM,mRNA,2015801,2583279,297,1.00
ptg014559l,1742257,1742550,293,EVM,mRNA,45996,2195150,293,1.00
ptg014585l,1137190,1137487,297,EVM,mRNA,494856,1534107,297,1.00
ptg014592l,631135,631429,294,EVM,mRNA,566424,1369632,294,1.00
ptg014592l,1186618,1186937,319,EVM,mRNA,566424,1369632,319,1.00
ptg014594l,664357,664678,321,EVM,mRNA,627646,1098049,321,1.00
ptg014594l,706903,707185,282,EVM,mRNA,627646,1098049,282,1.00
ptg014594l,849394,849700,306,EVM,mRNA,627646,1098049,306,1.00
ptg014594l,924412,924697,285,EVM,mRNA,627646,1098049,285,1.00
ptg014597l,117082,117373,291,EVM,mRNA,104453,356611,291,1.00
ptg014598l,1357612,1357921,309,EVM,mRNA,1331681,1548979,309,1.00
ptg014598l,1476445,1476733,288,EVM,mRNA,1331681,1548979,288,1.00
ptg014598l,1750742,1751030,288,EVM,mRNA,1656372,1863067,288,1.00
ptg014599l,1931505,1931785,280,EVM,mRNA,1238298,2079585,280,1.00
ptg014602l,875695,875995,300,EVM,mRNA,704072,1103384,300,1.00
ptg014602l,1083335,1083639,304,EVM,mRNA,704072,1103384,304,1.00
ptg014607l,309931,310253,322,EVM,mRNA,127279,314935,322,1.00
ptg014611l,224464,224758,294,EVM,mRNA,47707,334121,294,1.00
ptg014620l,1046213,1046548,335,EVM,mRNA,518073,1484570,335,1.00
ptg014620l,1138218,1138538,320,EVM,mRNA,518073,1484570,320,1.00
ptg014631l,1207971,1208254,283,EVM,mRNA,1154340,1259163,283,1.00
ptg014632l,479702,480018,316,EVM,mRNA,411359,1020763,316,1.00
ptg014633l,1000606,1000905,299,EVM,mRNA,949751,1135719,299,1.00
ptg014633l,1026371,1026632,261,EVM,mRNA,949751,1135719,261,1.00
ptg014633l,2757032,2757352,320,EVM,mRNA,2530320,2901239,320,1.00
ptg014634l,440870,441146,276,EVM,mRNA,232,536448,276,1.00
ptg014634l,1387227,1387520,293,EVM,mRNA,732167,1443850,293,1.00
ptg014638l,944653,944947,294,EVM,mRNA,722319,1269913,294,1.00
ptg014638l,957941,958203,262,EVM,mRNA,722319,1269913,262,1.00
ptg014638l,1131615,1131948,333,EVM,mRNA,722319,1269913,333,1.00
ptg014638l,1224778,1225084,306,EVM,mRNA,722319,1269913,306,1.00
ptg014648l,335278,335561,283,EVM,mRNA,204796,480854,283,1.00
ptg014648l,341105,341390,285,EVM,mRNA,204796,480854,285,1.00
ptg014648l,475225,475498,273,EVM,mRNA,204796,480854,273,1.00
ptg014650l,360578,360899,321,EVM,mRNA,71161,1490508,321,1.00
ptg014650l,377382,377672,290,EVM,mRNA,71161,1490508,290,1.00
ptg014656l,293825,294146,321,EVM,mRNA,142568,502920,321,1.00
ptg014658l,551051,551341,290,EVM,mRNA,440460,551360,290,1.00
ptg014669l,185541,185859,318,EVM,mRNA,25193,505496,318,1.00
ptg014675l,875748,876045,297,EVM,mRNA,870875,1398926,297,1.00
ptg014680l,221283,221607,324,EVM,mRNA,11029,256513,324,1.00
ptg014682l,1069967,1070292,325,EVM,mRNA,939862,1141134,325,1.00
ptg014683l,1684637,1684940,303,EVM,mRNA,686568,1951883,303,1.00
ptg014683l,2257089,2257409,320,EVM,mRNA,2243120,2616976,320,1.00
ptg014685l,1358821,1359112,291,EVM,mRNA,1251209,1454597,291,1.00
ptg014688l,88883,89179,296,EVM,mRNA,79081,357833,296,1.00
ptg014688l,1438298,1438586,288,EVM,mRNA,1363056,1476551,288,1.00
ptg014704l,151373,151661,288,EVM,mRNA,141675,424247,288,1.00
ptg014706l,159135,159428,293,EVM,mRNA,10983,325803,293,1.00
ptg014706l,240867,241140,273,EVM,mRNA,10983,325803,273,1.00
ptg014706l,575484,575793,309,EVM,mRNA,572189,670047,309,1.00
ptg014711l,164069,164354,285,EVM,mRNA,85362,210014,285,1.00
ptg014722l,789293,789572,279,EVM,mRNA,228436,1776058,279,1.00
ptg014723l,1052782,1053074,292,EVM,mRNA,482752,1637081,292,1.00
ptg014727l,187833,188146,313,EVM,mRNA,8571,699434,313,1.00
ptg014728l,418134,418454,320,EVM,mRNA,25392,574922,320,1.00
ptg014734l,160352,160642,290,EVM,mRNA,1046,207754,290,1.00
ptg014735l,531074,531387,313,EVM,mRNA,360695,1331000,313,1.00
ptg014735l,966329,966644,315,EVM,mRNA,360695,1331000,315,1.00
ptg014748l,10823,11084,261,EVM,mRNA,8864,249869,261,1.00
ptg014750l,2647826,2648140,314,EVM,mRNA,1755482,3767945,314,1.00
ptg014750l,3454432,3454738,306,EVM,mRNA,1755482,3767945,306,1.00
ptg014757l,649352,649655,303,EVM,mRNA,245467,661517,303,1.00
ptg014762l,1170823,1171099,276,EVM,mRNA,1169716,1180607,276,1.00
ptg014764l,2183160,2183443,283,EVM,mRNA,2160093,2313775,283,1.00
ptg014764l,2887618,2887929,311,EVM,mRNA,2839043,2918404,311,1.00
ptg014774l,475656,475939,283,EVM,mRNA,236341,488175,283,1.00
ptg014774l,1229602,1229919,317,EVM,mRNA,992574,1267099,317,1.00
ptg014793l,2268505,2268800,295,EVM,mRNA,1560271,3280956,295,1.00
ptg014802l,496769,497056,287,EVM,mRNA,3137,866203,287,1.00
ptg014802l,541233,541554,321,EVM,mRNA,3137,866203,321,1.00
ptg014808l,276113,276423,310,EVM,mRNA,225522,338793,310,1.00
ptg014808l,464539,464843,304,EVM,mRNA,438759,725173,304,1.00
ptg014808l,1082983,1083291,308,EVM,mRNA,853491,1319797,308,1.00
ptg014808l,1253530,1253812,282,EVM,mRNA,853491,1319797,282,1.00
ptg014815l,55718,56033,315,EVM,mRNA,13988,101605,315,1.00
ptg014818l,1851008,1851290,282,EVM,mRNA,1438233,1953093,282,1.00
ptg014845l,1647396,1647697,301,EVM,mRNA,1631938,1955376,301,1.00
ptg014845l,1728234,1728520,286,EVM,mRNA,1631938,1955376,286,1.00
ptg014845l,3297062,3297361,299,EVM,mRNA,2330519,3425106,299,1.00
ptg014845l,3410364,3410620,256,EVM,mRNA,2330519,3425106,256,1.00
ptg014849l,210010,210279,269,EVM,mRNA,47379,607607,269,1.00
ptg014854l,879106,879398,292,EVM,mRNA,54543,1182541,292,1.00
ptg014859l,1779173,1779468,295,EVM,mRNA,1158725,1879050,295,1.00
ptg014859l,2645749,2646019,270,EVM,mRNA,2310319,2751713,270,1.00
ptg014867l,1098353,1098668,315,EVM,mRNA,135739,1354093,315,1.00
ptg014872l,271525,271816,291,EVM,mRNA,63508,869891,291,1.00
ptg014874l,386592,386898,306,EVM,mRNA,83587,616379,306,1.00
ptg014874l,475099,475405,306,EVM,mRNA,83587,616379,306,1.00
ptg014878l,365394,365697,303,EVM,mRNA,18985,1212311,303,1.00
ptg014879l,7652,7953,301,EVM,mRNA,5374,140300,301,1.00
ptg014898l,402115,402392,277,EVM,mRNA,93222,2177766,277,1.00
ptg014898l,1287630,1287939,309,EVM,mRNA,93222,2177766,309,1.00
ptg014898l,2061195,2061472,277,EVM,mRNA,93222,2177766,277,1.00
ptg014903l,640165,640483,318,EVM,mRNA,256832,998026,318,1.00
ptg014903l,788145,788479,334,EVM,mRNA,256832,998026,334,1.00
ptg014904l,496767,497059,292,EVM,mRNA,10327,1348159,292,1.00
ptg014904l,643126,643404,278,EVM,mRNA,10327,1348159,278,1.00
ptg014906l,408656,408969,313,EVM,mRNA,80161,448786,313,1.00
ptg014913l,355546,355841,295,EVM,mRNA,23870,1578942,295,1.00
ptg014913l,605649,605948,299,EVM,mRNA,23870,1578942,299,1.00
ptg014913l,708885,709182,297,EVM,mRNA,23870,1578942,297,1.00
ptg014914l,21374,21643,269,EVM,mRNA,13850,106924,269,1.00
ptg014915l,929629,929909,280,EVM,mRNA,799647,1283409,280,1.00
ptg014917l,714581,714887,306,EVM,mRNA,710103,930444,306,1.00
ptg014917l,814087,814368,281,EVM,mRNA,710103,930444,281,1.00
ptg014939l,200404,200704,300,EVM,mRNA,187952,589493,300,1.00
ptg014939l,232241,232569,328,EVM,mRNA,187952,589493,328,1.00
ptg014947l,144307,144606,299,EVM,mRNA,111727,745734,299,1.00
ptg014951l,178013,178338,325,EVM,mRNA,139344,207391,325,1.00
ptg014968l,292230,292513,283,EVM,mRNA,50967,474056,283,1.00
ptg014975l,410800,411119,319,EVM,mRNA,115280,832812,319,1.00
ptg014975l,786956,787206,250,EVM,mRNA,115280,832812,250,1.00
ptg014984l,492459,492743,284,EVM,mRNA,406909,544963,284,1.00
ptg014995l,752541,752827,286,EVM,mRNA,652783,1242256,286,1.00
ptg014996l,694472,694741,269,EVM,mRNA,71418,757652,269,1.00
ptg015002l,583036,583332,296,EVM,mRNA,5505,1333518,296,1.00
ptg015002l,1301476,1301764,288,EVM,mRNA,5505,1333518,288,1.00
ptg015004l,10230,10516,286,EVM,mRNA,2259,1718758,286,1.00
ptg015015l,947118,947428,310,EVM,mRNA,262095,1064271,310,1.00
ptg015015l,1443608,1443935,327,EVM,mRNA,1348675,1678499,327,1.00
ptg015020l,847657,847984,327,EVM,mRNA,4362,1574397,327,1.00
ptg015020l,929716,930030,314,EVM,mRNA,4362,1574397,314,1.00
ptg015035l,958537,958843,306,EVM,mRNA,170548,1472586,306,1.00
ptg015035l,1340764,1341062,298,EVM,mRNA,170548,1472586,298,1.00
ptg015041l,309917,310174,257,EVM,mRNA,169534,1887788,257,1.00
ptg015041l,964417,964736,319,EVM,mRNA,169534,1887788,319,1.00
ptg015041l,1035647,1035946,299,EVM,mRNA,169534,1887788,299,1.00
ptg015051l,1840094,1840382,288,EVM,mRNA,596937,1973522,288,1.00
ptg015061l,1235316,1235635,319,EVM,mRNA,1090752,1325381,319,1.00
ptg015062l,291596,291902,306,EVM,mRNA,61305,982299,306,1.00
ptg015073l,420307,420645,338,EVM,mRNA,284118,1897405,338,1.00
ptg015078l,156338,156650,312,EVM,mRNA,32679,296869,312,1.00
ptg015080l,915944,916261,317,EVM,mRNA,212062,1283953,317,1.00
ptg015084l,716660,716983,323,EVM,mRNA,110840,1226499,323,1.00
ptg015084l,2593707,2594012,305,EVM,mRNA,2107762,3019211,305,1.00
ptg015086l,242803,243082,279,EVM,mRNA,159838,783258,279,1.00
ptg015086l,778060,778334,274,EVM,mRNA,159838,783258,274,1.00
ptg015090l,1020055,1020333,278,EVM,mRNA,471595,2461289,278,1.00
ptg015090l,2078077,2078391,314,EVM,mRNA,471595,2461289,314,1.00
ptg015102l,241437,241752,315,EVM,mRNA,25581,610041,315,1.00
ptg015116l,104926,105252,326,EVM,mRNA,14649,207696,326,1.00
ptg015116l,105416,105731,315,EVM,mRNA,14649,207696,315,1.00
ptg015125l,328061,328370,309,EVM,mRNA,78725,1189545,309,1.00
ptg015130l,914033,914341,308,EVM,mRNA,438540,1250961,308,1.00
ptg015131l,500676,500977,301,EVM,mRNA,495493,724916,301,1.00
ptg015131l,2471955,2472225,270,EVM,mRNA,2355518,2504753,270,1.00
ptg015141l,46421,46708,287,EVM,mRNA,42501,158537,287,1.00
ptg015141l,49876,50162,286,EVM,mRNA,42501,158537,286,1.00
ptg015143l,919079,919365,286,EVM,mRNA,239695,1577607,286,1.00
ptg015143l,1223850,1224161,311,EVM,mRNA,239695,1577607,311,1.00
ptg015146l,510445,510742,297,EVM,mRNA,2350,1215499,297,1.00
ptg015146l,1042091,1042381,290,EVM,mRNA,2350,1215499,290,1.00
ptg015150l,231598,231916,318,EVM,mRNA,121675,299175,318,1.00
ptg015151l,286429,286753,324,EVM,mRNA,130559,887626,324,1.00
ptg015159l,396241,396541,300,EVM,mRNA,21644,701312,300,1.00
ptg015170l,549673,549976,303,EVM,mRNA,350008,1694793,303,1.00
ptg015170l,1046159,1046495,336,EVM,mRNA,350008,1694793,336,1.00
ptg015170l,2579544,2579845,301,EVM,mRNA,2412200,2646788,301,1.00
ptg015180l,166572,166870,298,EVM,mRNA,7031,171963,298,1.00
ptg015181l,825860,826201,341,EVM,mRNA,567971,1075890,341,1.00
ptg015185l,1263120,1263394,274,EVM,mRNA,685459,1515488,274,1.00
ptg015188l,987905,988047,142,EVM,mRNA,452485,1177799,142,1.00
ptg015191l,632494,632789,295,EVM,mRNA,441722,1364187,295,1.00
ptg015191l,1102066,1102388,322,EVM,mRNA,441722,1364187,322,1.00
ptg015191l,1325205,1325520,315,EVM,mRNA,441722,1364187,315,1.00
ptg015205l,249129,249421,292,EVM,mRNA,36201,744499,292,1.00
ptg015205l,281771,282063,292,EVM,mRNA,36201,744499,292,1.00
ptg015205l,346270,346572,302,EVM,mRNA,36201,744499,302,1.00
ptg015209l,273779,274115,336,EVM,mRNA,116992,505672,336,1.00
ptg015215l,31563,31842,279,EVM,mRNA,4038,1191175,279,1.00
ptg015215l,925535,925846,311,EVM,mRNA,4038,1191175,311,1.00
ptg015218l,307155,307467,312,EVM,mRNA,163683,733577,312,1.00
ptg015225l,1317632,1317928,296,EVM,mRNA,1021558,2292205,296,1.00
ptg015231l,1143506,1143822,316,EVM,mRNA,590666,1143881,316,1.00
ptg015231l,1732262,1732556,294,EVM,mRNA,1672580,1882687,294,1.00
ptg015236l,579015,579310,295,EVM,mRNA,334173,1006895,295,1.00
ptg015236l,1135496,1135765,269,EVM,mRNA,1091044,1188393,269,1.00
ptg015237l,672939,673246,307,EVM,mRNA,596403,680263,307,1.00
ptg015239l,119855,120129,274,EVM,mRNA,6630,134229,274,1.00
ptg015248l,445641,445961,320,EVM,mRNA,253319,678197,320,1.00
ptg015255l,2641577,2641860,283,EVM,mRNA,2638650,2778414,283,1.00
ptg015260l,347924,348239,315,EVM,mRNA,70559,490837,315,1.00
ptg015266l,233340,233657,317,EVM,mRNA,106799,441296,317,1.00
ptg015289l,843779,844088,309,EVM,mRNA,754515,850716,309,1.00
ptg015293l,604238,604545,307,EVM,mRNA,456,777095,307,1.00
ptg015293l,1434097,1434413,316,EVM,mRNA,1330860,1907595,316,1.00
ptg015297l,2221289,2221569,280,EVM,mRNA,2191253,2266724,280,1.00
ptg015302l,252587,252879,292,EVM,mRNA,914,382769,292,1.00
ptg015303l,472169,472457,288,EVM,mRNA,231601,582495,288,1.00
ptg015306l,336274,336553,279,EVM,mRNA,93,970502,279,1.00
ptg015318l,1112158,1112453,295,EVM,mRNA,764568,1246981,295,1.00
ptg015352l,446031,446331,300,EVM,mRNA,180941,1670779,300,1.00
ptg015352l,492546,492836,290,EVM,mRNA,180941,1670779,290,1.00
ptg015352l,1285629,1285931,302,EVM,mRNA,180941,1670779,302,1.00
ptg015357l,1735565,1735881,316,EVM,mRNA,1273012,2080889,316,1.00
ptg015357l,3122762,3123072,310,EVM,mRNA,3072308,3575073,310,1.00
ptg015358l,326127,326412,285,EVM,mRNA,104041,461517,285,1.00
ptg015360l,148480,148817,337,EVM,mRNA,145474,535428,337,1.00
ptg015362l,81439,81719,280,EVM,mRNA,19685,292731,280,1.00
ptg015369l,268271,268561,290,EVM,mRNA,169648,897511,290,1.00
ptg015369l,268271,268561,290,GeneWise,mRNA,31475,897511,290,1.00
ptg015370l,725699,726005,306,EVM,mRNA,2372,855563,306,1.00
ptg015370l,1194710,1194989,279,EVM,mRNA,1072790,1237908,279,1.00
ptg015380l,1333771,1334048,277,EVM,mRNA,499428,1394500,277,1.00
ptg015386l,463011,463334,323,EVM,mRNA,203534,1199942,323,1.00
ptg015386l,1221073,1221364,291,EVM,mRNA,1213437,1765280,291,1.00
ptg015392l,390388,390665,277,EVM,mRNA,245496,581147,277,1.00
ptg015395l,12057,12379,322,EVM,mRNA,7361,367626,322,1.00
ptg015398l,184369,184655,286,EVM,mRNA,164340,320817,286,1.00
ptg015399l,190887,191210,323,EVM,mRNA,158923,506295,323,1.00
ptg015403l,1309318,1309603,285,EVM,mRNA,1273471,1477797,285,1.00
ptg015403l,1695131,1695462,331,EVM,mRNA,1622770,3289339,331,1.00
ptg015403l,2878950,2879259,309,EVM,mRNA,1622770,3289339,309,1.00
ptg015407l,161669,161978,309,EVM,mRNA,158235,511599,309,1.00
ptg015407l,443735,444018,283,EVM,mRNA,158235,511599,283,1.00
ptg015410l,402568,402867,299,EVM,mRNA,260637,737749,299,1.00
ptg015417l,942180,942479,299,EVM,mRNA,765909,1596216,299,1.00
ptg015420l,1067616,1067946,330,EVM,mRNA,940421,1113177,330,1.00
ptg015427l,622929,623249,320,EVM,mRNA,559724,1212243,320,1.00
ptg015427l,637223,637526,303,EVM,mRNA,559724,1212243,303,1.00
ptg015427l,934604,934903,299,EVM,mRNA,559724,1212243,299,1.00
ptg015427l,1168493,1168792,299,EVM,mRNA,559724,1212243,299,1.00
ptg015434l,960017,960320,303,EVM,mRNA,586162,981105,303,1.00
ptg015446l,281419,281729,310,EVM,mRNA,136771,1004820,310,1.00
ptg015448l,1039374,1039642,268,EVM,mRNA,723,1472786,268,1.00
ptg015454l,646281,646582,301,EVM,mRNA,135830,888655,301,1.00
ptg015468l,817596,817891,295,EVM,mRNA,668396,1557626,295,1.00
ptg015470l,1181327,1181609,282,EVM,mRNA,754582,1366867,282,1.00
ptg015470l,2103379,2103687,308,EVM,mRNA,1919454,2744576,308,1.00
ptg015470l,3336547,3336824,277,EVM,mRNA,3332177,3507517,277,1.00
ptg015472l,543512,543831,319,EVM,mRNA,525817,551387,319,1.00
ptg015473l,1085429,1085740,311,EVM,mRNA,620173,1176243,311,1.00
ptg015481l,960349,960681,332,EVM,mRNA,960241,1370263,332,1.00
ptg015486l,305053,305337,284,EVM,mRNA,189501,415423,284,1.00
ptg015496l,273282,273577,295,EVM,mRNA,7697,636029,295,1.00
ptg015496l,557465,557758,293,EVM,mRNA,7697,636029,293,1.00
ptg015504l,474518,474848,330,EVM,mRNA,12009,2216193,330,1.00
ptg015506l,111469,111782,313,EVM,mRNA,109620,119255,313,1.00
ptg015506l,3361545,3361861,316,EVM,mRNA,2844122,3426604,316,1.00
ptg015506l,3387452,3387760,308,EVM,mRNA,2844122,3426604,308,1.00
ptg015509l,154256,154560,304,EVM,mRNA,14318,1002768,304,1.00
ptg015509l,311030,311310,280,EVM,mRNA,14318,1002768,280,1.00
ptg015509l,674930,675256,326,EVM,mRNA,14318,1002768,326,1.00
ptg015509l,731305,731587,282,EVM,mRNA,14318,1002768,282,1.00
ptg015509l,834090,834323,233,EVM,mRNA,14318,1002768,233,1.00
ptg015532l,96802,97092,290,EVM,mRNA,2692,136972,290,1.00
ptg015532l,1279930,1280227,297,EVM,mRNA,238318,1918790,297,1.00
ptg015550l,169391,169694,303,EVM,mRNA,105834,318418,303,1.00
ptg015556l,1956101,1956401,300,EVM,mRNA,1566450,2352356,300,1.00
ptg015578l,1563623,1563941,318,EVM,mRNA,1435813,1592983,318,1.00
ptg015579l,865314,865624,310,EVM,mRNA,397806,972504,310,1.00
ptg015583l,254776,255074,298,EVM,mRNA,67348,321688,298,1.00
ptg015588l,202005,202290,285,EVM,mRNA,8755,410790,285,1.00
ptg015588l,1273364,1273662,298,EVM,mRNA,1036451,1963745,298,1.00
ptg015596l,46398,46674,276,EVM,mRNA,24803,57385,276,1.00
ptg015615l,1080536,1080860,324,EVM,mRNA,874670,1262664,324,1.00
ptg015617l,155302,155603,301,EVM,mRNA,129473,163505,301,1.00
ptg015620l,1364989,1365318,329,EVM,mRNA,1081829,1551835,329,1.00
ptg015620l,1416456,1416748,292,EVM,mRNA,1081829,1551835,292,1.00
ptg015630l,446702,447008,306,EVM,mRNA,91816,642108,306,1.00
ptg015630l,460162,460473,311,EVM,mRNA,91816,642108,311,1.00
ptg015638l,839500,839826,326,EVM,mRNA,832376,910174,326,1.00
ptg015641l,485085,485396,311,EVM,mRNA,412847,532095,311,1.00
ptg015659l,1903492,1903763,271,EVM,mRNA,1690218,2169707,271,1.00
ptg015674l,18611,18920,309,EVM,mRNA,1671,162690,309,1.00
ptg015679l,719736,719995,259,EVM,mRNA,14807,1208280,259,1.00
ptg015679l,721688,721973,285,EVM,mRNA,14807,1208280,285,1.00
ptg015691l,1079223,1079549,326,EVM,mRNA,510816,1369392,326,1.00
ptg015691l,1313807,1314103,296,EVM,mRNA,510816,1369392,296,1.00
ptg015704l,292325,292584,259,EVM,mRNA,280526,430739,259,1.00
ptg015710l,1040843,1041153,310,EVM,mRNA,783215,1109636,310,1.00
ptg015714l,1359126,1359440,314,EVM,mRNA,1000151,1428588,314,1.00
ptg015715l,81824,82120,296,EVM,mRNA,199,268691,296,1.00
ptg015718l,1358951,1359205,254,EVM,mRNA,1312819,1375829,254,1.00
ptg015720l,118134,118426,292,EVM,mRNA,86225,201577,292,1.00
ptg015729l,590446,590730,284,EVM,mRNA,394018,989761,284,1.00
ptg015729l,861577,861862,285,EVM,mRNA,394018,989761,285,1.00
ptg015745l,547648,547961,313,EVM,mRNA,467312,568122,313,1.00
ptg015748l,340327,340627,300,EVM,mRNA,339365,340399,72,0.24
ptg015748l,2350510,2350810,300,EVM,mRNA,1676627,2542589,300,1.00
ptg015748l,2438480,2438741,261,EVM,mRNA,1676627,2542589,261,1.00
ptg015752l,198447,198746,299,EVM,mRNA,40695,368518,299,1.00
ptg015752l,313350,313639,289,EVM,mRNA,40695,368518,289,1.00
ptg015756l,119999,120303,304,EVM,mRNA,43,271536,304,1.00
ptg015759l,1305221,1305482,261,EVM,mRNA,1276534,1425111,261,1.00
ptg015760l,400494,400778,284,EVM,mRNA,195477,573335,284,1.00
ptg015760l,1129565,1129881,316,EVM,mRNA,1128313,1625977,316,1.00
ptg015765l,1059930,1060214,284,EVM,mRNA,580600,1247227,284,1.00
ptg015765l,1150075,1150394,319,EVM,mRNA,580600,1247227,319,1.00
ptg015766l,58140,58463,323,EVM,mRNA,42030,115129,323,1.00
ptg015766l,1091001,1091282,281,EVM,mRNA,191625,1190959,281,1.00
ptg015768l,910214,910528,314,EVM,mRNA,736584,911039,314,1.00
ptg015768l,2802029,2802358,329,EVM,mRNA,2721830,3565461,329,1.00
ptg015768l,6299654,6299977,323,EVM,mRNA,5775631,7316770,323,1.00
ptg015772l,936056,936334,278,EVM,mRNA,322334,1095778,278,1.00
ptg015782l,1531519,1531835,316,EVM,mRNA,1297137,1775924,316,1.00
ptg015782l,1572128,1572447,319,EVM,mRNA,1297137,1775924,319,1.00
ptg015782l,2585900,2586199,299,EVM,mRNA,2309332,3064288,299,1.00
ptg015782l,3205781,3206109,328,EVM,mRNA,3200019,3206128,328,1.00
ptg015787l,1817137,1817416,279,EVM,mRNA,142559,2530899,279,1.00
ptg015791l,628522,628830,308,EVM,mRNA,496666,1411674,308,1.00
ptg015805l,208904,209219,315,EVM,mRNA,100403,334269,315,1.00
ptg015806l,572337,572650,313,EVM,mRNA,463571,1218064,313,1.00
ptg015814l,200378,200711,333,EVM,mRNA,13925,236833,333,1.00
ptg015819l,247861,248160,299,EVM,mRNA,36890,1188308,299,1.00
ptg015819l,337973,338254,281,EVM,mRNA,36890,1188308,281,1.00
ptg015819l,730500,730795,295,EVM,mRNA,36890,1188308,295,1.00
ptg015821l,800862,801148,286,EVM,mRNA,796023,946037,286,1.00
ptg015821l,819085,819405,320,EVM,mRNA,796023,946037,320,1.00
ptg015822l,442132,442433,301,EVM,mRNA,362086,763183,301,1.00
ptg015822l,518985,519304,319,EVM,mRNA,362086,763183,319,1.00
ptg015825l,118712,118988,276,EVM,mRNA,108883,752063,276,1.00
ptg015829l,1617153,1617445,292,EVM,mRNA,1583932,1686289,292,1.00
ptg015835l,179165,179447,282,EVM,mRNA,108111,650041,282,1.00
ptg015838l,133151,133470,319,EVM,mRNA,90256,207837,319,1.00
ptg015843l,646130,646403,273,EVM,mRNA,24194,1990995,273,1.00
ptg015845l,475790,476092,302,EVM,mRNA,203647,564428,302,1.00
ptg015845l,553641,553931,290,EVM,mRNA,203647,564428,290,1.00
ptg015845l,1771229,1771520,291,EVM,mRNA,1756431,1841857,291,1.00
ptg015849l,1243563,1243879,316,EVM,mRNA,1149850,1289239,316,1.00
ptg015853l,377100,377396,296,EVM,mRNA,319451,709971,296,1.00
ptg015857l,483349,483661,312,EVM,mRNA,309057,488444,312,1.00
ptg015874l,1215187,1215492,305,EVM,mRNA,621143,1384160,305,1.00
ptg015874l,1222330,1222649,319,EVM,mRNA,621143,1384160,319,1.00
ptg015883l,448863,449169,306,EVM,mRNA,315463,1498555,306,1.00
ptg015883l,1498167,1498485,318,EVM,mRNA,315463,1498555,318,1.00
ptg015884l,451913,452223,310,EVM,mRNA,83159,1058734,310,1.00
ptg015884l,716012,716322,310,EVM,mRNA,83159,1058734,310,1.00
ptg015884l,1729546,1729845,299,EVM,mRNA,1363996,2074936,299,1.00
ptg015894l,115318,115603,285,EVM,mRNA,76147,260576,285,1.00
ptg015915l,357272,357603,331,EVM,mRNA,330080,365833,331,1.00
ptg015919l,1885019,1885290,271,EVM,mRNA,1851319,2468457,271,1.00
ptg015923l,915040,915358,318,EVM,mRNA,95304,1250164,318,1.00
ptg015925l,160060,160340,280,EVM,mRNA,4362,258703,280,1.00
ptg015926l,423214,423483,269,EVM,mRNA,50811,552930,269,1.00
ptg015933l,502935,503210,275,EVM,mRNA,366887,884857,275,1.00
ptg015938l,314984,315314,330,EVM,mRNA,311947,1625152,330,1.00
ptg015938l,1015682,1015948,266,EVM,mRNA,311947,1625152,266,1.00
ptg015938l,1619514,1619787,273,EVM,mRNA,311947,1625152,273,1.00
ptg015946l,3043380,3043658,278,EVM,mRNA,2921293,3173581,278,1.00
ptg015952l,428278,428555,277,EVM,mRNA,338977,831892,277,1.00
ptg015952l,695741,696042,301,EVM,mRNA,338977,831892,301,1.00
ptg015953l,1548235,1548500,265,EVM,mRNA,720018,1722821,265,1.00
ptg015963l,229058,229360,302,EVM,mRNA,25458,532192,302,1.00
ptg015968l,145363,145666,303,EVM,mRNA,73905,207728,303,1.00
ptg015968l,148235,148556,321,EVM,mRNA,73905,207728,321,1.00
ptg015984l,265874,266177,303,EVM,mRNA,5822,481287,303,1.00
ptg015993l,385850,386154,304,EVM,mRNA,349870,445726,304,1.00
ptg015996l,452481,452795,314,EVM,mRNA,295764,642571,314,1.00
ptg015997l,130144,130424,280,EVM,mRNA,3219,421996,280,1.00
ptg016026l,158563,158865,302,EVM,mRNA,39217,932368,302,1.00
ptg016026l,365901,366218,317,EVM,mRNA,39217,932368,317,1.00
ptg016026l,375356,375642,286,EVM,mRNA,39217,932368,286,1.00
ptg016031l,1098430,1098713,283,EVM,mRNA,781203,1775754,283,1.00
ptg016031l,1227831,1228112,281,EVM,mRNA,781203,1775754,281,1.00
ptg016042l,148532,148814,282,EVM,mRNA,123351,183203,282,1.00
ptg016070l,691152,691436,284,EVM,mRNA,541408,1006043,284,1.00
ptg016072l,53060,53343,283,EVM,mRNA,20814,783776,283,1.00
ptg016072l,721320,721600,280,EVM,mRNA,20814,783776,280,1.00
ptg016072l,945479,945785,306,EVM,mRNA,918433,1061132,306,1.00
ptg016072l,1837279,1837564,285,EVM,mRNA,1345752,1876806,285,1.00
ptg016077l,301138,301468,330,EVM,mRNA,237136,612553,330,1.00
ptg016080l,2011870,2012171,301,EVM,mRNA,1692227,2019539,301,1.00
ptg016083l,1516043,1516329,286,EVM,mRNA,1430723,1600932,286,1.00
ptg016090l,207219,207528,309,EVM,mRNA,98099,301075,309,1.00
ptg016091l,408446,408767,321,EVM,mRNA,405656,1777645,321,1.00
ptg016103l,249204,249501,297,EVM,mRNA,180478,428729,297,1.00
ptg016112l,2183479,2183804,325,EVM,mRNA,1847062,2285889,325,1.00
ptg016112l,2229655,2229945,290,EVM,mRNA,1847062,2285889,290,1.00
ptg016128l,106114,106400,286,EVM,mRNA,4956,503300,286,1.00
ptg016130l,1121226,1121541,315,EVM,mRNA,8371,2442235,315,1.00
ptg016139l,722633,722940,307,EVM,mRNA,279915,836997,307,1.00
ptg016156l,434790,435114,324,EVM,mRNA,260330,447562,324,1.00
ptg016175l,167125,167411,286,EVM,mRNA,165160,629740,286,1.00
ptg016175l,256032,256314,282,EVM,mRNA,165160,629740,282,1.00
ptg016176l,356595,356872,277,EVM,mRNA,318878,1260456,277,1.00
ptg016194l,1471986,1472300,314,EVM,mRNA,1411717,1568235,314,1.00
ptg016196l,536160,536441,281,EVM,mRNA,459153,780664,281,1.00
ptg016196l,670732,671033,301,EVM,mRNA,459153,780664,301,1.00
ptg016220l,576566,576847,281,EVM,mRNA,269670,877807,281,1.00
ptg016220l,1668350,1668678,328,EVM,mRNA,1595315,2139474,328,1.00
ptg016220l,2062347,2062660,313,EVM,mRNA,1595315,2139474,313,1.00
ptg016238l,1119729,1120050,321,EVM,mRNA,163560,1235690,321,1.00
ptg016239l,1875546,1875808,262,EVM,mRNA,1681677,2409911,262,1.00
ptg016239l,2246416,2246717,301,EVM,mRNA,1681677,2409911,301,1.00
ptg016248l,823501,823786,285,EVM,mRNA,671427,1896643,285,1.00
ptg016248l,912284,912574,290,EVM,mRNA,671427,1896643,290,1.00
ptg016248l,1677754,1678053,299,EVM,mRNA,671427,1896643,299,1.00
ptg016265l,892003,892317,314,EVM,mRNA,423314,1443084,314,1.00
ptg016276l,181780,182090,310,EVM,mRNA,113171,786124,310,1.00
ptg016277l,387718,388026,308,EVM,mRNA,386082,430684,308,1.00
ptg016278l,346395,346703,308,EVM,mRNA,22501,680083,308,1.00
ptg016283l,65114,65482,368,EVM,mRNA,5164,214446,368,1.00
ptg016299l,938308,938621,313,EVM,mRNA,74642,1209184,313,1.00
ptg016302l,912832,913113,281,EVM,mRNA,765062,1637806,281,1.00
ptg016312l,959811,960091,280,EVM,mRNA,4535,2000767,280,1.00
ptg016312l,2198017,2198328,311,EVM,mRNA,2155430,2270730,311,1.00
ptg016313l,425431,425756,325,EVM,mRNA,240027,576282,325,1.00
ptg016344l,1797785,1798082,297,EVM,mRNA,1651001,1881226,297,1.00
ptg016345l,490103,490417,314,EVM,mRNA,335667,798449,314,1.00
ptg016345l,3284743,3285026,283,EVM,mRNA,2699366,3533616,283,1.00
ptg016363l,313320,313616,296,EVM,mRNA,276123,1392357,296,1.00
ptg016363l,805731,806003,272,EVM,mRNA,276123,1392357,272,1.00
ptg016363l,1120541,1120792,251,EVM,mRNA,276123,1392357,251,1.00
ptg016364l,715537,715868,331,EVM,mRNA,102893,861909,331,1.00
ptg016369l,447102,447414,312,EVM,mRNA,410280,529574,312,1.00
ptg016378l,395307,395611,304,EVM,mRNA,29120,1401119,304,1.00
ptg016382l,1304494,1304812,318,EVM,mRNA,473126,1441987,318,1.00
ptg016388l,657258,657554,296,EVM,mRNA,634724,967003,296,1.00
ptg016410l,587304,587611,307,EVM,mRNA,368979,768122,307,1.00
ptg016417l,624490,624797,307,EVM,mRNA,415926,746581,307,1.00
ptg016421l,312975,313269,294,EVM,mRNA,15321,377028,294,1.00
ptg016424l,126687,126980,293,EVM,mRNA,8496,552677,293,1.00
ptg016436l,721108,721404,296,EVM,mRNA,403829,968361,296,1.00
ptg016442l,1742424,1742723,299,EVM,mRNA,1595736,2154226,299,1.00
ptg016447l,284490,284805,315,EVM,mRNA,21411,326321,315,1.00
ptg016448l,48025,48314,289,EVM,mRNA,19706,51769,289,1.00
ptg016450l,437752,438051,299,EVM,mRNA,1369,721372,299,1.00
ptg016455l,85902,86214,312,EVM,mRNA,8338,143200,312,1.00
ptg016462l,1295664,1295978,314,EVM,mRNA,1150740,1393060,314,1.00
ptg016466l,615500,615809,309,EVM,mRNA,151830,1594289,309,1.00
ptg016466l,817654,817974,320,EVM,mRNA,151830,1594289,320,1.00
ptg016466l,906589,906902,313,EVM,mRNA,151830,1594289,313,1.00
ptg016466l,1407987,1408303,316,EVM,mRNA,151830,1594289,316,1.00
ptg016466l,3593289,3593553,264,EVM,mRNA,3122485,4000195,264,1.00
ptg016471l,423882,424174,292,EVM,mRNA,202931,450381,292,1.00
ptg016486l,191761,192036,275,EVM,mRNA,80637,371023,275,1.00
ptg016491l,1149982,1150290,308,EVM,mRNA,644981,1283223,308,1.00
ptg016491l,1668132,1668422,290,EVM,mRNA,1390459,1701264,290,1.00
ptg016491l,1691329,1691644,315,EVM,mRNA,1390459,1701264,315,1.00
ptg016502l,296568,296848,280,EVM,mRNA,11306,557603,280,1.00
ptg016502l,556915,557230,315,EVM,mRNA,11306,557603,315,1.00
ptg016509l,1462581,1462885,304,EVM,mRNA,669798,2362762,304,1.00
ptg016509l,2055077,2055371,294,EVM,mRNA,669798,2362762,294,1.00
ptg016526l,208294,208607,313,EVM,mRNA,76159,2944134,313,1.00
ptg016526l,600690,601000,310,EVM,mRNA,76159,2944134,310,1.00
ptg016526l,750176,750469,293,EVM,mRNA,76159,2944134,293,1.00
ptg016526l,940648,940961,313,EVM,mRNA,76159,2944134,313,1.00
ptg016526l,1151915,1152225,310,EVM,mRNA,76159,2944134,310,1.00
ptg016526l,2855748,2856074,326,EVM,mRNA,76159,2944134,326,1.00
ptg016532l,890107,890382,275,EVM,mRNA,692929,1463293,275,1.00
ptg016537l,575951,576253,302,EVM,mRNA,258522,1175976,302,1.00
ptg016545l,191145,191441,296,EVM,mRNA,88767,2101135,296,1.00
ptg016545l,1149275,1149566,291,EVM,mRNA,88767,2101135,291,1.00
ptg016545l,1481683,1481951,268,EVM,mRNA,88767,2101135,268,1.00
ptg016563l,442726,443036,310,EVM,mRNA,5010,657821,310,1.00
ptg016568l,261471,261781,310,EVM,mRNA,114547,403165,310,1.00
ptg016574l,285192,285472,280,EVM,mRNA,80602,452130,280,1.00
ptg016577l,254835,255154,319,EVM,mRNA,145445,491582,319,1.00
ptg016577l,756386,756693,307,EVM,mRNA,513021,1466785,307,1.00
ptg016577l,1048432,1048755,323,EVM,mRNA,513021,1466785,323,1.00
ptg016577l,1230195,1230499,304,EVM,mRNA,513021,1466785,304,1.00
ptg016577l,1327485,1327785,300,EVM,mRNA,513021,1466785,300,1.00
ptg016577l,1375699,1375983,284,EVM,mRNA,513021,1466785,284,1.00
ptg016577l,1431045,1431365,320,EVM,mRNA,513021,1466785,320,1.00
ptg016580l,360919,361230,311,EVM,mRNA,3379,520458,311,1.00
ptg016584l,112287,112614,327,EVM,mRNA,16317,416118,327,1.00
ptg016589l,712802,713100,298,EVM,mRNA,5991,877291,298,1.00
ptg016597l,627597,627886,289,EVM,mRNA,103268,1018711,289,1.00
ptg016598l,417467,417746,279,EVM,mRNA,54273,1680406,279,1.00
ptg016598l,436221,436507,286,EVM,mRNA,54273,1680406,286,1.00
ptg016598l,1309761,1310060,299,EVM,mRNA,54273,1680406,299,1.00
ptg016598l,1595429,1595713,284,EVM,mRNA,54273,1680406,284,1.00
ptg016609l,374617,374890,273,EVM,mRNA,110976,604285,273,1.00
ptg016610l,673998,674325,327,EVM,mRNA,428721,910547,327,1.00
ptg016611l,1320604,1320891,287,EVM,mRNA,268,2701957,287,1.00
ptg016616l,790539,790838,299,EVM,mRNA,765081,933355,299,1.00
ptg016625l,809347,809586,239,EVM,mRNA,634956,820900,239,1.00
ptg016628l,1001565,1001849,284,EVM,mRNA,990830,1037266,284,1.00
ptg016639l,328827,329126,299,EVM,mRNA,91178,836700,299,1.00
ptg016639l,619901,620196,295,EVM,mRNA,91178,836700,295,1.00
ptg016643l,310225,310495,270,EVM,mRNA,153533,409132,270,1.00
ptg016646l,264218,264532,314,EVM,mRNA,238229,330186,314,1.00
ptg016646l,1798221,1798535,314,EVM,mRNA,1263398,2058148,314,1.00
ptg016654l,387562,387855,293,EVM,mRNA,116689,729555,293,1.00
ptg016660l,765710,765992,282,EVM,mRNA,579177,1093362,282,1.00
ptg016662l,1405485,1405821,336,EVM,mRNA,925626,1596771,336,1.00
ptg016681l,18386,18661,275,EVM,mRNA,15777,28689,275,1.00
ptg016695l,521311,521605,294,EVM,mRNA,327518,596208,294,1.00
ptg016695l,573454,573751,297,EVM,mRNA,327518,596208,297,1.00
ptg016702l,375539,375847,308,EVM,mRNA,361423,885108,308,1.00
ptg016705l,284680,284995,315,EVM,mRNA,21289,499871,315,1.00
ptg016712l,96361,96654,293,EVM,mRNA,46834,431845,293,1.00
ptg016713l,484187,484494,307,EVM,mRNA,6873,943781,307,1.00
ptg016713l,768944,769228,284,EVM,mRNA,6873,943781,284,1.00
ptg016713l,923076,923362,286,EVM,mRNA,6873,943781,286,1.00
ptg016734l,27448,27753,305,EVM,mRNA,24093,378205,305,1.00
ptg016735l,286010,286327,317,EVM,mRNA,68118,420473,317,1.00
ptg016748l,1055902,1056188,286,EVM,mRNA,430294,1196331,286,1.00
ptg016748l,1178730,1179029,299,EVM,mRNA,430294,1196331,299,1.00
ptg016758l,60238,60529,291,EVM,mRNA,3870,434178,291,1.00
ptg016758l,1026323,1026614,291,EVM,mRNA,1022663,1342598,291,1.00
ptg016765l,923828,924136,308,EVM,mRNA,385236,1045860,308,1.00
ptg016769l,604721,605014,293,EVM,mRNA,526788,673250,293,1.00
ptg016805l,266251,266544,293,EVM,mRNA,222424,470951,293,1.00
ptg016816l,27256,27559,303,EVM,mRNA,24251,84447,303,1.00
ptg016827l,566528,566861,333,EVM,mRNA,419501,1033350,333,1.00
ptg016827l,804451,804764,313,EVM,mRNA,419501,1033350,313,1.00
ptg016827l,925232,925543,311,EVM,mRNA,419501,1033350,311,1.00
ptg016838l,349350,349628,278,EVM,mRNA,1089,397241,278,1.00
ptg016840l,725922,726218,296,EVM,mRNA,455661,981544,296,1.00
ptg016841l,687520,687801,281,EVM,mRNA,541835,1142383,281,1.00
ptg016841l,961828,962097,269,EVM,mRNA,541835,1142383,269,1.00
ptg016846l,439808,440118,310,EVM,mRNA,164959,751077,310,1.00
ptg016850l,399614,399929,315,EVM,mRNA,311411,427830,315,1.00
ptg016851l,533253,533551,298,EVM,mRNA,237690,1102010,298,1.00
ptg016855l,293726,293997,271,EVM,mRNA,97263,343656,271,1.00
ptg016868l,135390,135720,330,EVM,mRNA,133973,719179,330,1.00
ptg016868l,340959,341233,274,EVM,mRNA,133973,719179,274,1.00
ptg016873l,397904,398214,310,EVM,mRNA,360835,543547,310,1.00
ptg016884l,71788,72087,299,EVM,mRNA,1063,744140,299,1.00
ptg016884l,668422,668691,269,EVM,mRNA,1063,744140,269,1.00
ptg016890l,435687,436012,325,EVM,mRNA,378284,508853,325,1.00
ptg016904l,1002064,1002387,323,EVM,mRNA,980775,1096019,323,1.00
ptg016905l,766750,767056,306,EVM,mRNA,426940,2179275,306,1.00
ptg016905l,1226140,1226433,293,EVM,mRNA,426940,2179275,293,1.00
ptg016919l,303980,304279,299,EVM,mRNA,5708,576765,299,1.00
ptg016928l,225286,225607,321,EVM,mRNA,2787,307956,321,1.00
ptg016934l,1877173,1877497,324,EVM,mRNA,1406329,1920345,324,1.00
ptg016943l,203517,203816,299,EVM,mRNA,26958,568550,299,1.00
ptg016943l,280849,281146,297,EVM,mRNA,26958,568550,297,1.00
ptg016950l,259299,259592,293,EVM,mRNA,210438,854899,293,1.00
ptg016952l,125711,126022,311,EVM,mRNA,15884,215413,311,1.00
ptg016953l,167611,167899,288,EVM,mRNA,146817,232207,288,1.00
ptg016954l,506127,506414,287,EVM,mRNA,503364,506534,287,1.00
ptg016965l,38984,39238,254,EVM,mRNA,38,711338,254,1.00
ptg016969l,893248,893527,279,EVM,mRNA,893435,893893,93,0.33
ptg016979l,1134368,1134674,306,EVM,mRNA,1088573,1156610,306,1.00
ptg016992l,1294883,1295193,310,EVM,mRNA,1275652,1720794,310,1.00
ptg017004l,216406,216692,286,EVM,mRNA,90061,311290,286,1.00
ptg017005l,383690,384017,327,EVM,mRNA,333590,384968,327,1.00
ptg017007l,193794,194100,306,EVM,mRNA,192425,332190,306,1.00
ptg017014l,801281,801561,280,EVM,mRNA,590897,1063797,280,1.00
ptg017018l,541898,542176,278,EVM,mRNA,474031,543806,278,1.00
ptg017026l,141501,141787,286,EVM,mRNA,25121,380122,286,1.00
ptg017026l,317927,318252,325,EVM,mRNA,25121,380122,325,1.00
ptg017029l,544352,544668,316,EVM,mRNA,420833,678834,316,1.00
ptg017029l,577632,577949,317,EVM,mRNA,420833,678834,317,1.00
ptg017037l,1079579,1079887,308,EVM,mRNA,20342,1226717,308,1.00
ptg017037l,1901372,1901658,286,EVM,mRNA,1533756,2248037,286,1.00
ptg017065l,610133,610408,275,EVM,mRNA,536559,1639938,275,1.00
ptg017065l,736295,736608,313,EVM,mRNA,536559,1639938,313,1.00
ptg017066l,1034927,1035231,304,EVM,mRNA,669,1042288,304,1.00
ptg017072l,249764,250064,300,EVM,mRNA,11282,457656,300,1.00
ptg017072l,295858,296171,313,EVM,mRNA,11282,457656,313,1.00
ptg017093l,397105,397384,279,EVM,mRNA,338626,570031,279,1.00
ptg017100l,1137359,1137677,318,EVM,mRNA,26381,1433328,318,1.00
ptg017100l,2338611,2338897,286,EVM,mRNA,1526826,2417589,286,1.00
ptg017101l,306133,306448,315,EVM,mRNA,290033,777868,315,1.00
ptg017101l,473137,473460,323,EVM,mRNA,290033,777868,323,1.00
ptg017108l,2701928,2702240,312,EVM,mRNA,2582667,2732760,312,1.00
ptg017123l,577844,578125,281,EVM,mRNA,323393,829855,281,1.00
ptg017130l,98766,99038,272,EVM,mRNA,82448,624821,272,1.00
ptg017133l,53319,53606,287,EVM,mRNA,58,1507557,287,1.00
ptg017133l,1375605,1375895,290,EVM,mRNA,58,1507557,290,1.00
ptg017151l,316030,316336,306,EVM,mRNA,300490,434238,306,1.00
ptg017156l,800573,800878,305,EVM,mRNA,566651,1221919,305,1.00
ptg017156l,1111498,1111795,297,EVM,mRNA,566651,1221919,297,1.00
ptg017164l,906521,906800,279,EVM,mRNA,225658,2100396,279,1.00
ptg017165l,682003,682311,308,EVM,mRNA,157733,1237620,308,1.00
ptg017172l,235964,236248,284,EVM,mRNA,67001,255417,284,1.00
ptg017173l,217802,218101,299,EVM,mRNA,38691,367358,299,1.00
ptg017173l,245801,246097,296,EVM,mRNA,38691,367358,296,1.00
ptg017179l,884188,884483,295,EVM,mRNA,876707,905181,295,1.00
ptg017193l,1090194,1090522,328,EVM,mRNA,793667,2055088,328,1.00
ptg017193l,1137156,1137467,311,EVM,mRNA,793667,2055088,311,1.00
ptg017193l,1239991,1240269,278,EVM,mRNA,793667,2055088,278,1.00
ptg017193l,1821211,1821490,279,EVM,mRNA,793667,2055088,279,1.00
ptg017195l,283779,284068,289,EVM,mRNA,281365,841129,289,1.00
ptg017204l,1104546,1104841,295,EVM,mRNA,536612,1277432,295,1.00
ptg017206l,433085,433347,262,EVM,mRNA,355225,629778,262,1.00
ptg017218l,984037,984320,283,EVM,mRNA,980603,1006191,283,1.00
ptg017218l,1091883,1092173,290,EVM,mRNA,1040932,1189094,290,1.00
ptg017219l,357265,357575,310,EVM,mRNA,91977,557376,310,1.00
ptg017223l,417904,418192,288,EVM,mRNA,326757,567664,288,1.00
ptg017226l,822093,822406,313,EVM,mRNA,702860,952009,313,1.00
ptg017228l,13262,13581,319,EVM,mRNA,1466,707434,319,1.00
ptg017228l,209669,209934,265,EVM,mRNA,1466,707434,265,1.00
ptg017228l,554550,554837,287,EVM,mRNA,1466,707434,287,1.00
ptg017231l,461920,462224,304,EVM,mRNA,339308,472979,304,1.00
ptg017234l,1232152,1232451,299,EVM,mRNA,839652,1668069,299,1.00
ptg017234l,1446680,1446979,299,EVM,mRNA,839652,1668069,299,1.00
ptg017234l,1522283,1522579,296,EVM,mRNA,839652,1668069,296,1.00
ptg017234l,1558944,1559244,300,EVM,mRNA,839652,1668069,300,1.00
ptg017235l,658666,658956,290,EVM,mRNA,362984,806572,290,1.00
ptg017244l,352765,353076,311,EVM,mRNA,264569,1763090,311,1.00
ptg017244l,358392,358722,330,EVM,mRNA,264569,1763090,330,1.00
ptg017244l,525091,525410,319,EVM,mRNA,264569,1763090,319,1.00
ptg017244l,913916,914201,285,EVM,mRNA,264569,1763090,285,1.00
ptg017248l,832789,833069,280,EVM,mRNA,163056,914251,280,1.00
ptg017248l,871072,871392,320,EVM,mRNA,163056,914251,320,1.00
ptg017261l,914211,914529,318,EVM,mRNA,10465,1306697,318,1.00
ptg017267l,502332,502646,314,EVM,mRNA,326707,517865,314,1.00
ptg017270l,991006,991326,320,EVM,mRNA,678043,1955523,320,1.00
ptg017270l,1268577,1268899,322,EVM,mRNA,678043,1955523,322,1.00
ptg017277l,958068,958361,293,EVM,mRNA,852670,2012240,293,1.00
ptg017277l,1425537,1425816,279,EVM,mRNA,852670,2012240,279,1.00
ptg017281l,199018,199332,314,EVM,mRNA,92787,521538,314,1.00
ptg017281l,205157,205472,315,EVM,mRNA,92787,521538,315,1.00
ptg017287l,343820,344100,280,EVM,mRNA,171767,382808,280,1.00
ptg017291l,270573,270857,284,EVM,mRNA,154508,305233,284,1.00
ptg017296l,731003,731311,308,EVM,mRNA,671109,862770,308,1.00
ptg017305l,1199323,1199612,289,EVM,mRNA,778536,1592858,289,1.00
ptg017305l,1284664,1284989,325,EVM,mRNA,778536,1592858,325,1.00
ptg017311l,1297483,1297778,295,EVM,mRNA,1282324,1665362,295,1.00
ptg017319l,218668,218979,311,EVM,mRNA,59663,557127,311,1.00
ptg017322l,352750,353069,319,EVM,mRNA,322456,377796,319,1.00
ptg017324l,1835390,1835693,303,EVM,mRNA,1810448,2198662,303,1.00
ptg017325l,2174571,2174835,264,EVM,mRNA,1991381,2319718,264,1.00
ptg017325l,3464561,3464875,314,EVM,mRNA,3185545,4059875,314,1.00
ptg017325l,3939245,3939521,276,EVM,mRNA,3185545,4059875,276,1.00
ptg017325l,4057581,4057868,287,EVM,mRNA,3185545,4059875,287,1.00
ptg017333l,133358,133679,321,EVM,mRNA,44550,387956,321,1.00
ptg017333l,147473,147757,284,EVM,mRNA,44550,387956,284,1.00
ptg017333l,337544,337836,292,EVM,mRNA,44550,387956,292,1.00
ptg017358l,680030,680356,326,EVM,mRNA,510923,948911,326,1.00
ptg017364l,970870,971179,309,EVM,mRNA,329553,1786146,309,1.00
ptg017364l,1270259,1270552,293,EVM,mRNA,329553,1786146,293,1.00
ptg017364l,1644867,1645166,299,EVM,mRNA,329553,1786146,299,1.00
ptg017369l,218215,218495,280,EVM,mRNA,89259,783545,280,1.00
ptg017369l,1175381,1175666,285,EVM,mRNA,971717,1177690,285,1.00
ptg017388l,500507,500839,332,EVM,mRNA,94810,2181867,332,1.00
ptg017388l,629083,629397,314,EVM,mRNA,94810,2181867,314,1.00
ptg017388l,767098,767400,302,EVM,mRNA,94810,2181867,302,1.00
ptg017388l,1304140,1304439,299,EVM,mRNA,94810,2181867,299,1.00
ptg017392l,188891,189202,311,EVM,mRNA,27055,225359,311,1.00
ptg017392l,214794,215097,303,EVM,mRNA,27055,225359,303,1.00
ptg017399l,227630,227945,315,EVM,mRNA,198732,247437,315,1.00
ptg017427l,1522746,1523023,277,EVM,mRNA,1353216,1573333,277,1.00
ptg017433l,561047,561345,298,EVM,mRNA,421706,688130,298,1.00
ptg017434l,432680,432999,319,EVM,mRNA,78292,638547,319,1.00
ptg017434l,567591,567859,268,EVM,mRNA,78292,638547,268,1.00
ptg017437l,107618,107925,307,EVM,mRNA,8665,325536,307,1.00
ptg017439l,182142,182471,329,EVM,mRNA,28620,415522,329,1.00
ptg017441l,309560,309879,319,EVM,mRNA,75398,789487,319,1.00
ptg017442l,1342561,1342833,272,EVM,mRNA,1125788,1467584,272,1.00
ptg017454l,2287942,2288260,318,EVM,mRNA,3889,2716413,318,1.00
ptg017457l,1734038,1734282,244,EVM,mRNA,1421505,2350083,244,1.00
ptg017457l,1904599,1904851,252,EVM,mRNA,1421505,2350083,252,1.00
ptg017471l,1165180,1165461,281,EVM,mRNA,84772,1803636,281,1.00
ptg017471l,1578990,1579312,322,EVM,mRNA,84772,1803636,322,1.00
ptg017474l,613850,614177,327,EVM,mRNA,343405,2640880,327,1.00
ptg017474l,1995733,1996051,318,EVM,mRNA,343405,2640880,318,1.00
ptg017474l,2110778,2111090,312,EVM,mRNA,343405,2640880,312,1.00
ptg017474l,2210240,2210533,293,EVM,mRNA,343405,2640880,293,1.00
ptg017475l,839964,840259,295,EVM,mRNA,708841,923607,295,1.00
ptg017479l,44876,45195,319,EVM,mRNA,42916,175805,319,1.00
ptg017489l,233249,233529,280,EVM,mRNA,155394,648595,280,1.00
ptg017489l,267155,267469,314,EVM,mRNA,155394,648595,314,1.00
ptg017490l,102058,102348,290,EVM,mRNA,14849,595659,290,1.00
ptg017491l,416442,416754,312,EVM,mRNA,3545,452135,312,1.00
ptg017494l,586930,587224,294,EVM,mRNA,111145,1709733,294,1.00
ptg017494l,1356285,1356559,274,EVM,mRNA,111145,1709733,274,1.00
ptg017505l,118167,118464,297,EVM,mRNA,114906,768916,297,1.00
ptg017505l,384559,384840,281,EVM,mRNA,114906,768916,281,1.00
ptg017523l,173704,174016,312,EVM,mRNA,121519,1211347,312,1.00
ptg017523l,1028355,1028646,291,EVM,mRNA,121519,1211347,291,1.00
ptg017542l,783282,783585,303,EVM,mRNA,719547,865922,303,1.00
ptg017544l,41591,41890,299,EVM,mRNA,2520,227613,299,1.00
ptg017555l,29595,29882,287,EVM,mRNA,26993,187383,287,1.00
ptg017559l,1856904,1857184,280,EVM,mRNA,1267182,1996792,280,1.00
ptg017563l,927362,927658,296,EVM,mRNA,472407,964576,296,1.00
ptg017569l,1569745,1570068,323,EVM,mRNA,96895,4104967,323,1.00
ptg017569l,3100773,3101031,258,EVM,mRNA,96895,4104967,258,1.00
ptg017575l,272795,273079,284,EVM,mRNA,66553,525353,284,1.00
ptg017575l,416697,416984,287,EVM,mRNA,66553,525353,287,1.00
ptg017576l,747865,748167,302,EVM,mRNA,167665,1885532,302,1.00
ptg017576l,1772562,1772844,282,EVM,mRNA,167665,1885532,282,1.00
ptg017589l,334966,335276,310,EVM,mRNA,15093,487110,310,1.00
ptg017595l,831110,831409,299,EVM,mRNA,162994,1019045,299,1.00
ptg017603l,336555,336863,308,EVM,mRNA,99344,793622,308,1.00
ptg017608l,320654,320956,302,EVM,mRNA,204132,613748,302,1.00
ptg017620l,312828,313146,318,EVM,mRNA,7356,697395,318,1.00
ptg017626l,275154,275434,280,EVM,mRNA,96184,438006,280,1.00
ptg017628l,448295,448624,329,EVM,mRNA,237211,894319,329,1.00
ptg017628l,974771,975093,322,EVM,mRNA,930820,2832581,322,1.00
ptg017628l,1350878,1351183,305,EVM,mRNA,930820,2832581,305,1.00
ptg017632l,643072,643387,315,EVM,mRNA,107641,700954,315,1.00
ptg017632l,880720,881048,328,EVM,mRNA,841136,1157936,328,1.00
ptg017634l,110819,111102,283,EVM,mRNA,28270,743639,283,1.00
ptg017634l,693774,694091,317,EVM,mRNA,28270,743639,317,1.00
ptg017635l,152446,152734,288,EVM,mRNA,5450,256004,288,1.00
ptg017635l,255537,255814,277,EVM,mRNA,5450,256004,277,1.00
ptg017636l,194925,195214,289,EVM,mRNA,122080,324060,289,1.00
ptg017656l,2681,2977,296,EVM,mRNA,488,911812,296,1.00
ptg017656l,94831,95131,300,EVM,mRNA,488,911812,300,1.00
ptg017658l,347296,347619,323,EVM,mRNA,344539,535905,323,1.00
ptg017665l,368537,368812,275,EVM,mRNA,345346,388237,275,1.00
ptg017665l,677540,677836,296,EVM,mRNA,593886,861124,296,1.00
ptg017685l,388703,388989,286,EVM,mRNA,82381,470330,286,1.00
ptg017688l,182510,182795,285,EVM,mRNA,50533,557002,285,1.00
ptg017703l,419819,420117,298,EVM,mRNA,25679,1389644,298,1.00
ptg017703l,1154795,1155112,317,EVM,mRNA,25679,1389644,317,1.00
ptg017704l,484168,484482,314,EVM,mRNA,233,1017486,314,1.00
ptg017713l,913478,913788,310,EVM,mRNA,187292,943013,310,1.00
ptg017718l,118543,118868,325,EVM,mRNA,104607,329445,325,1.00
ptg017732l,298741,299035,294,EVM,mRNA,161391,320034,294,1.00
ptg017736l,313044,313323,279,EVM,mRNA,250619,402462,279,1.00
ptg017744l,157950,158196,246,EVM,mRNA,97925,368602,246,1.00
ptg017747l,20052,20364,312,EVM,mRNA,18612,156929,312,1.00
ptg017747l,122730,123018,288,EVM,mRNA,18612,156929,288,1.00
ptg017764l,693742,694060,318,EVM,mRNA,463760,707792,318,1.00
ptg017772l,219792,220112,320,EVM,mRNA,38181,245567,320,1.00
ptg017783l,2946245,2946550,305,EVM,mRNA,2423156,3617547,305,1.00
ptg017783l,3405103,3405421,318,EVM,mRNA,2423156,3617547,318,1.00
ptg017784l,375637,375946,309,EVM,mRNA,332013,1320698,309,1.00
ptg017785l,1605197,1605501,304,EVM,mRNA,935057,1745594,304,1.00
ptg017804l,466481,466783,302,EVM,mRNA,2795,1495721,302,1.00
ptg017815l,310197,310505,308,EVM,mRNA,293300,1009147,308,1.00
ptg017815l,681142,681425,283,EVM,mRNA,293300,1009147,283,1.00
ptg017815l,746274,746557,283,EVM,mRNA,293300,1009147,283,1.00
ptg017822l,81737,82050,313,EVM,mRNA,741,376333,313,1.00
ptg017825l,58271,58571,300,EVM,mRNA,653,162776,300,1.00
ptg017825l,149944,150243,299,EVM,mRNA,653,162776,299,1.00
ptg017828l,516486,516767,281,EVM,mRNA,304094,674506,281,1.00
ptg017836l,195279,195612,333,EVM,mRNA,102044,275349,333,1.00
ptg017845l,344560,344846,286,EVM,mRNA,144243,692164,286,1.00
ptg017852l,1131268,1131557,289,EVM,mRNA,545857,1448368,289,1.00
ptg017862l,470774,471054,280,EVM,mRNA,343196,541809,280,1.00
ptg017863l,255379,255697,318,EVM,mRNA,184153,416259,318,1.00
ptg017863l,274405,274732,327,EVM,mRNA,184153,416259,327,1.00
ptg017865l,2604771,2605077,306,EVM,mRNA,2560364,3239359,306,1.00
ptg017876l,119053,119382,329,EVM,mRNA,31978,239654,329,1.00
ptg017882l,1513275,1513565,290,EVM,mRNA,1404140,2300414,290,1.00
ptg017882l,2125806,2126094,288,EVM,mRNA,1404140,2300414,288,1.00
ptg017889l,923276,923593,317,EVM,mRNA,400892,1354359,317,1.00
ptg017889l,7058140,7058423,283,EVM,mRNA,6776034,7062466,283,1.00
ptg017898l,644808,645082,274,EVM,mRNA,1599,1297218,274,1.00
ptg017898l,693209,693520,311,EVM,mRNA,1599,1297218,311,1.00
ptg017908l,88264,88578,314,EVM,mRNA,72870,607747,314,1.00
ptg017908l,95908,96214,306,EVM,mRNA,72870,607747,306,1.00
ptg017912l,171848,172139,291,EVM,mRNA,47393,372686,291,1.00
ptg017917l,1117073,1117376,303,EVM,mRNA,2075,1269708,303,1.00
ptg017925l,211567,211902,335,EVM,mRNA,187347,423325,335,1.00
ptg017928l,580051,580350,299,EVM,mRNA,441732,681747,299,1.00
ptg017933l,183630,183935,305,EVM,mRNA,93701,203106,305,1.00
ptg017935l,194559,194870,311,EVM,mRNA,186452,576291,311,1.00
ptg017942l,805852,806133,281,EVM,mRNA,29849,828785,281,1.00
ptg017946l,1518397,1518696,299,EVM,mRNA,1320448,1770088,299,1.00
ptg017947l,469771,470079,308,EVM,mRNA,345973,624514,308,1.00
ptg017949l,589336,589669,333,EVM,mRNA,387768,990378,333,1.00
ptg017959l,517848,518159,311,EVM,mRNA,487584,533497,311,1.00
ptg017968l,1794319,1794637,318,EVM,mRNA,10191,2375133,318,1.00
ptg017995l,1177946,1178272,326,EVM,mRNA,721748,1260079,326,1.00
ptg018001l,694896,695216,320,EVM,mRNA,686799,797080,320,1.00
ptg018037l,644424,644746,322,EVM,mRNA,94426,674282,322,1.00
ptg018043l,106925,107212,287,EVM,mRNA,170,401551,287,1.00
ptg018044l,45293,45609,316,EVM,mRNA,32491,170826,316,1.00
ptg018059l,393355,393661,306,EVM,mRNA,117545,440359,306,1.00
ptg018060l,357402,357721,319,EVM,mRNA,317808,1370269,319,1.00
ptg018060l,661559,661833,274,EVM,mRNA,317808,1370269,274,1.00
ptg018060l,1127533,1127874,341,EVM,mRNA,317808,1370269,341,1.00
ptg018062l,155391,155689,298,EVM,mRNA,84822,395508,298,1.00
ptg018066l,230363,230689,326,EVM,mRNA,31,613153,326,1.00
ptg018072l,177329,177598,269,EVM,mRNA,174863,288927,269,1.00
ptg018076l,460833,461132,299,EVM,mRNA,169354,1206987,299,1.00
ptg018076l,880640,880941,301,EVM,mRNA,169354,1206987,301,1.00
ptg018076l,1188922,1189240,318,EVM,mRNA,169354,1206987,318,1.00
ptg018081l,503038,503337,299,EVM,mRNA,267361,510937,299,1.00
ptg018096l,1890004,1890312,308,EVM,mRNA,1224000,2502911,308,1.00
ptg018096l,2166565,2166865,300,EVM,mRNA,1224000,2502911,300,1.00
ptg018096l,2490789,2491081,292,EVM,mRNA,1224000,2502911,292,1.00
ptg018109l,540258,540551,293,EVM,mRNA,17043,629518,293,1.00
ptg018110l,73270,73546,276,EVM,mRNA,146,150258,276,1.00
ptg018124l,376431,376700,269,EVM,mRNA,49759,700889,269,1.00
ptg018125l,343646,343953,307,EVM,mRNA,11568,452797,307,1.00
ptg018129l,1408110,1408393,283,EVM,mRNA,1113914,2016778,283,1.00
ptg018133l,623987,624300,313,EVM,mRNA,63450,1291078,313,1.00
ptg018133l,909512,909789,277,EVM,mRNA,63450,1291078,277,1.00
ptg018133l,1158980,1159285,305,EVM,mRNA,63450,1291078,305,1.00
ptg018153l,594293,594589,296,EVM,mRNA,276906,747746,296,1.00
ptg018153l,695323,695622,299,EVM,mRNA,276906,747746,299,1.00
ptg018153l,706792,707095,303,EVM,mRNA,276906,747746,303,1.00
ptg018155l,209939,210231,292,EVM,mRNA,66387,235828,292,1.00
ptg018157l,711101,711387,286,EVM,mRNA,90910,1148873,286,1.00
ptg018158l,372301,372599,298,EVM,mRNA,82613,474893,298,1.00
ptg018158l,466469,466766,297,EVM,mRNA,82613,474893,297,1.00
ptg018170l,196177,196490,313,EVM,mRNA,11899,568642,313,1.00
ptg018176l,720386,720690,304,EVM,mRNA,685604,835597,304,1.00
ptg018181l,791092,791411,319,EVM,mRNA,512297,1765982,319,1.00
ptg018181l,1193441,1193715,274,EVM,mRNA,512297,1765982,274,1.00
ptg018181l,1293816,1294093,277,EVM,mRNA,512297,1765982,277,1.00
ptg018181l,1337725,1338050,325,EVM,mRNA,512297,1765982,325,1.00
ptg018191l,2049381,2049676,295,EVM,mRNA,1937134,2296618,295,1.00
ptg018192l,1621625,1621958,333,EVM,mRNA,582652,1633095,333,1.00
ptg018206l,1160475,1160791,316,EVM,mRNA,992336,1180259,316,1.00
ptg018227l,681781,682093,312,EVM,mRNA,1532,845158,312,1.00
ptg018227l,1341343,1341639,296,EVM,mRNA,967520,1494725,296,1.00
ptg018243l,429468,429774,306,EVM,mRNA,155610,513811,306,1.00
ptg018250l,586143,586430,287,EVM,mRNA,3295,725872,287,1.00
ptg018250l,618034,618327,293,EVM,mRNA,3295,725872,293,1.00
ptg018258l,81117,81429,312,EVM,mRNA,21076,1134603,312,1.00
ptg018258l,165693,165985,292,EVM,mRNA,21076,1134603,292,1.00
ptg018258l,628432,628754,322,EVM,mRNA,21076,1134603,322,1.00
ptg018270l,4225778,4226077,299,EVM,mRNA,3372632,4302649,299,1.00
ptg018275l,422930,423228,298,EVM,mRNA,193631,946852,298,1.00
ptg018275l,709361,709681,320,EVM,mRNA,193631,946852,320,1.00
ptg018275l,859617,859916,299,EVM,mRNA,193631,946852,299,1.00
ptg018285l,499600,499888,288,EVM,mRNA,361325,787809,288,1.00
ptg018291l,89734,90031,297,EVM,mRNA,29985,169370,297,1.00
ptg018291l,150346,150600,254,EVM,mRNA,29985,169370,254,1.00
ptg018293l,419258,419549,291,EVM,mRNA,258496,768934,291,1.00
ptg018293l,456944,457258,314,EVM,mRNA,258496,768934,314,1.00
ptg018320l,1036503,1036817,314,EVM,mRNA,1024213,1813341,314,1.00
ptg018324l,195915,196220,305,EVM,mRNA,106459,447590,305,1.00
ptg018324l,422601,422880,279,EVM,mRNA,106459,447590,279,1.00
ptg018324l,667371,667699,328,EVM,mRNA,554019,1694048,328,1.00
ptg018334l,297902,298195,293,EVM,mRNA,230181,642254,293,1.00
ptg018361l,250184,250485,301,EVM,mRNA,42355,618134,301,1.00
ptg018361l,484046,484323,277,EVM,mRNA,42355,618134,277,1.00
ptg018363l,1812942,1813264,322,EVM,mRNA,95618,1871607,322,1.00
ptg018364l,231678,231994,316,EVM,mRNA,89558,287922,316,1.00
ptg018373l,557582,557910,328,EVM,mRNA,307797,626816,328,1.00
ptg018376l,381099,381387,288,EVM,mRNA,38544,681532,288,1.00
ptg018385l,822274,822561,287,EVM,mRNA,331956,1198024,287,1.00
ptg018389l,879192,879485,293,EVM,mRNA,854974,989285,293,1.00
ptg018394l,146485,146801,316,EVM,mRNA,7693,151877,316,1.00
ptg018397l,185244,185548,304,EVM,mRNA,165801,424213,304,1.00
ptg018402l,225670,225979,309,EVM,mRNA,323,488773,309,1.00
ptg018405l,443707,443996,289,EVM,mRNA,301103,600953,289,1.00
ptg018411l,69596,69899,303,EVM,mRNA,34695,319674,303,1.00
ptg018414l,110546,110859,313,EVM,mRNA,55905,151610,313,1.00
ptg018427l,142118,142410,292,EVM,mRNA,916,820233,292,1.00
ptg018427l,469264,469560,296,EVM,mRNA,916,820233,296,1.00
ptg018431l,214866,215150,284,EVM,mRNA,60090,1174547,284,1.00
ptg018436l,3020161,3020471,310,EVM,mRNA,2747515,3616123,310,1.00
ptg018436l,3334325,3334643,318,EVM,mRNA,2747515,3616123,318,1.00
ptg018436l,6469352,6469669,317,EVM,mRNA,5257812,8119101,317,1.00
ptg018453l,1340795,1341109,314,EVM,mRNA,913845,1485713,314,1.00
ptg018461l,179435,179756,321,EVM,mRNA,163486,447061,321,1.00
ptg018471l,930340,930656,316,EVM,mRNA,523298,1767497,316,1.00
ptg018471l,948908,949224,316,EVM,mRNA,523298,1767497,316,1.00
ptg018471l,1283488,1283769,281,EVM,mRNA,523298,1767497,281,1.00
ptg018471l,1726187,1726496,309,EVM,mRNA,523298,1767497,309,1.00
ptg018477l,352500,352796,296,EVM,mRNA,131088,369253,296,1.00
ptg018488l,152919,153198,279,EVM,mRNA,4709,236621,279,1.00
ptg018488l,454748,454978,230,EVM,mRNA,416068,474049,230,1.00
ptg018488l,473567,473829,262,EVM,mRNA,416068,474049,262,1.00
ptg018488l,681560,681885,325,EVM,mRNA,598440,786032,325,1.00
ptg018490l,34491,34789,298,EVM,mRNA,2887,99502,298,1.00
ptg018504l,258274,258606,332,EVM,mRNA,45420,482446,332,1.00
ptg018520l,127314,127614,300,EVM,mRNA,193,2351310,300,1.00
ptg018520l,138684,138968,284,EVM,mRNA,193,2351310,284,1.00
ptg018520l,653395,653721,326,EVM,mRNA,193,2351310,326,1.00
ptg018520l,870051,870384,333,EVM,mRNA,193,2351310,333,1.00
ptg018520l,872117,872433,316,EVM,mRNA,193,2351310,316,1.00
ptg018520l,3726056,3726360,304,EVM,mRNA,3633716,4032613,304,1.00
ptg018527l,137305,137448,143,EVM,mRNA,325,952754,143,1.00
ptg018527l,231856,232142,286,EVM,mRNA,325,952754,286,1.00
ptg018529l,124027,124326,299,EVM,mRNA,25808,152217,299,1.00
ptg018541l,449432,449751,319,EVM,mRNA,87914,564860,319,1.00
ptg018559l,1102098,1102384,286,EVM,mRNA,1063052,1305155,286,1.00
ptg018560l,401826,402116,290,EVM,mRNA,156347,604805,290,1.00
ptg018560l,407121,407422,301,EVM,mRNA,156347,604805,301,1.00
ptg018565l,1398972,1399257,285,EVM,mRNA,1279170,1430908,285,1.00
ptg018571l,528409,528726,317,EVM,mRNA,239425,954079,317,1.00
ptg018576l,240439,240721,282,EVM,mRNA,32744,1381819,282,1.00
ptg018580l,474051,474371,320,EVM,mRNA,89568,1634575,320,1.00
ptg018580l,1187020,1187347,327,EVM,mRNA,89568,1634575,327,1.00
ptg018580l,2312499,2312803,304,EVM,mRNA,2083718,2609908,304,1.00
ptg018580l,2528213,2528508,295,EVM,mRNA,2083718,2609908,295,1.00
ptg018580l,2685742,2686045,303,EVM,mRNA,2666953,2985033,303,1.00
ptg018581l,382948,383218,270,EVM,mRNA,121925,465115,270,1.00
ptg018585l,97794,98107,313,EVM,mRNA,97801,354488,307,0.98
ptg018590l,258480,258776,296,EVM,mRNA,117,1016409,296,1.00
ptg018592l,33862,34145,283,EVM,mRNA,39,52531,283,1.00
ptg018592l,484973,485276,303,EVM,mRNA,310777,495444,303,1.00
ptg018600l,326584,326897,313,EVM,mRNA,191649,402900,313,1.00
ptg018601l,84517,84847,330,EVM,mRNA,36795,205220,330,1.00
ptg018601l,84978,85263,285,EVM,mRNA,36795,205220,285,1.00
ptg018616l,129482,129792,310,EVM,mRNA,91182,181770,310,1.00
ptg018620l,225980,226262,282,EVM,mRNA,187580,287947,282,1.00
ptg018631l,854760,855062,302,EVM,mRNA,623440,932532,302,1.00
ptg018632l,763106,763400,294,EVM,mRNA,90070,1651511,294,1.00
ptg018648l,709087,709342,255,EVM,mRNA,465862,830588,255,1.00
ptg018652l,240709,240997,288,EVM,mRNA,147617,738738,288,1.00
ptg018653l,246349,246658,309,EVM,mRNA,192695,253331,309,1.00
ptg018655l,675629,675933,304,EVM,mRNA,3289,900024,304,1.00
ptg018665l,1718734,1719027,293,EVM,mRNA,402103,2235467,293,1.00
ptg018665l,2038140,2038450,310,EVM,mRNA,402103,2235467,310,1.00
ptg018665l,2086437,2086731,294,EVM,mRNA,402103,2235467,294,1.00
ptg018670l,563996,564296,300,EVM,mRNA,430394,790070,300,1.00
ptg018674l,1914001,1914305,304,EVM,mRNA,1752095,1918384,304,1.00
ptg018674l,2058879,2059197,318,EVM,mRNA,1955386,2108610,318,1.00
ptg018676l,1771304,1771593,289,EVM,mRNA,1151109,1776858,289,1.00
ptg018686l,250468,250757,289,EVM,mRNA,18566,878967,289,1.00
ptg018689l,489601,489900,299,EVM,mRNA,347899,910869,299,1.00
ptg018696l,203743,204074,331,EVM,mRNA,196268,539933,331,1.00
ptg018696l,245845,246129,284,EVM,mRNA,196268,539933,284,1.00
ptg018715l,59810,60097,287,EVM,mRNA,157,293364,287,1.00
ptg018736l,597646,597952,306,EVM,mRNA,528493,1013771,306,1.00
ptg018742l,629333,629633,300,EVM,mRNA,578799,839167,300,1.00
ptg018750l,139303,139600,297,EVM,mRNA,9191,385474,297,1.00
ptg018760l,295755,296022,267,EVM,mRNA,69643,626079,267,1.00
ptg018761l,261660,261951,291,EVM,mRNA,2278,459060,291,1.00
ptg018769l,214863,215163,300,EVM,mRNA,168514,695155,300,1.00
ptg018769l,452417,452716,299,EVM,mRNA,168514,695155,299,1.00
ptg018773l,53969,54249,280,EVM,mRNA,26690,247558,280,1.00
ptg018777l,252435,252728,293,EVM,mRNA,37284,860455,293,1.00
ptg018798l,178643,178916,273,EVM,mRNA,176612,850298,273,1.00
ptg018798l,762878,763160,282,EVM,mRNA,176612,850298,282,1.00
ptg018799l,155784,156058,274,EVM,mRNA,11852,242124,274,1.00
ptg018813l,605062,605372,310,EVM,mRNA,2008,949253,310,1.00
ptg018816l,1586345,1586646,301,EVM,mRNA,209817,1747703,301,1.00
ptg018820l,196620,196941,321,EVM,mRNA,1830,506436,321,1.00
ptg018828l,283629,283954,325,EVM,mRNA,1116,733818,325,1.00
ptg018847l,160248,160527,279,EVM,mRNA,39449,671092,279,1.00
ptg018850l,440948,441272,324,EVM,mRNA,269202,1070237,324,1.00
ptg018850l,585657,585966,309,EVM,mRNA,269202,1070237,309,1.00
ptg018853l,1073284,1073585,301,EVM,mRNA,477595,1489555,301,1.00
ptg018853l,1205095,1205368,273,EVM,mRNA,477595,1489555,273,1.00
ptg018857l,807500,807807,307,EVM,mRNA,155936,1667434,307,1.00
ptg018857l,1109833,1110157,324,EVM,mRNA,155936,1667434,324,1.00
ptg018857l,1583538,1583863,325,EVM,mRNA,155936,1667434,325,1.00
ptg018859l,196465,196749,284,EVM,mRNA,166123,251246,284,1.00
ptg018859l,226247,226531,284,EVM,mRNA,166123,251246,284,1.00
ptg018870l,118897,119207,310,EVM,mRNA,54503,122990,310,1.00
ptg018872l,69313,69610,297,EVM,mRNA,55009,172513,297,1.00
ptg018872l,1348317,1348608,291,EVM,mRNA,1200424,1688729,291,1.00
ptg018878l,441695,442000,305,EVM,mRNA,301776,484092,305,1.00
ptg018891l,306794,307110,316,EVM,mRNA,272821,414192,316,1.00
ptg018891l,410174,410487,313,EVM,mRNA,272821,414192,313,1.00
ptg018891l,1095685,1096017,332,EVM,mRNA,1053880,1934654,332,1.00
ptg018891l,1717469,1717766,297,EVM,mRNA,1053880,1934654,297,1.00
ptg018891l,4202284,4202598,314,EVM,mRNA,4183401,4687359,314,1.00
ptg018891l,4418832,4419136,304,EVM,mRNA,4183401,4687359,304,1.00
ptg018891l,6230454,6230749,295,EVM,mRNA,6077330,6616880,295,1.00
ptg018904l,880980,881240,260,EVM,mRNA,791938,2385843,260,1.00
ptg018904l,1005260,1005566,306,EVM,mRNA,791938,2385843,306,1.00
ptg018904l,2385434,2385719,285,EVM,mRNA,791938,2385843,285,1.00
ptg018913l,882886,883213,327,EVM,mRNA,873897,1108253,327,1.00
ptg018926l,460561,460886,325,EVM,mRNA,460509,557059,325,1.00
ptg018931l,207204,207481,277,EVM,mRNA,194655,649290,277,1.00
ptg018931l,1238560,1238881,321,EVM,mRNA,1075178,1852168,321,1.00
ptg018935l,181668,181956,288,EVM,mRNA,144299,276464,288,1.00
ptg018939l,379819,380104,285,EVM,mRNA,190172,442855,285,1.00
ptg018941l,979529,979796,267,EVM,mRNA,955243,988627,267,1.00
ptg018982l,157402,157689,287,EVM,mRNA,17311,543520,287,1.00
ptg018982l,174236,174536,300,EVM,mRNA,17311,543520,300,1.00
ptg018982l,540910,541228,318,EVM,mRNA,17311,543520,318,1.00
ptg018990l,439169,439454,285,EVM,mRNA,436928,474984,285,1.00
ptg018990l,461446,461764,318,EVM,mRNA,436928,474984,318,1.00
ptg018991l,640677,641008,331,EVM,mRNA,583015,801168,331,1.00
ptg018994l,54153,54452,299,EVM,mRNA,24197,1031628,299,1.00
ptg018994l,307305,307612,307,EVM,mRNA,24197,1031628,307,1.00
ptg019006l,81977,82261,284,EVM,mRNA,14916,265350,284,1.00
ptg019023l,324493,324774,281,EVM,mRNA,295429,487706,281,1.00
ptg019042l,258681,258982,301,EVM,mRNA,236802,792956,301,1.00
ptg019042l,608965,609286,321,EVM,mRNA,236802,792956,321,1.00
ptg019043l,736316,736618,302,EVM,mRNA,530117,800719,302,1.00
ptg019050l,514418,514727,309,EVM,mRNA,116227,569594,309,1.00
ptg019060l,319103,319401,298,EVM,mRNA,2055,816489,298,1.00
ptg019066l,1380499,1380774,275,EVM,mRNA,126512,1582394,275,1.00
ptg019069l,968635,968934,299,EVM,mRNA,826639,1680048,299,1.00
ptg019069l,1183134,1183423,289,EVM,mRNA,826639,1680048,289,1.00
ptg019070l,399109,399407,298,EVM,mRNA,352203,581432,298,1.00
ptg019090l,304182,304480,298,EVM,mRNA,1714,450457,298,1.00
ptg019090l,375087,375385,298,EVM,mRNA,1714,450457,298,1.00
ptg019101l,93221,93548,327,EVM,mRNA,71,350672,327,1.00
ptg019101l,461730,462024,294,EVM,mRNA,456626,539226,294,1.00
ptg019101l,735728,736029,301,EVM,mRNA,690301,1340763,301,1.00
ptg019101l,1682272,1682582,310,EVM,mRNA,1643575,1989030,310,1.00
ptg019111l,1544366,1544683,317,EVM,mRNA,1501380,1601889,317,1.00
ptg019112l,813784,814062,278,EVM,mRNA,335335,873053,278,1.00
ptg019120l,321505,321787,282,EVM,mRNA,142627,379541,282,1.00
ptg019120l,343065,343378,313,EVM,mRNA,142627,379541,313,1.00
ptg019143l,149107,149423,316,EVM,mRNA,27892,206286,316,1.00
ptg019180l,574735,575023,288,EVM,mRNA,478897,1057797,288,1.00
ptg019180l,726894,727204,310,EVM,mRNA,478897,1057797,310,1.00
ptg019180l,1726997,1727295,298,EVM,mRNA,1347554,2532936,298,1.00
ptg019197l,927154,927473,319,EVM,mRNA,173259,1528316,319,1.00
ptg019198l,330182,330509,327,EVM,mRNA,309026,474139,327,1.00
ptg019211l,172414,172733,319,EVM,mRNA,7029,651349,319,1.00
ptg019211l,1530183,1530471,288,EVM,mRNA,1212915,2171749,288,1.00
ptg019214l,1086863,1087144,281,EVM,mRNA,1048204,1303035,281,1.00
ptg019216l,74326,74621,295,EVM,mRNA,11161,238521,295,1.00
ptg019221l,265171,265451,280,EVM,mRNA,128383,325703,280,1.00
ptg019258l,194083,194385,302,EVM,mRNA,122915,353278,302,1.00
ptg019263l,1012654,1012954,300,EVM,mRNA,701619,1558744,300,1.00
ptg019265l,763172,763455,283,EVM,mRNA,596155,842570,283,1.00
ptg019271l,147842,148163,321,EVM,mRNA,3969,181318,321,1.00
ptg019271l,498423,498715,292,EVM,mRNA,187844,1308858,292,1.00
ptg019277l,1202166,1202450,284,EVM,mRNA,1155633,1652067,284,1.00
ptg019277l,1644514,1644795,281,EVM,mRNA,1155633,1652067,281,1.00
ptg019286l,516371,516632,261,EVM,mRNA,118471,689161,261,1.00
ptg019288l,2237107,2237406,299,EVM,mRNA,1524727,2317597,299,1.00
ptg019294l,730751,731076,325,EVM,mRNA,346078,1015346,325,1.00
ptg019303l,223477,223776,299,EVM,mRNA,203919,282994,299,1.00
ptg019303l,958613,958895,282,EVM,mRNA,741673,1022070,282,1.00
ptg019303l,970895,971177,282,EVM,mRNA,741673,1022070,282,1.00
ptg019306l,1198311,1198615,304,EVM,mRNA,1195192,1280513,304,1.00
ptg019310l,286697,287013,316,EVM,mRNA,86787,370888,316,1.00
ptg019316l,409520,409828,308,EVM,mRNA,254959,1336489,308,1.00
ptg019316l,908528,908854,326,EVM,mRNA,254959,1336489,326,1.00
ptg019316l,1140883,1141178,295,EVM,mRNA,254959,1336489,295,1.00
ptg019321l,44087,44401,314,EVM,mRNA,28165,112849,314,1.00
ptg019321l,532725,533021,296,EVM,mRNA,527800,1010731,296,1.00
ptg019335l,125560,125878,318,EVM,mRNA,119462,133961,318,1.00
ptg019347l,213778,214064,286,EVM,mRNA,6744,554540,286,1.00
ptg019347l,474311,474610,299,EVM,mRNA,6744,554540,299,1.00
ptg019354l,523493,523809,316,EVM,mRNA,1427,1191855,316,1.00
ptg019388l,326316,326633,317,EVM,mRNA,472,608496,317,1.00
ptg019388l,792581,792887,306,EVM,mRNA,711319,814254,306,1.00
ptg019423l,347358,347660,302,EVM,mRNA,46667,521305,302,1.00
ptg019429l,282767,283074,307,EVM,mRNA,204649,305505,307,1.00
ptg019434l,328469,328744,275,EVM,mRNA,179977,661953,275,1.00
ptg019440l,254285,254589,304,EVM,mRNA,148891,614408,304,1.00
ptg019441l,31750,32070,320,EVM,mRNA,22200,87274,320,1.00
ptg019443l,293797,294075,278,EVM,mRNA,250311,325074,278,1.00
ptg019444l,2606500,2606800,300,EVM,mRNA,297605,3533115,300,1.00
ptg019451l,133824,134148,324,EVM,mRNA,14803,371801,324,1.00
ptg019451l,311210,311522,312,EVM,mRNA,14803,371801,312,1.00
ptg019455l,24338,24639,301,EVM,mRNA,16654,250543,301,1.00
ptg019455l,104372,104669,297,EVM,mRNA,16654,250543,297,1.00
ptg019459l,9059,9356,297,EVM,mRNA,1454,269572,297,1.00
ptg019459l,540913,541232,319,EVM,mRNA,407842,1095918,319,1.00
ptg019465l,1701705,1702048,343,EVM,mRNA,1684730,1893197,343,1.00
ptg019483l,161394,161716,322,EVM,mRNA,76431,1214396,322,1.00
ptg019483l,443678,443977,299,EVM,mRNA,76431,1214396,299,1.00
ptg019483l,649657,649949,292,EVM,mRNA,76431,1214396,292,1.00
ptg019483l,1396582,1396882,300,EVM,mRNA,1349243,1874011,300,1.00
ptg019483l,1664679,1664978,299,EVM,mRNA,1349243,1874011,299,1.00
ptg019491l,245018,245329,311,EVM,mRNA,213813,337399,311,1.00
ptg019492l,191923,192194,271,EVM,mRNA,108843,268027,271,1.00
ptg019493l,706485,706790,305,EVM,mRNA,496121,978400,305,1.00
ptg019495l,227975,228257,282,EVM,mRNA,139131,659518,282,1.00
ptg019495l,443314,443612,298,EVM,mRNA,139131,659518,298,1.00
ptg019495l,554428,554717,289,EVM,mRNA,139131,659518,289,1.00
ptg019507l,1145486,1145754,268,EVM,mRNA,1145706,1146755,49,0.18
ptg019516l,615953,616253,300,EVM,mRNA,48605,880931,300,1.00
ptg019525l,571927,572243,316,EVM,mRNA,537232,608851,316,1.00
ptg019533l,154857,155183,326,EVM,mRNA,8436,248847,326,1.00
ptg019574l,142636,142919,283,EVM,mRNA,135224,521599,283,1.00
ptg019581l,721153,721471,318,EVM,mRNA,603245,859930,318,1.00
ptg019581l,1708184,1708473,289,EVM,mRNA,1191312,2562907,289,1.00
ptg019584l,655650,655951,301,EVM,mRNA,646982,777773,301,1.00
ptg019588l,892437,892736,299,EVM,mRNA,672327,963053,299,1.00
ptg019621l,1781923,1782240,317,EVM,mRNA,1432280,1914397,317,1.00
ptg019654l,199099,199374,275,EVM,mRNA,55649,386446,275,1.00
ptg019665l,385995,386305,310,EVM,mRNA,313568,457725,310,1.00
ptg019665l,768596,768902,306,EVM,mRNA,460961,930751,306,1.00
ptg019669l,533003,533292,289,EVM,mRNA,198280,559597,289,1.00
ptg019671l,249674,249962,288,EVM,mRNA,40682,711180,288,1.00
ptg019672l,199249,199551,302,EVM,mRNA,130291,500484,302,1.00
ptg019681l,396317,396626,309,EVM,mRNA,382260,724786,309,1.00
ptg019686l,525371,525647,276,EVM,mRNA,46581,596321,276,1.00
ptg019686l,632852,633145,293,EVM,mRNA,598503,735820,293,1.00
ptg019691l,573449,573728,279,EVM,mRNA,98290,1238292,279,1.00
ptg019691l,944450,944715,265,EVM,mRNA,98290,1238292,265,1.00
ptg019693l,221508,221822,314,EVM,mRNA,103491,261686,314,1.00
ptg019702l,1497744,1498052,308,EVM,mRNA,652608,1682187,308,1.00
ptg019702l,1519175,1519493,318,EVM,mRNA,652608,1682187,318,1.00
ptg019703l,96150,96463,313,EVM,mRNA,72262,182557,313,1.00
ptg019719l,199745,200077,332,EVM,mRNA,29499,248079,332,1.00
ptg019741l,205253,205559,306,EVM,mRNA,15119,237756,306,1.00
ptg019742l,405007,405300,293,EVM,mRNA,21592,580754,293,1.00
ptg019761l,157941,158213,272,EVM,mRNA,56712,257581,272,1.00
ptg019767l,333768,334031,263,EVM,mRNA,16648,415906,263,1.00
ptg019788l,271227,271544,317,EVM,mRNA,78342,348724,317,1.00
ptg019788l,853558,853856,298,EVM,mRNA,789487,1066445,298,1.00
ptg019790l,365034,365345,311,EVM,mRNA,75982,391177,311,1.00
ptg019802l,432408,432736,328,EVM,mRNA,428413,504012,328,1.00
ptg019810l,1462771,1463101,330,EVM,mRNA,1461550,1581326,330,1.00
ptg019810l,1497244,1497563,319,EVM,mRNA,1461550,1581326,319,1.00
ptg019820l,271228,271531,303,EVM,mRNA,188477,562719,303,1.00
ptg019831l,637199,637501,302,EVM,mRNA,455243,976564,302,1.00
ptg019852l,397119,397421,302,EVM,mRNA,214525,878802,302,1.00
ptg019854l,760577,760884,307,EVM,mRNA,314152,791616,307,1.00
ptg019865l,173337,173612,275,EVM,mRNA,80907,396365,275,1.00
ptg019865l,666348,666646,298,EVM,mRNA,483359,773774,298,1.00
ptg019879l,406433,406732,299,EVM,mRNA,91128,1218682,299,1.00
ptg019879l,467602,467901,299,EVM,mRNA,91128,1218682,299,1.00
ptg019885l,143010,143338,328,EVM,mRNA,59268,641683,328,1.00
ptg019885l,459529,459841,312,EVM,mRNA,59268,641683,312,1.00
ptg019900l,293536,293855,319,EVM,mRNA,63814,1087821,319,1.00
ptg019900l,756708,757015,307,EVM,mRNA,63814,1087821,307,1.00
ptg019900l,1016653,1016974,321,EVM,mRNA,63814,1087821,321,1.00
ptg019902l,177163,177438,275,EVM,mRNA,83666,615163,275,1.00
ptg019908l,257905,258200,295,EVM,mRNA,209967,278949,295,1.00
ptg019911l,66155,66297,142,EVM,mRNA,47386,262819,142,1.00
ptg019911l,161779,162066,287,EVM,mRNA,47386,262819,287,1.00
ptg019927l,300632,300941,309,EVM,mRNA,116522,474389,309,1.00
ptg019935l,36512,36840,328,EVM,mRNA,9610,342543,328,1.00
ptg019962l,3415808,3416088,280,EVM,mRNA,3087421,3496141,280,1.00
ptg019962l,4137199,4137480,281,EVM,mRNA,4009950,4264034,281,1.00
ptg019972l,356442,356759,317,EVM,mRNA,245189,406352,317,1.00
ptg019983l,334705,335016,311,EVM,mRNA,280416,343478,311,1.00
ptg019992l,865035,865337,302,EVM,mRNA,823437,1032083,302,1.00
ptg020000l,481432,481716,284,EVM,mRNA,27800,1057702,284,1.00
ptg020000l,849000,849318,318,EVM,mRNA,27800,1057702,318,1.00
ptg020006l,208905,209210,305,EVM,mRNA,12087,1087724,305,1.00
ptg020010l,34967,35270,303,EVM,mRNA,34824,271316,303,1.00
ptg020010l,48167,48460,293,EVM,mRNA,34824,271316,293,1.00
ptg020024l,354117,354383,266,EVM,mRNA,290139,443242,266,1.00
ptg020053l,258573,258892,319,EVM,mRNA,9603,443675,319,1.00
ptg020078l,958130,958411,281,EVM,mRNA,503523,1020421,281,1.00
ptg020092l,781896,782217,321,EVM,mRNA,741865,1019438,321,1.00
ptg020116l,543085,543353,268,EVM,mRNA,365873,618731,268,1.00
ptg020123l,1028334,1028614,280,EVM,mRNA,190391,1117861,280,1.00
ptg020165l,700498,700828,330,EVM,mRNA,662381,864260,330,1.00
ptg020168l,597490,597786,296,EVM,mRNA,498895,1050261,296,1.00
ptg020168l,726019,726314,295,EVM,mRNA,498895,1050261,295,1.00
ptg020171l,227039,227346,307,EVM,mRNA,2862,919406,307,1.00
ptg020171l,864304,864609,305,EVM,mRNA,2862,919406,305,1.00
ptg020180l,782779,783059,280,EVM,mRNA,238490,1363446,280,1.00
ptg020180l,1317330,1317629,299,EVM,mRNA,238490,1363446,299,1.00
ptg020187l,1137016,1137333,317,EVM,mRNA,1084645,1382269,317,1.00
ptg020198l,860308,860637,329,EVM,mRNA,766770,870618,329,1.00
ptg020208l,56308,56596,288,EVM,mRNA,26124,283376,288,1.00
ptg020208l,261611,261889,278,EVM,mRNA,26124,283376,278,1.00
ptg020208l,261611,261889,278,GeMoMa,mRNA,206574,400506,278,1.00
ptg020217l,415774,416102,328,EVM,mRNA,321457,553674,328,1.00
ptg020224l,77036,77352,316,EVM,mRNA,28894,309474,316,1.00
ptg020224l,301528,301842,314,EVM,mRNA,28894,309474,314,1.00
ptg020227l,424599,424915,316,EVM,mRNA,402494,553583,316,1.00
ptg020240l,231155,231479,324,EVM,mRNA,23573,436564,324,1.00
ptg020243l,140327,140637,310,EVM,mRNA,1873,730836,310,1.00
ptg020254l,354736,355056,320,EVM,mRNA,310534,832511,320,1.00
ptg020254l,662129,662434,305,EVM,mRNA,310534,832511,305,1.00
ptg020261l,798824,799153,329,EVM,mRNA,691407,888747,329,1.00
ptg020266l,203464,203789,325,EVM,mRNA,34762,377992,325,1.00
ptg020270l,92562,92851,289,EVM,mRNA,19382,105711,289,1.00
ptg020277l,174199,174515,316,EVM,mRNA,17933,462073,316,1.00
ptg020286l,527627,527950,323,EVM,mRNA,505270,2140930,323,1.00
ptg020286l,1115710,1116023,313,EVM,mRNA,505270,2140930,313,1.00
ptg020286l,1949265,1949565,300,EVM,mRNA,505270,2140930,300,1.00
ptg020289l,397631,397976,345,EVM,mRNA,69666,754068,345,1.00
ptg020289l,460641,460922,281,EVM,mRNA,69666,754068,281,1.00
ptg020307l,264569,264900,331,EVM,mRNA,108072,334931,331,1.00
ptg020307l,330762,331080,318,EVM,mRNA,108072,334931,318,1.00
ptg020320l,194984,195306,322,EVM,mRNA,188145,356980,322,1.00
ptg020343l,838005,838295,290,EVM,mRNA,546021,908869,290,1.00
ptg020350l,382023,382309,286,EVM,mRNA,40517,836964,286,1.00
ptg020350l,382340,382648,308,EVM,mRNA,40517,836964,308,1.00
ptg020350l,383694,383996,302,EVM,mRNA,40517,836964,302,1.00
ptg020350l,384368,384661,293,EVM,mRNA,40517,836964,293,1.00
ptg020350l,519267,519553,286,EVM,mRNA,40517,836964,286,1.00
ptg020378l,492555,492841,286,EVM,mRNA,419545,1043902,286,1.00
ptg020388l,100080,100381,301,EVM,mRNA,77050,288907,301,1.00
ptg020391l,412413,412733,320,EVM,mRNA,46078,418837,320,1.00
ptg020397l,579292,579590,298,EVM,mRNA,345927,664176,298,1.00
ptg020435l,1338328,1338615,287,EVM,mRNA,966272,3131752,287,1.00
ptg020435l,2154995,2155302,307,EVM,mRNA,966272,3131752,307,1.00
ptg020441l,2312992,2313276,284,EVM,mRNA,2274128,2630426,284,1.00
ptg020447l,41634,41961,327,EVM,mRNA,10137,649243,327,1.00
ptg020471l,2443511,2443811,300,EVM,mRNA,1851757,2756622,300,1.00
ptg020471l,4768261,4768582,321,EVM,mRNA,4176934,5168086,321,1.00
ptg020471l,4783686,4784005,319,EVM,mRNA,4176934,5168086,319,1.00
ptg020471l,4970841,4971168,327,EVM,mRNA,4176934,5168086,327,1.00
ptg020485l,154201,154526,325,EVM,mRNA,71050,160365,325,1.00
ptg020485l,903410,903730,320,EVM,mRNA,807479,1014462,320,1.00
ptg020492l,267809,268124,315,EVM,mRNA,18489,850831,315,1.00
ptg020495l,385306,385622,316,EVM,mRNA,147284,395081,316,1.00
ptg020501l,308206,308534,328,EVM,mRNA,98867,567227,328,1.00
ptg020511l,97767,98082,315,EVM,mRNA,24348,566669,315,1.00
ptg020535l,387045,387330,285,EVM,mRNA,269602,1440368,285,1.00
ptg020543l,1119501,1119809,308,EVM,mRNA,1114001,2071691,308,1.00
ptg020543l,1130773,1131081,308,EVM,mRNA,1114001,2071691,308,1.00
ptg020543l,1702565,1702858,293,EVM,mRNA,1114001,2071691,293,1.00
ptg020543l,1745890,1746218,328,EVM,mRNA,1114001,2071691,328,1.00
ptg020548l,204662,204921,259,EVM,mRNA,194190,288622,259,1.00
ptg020548l,438630,438949,319,EVM,mRNA,381649,441507,319,1.00
ptg020549l,102256,102571,315,EVM,mRNA,60762,112655,315,1.00
ptg020560l,238296,238574,278,EVM,mRNA,212949,425650,278,1.00
ptg020560l,280341,280621,280,EVM,mRNA,212949,425650,280,1.00
ptg020560l,420523,420832,309,EVM,mRNA,212949,425650,309,1.00
ptg020568l,28699,29012,313,EVM,mRNA,14517,36177,313,1.00
ptg020569l,25698,25994,296,EVM,mRNA,19239,745076,296,1.00
ptg020569l,233093,233393,300,EVM,mRNA,19239,745076,300,1.00
ptg020569l,937620,937940,320,EVM,mRNA,819715,1116270,320,1.00
ptg020569l,954522,954819,297,EVM,mRNA,819715,1116270,297,1.00
ptg020570l,305797,306105,308,EVM,mRNA,275169,365125,308,1.00
ptg020571l,919979,920304,325,EVM,mRNA,68934,1535510,325,1.00
ptg020573l,145168,145446,278,EVM,mRNA,74051,214295,278,1.00
ptg020579l,4626036,4626329,293,EVM,mRNA,3176556,5951408,293,1.00
ptg020579l,4701943,4702241,298,EVM,mRNA,3176556,5951408,298,1.00
ptg020588l,265986,266286,300,EVM,mRNA,194434,390247,300,1.00
ptg020595l,8508,8820,312,EVM,mRNA,1160,58776,312,1.00
ptg020605l,238995,239313,318,EVM,mRNA,49884,252830,318,1.00
ptg020622l,514245,514534,289,EVM,mRNA,506210,814455,289,1.00
ptg020624l,440994,441274,280,EVM,mRNA,510,850876,280,1.00
ptg020642l,84660,84975,315,EVM,mRNA,25818,120728,315,1.00
ptg020652l,561864,562162,298,EVM,mRNA,111709,830875,298,1.00
ptg020652l,727127,727420,293,EVM,mRNA,111709,830875,293,1.00
ptg020686l,132392,132719,327,EVM,mRNA,39123,458007,327,1.00
ptg020686l,338834,339121,287,EVM,mRNA,39123,458007,287,1.00
ptg020702l,130561,130847,286,EVM,mRNA,4214,370151,286,1.00
ptg020702l,149205,149484,279,EVM,mRNA,4214,370151,279,1.00
ptg020706l,618234,618551,317,EVM,mRNA,191984,1398579,317,1.00
ptg020706l,750391,750712,321,EVM,mRNA,191984,1398579,321,1.00
ptg020715l,570211,570525,314,EVM,mRNA,111446,658534,314,1.00
ptg020742l,194457,194771,314,EVM,mRNA,18021,601955,314,1.00
ptg020742l,471579,471869,290,EVM,mRNA,18021,601955,290,1.00
ptg020748l,249424,249725,301,EVM,mRNA,42471,442492,301,1.00
ptg020748l,262149,262429,280,EVM,mRNA,42471,442492,280,1.00
ptg020748l,436729,437045,316,EVM,mRNA,42471,442492,316,1.00
ptg020757l,91442,91723,281,EVM,mRNA,12852,145511,281,1.00
ptg020802l,881165,881477,312,EVM,mRNA,62487,1258427,312,1.00
ptg020802l,1451671,1451971,300,EVM,mRNA,1382854,1569117,300,1.00
ptg020808l,489515,489833,318,EVM,mRNA,448428,547258,318,1.00
ptg020819l,142545,142831,286,EVM,mRNA,13295,424740,286,1.00
ptg020825l,129970,130267,297,EVM,mRNA,30670,259337,297,1.00
ptg020830l,653635,653951,316,EVM,mRNA,631174,656920,316,1.00
ptg020834l,161314,161612,298,EVM,mRNA,102538,198204,298,1.00
ptg020842l,366301,366607,306,EVM,mRNA,186982,902907,306,1.00
ptg020842l,621490,621822,332,EVM,mRNA,186982,902907,332,1.00
ptg020846l,1038335,1038626,291,EVM,mRNA,449263,1535207,291,1.00
ptg020864l,210535,210838,303,EVM,mRNA,194094,429597,303,1.00
ptg020883l,354724,355008,284,EVM,mRNA,37707,674254,284,1.00
ptg020899l,332615,332922,307,EVM,mRNA,144412,558663,307,1.00
ptg020900l,488681,488984,303,EVM,mRNA,381577,747623,303,1.00
ptg020901l,51088,51387,299,EVM,mRNA,42558,101033,299,1.00
ptg020908l,189234,189515,281,EVM,mRNA,30735,267259,281,1.00
ptg020908l,786214,786530,316,EVM,mRNA,468761,924708,316,1.00
ptg020929l,263089,263388,299,EVM,mRNA,97289,410531,299,1.00
ptg020968l,900707,900992,285,EVM,mRNA,815246,901940,285,1.00
ptg020972l,2706419,2706727,308,EVM,mRNA,1936879,2793181,308,1.00
ptg020972l,2711761,2712084,323,EVM,mRNA,1936879,2793181,323,1.00
ptg020984l,193996,194319,323,EVM,mRNA,183937,691478,323,1.00
ptg020984l,330518,330814,296,EVM,mRNA,183937,691478,296,1.00
ptg020996l,152270,152567,297,EVM,mRNA,76544,154951,297,1.00
ptg020997l,672321,672615,294,EVM,mRNA,278424,930381,294,1.00
ptg021017l,326621,326925,304,EVM,mRNA,94914,912199,304,1.00
ptg021017l,498386,498710,324,EVM,mRNA,94914,912199,324,1.00
ptg021026l,872695,872992,297,EVM,mRNA,662721,945828,297,1.00
ptg021031l,440126,440425,299,EVM,mRNA,379735,562779,299,1.00
ptg021037l,593409,593729,320,EVM,mRNA,11318,697244,320,1.00
ptg021038l,725532,725840,308,EVM,mRNA,660231,753713,308,1.00
ptg021038l,726262,726592,330,EVM,mRNA,660231,753713,330,1.00
ptg021042l,133543,133837,294,EVM,mRNA,43269,189257,294,1.00
ptg021042l,422640,422964,324,EVM,mRNA,359755,537197,324,1.00
ptg021052l,68641,68963,322,EVM,mRNA,36022,74263,322,1.00
ptg021064l,1118950,1119230,280,EVM,mRNA,402557,1332107,280,1.00
ptg021074l,502725,503054,329,EVM,mRNA,431939,628807,329,1.00
ptg021074l,543981,544284,303,EVM,mRNA,431939,628807,303,1.00
ptg021078l,247656,247980,324,EVM,mRNA,76226,646746,324,1.00
ptg021083l,309709,310015,306,EVM,mRNA,217835,445512,306,1.00
ptg021091l,1374322,1374621,299,EVM,mRNA,1316146,1601897,299,1.00
ptg021091l,2356064,2356363,299,EVM,mRNA,2162906,2366070,299,1.00
ptg021105l,449895,450197,302,EVM,mRNA,57516,512997,302,1.00
ptg021107l,127586,127891,305,EVM,mRNA,55457,270203,305,1.00
ptg021127l,333056,333341,285,EVM,mRNA,38440,412106,285,1.00
ptg021128l,122690,123018,328,EVM,mRNA,206,215784,328,1.00
ptg021128l,205807,206124,317,EVM,mRNA,206,215784,317,1.00
ptg021128l,493427,493713,286,EVM,mRNA,492238,507723,286,1.00
ptg021167l,499141,499436,295,EVM,mRNA,269363,884536,295,1.00
ptg021182l,406373,406696,323,EVM,mRNA,34685,745406,323,1.00
ptg021197l,581883,582181,298,EVM,mRNA,440131,812398,298,1.00
ptg021197l,657954,658266,312,EVM,mRNA,440131,812398,312,1.00
ptg021198l,222823,223162,339,EVM,mRNA,68,925989,339,1.00
ptg021202l,828467,828758,291,EVM,mRNA,394412,1292204,291,1.00
ptg021202l,1196816,1197121,305,EVM,mRNA,394412,1292204,305,1.00
ptg021211l,508152,508469,317,EVM,mRNA,490852,643656,317,1.00
ptg021214l,515422,515703,281,EVM,mRNA,28999,1036260,281,1.00
ptg021222l,241602,241893,291,EVM,mRNA,193062,354017,291,1.00
ptg021229l,678129,678448,319,EVM,mRNA,653067,1430325,319,1.00
ptg021229l,780632,780926,294,EVM,mRNA,653067,1430325,294,1.00
ptg021264l,338548,338875,327,EVM,mRNA,336459,346314,327,1.00
ptg021287l,2045092,2045399,307,EVM,mRNA,1667507,2140412,307,1.00
ptg021287l,2410131,2410412,281,EVM,mRNA,2378850,3189450,281,1.00
ptg021287l,2443842,2444162,320,EVM,mRNA,2378850,3189450,320,1.00
ptg021287l,2564505,2564814,309,EVM,mRNA,2378850,3189450,309,1.00
ptg021296l,974293,974586,293,EVM,mRNA,860921,1366704,293,1.00
ptg021333l,292701,293000,299,EVM,mRNA,131152,900711,299,1.00
ptg021333l,621306,621575,269,EVM,mRNA,131152,900711,269,1.00
ptg021333l,1154422,1154731,309,EVM,mRNA,1104829,1403135,309,1.00
ptg021333l,1392191,1392485,294,EVM,mRNA,1104829,1403135,294,1.00
ptg021345l,662554,662852,298,EVM,mRNA,579477,695915,298,1.00
ptg021355l,73982,74278,296,EVM,mRNA,45889,445571,296,1.00
ptg021366l,125030,125346,316,EVM,mRNA,46036,310322,316,1.00
ptg021367l,521526,521808,282,EVM,mRNA,271306,704971,282,1.00
ptg021367l,624803,625102,299,EVM,mRNA,271306,704971,299,1.00
ptg021391l,521779,522099,320,EVM,mRNA,1380,830167,320,1.00
ptg021417l,391638,391952,314,EVM,mRNA,209940,613999,314,1.00
ptg021425l,85947,86242,295,EVM,mRNA,42846,159130,295,1.00
ptg021432l,224308,224607,299,EVM,mRNA,63953,465469,299,1.00
ptg021442l,1356940,1357229,289,EVM,mRNA,1192093,1651998,289,1.00
ptg021450l,736540,736806,266,EVM,mRNA,17852,780363,266,1.00
ptg021488l,1120498,1120824,326,EVM,mRNA,449968,1272262,326,1.00
ptg021492l,834486,834760,274,EVM,mRNA,827079,893235,274,1.00
ptg021516l,110732,111040,308,EVM,mRNA,52611,121480,308,1.00
ptg021517l,338568,338878,310,EVM,mRNA,46641,563524,310,1.00
ptg021527l,471567,471884,317,EVM,mRNA,294056,822989,317,1.00
ptg021528l,180802,181094,292,EVM,mRNA,138212,184053,292,1.00
ptg021530l,509089,509388,299,EVM,mRNA,77213,630971,299,1.00
ptg021541l,384012,384335,323,EVM,mRNA,334432,536560,323,1.00
ptg021544l,807969,808238,269,EVM,mRNA,788984,955247,269,1.00
ptg021544l,902203,902510,307,EVM,mRNA,788984,955247,307,1.00
ptg021556l,143797,144092,295,EVM,mRNA,85764,238225,295,1.00
ptg021565l,172921,173205,284,EVM,mRNA,6230,585949,284,1.00
ptg021565l,465262,465579,317,EVM,mRNA,6230,585949,317,1.00
ptg021568l,242038,242326,288,EVM,mRNA,20360,799131,288,1.00
ptg021569l,262240,262522,282,EVM,mRNA,13919,282756,282,1.00
ptg021569l,268364,268643,279,EVM,mRNA,13919,282756,279,1.00
ptg021574l,262679,262998,319,EVM,mRNA,151262,779140,319,1.00
ptg021574l,1138452,1138767,315,EVM,mRNA,1068085,1249988,315,1.00
ptg021575l,445129,445429,300,EVM,mRNA,124054,931038,300,1.00
ptg021575l,830766,831093,327,EVM,mRNA,124054,931038,327,1.00
ptg021614l,3471924,3472214,290,EVM,mRNA,2661592,3534315,290,1.00
ptg021641l,77996,78295,299,EVM,mRNA,5116,361500,299,1.00
ptg021647l,463194,463513,319,EVM,mRNA,221839,702195,319,1.00
ptg021653l,728711,728994,283,EVM,mRNA,12601,787343,283,1.00
ptg021668l,460942,461238,296,EVM,mRNA,268399,464197,296,1.00
ptg021679l,532206,532478,272,EVM,mRNA,459523,970112,272,1.00
ptg021680l,614911,615238,327,EVM,mRNA,509773,694944,327,1.00
ptg021697l,1628367,1628655,288,EVM,mRNA,1608263,1805997,288,1.00
ptg021704l,424704,425033,329,EVM,mRNA,23649,654854,329,1.00
ptg021730l,500736,501052,316,EVM,mRNA,39083,507071,316,1.00
ptg021751l,64323,64638,315,EVM,mRNA,19579,300495,315,1.00
ptg021763l,484167,484468,301,EVM,mRNA,136633,836589,301,1.00
ptg021764l,282173,282482,309,EVM,mRNA,156190,385188,309,1.00
ptg021765l,881474,881756,282,EVM,mRNA,837704,1321341,282,1.00
ptg021773l,565215,565512,297,EVM,mRNA,536288,665345,297,1.00
ptg021796l,498910,499190,280,EVM,mRNA,113,739522,280,1.00
ptg021799l,2697652,2697968,316,EVM,mRNA,2549033,3013954,316,1.00
ptg021809l,399893,400183,290,EVM,mRNA,300000,497995,290,1.00
ptg021811l,168630,168915,285,EVM,mRNA,50490,201849,285,1.00
ptg021819l,277836,278162,326,EVM,mRNA,53392,278788,326,1.00
ptg021824l,114888,115198,310,EVM,mRNA,73499,117193,310,1.00
ptg021840l,257387,257709,322,EVM,mRNA,76507,1184961,322,1.00
ptg021841l,411363,411670,307,EVM,mRNA,235209,1022752,307,1.00
ptg021847l,163113,163415,302,EVM,mRNA,48409,1818172,302,1.00
ptg021847l,745634,745961,327,EVM,mRNA,48409,1818172,327,1.00
ptg021847l,1693549,1693859,310,EVM,mRNA,48409,1818172,310,1.00
ptg021848l,1636207,1636506,299,EVM,mRNA,1260054,1793103,299,1.00
ptg021860l,342017,342347,330,EVM,mRNA,20165,1442145,330,1.00
ptg021870l,467269,467578,309,EVM,mRNA,451081,590744,309,1.00
ptg021875l,661557,661839,282,EVM,mRNA,480675,998036,282,1.00
ptg021878l,21020,21315,295,EVM,mRNA,507,566505,295,1.00
ptg021878l,531933,532231,298,EVM,mRNA,507,566505,298,1.00
ptg021878l,1305348,1305621,273,EVM,mRNA,618699,1673986,273,1.00
ptg021923l,175733,176026,293,EVM,mRNA,28277,722588,293,1.00
ptg021924l,273392,273652,260,EVM,mRNA,263837,775216,260,1.00
ptg021931l,485587,485886,299,EVM,mRNA,337767,535471,299,1.00
ptg021940l,85770,86070,300,EVM,mRNA,51045,423553,300,1.00
ptg021941l,95504,95805,301,EVM,mRNA,1542,740560,301,1.00
ptg021941l,296132,296415,283,EVM,mRNA,1542,740560,283,1.00
ptg021943l,469252,469551,299,EVM,mRNA,8106,955884,299,1.00
ptg021943l,604621,604882,261,EVM,mRNA,8106,955884,261,1.00
ptg021943l,739192,739512,320,EVM,mRNA,8106,955884,320,1.00
ptg021945l,695816,696111,295,EVM,mRNA,402485,708638,295,1.00
ptg021960l,467277,467598,321,EVM,mRNA,437800,562424,321,1.00
ptg021974l,1910610,1910908,298,EVM,mRNA,104002,2701838,298,1.00
ptg021974l,2389713,2390023,310,EVM,mRNA,104002,2701838,310,1.00
ptg021986l,361399,361694,295,EVM,mRNA,186313,439174,295,1.00
ptg022000l,118669,118958,289,EVM,mRNA,62914,275892,289,1.00
ptg022005l,438793,439087,294,EVM,mRNA,250120,480780,294,1.00
ptg022005l,445827,446150,323,EVM,mRNA,250120,480780,323,1.00
ptg022012l,400051,400361,310,EVM,mRNA,170640,923103,310,1.00
ptg022033l,63573,63855,282,EVM,mRNA,10814,455254,282,1.00
ptg022033l,440254,440568,314,EVM,mRNA,10814,455254,314,1.00
ptg022051l,776995,777296,301,EVM,mRNA,342877,1407260,301,1.00
ptg022054l,1236927,1237230,303,EVM,mRNA,15363,1240868,303,1.00
ptg022061l,984250,984561,311,EVM,mRNA,539879,1734023,311,1.00
ptg022061l,2193744,2194038,294,EVM,mRNA,1970336,2239893,294,1.00
ptg022062l,667126,667410,284,EVM,mRNA,54524,875353,284,1.00
ptg022072l,66876,67158,282,EVM,mRNA,13690,104018,282,1.00
ptg022080l,202161,202484,323,EVM,mRNA,42652,314134,323,1.00
ptg022090l,146550,146833,283,EVM,mRNA,6558,867960,283,1.00
ptg022090l,422182,422496,314,EVM,mRNA,6558,867960,314,1.00
ptg022090l,492238,492558,320,EVM,mRNA,6558,867960,320,1.00
ptg022094l,62204,62496,292,EVM,mRNA,33416,223135,292,1.00
ptg022104l,534864,535157,293,EVM,mRNA,431883,736149,293,1.00
ptg022119l,580192,580455,263,EVM,mRNA,131425,626006,263,1.00
ptg022158l,136497,136830,333,EVM,mRNA,5982,895734,333,1.00
ptg022183l,193626,193929,303,EVM,mRNA,168696,555081,303,1.00
ptg022183l,548669,548948,279,EVM,mRNA,168696,555081,279,1.00
ptg022188l,482501,482764,263,EVM,mRNA,467411,582632,263,1.00
ptg022197l,677732,678054,322,EVM,mRNA,677084,1078640,322,1.00
ptg022201l,376068,376347,279,EVM,mRNA,271635,712316,279,1.00
ptg022226l,222708,222993,285,EVM,mRNA,99091,378123,285,1.00
ptg022227l,110691,110971,280,EVM,mRNA,77768,545680,280,1.00
ptg022256l,559022,559322,300,EVM,mRNA,518010,578724,300,1.00
ptg022261l,56853,57149,296,EVM,mRNA,14324,147246,296,1.00
ptg022278l,903847,904121,274,EVM,mRNA,903593,1332896,274,1.00
ptg022307l,708787,709090,303,EVM,mRNA,3397,875529,303,1.00
ptg022334l,193650,193956,306,EVM,mRNA,91080,740241,306,1.00
ptg022351l,75809,76109,300,EVM,mRNA,4142,236988,300,1.00
ptg022384l,334988,335286,298,EVM,mRNA,194191,449241,298,1.00
ptg022413l,129458,129744,286,EVM,mRNA,30963,308000,286,1.00
ptg022420l,1116659,1116960,301,EVM,mRNA,227538,1184450,301,1.00
ptg022427l,1386632,1386920,288,EVM,mRNA,1381470,1495748,288,1.00
ptg022453l,163286,163569,283,EVM,mRNA,34417,270445,283,1.00
ptg022467l,142592,142863,271,EVM,mRNA,96416,198655,271,1.00
ptg022474l,156552,156879,327,EVM,mRNA,406,443350,327,1.00
ptg022480l,89514,89808,294,EVM,mRNA,3215,218449,294,1.00
ptg022480l,581261,581533,272,EVM,mRNA,550679,586195,272,1.00
ptg022480l,1555461,1555792,331,EVM,mRNA,1001050,1907273,331,1.00
ptg022480l,1881270,1881576,306,EVM,mRNA,1001050,1907273,306,1.00
ptg022512l,829097,829419,322,EVM,mRNA,761039,865988,322,1.00
ptg022522l,334663,334982,319,EVM,mRNA,1580,1029559,319,1.00
ptg022529l,744624,744937,313,EVM,mRNA,365297,1190923,313,1.00
ptg022543l,11339,11627,288,EVM,mRNA,977,88795,288,1.00
ptg022556l,195018,195334,316,EVM,mRNA,141363,204612,316,1.00
ptg022559l,171274,171594,320,EVM,mRNA,103780,177941,320,1.00
ptg022568l,155872,156183,311,EVM,mRNA,72489,327624,311,1.00
ptg022581l,175242,175529,287,EVM,mRNA,142305,719033,287,1.00
ptg022581l,540441,540716,275,EVM,mRNA,142305,719033,275,1.00
ptg022597l,959381,959699,318,EVM,mRNA,806889,961886,318,1.00
ptg022620l,166633,166940,307,EVM,mRNA,145741,615951,307,1.00
ptg022621l,552042,552325,283,EVM,mRNA,505524,822667,283,1.00
ptg022632l,206271,206561,290,EVM,mRNA,120273,486832,290,1.00
ptg022634l,235730,236039,309,EVM,mRNA,206960,265142,309,1.00
ptg022640l,32849,33158,309,EVM,mRNA,13777,1444971,309,1.00
ptg022641l,232905,233230,325,EVM,mRNA,214626,257924,325,1.00
ptg022662l,57298,57595,297,EVM,mRNA,56644,58710,297,1.00
ptg022691l,180351,180640,289,EVM,mRNA,27387,220970,289,1.00
ptg022720l,205371,205690,319,EVM,mRNA,9160,404880,319,1.00
ptg022721l,406605,406922,317,EVM,mRNA,238725,1637491,317,1.00
ptg022721l,1598030,1598319,289,EVM,mRNA,238725,1637491,289,1.00
ptg022724l,327963,328272,309,EVM,mRNA,60776,497821,309,1.00
ptg022724l,329915,330188,273,EVM,mRNA,60776,497821,273,1.00
ptg022774l,250332,250620,288,EVM,mRNA,236098,378054,288,1.00
ptg022779l,231629,231911,282,EVM,mRNA,35433,238057,282,1.00
ptg022786l,349239,349510,271,EVM,mRNA,19279,655031,271,1.00
ptg022786l,590643,590925,282,EVM,mRNA,19279,655031,282,1.00
ptg022786l,1304912,1305213,301,EVM,mRNA,1260038,1458653,301,1.00
ptg022801l,195308,195629,321,EVM,mRNA,285,198120,321,1.00
ptg022817l,492934,493235,301,EVM,mRNA,160686,1194725,301,1.00
ptg022817l,506286,506590,304,EVM,mRNA,160686,1194725,304,1.00
ptg022817l,691944,692262,318,EVM,mRNA,160686,1194725,318,1.00
ptg022828l,268050,268344,294,EVM,mRNA,85525,438006,294,1.00
ptg022846l,275995,276288,293,EVM,mRNA,102808,315474,293,1.00
ptg022866l,21332,21644,312,EVM,mRNA,1450,191434,312,1.00
ptg022873l,720105,720424,319,EVM,mRNA,720378,1564531,47,0.15
ptg022904l,251725,252018,293,EVM,mRNA,137309,276826,293,1.00
ptg022984l,340844,341134,290,GeneWise,mRNA,284357,574223,290,1.00
ptg023032l,125832,126147,315,EVM,mRNA,54756,178210,315,1.00
ptg023071l,219256,219555,299,EVM,mRNA,677,438475,299,1.00
ptg023106l,423361,423657,296,EVM,mRNA,161818,627698,296,1.00
ptg023168l,264966,265273,307,EVM,mRNA,233111,846590,307,1.00
ptg023184l,940215,940514,299,EVM,mRNA,235326,961460,299,1.00
ptg023189l,501864,502172,308,EVM,mRNA,99859,1230506,308,1.00
ptg023190l,104831,105117,286,EVM,mRNA,91290,183833,286,1.00
ptg023195l,298888,299206,318,EVM,mRNA,175198,530302,318,1.00
ptg023203l,128642,128931,289,EVM,mRNA,57708,142672,289,1.00
ptg023224l,108266,108582,316,EVM,mRNA,105872,419963,316,1.00
ptg023224l,173703,174016,313,EVM,mRNA,105872,419963,313,1.00
ptg023230l,111460,111741,281,EVM,mRNA,93143,122939,281,1.00
ptg023248l,811873,812202,329,EVM,mRNA,707614,829711,329,1.00
ptg023278l,1465184,1465513,329,EVM,mRNA,1419007,1481088,329,1.00
ptg023288l,520666,520940,274,EVM,mRNA,147618,807870,274,1.00
ptg023297l,309723,310048,325,EVM,mRNA,131906,347529,325,1.00
ptg023318l,826067,826359,292,EVM,mRNA,764863,910468,292,1.00
ptg023343l,453950,454256,306,EVM,mRNA,86322,512259,306,1.00
ptg023374l,278899,279191,292,EVM,mRNA,83383,377065,292,1.00
ptg023375l,83543,83851,308,EVM,mRNA,31633,145002,308,1.00
ptg023397l,283900,284198,298,EVM,mRNA,174470,306262,298,1.00
ptg023407l,11594,11887,293,EVM,mRNA,11803,86830,85,0.29
ptg023420l,179561,179854,293,EVM,mRNA,146396,420673,293,1.00
ptg023421l,114237,114547,310,EVM,mRNA,163,291027,310,1.00
ptg023422l,1416948,1417258,310,EVM,mRNA,1025243,1620534,310,1.00
ptg023428l,185509,185796,287,EVM,mRNA,118842,701155,287,1.00
ptg023428l,571531,571828,297,EVM,mRNA,118842,701155,297,1.00
ptg023462l,130423,130722,299,EVM,mRNA,25027,615093,299,1.00
ptg023470l,724599,724886,287,EVM,mRNA,47322,1615569,287,1.00
ptg023472l,107819,108091,272,EVM,mRNA,107915,488945,177,0.65
ptg023472l,322418,322696,278,EVM,mRNA,107915,488945,278,1.00
ptg023472l,1736840,1737109,269,EVM,mRNA,1736671,1737816,269,1.00
ptg023502l,136314,136634,320,EVM,mRNA,134878,241532,320,1.00
ptg023502l,548988,549301,313,EVM,mRNA,404267,554351,313,1.00
ptg023530l,202082,202363,281,EVM,mRNA,90098,373539,281,1.00
ptg023535l,541241,541523,282,EVM,mRNA,471290,908823,282,1.00
ptg023544l,220312,220626,314,EVM,mRNA,64008,240130,314,1.00
ptg023550l,634345,634651,306,EVM,mRNA,434094,693758,306,1.00
ptg023550l,686328,686659,331,EVM,mRNA,434094,693758,331,1.00
ptg023585l,183240,183554,314,EVM,mRNA,94514,237782,314,1.00
ptg023607l,495477,495764,287,EVM,mRNA,454462,558759,287,1.00
ptg023656l,749350,749637,287,EVM,mRNA,517901,879810,287,1.00
ptg023671l,177750,178063,313,EVM,mRNA,165559,223123,313,1.00
ptg023704l,93121,93436,315,EVM,mRNA,81254,175652,315,1.00
ptg023763l,32264,32588,324,EVM,mRNA,13307,381102,324,1.00
ptg023768l,924559,924849,290,EVM,mRNA,886484,1187878,290,1.00
ptg023775l,1904988,1905293,305,EVM,mRNA,1736084,3481310,305,1.00
ptg023775l,2205293,2205627,334,EVM,mRNA,1736084,3481310,334,1.00
ptg023776l,106717,107019,302,EVM,mRNA,758,561542,302,1.00
ptg023779l,481504,481834,330,EVM,mRNA,61501,1112417,330,1.00
ptg023800l,220888,221160,272,EVM,mRNA,19311,637150,272,1.00
ptg023815l,1333466,1333765,299,EVM,mRNA,316649,1479316,299,1.00
ptg023821l,359903,360222,319,EVM,mRNA,301419,394348,319,1.00
ptg023841l,321406,321683,277,EVM,mRNA,107205,554648,277,1.00
ptg023865l,86670,86962,292,EVM,mRNA,86944,87384,19,0.07
ptg023881l,417540,417854,314,EVM,mRNA,38893,457449,314,1.00
ptg023895l,647913,648218,305,EVM,mRNA,591184,822601,305,1.00
ptg023895l,707827,708140,313,EVM,mRNA,591184,822601,313,1.00
ptg023901l,498626,498939,313,EVM,mRNA,192190,552186,313,1.00
ptg023903l,239973,240246,273,EVM,mRNA,1057,272349,273,1.00
ptg023923l,160238,160486,248,EVM,mRNA,2593,183520,248,1.00
ptg023925l,144413,144735,322,EVM,mRNA,43113,1395705,322,1.00
ptg023925l,362538,362841,303,EVM,mRNA,43113,1395705,303,1.00
ptg023952l,744790,745107,317,EVM,mRNA,484641,1210345,317,1.00
ptg023952l,925646,925949,303,EVM,mRNA,484641,1210345,303,1.00
ptg023971l,285109,285444,335,EVM,mRNA,265212,891082,335,1.00
ptg023971l,655820,656141,321,EVM,mRNA,265212,891082,321,1.00
ptg023973l,414991,415283,292,EVM,mRNA,171822,514263,292,1.00
ptg024013l,375921,376211,290,EVM,mRNA,281278,471760,290,1.00
ptg024013l,899419,899740,321,EVM,mRNA,889264,1273272,321,1.00
ptg024013l,1062337,1062624,287,EVM,mRNA,889264,1273272,287,1.00
ptg024023l,94831,95142,311,EVM,mRNA,11101,328184,311,1.00
ptg024045l,248836,249119,283,EVM,mRNA,113218,339908,283,1.00
ptg024060l,439299,439627,328,EVM,mRNA,374893,764788,328,1.00
ptg024064l,208400,208715,315,EVM,mRNA,55077,670900,315,1.00
ptg024064l,550259,550514,255,EVM,mRNA,55077,670900,255,1.00
ptg024083l,165070,165371,301,EVM,mRNA,18484,321942,301,1.00
ptg024087l,343909,344237,328,EVM,mRNA,11254,860288,328,1.00
ptg024090l,640899,641200,301,EVM,mRNA,77602,988901,301,1.00
ptg024109l,370144,370433,289,EVM,mRNA,130993,704782,289,1.00
ptg024135l,234395,234710,315,EVM,mRNA,18198,250842,315,1.00
ptg024140l,650091,650408,317,EVM,mRNA,278652,673363,317,1.00
ptg024148l,331140,331426,286,EVM,mRNA,178098,689118,286,1.00
ptg024148l,648333,648627,294,EVM,mRNA,178098,689118,294,1.00
ptg024159l,645769,646078,309,EVM,mRNA,91491,686391,309,1.00
ptg024175l,179924,180218,294,EVM,mRNA,24376,224849,294,1.00
ptg024202l,272828,273137,309,EVM,mRNA,197544,294290,309,1.00
ptg024208l,73531,73830,299,EVM,mRNA,23419,230394,299,1.00
ptg024211l,77066,77385,319,EVM,mRNA,58749,371001,319,1.00
ptg024211l,97454,97760,306,EVM,mRNA,58749,371001,306,1.00
ptg024225l,134112,134412,300,EVM,mRNA,52786,217041,300,1.00
ptg024225l,142531,142847,316,EVM,mRNA,52786,217041,316,1.00
ptg024225l,146521,146821,300,EVM,mRNA,52786,217041,300,1.00
ptg024234l,226183,226487,304,EVM,mRNA,110961,321982,304,1.00
ptg024238l,110332,110635,303,EVM,mRNA,32851,231907,303,1.00
ptg024247l,288750,289067,317,EVM,mRNA,25614,425066,317,1.00
ptg024281l,674389,674699,310,EVM,mRNA,31317,787958,310,1.00
ptg024284l,36808,37109,301,EVM,mRNA,31015,45606,301,1.00
ptg024332l,95420,95727,307,EVM,mRNA,23951,128284,307,1.00
ptg024357l,198017,198310,293,EVM,mRNA,71915,220312,293,1.00
ptg024377l,237773,238094,321,EVM,mRNA,150822,397287,321,1.00
ptg024400l,189093,189402,309,EVM,mRNA,105307,269975,309,1.00
ptg024471l,270314,270630,316,EVM,mRNA,50379,293669,316,1.00
ptg024508l,94649,94975,326,EVM,mRNA,36772,130841,326,1.00
ptg024508l,459056,459363,307,EVM,mRNA,308927,517578,307,1.00
ptg024508l,476798,477079,281,EVM,mRNA,308927,517578,281,1.00
ptg024554l,489868,490161,293,EVM,mRNA,184734,693415,293,1.00
ptg024569l,100861,101171,310,EVM,mRNA,13685,219694,310,1.00
ptg024585l,1048451,1048760,309,EVM,mRNA,488918,1352750,309,1.00
ptg024585l,1146058,1146331,273,EVM,mRNA,488918,1352750,273,1.00
ptg024604l,855433,855746,313,EVM,mRNA,464477,2051588,313,1.00
ptg024604l,1050299,1050611,312,EVM,mRNA,464477,2051588,312,1.00
ptg024604l,1648168,1648479,311,EVM,mRNA,464477,2051588,311,1.00
ptg024623l,95777,96103,326,EVM,mRNA,7767,98962,326,1.00
ptg024626l,243631,243929,298,EVM,mRNA,47336,299142,298,1.00
ptg024626l,259834,260123,289,EVM,mRNA,47336,299142,289,1.00
ptg024673l,405519,405816,297,EVM,mRNA,353295,980163,297,1.00
ptg024694l,203239,203541,302,EVM,mRNA,13063,555488,302,1.00
ptg024694l,548561,548889,328,EVM,mRNA,13063,555488,328,1.00
ptg024706l,1236896,1237191,295,EVM,mRNA,643528,2289897,295,1.00
ptg024706l,1873446,1873723,277,EVM,mRNA,643528,2289897,277,1.00
ptg024761l,46262,46549,287,EVM,mRNA,8341,53717,287,1.00
ptg024764l,450689,451019,330,EVM,mRNA,378334,634445,330,1.00
ptg024804l,187485,187823,338,EVM,mRNA,111045,387010,338,1.00
ptg024860l,245475,245787,312,EVM,mRNA,197177,435406,312,1.00
ptg024903l,351967,352264,297,EVM,mRNA,224917,1134344,297,1.00
ptg024903l,373756,374055,299,EVM,mRNA,224917,1134344,299,1.00
ptg024903l,816043,816308,265,EVM,mRNA,224917,1134344,265,1.00
ptg024932l,247221,247550,329,EVM,mRNA,192508,321456,329,1.00
ptg024971l,256512,256818,306,EVM,mRNA,135381,349855,306,1.00
ptg024971l,346620,346936,316,EVM,mRNA,135381,349855,316,1.00
ptg024981l,119148,119468,320,EVM,mRNA,78871,160893,320,1.00
ptg024984l,680574,680869,295,EVM,mRNA,137185,785886,295,1.00
ptg025010l,330499,330785,286,EVM,mRNA,306057,382669,286,1.00
ptg025047l,705050,705373,323,EVM,mRNA,700816,860236,323,1.00
ptg025083l,271966,272288,322,EVM,mRNA,144004,433227,322,1.00
ptg025083l,684656,684936,280,EVM,mRNA,673555,728522,280,1.00
ptg025093l,847677,847979,302,EVM,mRNA,298375,990462,302,1.00
ptg025098l,622739,623029,290,EVM,mRNA,63318,1060216,290,1.00
ptg025105l,614440,614742,302,EVM,mRNA,315777,651195,302,1.00
ptg025109l,345415,345689,274,EVM,mRNA,161349,1285927,274,1.00
ptg025120l,79321,79623,302,EVM,mRNA,30704,150194,302,1.00
ptg025152l,148368,148675,307,EVM,mRNA,87097,427896,307,1.00
ptg025160l,390014,390305,291,EVM,mRNA,187724,510029,291,1.00
ptg025191l,599934,600226,292,EVM,mRNA,38558,765157,292,1.00
ptg025205l,74251,74551,300,EVM,mRNA,25456,193140,300,1.00
ptg025229l,334489,334805,316,EVM,mRNA,78147,880150,316,1.00
ptg025240l,301905,302188,283,EVM,mRNA,21502,327936,283,1.00
ptg025266l,811291,811614,323,EVM,mRNA,674281,839146,323,1.00
ptg025285l,365341,365667,326,EVM,mRNA,201912,1526961,326,1.00
ptg025285l,1217445,1217745,300,EVM,mRNA,201912,1526961,300,1.00
ptg025304l,152093,152400,307,EVM,mRNA,132339,152766,307,1.00
ptg025306l,370542,370865,323,EVM,mRNA,280779,449071,323,1.00
ptg025312l,317925,318243,318,EVM,mRNA,7433,824085,318,1.00
ptg025312l,630271,630545,274,EVM,mRNA,7433,824085,274,1.00
ptg025312l,991826,992107,281,EVM,mRNA,925982,1204336,281,1.00
ptg025366l,266073,266376,303,EVM,mRNA,153456,431737,303,1.00
ptg025376l,2078938,2079243,305,EVM,mRNA,1506174,2132297,305,1.00
ptg025376l,2824067,2824364,297,EVM,mRNA,2739667,3215812,297,1.00
ptg025376l,2958728,2959015,287,EVM,mRNA,2739667,3215812,287,1.00
ptg025376l,3121143,3121452,309,EVM,mRNA,2739667,3215812,309,1.00
ptg025382l,369112,369427,315,EVM,mRNA,34,465774,315,1.00
ptg025382l,376181,376506,325,EVM,mRNA,34,465774,325,1.00
ptg025396l,247743,248042,299,EVM,mRNA,132853,495257,299,1.00
ptg025422l,317587,317907,320,EVM,mRNA,225805,630218,320,1.00
ptg025424l,238627,238927,300,EVM,mRNA,211002,242302,300,1.00
ptg025438l,471649,471959,310,EVM,mRNA,4312,508401,310,1.00
ptg025444l,275402,275718,316,EVM,mRNA,222967,333409,316,1.00
ptg025466l,1302554,1302873,319,EVM,mRNA,1205371,1401049,319,1.00
ptg025467l,59238,59526,288,EVM,mRNA,34211,95825,288,1.00
ptg025474l,317001,317310,309,EVM,mRNA,310441,569645,309,1.00
ptg025510l,347382,347711,329,EVM,mRNA,311610,478554,329,1.00
ptg025516l,829671,830012,341,EVM,mRNA,690226,895721,341,1.00
ptg025525l,33256,33581,325,EVM,mRNA,3770,226504,325,1.00
ptg025532l,699344,699617,273,EVM,mRNA,629330,770399,273,1.00
ptg025578l,97459,97751,292,EVM,mRNA,68272,139769,292,1.00
ptg025582l,267337,267661,324,EVM,mRNA,229997,316911,324,1.00
ptg025599l,724435,724763,328,EVM,mRNA,205723,859925,328,1.00
ptg025599l,817969,818237,268,EVM,mRNA,205723,859925,268,1.00
ptg025631l,597510,597808,298,EVM,mRNA,561482,811962,298,1.00
ptg025631l,665572,665885,313,EVM,mRNA,561482,811962,313,1.00
ptg025631l,728352,728646,294,EVM,mRNA,561482,811962,294,1.00
ptg025652l,532192,532505,313,EVM,mRNA,532060,532449,257,0.82
ptg025657l,301773,302080,307,EVM,mRNA,284680,1151633,307,1.00
ptg025673l,285319,285622,303,EVM,mRNA,59869,364539,303,1.00
ptg025682l,217002,217285,283,EVM,mRNA,30126,706682,283,1.00
ptg025704l,455339,455630,291,EVM,mRNA,310060,465825,291,1.00
ptg025715l,408596,408904,308,EVM,mRNA,68365,990195,308,1.00
ptg025722l,304177,304511,334,EVM,mRNA,243281,313199,334,1.00
ptg025778l,130238,130522,284,EVM,mRNA,75253,232757,284,1.00
ptg025780l,82992,83318,326,EVM,mRNA,53099,518583,326,1.00
ptg025780l,411999,412277,278,EVM,mRNA,53099,518583,278,1.00
ptg025805l,659349,659652,303,EVM,mRNA,43248,682649,303,1.00
ptg025862l,65646,65941,295,EVM,mRNA,7209,2573245,295,1.00
ptg025862l,739046,739353,307,EVM,mRNA,7209,2573245,307,1.00
ptg025862l,1986259,1986574,315,EVM,mRNA,7209,2573245,315,1.00
ptg025904l,90509,90845,336,EVM,mRNA,43918,206805,336,1.00
ptg025952l,234231,234479,248,EVM,mRNA,45364,385537,248,1.00
ptg026045l,413624,413940,316,EVM,mRNA,413665,488126,276,0.87
ptg026069l,1039924,1040202,278,EVM,mRNA,993386,1199176,278,1.00
ptg026085l,146254,146572,318,EVM,mRNA,28661,214737,318,1.00
ptg026118l,172449,172762,313,EVM,mRNA,10931,768915,313,1.00
ptg026128l,320566,320870,304,EVM,mRNA,160542,391368,304,1.00
ptg026190l,56366,56663,297,EVM,mRNA,52029,106315,297,1.00
ptg026190l,215168,215460,292,EVM,mRNA,155514,447653,292,1.00
ptg026204l,542037,542333,296,EVM,mRNA,1417,993617,296,1.00
ptg026218l,130692,130983,291,EVM,mRNA,15340,170968,291,1.00
ptg026294l,1122429,1122724,295,EVM,mRNA,707795,1961561,295,1.00
ptg026348l,965659,965945,286,EVM,mRNA,114856,1064558,286,1.00
ptg026382l,88404,88701,297,EVM,mRNA,924,581687,297,1.00
ptg026382l,96454,96739,285,EVM,mRNA,924,581687,285,1.00
ptg026390l,322021,322335,314,EVM,mRNA,103207,514502,314,1.00
ptg026451l,454515,454830,315,EVM,mRNA,154141,771789,315,1.00
ptg026467l,38957,39271,314,EVM,mRNA,26604,92831,314,1.00
ptg026489l,368016,368338,322,EVM,mRNA,40529,511123,322,1.00
ptg026497l,65811,66123,312,EVM,mRNA,34006,362376,312,1.00
ptg026499l,508307,508621,314,EVM,mRNA,162448,642466,314,1.00
ptg026534l,265425,265699,274,EVM,mRNA,31266,297945,274,1.00
ptg026537l,800276,800590,314,EVM,mRNA,453249,904042,314,1.00
ptg026562l,675603,675925,322,EVM,mRNA,480455,752665,322,1.00
ptg026632l,541758,542060,302,EVM,mRNA,393606,604305,302,1.00
ptg026643l,251945,252275,330,EVM,mRNA,396,290798,330,1.00
ptg026661l,831054,831392,338,EVM,mRNA,282108,912372,338,1.00
ptg026686l,51195,51498,303,EVM,mRNA,880,218807,303,1.00
ptg026714l,146852,147126,274,EVM,mRNA,68337,850991,274,1.00
ptg026714l,239869,240180,311,EVM,mRNA,68337,850991,311,1.00
ptg026734l,197728,198007,279,EVM,mRNA,78828,283594,279,1.00
ptg026745l,178355,178653,298,EVM,mRNA,104250,300076,298,1.00
ptg026769l,184766,185044,278,EVM,mRNA,10362,338374,278,1.00
ptg026825l,441066,441361,295,EVM,mRNA,412348,474038,295,1.00
ptg026855l,1272539,1272829,290,EVM,mRNA,1058514,3146954,290,1.00
ptg026855l,1908641,1908953,312,EVM,mRNA,1058514,3146954,312,1.00
ptg026855l,2388646,2388941,295,EVM,mRNA,1058514,3146954,295,1.00
ptg026855l,3338691,3338982,291,EVM,mRNA,3256729,3504895,291,1.00
ptg026870l,366937,367237,300,EVM,mRNA,68079,607163,300,1.00
ptg026870l,601035,601334,299,EVM,mRNA,68079,607163,299,1.00
ptg026909l,93311,93627,316,EVM,mRNA,80667,121761,316,1.00
ptg026966l,1214946,1215227,281,EVM,mRNA,256790,1658529,281,1.00
ptg027031l,208538,208838,300,EVM,mRNA,80896,474690,300,1.00
ptg027040l,172643,172954,311,EVM,mRNA,55331,289297,311,1.00
ptg027050l,37114,37441,327,EVM,mRNA,11068,40376,327,1.00
ptg027089l,542891,543175,284,EVM,mRNA,114002,776781,284,1.00
ptg027089l,733065,733345,280,EVM,mRNA,114002,776781,280,1.00
ptg027148l,167936,168234,298,EVM,mRNA,12836,220542,298,1.00
ptg027157l,204363,204678,315,EVM,mRNA,3605,251859,315,1.00
ptg027166l,263159,263460,301,EVM,mRNA,245326,347449,301,1.00
ptg027224l,1867176,1867468,292,EVM,mRNA,682855,2369865,292,1.00
ptg027238l,140977,141275,298,EVM,mRNA,442,1016923,298,1.00
ptg027239l,1247217,1247502,285,EVM,mRNA,1247256,1399375,247,0.87
ptg027289l,259656,259943,287,EVM,mRNA,231650,753538,287,1.00
ptg027289l,675361,675640,279,EVM,mRNA,231650,753538,279,1.00
ptg027294l,222018,222331,313,EVM,mRNA,4332,359857,313,1.00
ptg027295l,54243,54527,284,EVM,mRNA,523,114359,284,1.00
ptg027295l,199891,200206,315,EVM,mRNA,122157,218646,315,1.00
ptg027341l,128266,128553,287,EVM,mRNA,63129,571682,287,1.00
ptg027349l,86101,86408,307,EVM,mRNA,20228,94785,307,1.00
ptg027354l,264684,264971,287,EVM,mRNA,118614,444499,287,1.00
ptg027355l,106130,106411,281,EVM,mRNA,34206,584345,281,1.00
ptg027395l,183829,184137,308,EVM,mRNA,88062,289807,308,1.00
ptg027429l,3710356,3710668,312,EVM,mRNA,3557280,3848115,312,1.00
ptg027439l,498952,499233,281,EVM,mRNA,3982,1296842,281,1.00
ptg027439l,1039206,1039532,326,EVM,mRNA,3982,1296842,326,1.00
ptg027439l,1618134,1618423,289,EVM,mRNA,1416617,2222605,289,1.00
ptg027439l,1799811,1800118,307,EVM,mRNA,1416617,2222605,307,1.00
ptg027439l,1830554,1830876,322,EVM,mRNA,1416617,2222605,322,1.00
ptg027439l,1988798,1989060,262,EVM,mRNA,1416617,2222605,262,1.00
ptg027466l,1491347,1491650,303,EVM,mRNA,1025643,2703622,303,1.00
ptg027472l,234352,234647,295,EVM,mRNA,2240,458302,295,1.00
ptg027494l,323921,324227,306,EVM,mRNA,112472,333124,306,1.00
ptg027502l,695591,695889,298,EVM,mRNA,479333,837809,298,1.00
ptg027533l,67672,67971,299,EVM,mRNA,46026,207394,299,1.00
ptg027539l,49002,49327,325,EVM,mRNA,799,118704,325,1.00
ptg027575l,411445,411754,309,EVM,mRNA,135613,537534,309,1.00
ptg027599l,226970,227251,281,EVM,mRNA,2487,292602,281,1.00
ptg027620l,192518,192771,253,EVM,mRNA,166723,211059,253,1.00
ptg027620l,634182,634324,142,EVM,mRNA,579867,655188,142,1.00
ptg027669l,1537221,1537503,282,EVM,mRNA,1197143,1866077,282,1.00
ptg027675l,120499,120821,322,EVM,mRNA,18879,122912,322,1.00
ptg027700l,47818,48095,277,EVM,mRNA,32709,154949,277,1.00
ptg027703l,512924,513223,299,EVM,mRNA,360883,532177,299,1.00
ptg027729l,108463,108798,335,EVM,mRNA,44806,203670,335,1.00
ptg027730l,389040,389350,310,EVM,mRNA,252256,398757,310,1.00
ptg027777l,1098574,1098884,310,EVM,mRNA,931011,1783902,310,1.00
ptg027777l,2055546,2055838,292,EVM,mRNA,1894085,2071243,292,1.00
ptg027814l,731822,732108,286,EVM,mRNA,642744,754012,286,1.00
ptg027832l,182039,182325,286,EVM,mRNA,5997,299461,286,1.00
ptg027846l,290950,291274,324,EVM,mRNA,22760,696706,324,1.00
ptg027865l,61862,62165,303,EVM,mRNA,3876,64035,303,1.00
ptg027866l,134602,134920,318,EVM,mRNA,6679,471045,318,1.00
ptg027901l,613493,613816,323,EVM,mRNA,435210,631540,323,1.00
ptg027903l,254765,255055,290,EVM,mRNA,78807,303599,290,1.00
ptg027936l,251718,252037,319,EVM,mRNA,194322,489460,319,1.00
ptg027936l,309457,309759,302,EVM,mRNA,194322,489460,302,1.00
ptg027944l,74679,75010,331,EVM,mRNA,48495,211987,331,1.00
ptg027952l,32193,32494,301,EVM,mRNA,7456,114471,301,1.00
ptg027971l,386328,386623,295,EVM,mRNA,136279,618591,295,1.00
ptg028014l,264854,265153,299,EVM,mRNA,102698,406383,299,1.00
ptg028040l,728626,728909,283,EVM,mRNA,18568,947798,283,1.00
ptg028040l,798617,798893,276,EVM,mRNA,18568,947798,276,1.00
ptg028040l,827458,827748,290,EVM,mRNA,18568,947798,290,1.00
ptg028040l,876061,876370,309,EVM,mRNA,18568,947798,309,1.00
ptg028128l,142232,142504,272,EVM,mRNA,137525,330753,272,1.00
ptg028128l,442063,442355,292,EVM,mRNA,386611,642550,292,1.00
ptg028188l,60578,60905,327,EVM,mRNA,716,70363,327,1.00
ptg028220l,707957,708283,326,EVM,mRNA,494403,763796,326,1.00
ptg028238l,755124,755421,297,EVM,mRNA,749363,1318431,297,1.00
ptg028290l,85426,85757,331,EVM,mRNA,18590,150722,331,1.00
ptg028392l,134673,134969,296,EVM,mRNA,35713,171441,296,1.00
ptg028394l,49492,49801,309,EVM,mRNA,32285,184195,309,1.00
ptg028394l,53138,53443,305,EVM,mRNA,32285,184195,305,1.00
ptg028415l,168709,169017,308,EVM,mRNA,92432,200188,308,1.00
ptg028417l,288174,288470,296,EVM,mRNA,8943,343217,296,1.00
ptg028459l,35309,35615,306,EVM,mRNA,34925,81899,306,1.00
ptg028488l,43361,43665,304,EVM,mRNA,8336,160525,304,1.00
ptg028499l,86344,86658,314,EVM,mRNA,79584,516706,314,1.00
ptg028499l,183070,183379,309,EVM,mRNA,79584,516706,309,1.00
ptg028550l,375995,376311,316,EVM,mRNA,294739,397190,316,1.00
ptg028577l,389192,389462,270,EVM,mRNA,340136,552249,270,1.00
ptg028596l,80035,80325,290,EVM,mRNA,9568,456397,290,1.00
ptg028768l,387895,388200,305,EVM,mRNA,234301,1485447,305,1.00
ptg028849l,567113,567437,324,EVM,mRNA,479583,755395,324,1.00
ptg028849l,717799,718094,295,EVM,mRNA,479583,755395,295,1.00
ptg028864l,363170,363498,328,EVM,mRNA,188991,389789,328,1.00
ptg028879l,259063,259392,329,EVM,mRNA,361,448569,329,1.00
ptg028913l,209703,210004,301,EVM,mRNA,30560,677243,301,1.00
ptg028959l,309379,309670,291,EVM,mRNA,204813,449260,291,1.00
ptg028959l,420700,420999,299,EVM,mRNA,204813,449260,299,1.00
ptg028986l,91404,91697,293,EVM,mRNA,43903,117262,293,1.00
ptg029017l,470706,471019,313,EVM,mRNA,455647,517802,313,1.00
ptg029021l,116260,116576,316,EVM,mRNA,18518,343156,316,1.00
ptg029100l,1692865,1693181,316,EVM,mRNA,1308708,1753331,316,1.00
ptg029154l,45655,45967,312,EVM,mRNA,21328,137991,312,1.00
ptg029154l,82004,82292,288,EVM,mRNA,21328,137991,288,1.00
ptg029154l,274563,274833,270,EVM,mRNA,239698,298310,270,1.00
ptg029164l,472936,473211,275,EVM,mRNA,451183,857620,275,1.00
ptg029200l,134456,134755,299,EVM,mRNA,32823,240682,299,1.00
ptg029202l,274520,274805,285,EVM,mRNA,269192,290958,285,1.00
ptg029224l,579939,580255,316,EVM,mRNA,62966,2412446,316,1.00
ptg029224l,1422412,1422688,276,EVM,mRNA,62966,2412446,276,1.00
ptg029224l,1425442,1425771,329,EVM,mRNA,62966,2412446,329,1.00
ptg029224l,2157837,2158120,283,EVM,mRNA,62966,2412446,283,1.00
ptg029224l,2269769,2270078,309,EVM,mRNA,62966,2412446,309,1.00
ptg029224l,4076986,4077282,296,EVM,mRNA,4006775,5088733,296,1.00
ptg029224l,4231979,4232295,316,EVM,mRNA,4006775,5088733,316,1.00
ptg029224l,4717921,4718214,293,EVM,mRNA,4006775,5088733,293,1.00
ptg029224l,5429173,5429476,303,EVM,mRNA,5351315,5464757,303,1.00
ptg029245l,236683,236977,294,EVM,mRNA,76636,893467,294,1.00
ptg029260l,139131,139424,293,EVM,mRNA,138004,517356,293,1.00
ptg029260l,256091,256407,316,EVM,mRNA,138004,517356,316,1.00
ptg029323l,108818,109112,294,EVM,mRNA,1864,169373,294,1.00
ptg029440l,315290,315605,315,EVM,mRNA,284212,328764,315,1.00
ptg029440l,792477,792772,295,EVM,mRNA,399162,911717,295,1.00
ptg029449l,304207,304535,328,EVM,mRNA,5,418824,328,1.00
ptg029529l,90624,90951,327,EVM,mRNA,47194,96235,327,1.00
ptg029573l,211608,211745,137,EVM,mRNA,66871,260682,137,1.00
ptg029627l,679984,680283,299,EVM,mRNA,497833,882575,299,1.00
ptg029659l,27014,27323,309,EVM,mRNA,5627,264608,309,1.00
ptg029659l,248051,248371,320,EVM,mRNA,5627,264608,320,1.00
ptg029697l,427145,427446,301,EVM,mRNA,139818,434978,301,1.00
ptg029746l,304442,304722,280,EVM,mRNA,85401,445116,280,1.00
ptg029799l,299076,299361,285,EVM,mRNA,42505,308510,285,1.00
ptg029934l,79813,80129,316,EVM,mRNA,18155,147568,316,1.00
ptg029972l,330403,330722,319,EVM,mRNA,310930,340271,319,1.00
ptg030044l,160289,160625,336,EVM,mRNA,160264,296341,336,1.00
ptg030044l,254566,254860,294,EVM,mRNA,160264,296341,294,1.00
ptg030114l,538249,538567,318,EVM,mRNA,99429,694601,318,1.00
ptg030150l,111428,111725,297,EVM,mRNA,57103,412054,297,1.00
ptg030150l,211499,211826,327,EVM,mRNA,57103,412054,327,1.00
ptg030249l,1281237,1281556,319,EVM,mRNA,223942,1527638,319,1.00
ptg030249l,3191774,3192116,342,EVM,mRNA,1897281,5682586,342,1.00
ptg030265l,231402,231692,290,EVM,mRNA,115795,456164,290,1.00
ptg030305l,112112,112409,297,EVM,mRNA,46231,311928,297,1.00
ptg030382l,2916405,2916694,289,EVM,mRNA,2574117,2937187,289,1.00
ptg030413l,151145,151455,310,EVM,mRNA,95284,214296,310,1.00
ptg030453l,73667,73994,327,EVM,mRNA,48748,130776,327,1.00
ptg030455l,22375,22685,310,EVM,mRNA,16170,123591,310,1.00
ptg030466l,2425129,2425455,326,EVM,mRNA,2390793,2635025,326,1.00
ptg030467l,414296,414627,331,EVM,mRNA,329008,471706,331,1.00
ptg030564l,91346,91646,300,EVM,mRNA,17652,131520,300,1.00
ptg030569l,1453582,1453864,282,EVM,mRNA,1136826,1455827,282,1.00
ptg030604l,116082,116356,274,EVM,mRNA,2054,209751,274,1.00
ptg030624l,483927,484229,302,EVM,mRNA,32586,593884,302,1.00
ptg030629l,3101,3424,323,EVM,mRNA,3348,25874,77,0.24
ptg030657l,24512,24836,324,EVM,mRNA,33,38282,324,1.00
ptg030910l,95144,95376,232,EVM,mRNA,46541,313105,232,1.00
ptg030933l,31058,31386,328,EVM,mRNA,4443,52762,328,1.00
ptg030979l,73158,73451,293,EVM,mRNA,47875,197889,293,1.00
ptg031022l,152784,153078,294,EVM,mRNA,103521,211181,294,1.00
ptg031131l,590227,590515,288,EVM,mRNA,401418,814391,288,1.00
ptg031131l,1003481,1003767,286,EVM,mRNA,991878,1104055,286,1.00
ptg031136l,176109,176397,288,EVM,mRNA,4919,358116,288,1.00
ptg031180l,34123,34409,286,EVM,mRNA,3920,107006,286,1.00
ptg031205l,533529,533797,268,EVM,mRNA,140312,649808,268,1.00
ptg031396l,147281,147590,309,EVM,mRNA,22530,203426,309,1.00
ptg031485l,98055,98370,315,EVM,mRNA,13674,291107,315,1.00
ptg031511l,69436,69755,319,EVM,mRNA,2159,373573,319,1.00
ptg031567l,211552,211829,277,EVM,mRNA,170373,287085,277,1.00
ptg031584l,1255275,1255606,331,EVM,mRNA,937479,1455578,331,1.00
ptg031610l,102449,102739,290,EVM,mRNA,88491,114954,290,1.00
ptg031734l,814161,814456,295,EVM,mRNA,129660,1093868,295,1.00
ptg031790l,223439,223718,279,EVM,mRNA,130466,266151,279,1.00
ptg031893l,123718,124018,300,EVM,mRNA,113930,274083,300,1.00
ptg031898l,331357,331654,297,EVM,mRNA,114564,473822,297,1.00
ptg031923l,462629,462951,322,EVM,mRNA,414945,765801,322,1.00
ptg031923l,465554,465880,326,EVM,mRNA,414945,765801,326,1.00
ptg031923l,518568,518854,286,EVM,mRNA,414945,765801,286,1.00
ptg032055l,41025,41341,316,EVM,mRNA,9792,115277,316,1.00
ptg032112l,80525,80828,303,EVM,mRNA,1469,169719,303,1.00
ptg032129l,446763,447062,299,EVM,mRNA,179562,450121,299,1.00
ptg032158l,54886,55145,259,EVM,mRNA,53303,176032,259,1.00
ptg032175l,204631,204919,288,EVM,mRNA,48513,216869,288,1.00
ptg032310l,84214,84512,298,EVM,mRNA,1856,90710,298,1.00
ptg032334l,213832,214171,339,EVM,mRNA,80086,220752,339,1.00
ptg032341l,361474,361779,305,EVM,mRNA,12236,570100,305,1.00
ptg032354l,599485,599800,315,EVM,mRNA,481218,973421,315,1.00
ptg032354l,727730,728032,302,EVM,mRNA,481218,973421,302,1.00
ptg032356l,62428,62722,294,EVM,mRNA,31128,89754,294,1.00
ptg032362l,212628,212932,304,EVM,mRNA,26955,279394,304,1.00
ptg032445l,25003,25326,323,EVM,mRNA,22616,84932,323,1.00
ptg032486l,209581,209874,293,EVM,mRNA,37641,230199,293,1.00
ptg032496l,821750,822067,317,EVM,mRNA,819152,952135,317,1.00
ptg032538l,193786,194077,291,EVM,mRNA,92308,786696,291,1.00
ptg032562l,929591,929871,280,EVM,mRNA,810561,1780523,280,1.00
ptg032562l,1086877,1087164,287,EVM,mRNA,810561,1780523,287,1.00
ptg032562l,1479934,1480255,321,EVM,mRNA,810561,1780523,321,1.00
ptg032562l,1551611,1551919,308,EVM,mRNA,810561,1780523,308,1.00
ptg032570l,179169,179497,328,EVM,mRNA,115495,220050,328,1.00
ptg032638l,816633,816937,304,EVM,mRNA,787302,901439,304,1.00
ptg032654l,118056,118336,280,EVM,mRNA,27009,277652,280,1.00
ptg032733l,99957,100252,295,EVM,mRNA,117,132726,295,1.00
ptg032742l,249250,249555,305,EVM,mRNA,167805,736040,305,1.00
ptg032742l,288302,288629,327,EVM,mRNA,167805,736040,327,1.00
ptg032830l,208948,209268,320,EVM,mRNA,84857,353505,320,1.00
ptg032830l,352056,352337,281,EVM,mRNA,84857,353505,281,1.00
ptg032875l,60834,61127,293,EVM,mRNA,12486,130231,293,1.00
ptg032880l,120165,120462,297,EVM,mRNA,73217,241206,297,1.00
ptg033052l,287342,287631,289,EVM,mRNA,209335,290128,289,1.00
ptg033169l,198348,198666,318,EVM,mRNA,98218,235486,318,1.00
ptg033324l,646534,646845,311,EVM,mRNA,354637,671530,311,1.00
ptg033419l,299719,300031,312,EVM,mRNA,34269,387122,312,1.00
ptg033419l,359660,359934,274,EVM,mRNA,34269,387122,274,1.00
ptg033419l,719647,719965,318,EVM,mRNA,442761,859163,318,1.00
ptg033419l,1419702,1420012,310,EVM,mRNA,1116061,1619457,310,1.00
ptg033440l,1138837,1139125,288,EVM,mRNA,1028442,1153246,288,1.00
ptg033619l,228583,228909,326,EVM,mRNA,39151,249942,326,1.00
ptg033620l,74408,74736,328,EVM,mRNA,42380,101218,328,1.00
ptg033629l,252148,252425,277,EVM,mRNA,57184,307950,277,1.00
ptg033723l,1751659,1751990,331,EVM,mRNA,1747483,1805143,331,1.00
ptg033859l,9543,9881,338,EVM,mRNA,9631,10980,251,0.74
ptg033892l,4785,5120,335,EVM,mRNA,1147,148021,335,1.00
ptg033933l,495627,495911,284,EVM,mRNA,293890,816771,284,1.00
ptg034053l,301237,301523,286,EVM,mRNA,37111,351538,286,1.00
ptg034120l,56904,57234,330,EVM,mRNA,2787,189637,330,1.00
ptg034307l,341026,341345,319,EVM,mRNA,116522,481015,319,1.00
ptg034374l,134208,134519,311,EVM,mRNA,131452,173691,311,1.00
ptg034400l,2561110,2561398,288,EVM,mRNA,2477671,2570531,288,1.00
ptg034495l,707232,707523,291,EVM,mRNA,137276,2727089,291,1.00
ptg034495l,819867,820188,321,EVM,mRNA,137276,2727089,321,1.00
ptg034523l,387613,387905,292,EVM,mRNA,108322,488559,292,1.00
ptg034538l,110609,110891,282,EVM,mRNA,88964,403486,282,1.00
ptg034538l,203395,203706,311,EVM,mRNA,88964,403486,311,1.00
ptg034627l,538067,538390,323,EVM,mRNA,408106,548276,323,1.00
ptg034726l,862275,862591,316,EVM,mRNA,862508,1036016,84,0.27
ptg034847l,281149,281478,329,EVM,mRNA,121935,358508,329,1.00
ptg034931l,97209,97516,307,EVM,mRNA,3131,172212,307,1.00
ptg034990l,1990308,1990615,307,EVM,mRNA,1768459,2204387,307,1.00
ptg035129l,40083,40375,292,EVM,mRNA,24025,341682,292,1.00
ptg035232l,548564,548880,316,EVM,mRNA,292925,595888,316,1.00
ptg035368l,193521,193817,296,EVM,mRNA,41659,197163,296,1.00
ptg035636l,1362431,1362709,278,EVM,mRNA,357391,3359226,278,1.00
ptg035636l,2510466,2510780,314,EVM,mRNA,357391,3359226,314,1.00
ptg035694l,508415,508707,292,EVM,mRNA,6605,789599,292,1.00
ptg035734l,255544,255883,339,EVM,mRNA,21764,808553,339,1.00
ptg035927l,59561,59874,313,EVM,mRNA,6497,205012,313,1.00
ptg035989l,35003,35308,305,EVM,mRNA,1355,135326,305,1.00
ptg035989l,132346,132656,310,EVM,mRNA,1355,135326,310,1.00
ptg036034l,216847,217163,316,EVM,mRNA,9512,325919,316,1.00
ptg036193l,214481,214762,281,EVM,mRNA,18054,240191,281,1.00
ptg036223l,124137,124409,272,EVM,mRNA,34534,328887,272,1.00
ptg036223l,188806,189122,316,EVM,mRNA,34534,328887,316,1.00
ptg036480l,319237,319542,305,EVM,mRNA,103212,566334,305,1.00
ptg036533l,18028,18351,323,EVM,mRNA,13317,24190,323,1.00
ptg036584l,217638,217927,289,EVM,mRNA,123993,225837,289,1.00
ptg036664l,72712,73008,296,EVM,mRNA,64558,288302,296,1.00
ptg036866l,1021109,1021382,273,EVM,mRNA,74417,1569393,273,1.00
ptg037173l,138597,138905,308,EVM,mRNA,379,408563,308,1.00
ptg037327l,215615,215921,306,EVM,mRNA,186365,255285,306,1.00
ptg037498l,598308,598548,240,EVM,mRNA,305422,607345,240,1.00
ptg037615l,312673,312977,304,EVM,mRNA,57205,1402951,304,1.00
ptg037615l,5608029,5608327,298,EVM,mRNA,3134386,5768312,298,1.00
ptg037804l,46399,46697,298,EVM,mRNA,6172,50302,298,1.00
ptg037939l,535895,536180,285,EVM,mRNA,38575,789296,285,1.00
ptg038073l,102953,103250,297,EVM,mRNA,103000,173013,251,0.85
ptg038084l,862923,863221,298,EVM,mRNA,852471,992081,298,1.00
ptg038109l,200329,200639,310,EVM,mRNA,75512,218918,310,1.00
ptg038227l,702441,702734,293,EVM,mRNA,670492,923352,293,1.00
ptg038227l,735405,735714,309,EVM,mRNA,670492,923352,309,1.00
ptg038237l,699195,699511,316,EVM,mRNA,157592,1897548,316,1.00
ptg038237l,722402,722725,323,EVM,mRNA,157592,1897548,323,1.00
ptg038237l,1342467,1342747,280,EVM,mRNA,157592,1897548,280,1.00
ptg038239l,339607,339914,307,EVM,mRNA,290369,440293,307,1.00
ptg038272l,178675,178954,279,EVM,mRNA,116706,328151,279,1.00
ptg038294l,132294,132582,288,EVM,mRNA,83,166832,288,1.00
ptg038357l,1538449,1538765,316,EVM,mRNA,1340680,1596996,316,1.00
ptg038398l,37106,37433,327,EVM,mRNA,11375,70902,327,1.00
ptg038417l,60966,61275,309,EVM,mRNA,487,318339,309,1.00
ptg038437l,187025,187312,287,EVM,mRNA,116414,246765,287,1.00
ptg038673l,19738,20046,308,EVM,mRNA,456,156730,308,1.00
ptg038673l,143937,144220,283,EVM,mRNA,456,156730,283,1.00
ptg038679l,302767,303048,281,EVM,mRNA,284556,475258,281,1.00
ptg038705l,61962,62259,297,EVM,mRNA,56036,125366,297,1.00
ptg038912l,124972,125261,289,EVM,mRNA,15929,209168,289,1.00
ptg039121l,124814,125087,273,EVM,mRNA,21205,126878,273,1.00
ptg039452l,1984497,1984803,306,EVM,mRNA,18915,2336543,306,1.00
ptg039452l,2012256,2012572,316,EVM,mRNA,18915,2336543,316,1.00
ptg039547l,281312,281636,324,EVM,mRNA,219592,367890,324,1.00
ptg039549l,2843049,2843356,307,EVM,mRNA,2665869,3117568,307,1.00
ptg039789l,1533338,1533640,302,EVM,mRNA,528003,2097300,302,1.00
ptg039888l,204640,204922,282,EVM,mRNA,135077,232776,282,1.00
ptg040065l,815104,815424,320,EVM,mRNA,253983,1755154,320,1.00
ptg040204l,1968670,1968921,251,EVM,mRNA,1965572,2047265,251,1.00
ptg040204l,2961503,2961813,310,EVM,mRNA,2299683,5557079,310,1.00
ptg040204l,4095212,4095533,321,EVM,mRNA,2299683,5557079,321,1.00
ptg040204l,5242061,5242347,286,EVM,mRNA,2299683,5557079,286,1.00
ptg040380l,137519,137841,322,EVM,mRNA,106400,283354,322,1.00
ptg040380l,204124,204391,267,EVM,mRNA,106400,283354,267,1.00
ptg040380l,274095,274372,277,EVM,mRNA,106400,283354,277,1.00
ptg040380l,1819239,1819516,277,EVM,mRNA,1635112,1954278,277,1.00
ptg040911l,201492,201804,312,EVM,mRNA,57932,203136,312,1.00
ptg041372l,105380,105689,309,EVM,mRNA,15601,132598,309,1.00
ptg041375l,88234,88528,294,EVM,mRNA,27850,89873,294,1.00
ptg041564l,451081,451404,323,EVM,mRNA,115673,2614828,323,1.00
ptg041564l,573186,573459,273,EVM,mRNA,115673,2614828,273,1.00
ptg041564l,668235,668567,332,EVM,mRNA,115673,2614828,332,1.00
ptg041564l,1249429,1249729,300,EVM,mRNA,115673,2614828,300,1.00
ptg041813l,365861,366161,300,EVM,mRNA,203185,746122,300,1.00
ptg041813l,563681,564007,326,EVM,mRNA,203185,746122,326,1.00
ptg042415l,819318,819621,303,EVM,mRNA,673908,1320883,303,1.00
ptg042482l,45768,46080,312,EVM,mRNA,6023,63418,312,1.00
ptg042616l,362463,362776,313,EVM,mRNA,190067,424991,313,1.00
ptg042616l,1044574,1044871,297,EVM,mRNA,740146,1148769,297,1.00
ptg042616l,1045340,1045668,328,EVM,mRNA,740146,1148769,328,1.00
ptg042644l,108263,108584,321,EVM,mRNA,37745,118505,321,1.00
ptg042824l,64304,64600,296,EVM,mRNA,3948,66234,296,1.00
ptg043603l,119744,120026,282,GeneWise,mRNA,116479,143503,282,1.00
ptg043615l,697537,697845,308,EVM,mRNA,4619,1668313,308,1.00
ptg043615l,1060412,1060714,302,EVM,mRNA,4619,1668313,302,1.00
ptg043615l,1085700,1085982,282,EVM,mRNA,4619,1668313,282,1.00
ptg043615l,1146389,1146691,302,EVM,mRNA,4619,1668313,302,1.00
ptg043860l,35041,35369,328,EVM,mRNA,200,61796,328,1.00
ptg044481l,155552,155875,323,EVM,mRNA,148249,247051,323,1.00
ptg044989l,92016,92329,313,EVM,mRNA,26223,349756,313,1.00
ptg044989l,110976,111261,285,EVM,mRNA,26223,349756,285,1.00
ptg045224l,83500,83815,315,EVM,mRNA,36334,181786,315,1.00
ptg045588l,18298,18613,315,EVM,mRNA,1716,44199,315,1.00
ptg045652l,535661,535975,314,EVM,mRNA,282802,554796,314,1.00
ptg045652l,550441,550728,287,EVM,mRNA,282802,554796,287,1.00
ptg046538l,1148906,1149185,279,EVM,mRNA,380521,1436687,279,1.00
ptg046538l,1387545,1387847,302,EVM,mRNA,380521,1436687,302,1.00
ptg046574l,2062150,2062461,311,EVM,mRNA,1936709,2373172,311,1.00
ptg046659l,1493235,1493532,297,EVM,mRNA,873930,1496827,297,1.00
ptg047540l,19799,20110,311,EVM,mRNA,2960,45380,311,1.00
ptg047602l,62643,62940,297,EVM,mRNA,56512,70201,297,1.00
ptg047790l,110031,110309,278,EVM,mRNA,42119,284185,278,1.00
ptg048676l,31631,31977,346,EVM,mRNA,19112,39072,346,1.00
ptg050038l,306926,307227,301,EVM,mRNA,127306,586949,301,1.00
ptg050256l,328244,328534,290,EVM,mRNA,937,1034281,290,1.00
ptg050256l,424352,424639,287,EVM,mRNA,937,1034281,287,1.00
ptg050782l,10673,10986,313,EVM,mRNA,1069,15198,313,1.00
ptg051921l,385619,385919,300,EVM,mRNA,319835,488781,300,1.00
ptg052241l,1018898,1019233,335,EVM,mRNA,602374,1019200,302,0.90
ptg052562l,282216,282532,316,EVM,mRNA,102837,290568,316,1.00
ptg053617l,348719,349018,299,EVM,mRNA,208704,477253,299,1.00
ptg054642l,119185,119487,302,EVM,mRNA,26301,344155,302,1.00
ptg054642l,205474,205802,328,EVM,mRNA,26301,344155,328,1.00
ptg054642l,291880,292202,322,EVM,mRNA,26301,344155,322,1.00
ptg054830l,244691,245007,316,EVM,mRNA,55908,280691,316,1.00
ptg055436l,91314,91603,289,EVM,mRNA,86936,92640,289,1.00
ptg057195l,1066621,1066943,322,EVM,mRNA,608480,1331129,322,1.00
ptg000002l,184842,185142,300,EVM,mRNA,46146,4527702,300,1.00
ptg000002l,1757469,1757782,313,EVM,mRNA,46146,4527702,313,1.00
ptg000002l,1908279,1908582,303,EVM,mRNA,46146,4527702,303,1.00
ptg000002l,4304798,4305097,299,EVM,mRNA,46146,4527702,299,1.00
ptg000005l,4323209,4323535,326,EVM,mRNA,4105573,7068508,326,1.00
ptg000005l,4768667,4768975,308,EVM,mRNA,4105573,7068508,308,1.00
ptg000005l,4774721,4774992,271,EVM,mRNA,4105573,7068508,271,1.00
ptg000006l,2695740,2696029,289,EVM,mRNA,1147605,4254885,289,1.00
ptg000006l,3774075,3774384,309,EVM,mRNA,1147605,4254885,309,1.00
ptg000008l,760387,760661,274,EVM,mRNA,699434,1443564,274,1.00
ptg000008l,2281922,2282236,314,EVM,mRNA,1620057,3476985,314,1.00
ptg000008l,2877150,2877443,293,EVM,mRNA,1620057,3476985,293,1.00
ptg000008l,3759899,3760197,298,EVM,mRNA,3677349,4020156,298,1.00
ptg000010l,933465,933792,327,EVM,mRNA,894834,1367318,327,1.00
ptg000012l,192208,192505,297,EVM,mRNA,4466,852547,297,1.00
ptg000012l,481036,481349,313,EVM,mRNA,4466,852547,313,1.00
ptg000012l,494487,494789,302,EVM,mRNA,4466,852547,302,1.00
ptg000012l,1220576,1220838,262,EVM,mRNA,1174082,1868809,262,1.00
ptg000017l,232043,232349,306,EVM,mRNA,26148,1379437,306,1.00
ptg000017l,1231272,1231552,280,EVM,mRNA,26148,1379437,280,1.00
ptg000019l,845191,845484,293,EVM,mRNA,166508,1318922,293,1.00
ptg000020l,487621,487907,286,EVM,mRNA,20440,1311707,286,1.00
ptg000020l,2252993,2253303,310,EVM,mRNA,2191420,2787481,310,1.00
ptg000023l,2374781,2375060,279,EVM,mRNA,1758092,3235798,279,1.00
ptg000024l,2665313,2665608,295,EVM,mRNA,2518034,2760365,295,1.00
ptg000024l,3110425,3110708,283,EVM,mRNA,2893721,3429021,283,1.00
ptg000024l,3160111,3160414,303,EVM,mRNA,2893721,3429021,303,1.00
ptg000024l,5827563,5827870,307,EVM,mRNA,4797036,5959847,307,1.00
ptg000024l,5877911,5878218,307,EVM,mRNA,4797036,5959847,307,1.00
ptg000027l,776435,776750,315,EVM,mRNA,372562,882562,315,1.00
ptg000028l,1191540,1191823,283,EVM,mRNA,842462,1280167,283,1.00
ptg000035l,579698,579996,298,EVM,mRNA,388508,2578542,298,1.00
ptg000037l,1503712,1504007,295,EVM,mRNA,472727,1873051,295,1.00
ptg000037l,3078605,3078923,318,EVM,mRNA,3029668,3652283,318,1.00
ptg000037l,3218254,3218582,328,EVM,mRNA,3029668,3652283,328,1.00
ptg000037l,3448981,3449307,326,EVM,mRNA,3029668,3652283,326,1.00
ptg000037l,3573281,3573583,302,EVM,mRNA,3029668,3652283,302,1.00
ptg000037l,4454077,4454398,321,EVM,mRNA,4393546,4816887,321,1.00
ptg000039l,4383643,4383946,303,EVM,mRNA,2881423,4489599,303,1.00
ptg000039l,4389784,4390085,301,EVM,mRNA,2881423,4489599,301,1.00
ptg000042l,1429813,1430120,307,EVM,mRNA,1305237,2580709,307,1.00
ptg000043l,824224,824516,292,EVM,mRNA,797370,2450439,292,1.00
ptg000043l,927237,927553,316,EVM,mRNA,797370,2450439,316,1.00
ptg000043l,1229327,1229607,280,EVM,mRNA,797370,2450439,280,1.00
ptg000043l,2250678,2250994,316,EVM,mRNA,797370,2450439,316,1.00
ptg000044l,1735601,1735915,314,EVM,mRNA,1259154,2127049,314,1.00
ptg000044l,2078189,2078506,317,EVM,mRNA,1259154,2127049,317,1.00
ptg000046l,515125,515397,272,EVM,mRNA,266149,978015,272,1.00
ptg000048l,1234411,1234699,288,EVM,mRNA,1126939,2341187,288,1.00
ptg000048l,3111320,3111627,307,EVM,mRNA,2470593,4396555,307,1.00
ptg000048l,4169851,4170132,281,EVM,mRNA,2470593,4396555,281,1.00
ptg000048l,4326392,4326709,317,EVM,mRNA,2470593,4396555,317,1.00
ptg000048l,6208551,6208864,313,EVM,mRNA,4489515,6515745,313,1.00
ptg000048l,7848632,7848915,283,EVM,mRNA,7063913,9875443,283,1.00
ptg000048l,7927842,7928138,296,EVM,mRNA,7063913,9875443,296,1.00
ptg000048l,8107749,8108016,267,EVM,mRNA,7063913,9875443,267,1.00
ptg000048l,12617803,12618107,304,EVM,mRNA,11771990,12709159,304,1.00
ptg000048l,14107608,14107897,289,EVM,mRNA,13609286,16499777,289,1.00
ptg000048l,14712663,14712952,289,EVM,mRNA,13609286,16499777,289,1.00
ptg000048l,14891348,14891657,309,EVM,mRNA,13609286,16499777,309,1.00
ptg000048l,15011409,15011680,271,EVM,mRNA,13609286,16499777,271,1.00
ptg000048l,15017701,15018008,307,EVM,mRNA,13609286,16499777,307,1.00
ptg000048l,15597620,15597901,281,EVM,mRNA,13609286,16499777,281,1.00
ptg000048l,15657574,15657864,290,EVM,mRNA,13609286,16499777,290,1.00
ptg000051l,494986,495282,296,EVM,mRNA,430404,576239,296,1.00
ptg000052l,56468,56766,298,EVM,mRNA,36847,1735268,298,1.00
ptg000052l,967130,967418,288,EVM,mRNA,36847,1735268,288,1.00
ptg000052l,1417430,1417744,314,EVM,mRNA,36847,1735268,314,1.00
ptg000055l,459802,460132,330,EVM,mRNA,368670,761688,330,1.00
ptg000055l,532563,532878,315,EVM,mRNA,368670,761688,315,1.00
ptg000055l,622603,622893,290,EVM,mRNA,368670,761688,290,1.00
ptg000057l,1866889,1867182,293,EVM,mRNA,1556594,1880937,293,1.00
ptg000061l,76517,76803,286,EVM,mRNA,14774,791807,286,1.00
ptg000062l,1192111,1192410,299,EVM,mRNA,680220,3390047,299,1.00
ptg000062l,1723766,1724099,333,EVM,mRNA,680220,3390047,333,1.00
ptg000062l,2457699,2457985,286,EVM,mRNA,680220,3390047,286,1.00
ptg000062l,2900429,2900710,281,EVM,mRNA,680220,3390047,281,1.00
ptg000063l,1269349,1269665,316,EVM,mRNA,89735,1966211,316,1.00
ptg000065l,1203937,1204260,323,EVM,mRNA,137152,2451324,323,1.00
ptg000065l,1867881,1868177,296,EVM,mRNA,137152,2451324,296,1.00
ptg000065l,2656371,2656678,307,EVM,mRNA,2655598,2905386,307,1.00
ptg000068l,948587,948897,310,EVM,mRNA,109806,1962004,310,1.00
ptg000068l,1070674,1070983,309,EVM,mRNA,109806,1962004,309,1.00
ptg000069l,2587376,2587680,304,EVM,mRNA,1757704,3331821,304,1.00
ptg000070l,193904,194230,326,EVM,mRNA,18570,194078,174,0.53
ptg000071l,2280143,2280428,285,EVM,mRNA,2255240,2574360,285,1.00
ptg000071l,2404654,2404966,312,EVM,mRNA,2255240,2574360,312,1.00
ptg000071l,2999043,2999370,327,EVM,mRNA,2857943,3462612,327,1.00
ptg000071l,5602261,5602536,275,EVM,mRNA,5177459,5753075,275,1.00
ptg000071l,5697812,5698123,311,EVM,mRNA,5177459,5753075,311,1.00
ptg000071l,6076865,6077163,298,EVM,mRNA,6032304,6574133,298,1.00
ptg000074l,2619453,2619731,278,EVM,mRNA,2534491,2946336,278,1.00
ptg000074l,2672666,2672945,279,EVM,mRNA,2534491,2946336,279,1.00
ptg000076l,230116,230410,294,EVM,mRNA,45572,529312,294,1.00
ptg000078l,897914,898236,322,EVM,mRNA,829253,4219199,322,1.00
ptg000078l,1068815,1069104,289,EVM,mRNA,829253,4219199,289,1.00
ptg000078l,1278169,1278494,325,EVM,mRNA,829253,4219199,325,1.00
ptg000078l,1469799,1470080,281,EVM,mRNA,829253,4219199,281,1.00
ptg000078l,2174583,2174893,310,EVM,mRNA,829253,4219199,310,1.00
ptg000078l,3103972,3104280,308,EVM,mRNA,829253,4219199,308,1.00
ptg000079l,1816428,1816753,325,EVM,mRNA,1628244,1989761,325,1.00
ptg000079l,1889334,1889635,301,EVM,mRNA,1628244,1989761,301,1.00
ptg000080l,3117094,3117379,285,EVM,mRNA,3048490,3287607,285,1.00
ptg000080l,3233117,3233398,281,EVM,mRNA,3048490,3287607,281,1.00
ptg000081l,164453,164785,332,EVM,mRNA,9569,2605966,332,1.00
ptg000082l,5578404,5578700,296,EVM,mRNA,4759423,6231614,296,1.00
ptg000082l,5743542,5743830,288,EVM,mRNA,4759423,6231614,288,1.00
ptg000084l,226260,226583,323,EVM,mRNA,35834,407136,323,1.00
ptg000085l,768381,768706,325,EVM,mRNA,254752,3353483,325,1.00
ptg000085l,1008485,1008780,295,EVM,mRNA,254752,3353483,295,1.00
ptg000085l,4239934,4240255,321,EVM,mRNA,3774619,4447363,321,1.00
ptg000085l,4279849,4280169,320,EVM,mRNA,3774619,4447363,320,1.00
ptg000085l,4583774,4584082,308,EVM,mRNA,4447830,5217106,308,1.00
ptg000085l,4997365,4997650,285,EVM,mRNA,4447830,5217106,285,1.00
ptg000086l,679747,680029,282,EVM,mRNA,18327,795961,282,1.00
ptg000086l,984814,985129,315,EVM,mRNA,984119,1147818,315,1.00
ptg000088l,11749,12029,280,EVM,mRNA,5,147205,280,1.00
ptg000089l,75888,76221,333,EVM,mRNA,74384,1433661,333,1.00
ptg000089l,346559,346862,303,EVM,mRNA,74384,1433661,303,1.00
ptg000090l,686058,686345,287,EVM,mRNA,364228,761987,287,1.00
ptg000092l,1058551,1058816,265,EVM,mRNA,883322,1346189,265,1.00
ptg000093l,48352,48650,298,EVM,mRNA,22575,220669,298,1.00
ptg000094l,3063532,3063832,300,EVM,mRNA,2489760,3137076,300,1.00
ptg000094l,3226180,3226479,299,EVM,mRNA,3145188,3322418,299,1.00
ptg000094l,3552550,3552863,313,EVM,mRNA,3480382,4285567,313,1.00
ptg000094l,7634743,7635068,325,EVM,mRNA,7566919,7728833,325,1.00
ptg000094l,7820191,7820473,282,EVM,mRNA,7779674,8182876,282,1.00
ptg000096l,1118293,1118604,311,EVM,mRNA,957460,3859327,311,1.00
ptg000096l,1655820,1656134,314,EVM,mRNA,957460,3859327,314,1.00
ptg000096l,1660227,1660528,301,EVM,mRNA,957460,3859327,301,1.00
ptg000096l,3435566,3435874,308,EVM,mRNA,957460,3859327,308,1.00
ptg000098l,450469,450774,305,EVM,mRNA,408165,3158393,305,1.00
ptg000098l,547663,547976,313,EVM,mRNA,408165,3158393,313,1.00
ptg000098l,1061994,1062285,291,EVM,mRNA,408165,3158393,291,1.00
ptg000098l,1303687,1304001,314,EVM,mRNA,408165,3158393,314,1.00
ptg000098l,1749011,1749324,313,EVM,mRNA,408165,3158393,313,1.00
ptg000098l,2043186,2043497,311,EVM,mRNA,408165,3158393,311,1.00
ptg000098l,2767302,2767590,288,EVM,mRNA,408165,3158393,288,1.00
ptg000098l,2905524,2905822,298,EVM,mRNA,408165,3158393,298,1.00
ptg000100l,862856,863182,326,EVM,mRNA,159073,1055643,326,1.00
ptg000103l,852643,852952,309,EVM,mRNA,331929,861908,309,1.00
ptg000104l,2586976,2587307,331,EVM,mRNA,2442853,2625590,331,1.00
ptg000104l,3987267,3987555,288,EVM,mRNA,2783010,4210803,288,1.00
ptg000104l,5110942,5111227,285,EVM,mRNA,5053288,5115074,285,1.00
ptg000104l,5600594,5600892,298,EVM,mRNA,5302444,5870268,298,1.00
ptg000104l,6162069,6162381,312,EVM,mRNA,6002881,7118950,312,1.00
ptg000104l,6629850,6630168,318,EVM,mRNA,6002881,7118950,318,1.00
ptg000104l,6940322,6940645,323,EVM,mRNA,6002881,7118950,323,1.00
ptg000104l,9549707,9550018,311,EVM,mRNA,9185228,10880176,311,1.00
ptg000104l,9713306,9713599,293,EVM,mRNA,9185228,10880176,293,1.00
ptg000104l,9736560,9736878,318,EVM,mRNA,9185228,10880176,318,1.00
ptg000104l,9934107,9934418,311,EVM,mRNA,9185228,10880176,311,1.00
ptg000104l,10300706,10301029,323,EVM,mRNA,9185228,10880176,323,1.00
ptg000104l,10532986,10533281,295,EVM,mRNA,9185228,10880176,295,1.00
ptg000104l,10542938,10543260,322,EVM,mRNA,9185228,10880176,322,1.00
ptg000107l,7377589,7377877,288,EVM,mRNA,6686796,8114370,288,1.00
ptg000107l,8682609,8682887,278,EVM,mRNA,8462154,8753491,278,1.00
ptg000107l,8873200,8873508,308,EVM,mRNA,8816631,9649395,308,1.00
ptg000107l,9468560,9468881,321,EVM,mRNA,8816631,9649395,321,1.00
ptg000109l,306094,306364,270,EVM,mRNA,17928,364413,270,1.00
ptg000111l,2405278,2405569,291,EVM,mRNA,1512074,2715737,291,1.00
ptg000113l,888995,889295,300,EVM,mRNA,366490,1213046,300,1.00
ptg000115l,443961,444253,292,EVM,mRNA,276346,1067676,292,1.00
ptg000115l,784456,784784,328,EVM,mRNA,276346,1067676,328,1.00
ptg000119l,984936,985255,319,EVM,mRNA,883581,2764029,319,1.00
ptg000121l,403776,404091,315,EVM,mRNA,101422,567535,315,1.00
ptg000121l,407805,408096,291,EVM,mRNA,101422,567535,291,1.00
ptg000121l,1757394,1757697,303,EVM,mRNA,1031671,3010225,303,1.00
ptg000121l,2141169,2141456,287,EVM,mRNA,1031671,3010225,287,1.00
ptg000121l,2513957,2514304,347,EVM,mRNA,1031671,3010225,347,1.00
ptg000122l,2849308,2849603,295,EVM,mRNA,2534648,3257800,295,1.00
ptg000122l,3245735,3246055,320,EVM,mRNA,2534648,3257800,320,1.00
ptg000122l,3273740,3274053,313,EVM,mRNA,3264587,3300606,313,1.00
ptg000122l,4743285,4743555,270,EVM,mRNA,3875265,5500366,270,1.00
ptg000123l,3644832,3645151,319,EVM,mRNA,3194314,4351153,319,1.00
ptg000123l,4186393,4186687,294,EVM,mRNA,3194314,4351153,294,1.00
ptg000123l,5411967,5412289,322,EVM,mRNA,4833841,5446301,322,1.00
ptg000124l,102845,103157,312,EVM,mRNA,22159,1251749,312,1.00
ptg000124l,118156,118473,317,EVM,mRNA,22159,1251749,317,1.00
ptg000124l,880341,880646,305,EVM,mRNA,22159,1251749,305,1.00
ptg000126l,1775094,1775382,288,EVM,mRNA,1534956,1837617,288,1.00
ptg000127l,2732624,2732921,297,EVM,mRNA,1852090,3145142,297,1.00
ptg000128l,1953681,1953950,269,EVM,mRNA,1641898,2228306,269,1.00
ptg000128l,2151878,2152193,315,EVM,mRNA,1641898,2228306,315,1.00
ptg000130l,1658756,1659048,292,EVM,mRNA,1385814,2707046,292,1.00
ptg000130l,1716618,1716904,286,EVM,mRNA,1385814,2707046,286,1.00
ptg000130l,2666449,2666782,333,EVM,mRNA,1385814,2707046,333,1.00
ptg000131l,2692361,2692656,295,EVM,mRNA,1824454,4418067,295,1.00
ptg000131l,2995683,2996007,324,EVM,mRNA,1824454,4418067,324,1.00
ptg000131l,3103472,3103759,287,EVM,mRNA,1824454,4418067,287,1.00
ptg000131l,3318928,3319250,322,EVM,mRNA,1824454,4418067,322,1.00
ptg000131l,5059217,5059500,283,EVM,mRNA,4894894,5144474,283,1.00
ptg000131l,6878203,6878504,301,EVM,mRNA,6740554,6998299,301,1.00
ptg000135l,388858,389183,325,EVM,mRNA,150329,589949,325,1.00
ptg000136l,483795,484093,298,EVM,mRNA,114325,553319,298,1.00
ptg000137l,181507,181806,299,EVM,mRNA,2066,4909130,299,1.00
ptg000137l,1144577,1144879,302,EVM,mRNA,2066,4909130,302,1.00
ptg000137l,1292011,1292320,309,EVM,mRNA,2066,4909130,309,1.00
ptg000137l,2543307,2543616,309,EVM,mRNA,2066,4909130,309,1.00
ptg000137l,2822218,2822526,308,EVM,mRNA,2066,4909130,308,1.00
ptg000138l,612306,612624,318,EVM,mRNA,518411,1005374,318,1.00
ptg000140l,1794288,1794624,336,EVM,mRNA,18673,2139737,336,1.00
ptg000140l,2075461,2075726,265,EVM,mRNA,18673,2139737,265,1.00
ptg000142l,592166,592473,307,EVM,mRNA,443005,1980528,307,1.00
ptg000147l,1281472,1281783,311,EVM,mRNA,965370,1454819,311,1.00
ptg000147l,2030364,2030679,315,EVM,mRNA,1827026,2532639,315,1.00
ptg000147l,2143292,2143591,299,EVM,mRNA,1827026,2532639,299,1.00
ptg000147l,2683723,2684011,288,EVM,mRNA,2645525,3197844,288,1.00
ptg000147l,5348264,5348564,300,EVM,mRNA,5028181,5369550,300,1.00
ptg000148l,1613557,1613863,306,EVM,mRNA,1345159,1846314,306,1.00
ptg000148l,2180944,2181236,292,EVM,mRNA,2128606,2260474,292,1.00
ptg000151l,1707878,1708195,317,EVM,mRNA,1529554,2139986,317,1.00
ptg000152l,1061636,1061934,298,EVM,mRNA,941110,1317438,298,1.00
ptg000152l,1177368,1177644,276,EVM,mRNA,941110,1317438,276,1.00
ptg000155l,703678,703993,315,EVM,mRNA,606767,2549278,315,1.00
ptg000155l,1566251,1566519,268,EVM,mRNA,606767,2549278,268,1.00
ptg000155l,2027794,2028077,283,EVM,mRNA,606767,2549278,283,1.00
ptg000155l,2442500,2442823,323,EVM,mRNA,606767,2549278,323,1.00
ptg000156l,4191684,4191985,301,EVM,mRNA,3881833,4273335,301,1.00
ptg000156l,6435400,6435685,285,EVM,mRNA,5925701,6465921,285,1.00
ptg000157l,2306542,2306841,299,EVM,mRNA,2240766,2392819,299,1.00
ptg000159l,277585,277880,295,EVM,mRNA,205428,309612,295,1.00
ptg000160l,1006139,1006428,289,EVM,mRNA,616105,1244387,289,1.00
ptg000161l,1146300,1146590,290,EVM,mRNA,4050,1629896,290,1.00
ptg000161l,5378148,5378460,312,EVM,mRNA,5351569,5528712,312,1.00
ptg000164l,382263,382526,263,EVM,mRNA,292902,796038,263,1.00
ptg000168l,2391661,2391976,315,EVM,mRNA,2351189,2580692,315,1.00
ptg000168l,2951802,2952099,297,EVM,mRNA,2691341,2984753,297,1.00
ptg000168l,2956166,2956460,294,EVM,mRNA,2691341,2984753,294,1.00
ptg000170l,2083945,2084206,261,EVM,mRNA,3507,3233451,261,1.00
ptg000170l,2201292,2201600,308,EVM,mRNA,3507,3233451,308,1.00
ptg000171l,652070,652387,317,EVM,mRNA,588971,1118695,317,1.00
ptg000171l,1062785,1063108,323,EVM,mRNA,588971,1118695,323,1.00
ptg000175l,1781099,1781395,296,EVM,mRNA,1119027,2244956,296,1.00
ptg000180l,7311705,7312022,317,EVM,mRNA,7297647,7437541,317,1.00
ptg000180l,7383111,7383410,299,EVM,mRNA,7297647,7437541,299,1.00
ptg000186l,1932909,1933208,299,EVM,mRNA,1508805,1977176,299,1.00
ptg000188l,1239962,1240302,340,EVM,mRNA,1215933,1416825,340,1.00
ptg000190l,386470,386753,283,EVM,mRNA,87531,573077,283,1.00
ptg000193l,131453,131769,316,EVM,mRNA,1412,161090,316,1.00
ptg000195l,1432550,1432856,306,EVM,mRNA,1415789,1624793,306,1.00
ptg000197l,2541628,2541926,298,EVM,mRNA,2391457,2907469,298,1.00
ptg000197l,2591204,2591521,317,EVM,mRNA,2391457,2907469,317,1.00
ptg000197l,3037245,3037561,316,EVM,mRNA,3023625,4406254,316,1.00
ptg000200l,704091,704422,331,EVM,mRNA,672080,715432,331,1.00
ptg000200l,1286880,1287171,291,EVM,mRNA,1184546,3285826,291,1.00
ptg000200l,1923964,1924293,329,EVM,mRNA,1184546,3285826,329,1.00
ptg000200l,3535075,3535401,326,EVM,mRNA,3532902,6134524,326,1.00
ptg000200l,4195578,4195861,283,EVM,mRNA,3532902,6134524,283,1.00
ptg000200l,5088598,5088895,297,EVM,mRNA,3532902,6134524,297,1.00
ptg000200l,5217063,5217351,288,EVM,mRNA,3532902,6134524,288,1.00
ptg000200l,5397105,5397396,291,EVM,mRNA,3532902,6134524,291,1.00
ptg000200l,5999697,5999998,301,EVM,mRNA,3532902,6134524,301,1.00
ptg000201l,429289,429593,304,EVM,mRNA,147003,603709,304,1.00
ptg000201l,511528,511832,304,EVM,mRNA,147003,603709,304,1.00
ptg000203l,134891,135166,275,EVM,mRNA,48996,1394637,275,1.00
ptg000203l,306376,306664,288,EVM,mRNA,48996,1394637,288,1.00
ptg000203l,1304377,1304652,275,EVM,mRNA,48996,1394637,275,1.00
ptg000206l,520480,520779,299,EVM,mRNA,354300,4456616,299,1.00
ptg000206l,879377,879637,260,EVM,mRNA,354300,4456616,260,1.00
ptg000206l,2038207,2038479,272,EVM,mRNA,354300,4456616,272,1.00
ptg000206l,2154277,2154584,307,EVM,mRNA,354300,4456616,307,1.00
ptg000206l,2587022,2587323,301,EVM,mRNA,354300,4456616,301,1.00
ptg000206l,2992153,2992434,281,EVM,mRNA,354300,4456616,281,1.00
ptg000206l,3383055,3383353,298,EVM,mRNA,354300,4456616,298,1.00
ptg000206l,3799693,3799975,282,EVM,mRNA,354300,4456616,282,1.00
ptg000207l,304458,304761,303,EVM,mRNA,200080,1329578,303,1.00
ptg000208l,350083,350382,299,EVM,mRNA,42265,786803,299,1.00
ptg000208l,724963,725299,336,EVM,mRNA,42265,786803,336,1.00
ptg000208l,773107,773403,296,EVM,mRNA,42265,786803,296,1.00
ptg000209l,2757393,2757681,288,EVM,mRNA,2304663,2797807,288,1.00
ptg000209l,3182422,3182702,280,EVM,mRNA,3009178,4158957,280,1.00
ptg000209l,4099603,4099902,299,EVM,mRNA,3009178,4158957,299,1.00
ptg000209l,5656244,5656578,334,EVM,mRNA,5593974,5954146,334,1.00
ptg000210l,142425,142741,316,EVM,mRNA,1724,1815820,316,1.00
ptg000210l,3165711,3165988,277,EVM,mRNA,2546470,4858239,277,1.00
ptg000210l,3380519,3380835,316,EVM,mRNA,2546470,4858239,316,1.00
ptg000210l,4834420,4834732,312,EVM,mRNA,2546470,4858239,312,1.00
ptg000210l,5028185,5028506,321,EVM,mRNA,4871301,5058043,321,1.00
ptg000211l,540758,541055,297,EVM,mRNA,346911,1827539,297,1.00
ptg000212l,1545283,1545605,322,EVM,mRNA,1448450,1691882,322,1.00
ptg000215l,2155091,2155405,314,EVM,mRNA,2059845,2547407,314,1.00
ptg000218l,2557664,2557947,283,EVM,mRNA,2557743,2931433,205,0.72
ptg000219l,1330064,1330358,294,EVM,mRNA,1155234,1697660,294,1.00
ptg000219l,4345066,4345360,294,EVM,mRNA,2252632,4735888,294,1.00
ptg000219l,4638558,4638861,303,EVM,mRNA,2252632,4735888,303,1.00
ptg000221l,1391322,1391624,302,EVM,mRNA,1338790,1393792,302,1.00
ptg000221l,1451512,1451819,307,EVM,mRNA,1402673,1743167,307,1.00
ptg000221l,2566158,2566490,332,EVM,mRNA,2456088,2798584,332,1.00
ptg000221l,2948679,2948960,281,EVM,mRNA,2822668,2989968,281,1.00
ptg000222l,1833259,1833586,327,EVM,mRNA,1183186,2106358,327,1.00
ptg000222l,2650495,2650793,298,EVM,mRNA,2499407,3043948,298,1.00
ptg000230l,447147,447444,297,EVM,mRNA,281341,1189352,297,1.00
ptg000230l,1085448,1085717,269,EVM,mRNA,281341,1189352,269,1.00
ptg000231l,436051,436345,294,EVM,mRNA,320975,1488792,294,1.00
ptg000231l,449865,450170,305,EVM,mRNA,320975,1488792,305,1.00
ptg000231l,468824,469119,295,EVM,mRNA,320975,1488792,295,1.00
ptg000231l,575118,575435,317,EVM,mRNA,320975,1488792,317,1.00
ptg000232l,1107741,1108035,294,EVM,mRNA,867869,2998219,294,1.00
ptg000232l,1156541,1156849,308,EVM,mRNA,867869,2998219,308,1.00
ptg000232l,2734129,2734438,309,EVM,mRNA,867869,2998219,309,1.00
ptg000232l,2951155,2951459,304,EVM,mRNA,867869,2998219,304,1.00
ptg000234l,3136023,3136294,271,EVM,mRNA,3012522,3392597,271,1.00
ptg000234l,3546260,3546565,305,EVM,mRNA,3497872,3886652,305,1.00
ptg000234l,5566036,5566356,320,EVM,mRNA,5527394,7038804,320,1.00
ptg000234l,7384269,7384590,321,EVM,mRNA,7360983,9021840,321,1.00
ptg000234l,8076729,8077012,283,EVM,mRNA,7360983,9021840,283,1.00
ptg000235l,1771073,1771365,292,EVM,mRNA,1768946,2178881,292,1.00
ptg000235l,2512041,2512348,307,EVM,mRNA,2402373,3174141,307,1.00
ptg000236l,172747,173043,296,EVM,mRNA,81780,174427,296,1.00
ptg000236l,248974,249295,321,EVM,mRNA,210598,419898,321,1.00
ptg000236l,1477578,1477901,323,EVM,mRNA,789518,2505610,323,1.00
ptg000236l,2436789,2437069,280,EVM,mRNA,789518,2505610,280,1.00
ptg000237l,65424,65709,285,EVM,mRNA,60214,154885,285,1.00
ptg000237l,894523,894819,296,EVM,mRNA,790184,1094575,296,1.00
ptg000239l,364508,364814,306,EVM,mRNA,351441,1002967,306,1.00
ptg000239l,576805,577126,321,EVM,mRNA,351441,1002967,321,1.00
ptg000239l,757900,758171,271,EVM,mRNA,351441,1002967,271,1.00
ptg000240l,886990,887269,279,EVM,mRNA,658831,2022383,279,1.00
ptg000241l,233464,233779,315,EVM,mRNA,202259,1245383,315,1.00
ptg000241l,1748577,1748874,297,EVM,mRNA,1687025,1787594,297,1.00
ptg000241l,2148578,2148864,286,EVM,mRNA,2008756,2964669,286,1.00
ptg000241l,4161066,4161350,284,EVM,mRNA,3657826,4696081,284,1.00
ptg000241l,4280798,4281134,336,EVM,mRNA,3657826,4696081,336,1.00
ptg000244l,1161050,1161343,293,EVM,mRNA,912049,3884954,293,1.00
ptg000244l,4095731,4096030,299,EVM,mRNA,4042986,4215662,299,1.00
ptg000244l,4640909,4641201,292,EVM,mRNA,4397333,4729717,292,1.00
ptg000244l,5403113,5403404,291,EVM,mRNA,5290307,5529763,291,1.00
ptg000245l,828511,828822,311,EVM,mRNA,199844,1132224,311,1.00
ptg000245l,1128575,1128892,317,EVM,mRNA,199844,1132224,317,1.00
ptg000247l,210521,210812,291,EVM,mRNA,154708,1506252,291,1.00
ptg000247l,1114004,1114308,304,EVM,mRNA,154708,1506252,304,1.00
ptg000247l,1245945,1246236,291,EVM,mRNA,154708,1506252,291,1.00
ptg000248l,1961221,1961521,300,EVM,mRNA,1629152,2359891,300,1.00
ptg000248l,2294179,2294454,275,EVM,mRNA,1629152,2359891,275,1.00
ptg000248l,3302338,3302649,311,EVM,mRNA,2640716,4057751,311,1.00
ptg000249l,533815,534097,282,EVM,mRNA,44,722638,282,1.00
ptg000249l,2066942,2067256,314,EVM,mRNA,2018311,2096167,314,1.00
ptg000250l,738658,738930,272,EVM,mRNA,658913,4815339,272,1.00
ptg000250l,800847,801160,313,EVM,mRNA,658913,4815339,313,1.00
ptg000250l,1721533,1721840,307,EVM,mRNA,658913,4815339,307,1.00
ptg000250l,1832674,1832999,325,EVM,mRNA,658913,4815339,325,1.00
ptg000250l,2198325,2198603,278,EVM,mRNA,658913,4815339,278,1.00
ptg000250l,2691653,2691972,319,EVM,mRNA,658913,4815339,319,1.00
ptg000250l,4497407,4497717,310,EVM,mRNA,658913,4815339,310,1.00
ptg000251l,1223755,1224077,322,EVM,mRNA,6588,4994820,322,1.00
ptg000251l,1554819,1555121,302,EVM,mRNA,6588,4994820,302,1.00
ptg000251l,2866883,2867163,280,EVM,mRNA,6588,4994820,280,1.00
ptg000251l,3222254,3222561,307,EVM,mRNA,6588,4994820,307,1.00
ptg000251l,3374805,3375099,294,EVM,mRNA,6588,4994820,294,1.00
ptg000251l,3972835,3973134,299,EVM,mRNA,6588,4994820,299,1.00
ptg000251l,3989215,3989517,302,EVM,mRNA,6588,4994820,302,1.00
ptg000251l,4392722,4392996,274,EVM,mRNA,6588,4994820,274,1.00
ptg000251l,4632738,4633021,283,EVM,mRNA,6588,4994820,283,1.00
ptg000251l,4707504,4707793,289,EVM,mRNA,6588,4994820,289,1.00
ptg000251l,4769455,4769764,309,EVM,mRNA,6588,4994820,309,1.00
ptg000252l,895165,895463,298,EVM,mRNA,388878,944043,298,1.00
ptg000255l,511622,511938,316,EVM,mRNA,382998,625613,316,1.00
ptg000258l,382983,383319,336,EVM,mRNA,33007,446220,336,1.00
ptg000258l,708974,709294,320,EVM,mRNA,487076,1491066,320,1.00
ptg000258l,1289948,1290246,298,EVM,mRNA,487076,1491066,298,1.00
ptg000258l,2497260,2497592,332,EVM,mRNA,2029754,2596179,332,1.00
ptg000258l,3562627,3562948,321,EVM,mRNA,3150682,4286353,321,1.00
ptg000267l,2937957,2938288,331,EVM,mRNA,2627133,6826954,331,1.00
ptg000267l,3143387,3143659,272,EVM,mRNA,2627133,6826954,272,1.00
ptg000267l,3496228,3496541,313,EVM,mRNA,2627133,6826954,313,1.00
ptg000267l,3510897,3511206,309,EVM,mRNA,2627133,6826954,309,1.00
ptg000267l,3678373,3678672,299,EVM,mRNA,2627133,6826954,299,1.00
ptg000267l,4044618,4044908,290,EVM,mRNA,2627133,6826954,290,1.00
ptg000267l,4238909,4239226,317,EVM,mRNA,2627133,6826954,317,1.00
ptg000267l,5347306,5347614,308,EVM,mRNA,2627133,6826954,308,1.00
ptg000267l,5502407,5502696,289,EVM,mRNA,2627133,6826954,289,1.00
ptg000267l,5839712,5840004,292,EVM,mRNA,2627133,6826954,292,1.00
ptg000267l,5898247,5898542,295,EVM,mRNA,2627133,6826954,295,1.00
ptg000267l,6627569,6627864,295,EVM,mRNA,2627133,6826954,295,1.00
ptg000267l,6661480,6661785,305,EVM,mRNA,2627133,6826954,305,1.00
ptg000267l,10344191,10344493,302,EVM,mRNA,9217875,10794482,302,1.00
ptg000270l,1880420,1880707,287,EVM,mRNA,1386421,2366681,287,1.00
ptg000270l,2350621,2350931,310,EVM,mRNA,1386421,2366681,310,1.00
ptg000271l,1213849,1214150,301,EVM,mRNA,384543,1793455,301,1.00
ptg000271l,1477967,1478279,312,EVM,mRNA,384543,1793455,312,1.00
ptg000271l,2496527,2496845,318,EVM,mRNA,2229225,2524085,318,1.00
ptg000272l,455564,455854,290,EVM,mRNA,154315,619483,290,1.00
ptg000273l,1602725,1603034,309,EVM,mRNA,1383233,2492621,309,1.00
ptg000273l,2243678,2243977,299,EVM,mRNA,1383233,2492621,299,1.00
ptg000276l,4348212,4348502,290,EVM,mRNA,3290714,5993206,290,1.00
ptg000276l,4681169,4681482,313,EVM,mRNA,3290714,5993206,313,1.00
ptg000276l,5133441,5133758,317,EVM,mRNA,3290714,5993206,317,1.00
ptg000276l,5412128,5412441,313,EVM,mRNA,3290714,5993206,313,1.00
ptg000276l,5507256,5507534,278,EVM,mRNA,3290714,5993206,278,1.00
ptg000278l,199702,200002,300,EVM,mRNA,105193,749902,300,1.00
ptg000278l,254500,254802,302,EVM,mRNA,105193,749902,302,1.00
ptg000278l,616038,616330,292,EVM,mRNA,105193,749902,292,1.00
ptg000281l,318802,319099,297,EVM,mRNA,78645,1211877,297,1.00
ptg000281l,518521,518813,292,EVM,mRNA,78645,1211877,292,1.00
ptg000281l,542105,542420,315,EVM,mRNA,78645,1211877,315,1.00
ptg000282l,390148,390457,309,EVM,mRNA,315090,1241794,309,1.00
ptg000282l,931827,932148,321,EVM,mRNA,315090,1241794,321,1.00
ptg000282l,953293,953572,279,EVM,mRNA,315090,1241794,279,1.00
ptg000282l,2179228,2179542,314,EVM,mRNA,2010323,3019703,314,1.00
ptg000282l,2196360,2196677,317,EVM,mRNA,2010323,3019703,317,1.00
ptg000283l,594180,594458,278,EVM,mRNA,245966,1225610,278,1.00
ptg000283l,816769,817109,340,EVM,mRNA,245966,1225610,340,1.00
ptg000283l,3694559,3694865,306,EVM,mRNA,3537182,6919463,306,1.00
ptg000283l,3821956,3822250,294,EVM,mRNA,3537182,6919463,294,1.00
ptg000283l,4651352,4651653,301,EVM,mRNA,3537182,6919463,301,1.00
ptg000283l,4841828,4842156,328,EVM,mRNA,3537182,6919463,328,1.00
ptg000283l,5376278,5376561,283,EVM,mRNA,3537182,6919463,283,1.00
ptg000284l,100775,101102,327,EVM,mRNA,2457,159944,327,1.00
ptg000284l,541225,541529,304,EVM,mRNA,243719,725377,304,1.00
ptg000286l,76609,76909,300,EVM,mRNA,28111,593424,300,1.00
ptg000286l,202129,202448,319,EVM,mRNA,28111,593424,319,1.00
ptg000286l,381120,381419,299,EVM,mRNA,28111,593424,299,1.00
ptg000286l,3604277,3604607,330,EVM,mRNA,3515798,4085360,330,1.00
ptg000286l,3692774,3693072,298,EVM,mRNA,3515798,4085360,298,1.00
ptg000286l,4807866,4808148,282,EVM,mRNA,4637198,5531772,282,1.00
ptg000291l,983964,984263,299,EVM,mRNA,328177,1737392,299,1.00
ptg000291l,1172310,1172632,322,EVM,mRNA,328177,1737392,322,1.00
ptg000295l,780256,780571,315,EVM,mRNA,633618,1295530,315,1.00
ptg000297l,806084,806368,284,EVM,mRNA,359388,1699404,284,1.00
ptg000297l,3497302,3497574,272,EVM,mRNA,3012130,3974635,272,1.00
ptg000297l,3932055,3932381,326,EVM,mRNA,3012130,3974635,326,1.00
ptg000300l,296205,296519,314,EVM,mRNA,249363,2110753,314,1.00
ptg000300l,1202329,1202622,293,EVM,mRNA,249363,2110753,293,1.00
ptg000300l,1262271,1262542,271,EVM,mRNA,249363,2110753,271,1.00
ptg000300l,1496044,1496342,298,EVM,mRNA,249363,2110753,298,1.00
ptg000300l,2073636,2073931,295,EVM,mRNA,249363,2110753,295,1.00
ptg000304l,2688600,2688905,305,EVM,mRNA,1793964,2925562,305,1.00
ptg000304l,4549612,4549888,276,EVM,mRNA,4529914,4589306,276,1.00
ptg000304l,5391821,5392115,294,EVM,mRNA,4664898,5519285,294,1.00
ptg000305l,461516,461816,300,EVM,mRNA,253936,562990,300,1.00
ptg000305l,657064,657377,313,EVM,mRNA,656571,785051,313,1.00
ptg000305l,1698027,1698326,299,EVM,mRNA,957855,2449033,299,1.00
ptg000305l,1924217,1924508,291,EVM,mRNA,957855,2449033,291,1.00
ptg000305l,2012454,2012736,282,EVM,mRNA,957855,2449033,282,1.00
ptg000305l,2328238,2328537,299,EVM,mRNA,957855,2449033,299,1.00
ptg000307l,850505,850804,299,EVM,mRNA,652475,4834659,299,1.00
ptg000307l,1050182,1050481,299,EVM,mRNA,652475,4834659,299,1.00
ptg000307l,1413480,1413794,314,EVM,mRNA,652475,4834659,314,1.00
ptg000307l,1905558,1905856,298,EVM,mRNA,652475,4834659,298,1.00
ptg000307l,2060849,2061162,313,EVM,mRNA,652475,4834659,313,1.00
ptg000307l,2748778,2749043,265,EVM,mRNA,652475,4834659,265,1.00
ptg000307l,3116039,3116350,311,EVM,mRNA,652475,4834659,311,1.00
ptg000307l,3779822,3780110,288,EVM,mRNA,652475,4834659,288,1.00
ptg000307l,4221975,4222281,306,EVM,mRNA,652475,4834659,306,1.00
ptg000310l,3649151,3649435,284,EVM,mRNA,3230166,7488726,284,1.00
ptg000310l,6536951,6537269,318,EVM,mRNA,3230166,7488726,318,1.00
ptg000310l,6964880,6965180,300,EVM,mRNA,3230166,7488726,300,1.00
ptg000310l,7900649,7900957,308,EVM,mRNA,7774220,8014533,308,1.00
ptg000313l,1288933,1289222,289,EVM,mRNA,1160127,1384017,289,1.00
ptg000313l,2081346,2081660,314,EVM,mRNA,1787679,2110143,314,1.00
ptg000313l,2854098,2854394,296,EVM,mRNA,2596360,3059363,296,1.00
ptg000313l,3000702,3001009,307,EVM,mRNA,2596360,3059363,307,1.00
ptg000314l,1017653,1017940,287,EVM,mRNA,785467,1592692,287,1.00
ptg000314l,1409056,1409363,307,EVM,mRNA,785467,1592692,307,1.00
ptg000314l,1813137,1813425,288,EVM,mRNA,1711755,1879816,288,1.00
ptg000319l,466790,467071,281,EVM,mRNA,83583,1188258,281,1.00
ptg000319l,1811589,1811870,281,EVM,mRNA,1565221,1828200,281,1.00
ptg000320l,1967518,1967816,298,EVM,mRNA,1790120,3555311,298,1.00
ptg000322l,129039,129347,308,EVM,mRNA,82767,369187,308,1.00
ptg000322l,633568,633857,289,EVM,mRNA,516192,3324034,289,1.00
ptg000322l,2933808,2934099,291,EVM,mRNA,516192,3324034,291,1.00
ptg000323l,2883020,2883306,286,EVM,mRNA,2684397,3162752,286,1.00
ptg000325l,414018,414351,333,EVM,mRNA,126832,597266,333,1.00
ptg000325l,3576732,3577048,316,EVM,mRNA,3086268,3598720,316,1.00
ptg000325l,4005287,4005570,283,EVM,mRNA,3780544,4172741,283,1.00
ptg000327l,346449,346765,316,EVM,mRNA,160714,430198,316,1.00
ptg000327l,354441,354705,264,EVM,mRNA,160714,430198,264,1.00
ptg000327l,513774,514075,301,EVM,mRNA,449319,1546828,301,1.00
ptg000330l,778457,778756,299,EVM,mRNA,615191,1444434,299,1.00
ptg000330l,1204822,1205135,313,EVM,mRNA,615191,1444434,313,1.00
ptg000332l,911628,911942,314,EVM,mRNA,404754,2828904,314,1.00
ptg000332l,1943135,1943441,306,EVM,mRNA,404754,2828904,306,1.00
ptg000333l,1435,1686,251,EVM,mRNA,1214,1615,180,0.72
ptg000333l,498667,498961,294,EVM,mRNA,68509,647787,294,1.00
ptg000337l,3022181,3022473,292,EVM,mRNA,2957700,3613056,292,1.00
ptg000337l,3261233,3261566,333,EVM,mRNA,2957700,3613056,333,1.00
ptg000337l,3485266,3485555,289,EVM,mRNA,2957700,3613056,289,1.00
ptg000337l,4995142,4995429,287,EVM,mRNA,4685537,4996541,287,1.00
ptg000337l,7072159,7072474,315,EVM,mRNA,6551323,12385407,315,1.00
ptg000337l,7216460,7216766,306,EVM,mRNA,6551323,12385407,306,1.00
ptg000337l,7887170,7887469,299,EVM,mRNA,6551323,12385407,299,1.00
ptg000337l,8668861,8669155,294,EVM,mRNA,6551323,12385407,294,1.00
ptg000337l,9033576,9033904,328,EVM,mRNA,6551323,12385407,328,1.00
ptg000337l,9632311,9632619,308,EVM,mRNA,6551323,12385407,308,1.00
ptg000337l,10508770,10509067,297,EVM,mRNA,6551323,12385407,297,1.00
ptg000337l,10812902,10813201,299,EVM,mRNA,6551323,12385407,299,1.00
ptg000337l,11541651,11541980,329,EVM,mRNA,6551323,12385407,329,1.00
ptg000341l,109772,110067,295,EVM,mRNA,4367,1570649,295,1.00
ptg000341l,392553,392854,301,EVM,mRNA,4367,1570649,301,1.00
ptg000341l,486430,486729,299,EVM,mRNA,4367,1570649,299,1.00
ptg000341l,526926,527210,284,EVM,mRNA,4367,1570649,284,1.00
ptg000341l,557794,558121,327,EVM,mRNA,4367,1570649,327,1.00
ptg000341l,710151,710448,297,EVM,mRNA,4367,1570649,297,1.00
ptg000347l,199939,200265,326,EVM,mRNA,48663,480227,326,1.00
ptg000347l,436325,436620,295,EVM,mRNA,48663,480227,295,1.00
ptg000347l,2973908,2974189,281,EVM,mRNA,2934066,3150167,281,1.00
ptg000348l,3678943,3679260,317,EVM,mRNA,2266596,3778877,317,1.00
ptg000349l,1224459,1224758,299,EVM,mRNA,1043191,1796332,299,1.00
ptg000349l,1702930,1703224,294,EVM,mRNA,1043191,1796332,294,1.00
ptg000351l,1346326,1346618,292,EVM,mRNA,1345802,1346740,292,1.00
ptg000351l,1614249,1614547,298,EVM,mRNA,1495790,1699517,298,1.00
ptg000355l,663326,663655,329,EVM,mRNA,3756,1570155,329,1.00
ptg000356l,806799,807114,315,EVM,mRNA,264342,1246039,315,1.00
ptg000358l,882169,882450,281,EVM,mRNA,813391,1165789,281,1.00
ptg000359l,3249903,3250216,313,EVM,mRNA,2322317,3544825,313,1.00
ptg000363l,3878093,3878373,280,EVM,mRNA,3654955,4598071,280,1.00
ptg000365l,2132443,2132723,280,EVM,mRNA,2076172,2921880,280,1.00
ptg000365l,2391800,2392099,299,EVM,mRNA,2076172,2921880,299,1.00
ptg000367l,2797203,2797517,314,EVM,mRNA,2099445,2895555,314,1.00
ptg000368l,377489,377805,316,EVM,mRNA,321798,573489,316,1.00
ptg000368l,1021215,1021498,283,EVM,mRNA,849914,1091244,283,1.00
ptg000368l,1289279,1289589,310,EVM,mRNA,1172128,1440423,310,1.00
ptg000368l,1647592,1647875,283,EVM,mRNA,1499082,1970604,283,1.00
ptg000369l,572970,573286,316,EVM,mRNA,1589,1012200,316,1.00
ptg000372l,533981,534298,317,EVM,mRNA,531067,538060,317,1.00
ptg000373l,912239,912548,309,EVM,mRNA,698440,1919663,309,1.00
ptg000373l,914468,914792,324,EVM,mRNA,698440,1919663,324,1.00
ptg000373l,1013522,1013809,287,EVM,mRNA,698440,1919663,287,1.00
ptg000373l,2528555,2528844,289,EVM,mRNA,2523473,3947742,289,1.00
ptg000373l,2837679,2837963,284,EVM,mRNA,2523473,3947742,284,1.00
ptg000375l,2215294,2215575,281,EVM,mRNA,2136645,2407363,281,1.00
ptg000377l,1416217,1416533,316,EVM,mRNA,1317848,1536566,316,1.00
ptg000379l,253481,253737,256,EVM,mRNA,146222,698217,256,1.00
ptg000381l,6380069,6380373,304,EVM,mRNA,4609824,7496953,304,1.00
ptg000381l,6957135,6957459,324,EVM,mRNA,4609824,7496953,324,1.00
ptg000382l,1025960,1026266,306,EVM,mRNA,900283,1789693,306,1.00
ptg000382l,1595424,1595759,335,EVM,mRNA,900283,1789693,335,1.00
ptg000383l,1675797,1676118,321,EVM,mRNA,859381,2123000,321,1.00
ptg000383l,1991684,1991982,298,EVM,mRNA,859381,2123000,298,1.00
ptg000384l,2796788,2797110,322,EVM,mRNA,2760026,2888353,322,1.00
ptg000385l,556823,557134,311,EVM,mRNA,500923,1867437,311,1.00
ptg000385l,5721728,5722055,327,EVM,mRNA,3158222,5939850,327,1.00
ptg000387l,1878826,1879117,291,EVM,mRNA,1800487,1990120,291,1.00
ptg000387l,3799295,3799578,283,EVM,mRNA,3799371,4234694,208,0.73
ptg000389l,404222,404528,306,EVM,mRNA,288687,830477,306,1.00
ptg000389l,558213,558503,290,EVM,mRNA,288687,830477,290,1.00
ptg000389l,694596,694897,301,EVM,mRNA,288687,830477,301,1.00
ptg000389l,827320,827618,298,EVM,mRNA,288687,830477,298,1.00
ptg000393l,1471324,1471610,286,EVM,mRNA,694606,1896759,286,1.00
ptg000393l,1607407,1607704,297,EVM,mRNA,694606,1896759,297,1.00
ptg000393l,4196363,4196653,290,EVM,mRNA,4063477,5126964,290,1.00
ptg000393l,4300197,4300507,310,EVM,mRNA,4063477,5126964,310,1.00
ptg000393l,4639029,4639312,283,EVM,mRNA,4063477,5126964,283,1.00
ptg000393l,4911818,4912108,290,EVM,mRNA,4063477,5126964,290,1.00
ptg000393l,5026596,5026882,286,EVM,mRNA,4063477,5126964,286,1.00
ptg000397l,1190910,1191222,312,EVM,mRNA,821133,1519589,312,1.00
ptg000399l,3649933,3650211,278,EVM,mRNA,3014007,3927532,278,1.00
ptg000404l,2124052,2124356,304,EVM,mRNA,1867875,2351123,304,1.00
ptg000405l,806690,806988,298,EVM,mRNA,616038,1265933,298,1.00
ptg000405l,813513,813818,305,EVM,mRNA,616038,1265933,305,1.00
ptg000405l,813898,814197,299,EVM,mRNA,616038,1265933,299,1.00
ptg000405l,1263310,1263629,319,EVM,mRNA,616038,1265933,319,1.00
ptg000405l,1542517,1542805,288,EVM,mRNA,1539512,1999376,288,1.00
ptg000407l,1067198,1067509,311,EVM,mRNA,583774,1249046,311,1.00
ptg000407l,5305859,5306175,316,EVM,mRNA,4945780,6663877,316,1.00
ptg000407l,5945129,5945439,310,EVM,mRNA,4945780,6663877,310,1.00
ptg000407l,6369652,6369937,285,EVM,mRNA,4945780,6663877,285,1.00
ptg000407l,6592627,6592923,296,EVM,mRNA,4945780,6663877,296,1.00
ptg000407l,8909323,8909610,287,EVM,mRNA,8898490,9275159,287,1.00
ptg000407l,8970211,8970519,308,EVM,mRNA,8898490,9275159,308,1.00
ptg000408l,1153864,1154159,295,EVM,mRNA,232375,2109426,295,1.00
ptg000408l,5964915,5965241,326,EVM,mRNA,3399492,6114847,326,1.00
ptg000408l,6055314,6055608,294,EVM,mRNA,3399492,6114847,294,1.00
ptg000408l,6084255,6084536,281,EVM,mRNA,3399492,6114847,281,1.00
ptg000409l,950775,951093,318,EVM,mRNA,413708,1311210,318,1.00
ptg000409l,950775,951093,318,GeneWise,mRNA,413711,1311240,318,1.00
ptg000410l,1125334,1125657,323,EVM,mRNA,407683,2254312,323,1.00
ptg000410l,1533134,1533432,298,EVM,mRNA,407683,2254312,298,1.00
ptg000410l,1566602,1566904,302,EVM,mRNA,407683,2254312,302,1.00
ptg000410l,2022219,2022496,277,EVM,mRNA,407683,2254312,277,1.00
ptg000411l,4223351,4223602,251,EVM,mRNA,3933140,4507807,251,1.00
ptg000412l,1137858,1138178,320,EVM,mRNA,1018571,1850983,320,1.00
ptg000412l,1200762,1201048,286,EVM,mRNA,1018571,1850983,286,1.00
ptg000412l,1261548,1261864,316,EVM,mRNA,1018571,1850983,316,1.00
ptg000413l,426385,426699,314,EVM,mRNA,167032,1374907,314,1.00
ptg000413l,636108,636393,285,EVM,mRNA,167032,1374907,285,1.00
ptg000414l,1123766,1124061,295,EVM,mRNA,755470,1155163,295,1.00
ptg000414l,1731927,1732217,290,EVM,mRNA,1730851,2532879,290,1.00
ptg000421l,390690,390996,306,EVM,mRNA,244735,421216,306,1.00
ptg000430l,2304247,2304561,314,EVM,mRNA,2167138,2558521,314,1.00
ptg000433l,700251,700526,275,EVM,mRNA,451220,1552967,275,1.00
ptg000434l,1763150,1763452,302,EVM,mRNA,1756413,1817809,302,1.00
ptg000440l,441100,441400,300,EVM,mRNA,120237,1445033,300,1.00
ptg000442l,1560498,1560794,296,EVM,mRNA,841875,2522671,296,1.00
ptg000442l,5380126,5380380,254,EVM,mRNA,5238519,5772508,254,1.00
ptg000445l,2904376,2904664,288,EVM,mRNA,2509460,4479972,288,1.00
ptg000445l,3195549,3195838,289,EVM,mRNA,2509460,4479972,289,1.00
ptg000445l,4812939,4813238,299,EVM,mRNA,4627759,5011100,299,1.00
ptg000448l,1007263,1007577,314,EVM,mRNA,687806,2183258,314,1.00
ptg000448l,1374688,1374993,305,EVM,mRNA,687806,2183258,305,1.00
ptg000448l,1506114,1506409,295,EVM,mRNA,687806,2183258,295,1.00
ptg000450l,261415,261662,247,EVM,mRNA,101793,895414,247,1.00
ptg000450l,1996026,1996325,299,EVM,mRNA,1978596,2764476,299,1.00
ptg000450l,2277597,2277889,292,EVM,mRNA,1978596,2764476,292,1.00
ptg000450l,2499853,2500146,293,EVM,mRNA,1978596,2764476,293,1.00
ptg000450l,2555571,2555868,297,EVM,mRNA,1978596,2764476,297,1.00
ptg000451l,1280468,1280765,297,EVM,mRNA,372203,1813238,297,1.00
ptg000451l,4698454,4698752,298,EVM,mRNA,4178325,4943343,298,1.00
ptg000452l,74667,74944,277,EVM,mRNA,781,4516978,277,1.00
ptg000452l,3265888,3266148,260,EVM,mRNA,781,4516978,260,1.00
ptg000452l,4439539,4439823,284,EVM,mRNA,781,4516978,284,1.00
ptg000455l,897090,897390,300,EVM,mRNA,631888,1319549,300,1.00
ptg000455l,1036997,1037307,310,EVM,mRNA,631888,1319549,310,1.00
ptg000457l,1852260,1852559,299,EVM,mRNA,567292,2306371,299,1.00
ptg000457l,2091301,2091570,269,EVM,mRNA,567292,2306371,269,1.00
ptg000457l,2092672,2092957,285,EVM,mRNA,567292,2306371,285,1.00
ptg000461l,66625,66939,314,EVM,mRNA,9270,70327,314,1.00
ptg000465l,2283974,2284288,314,EVM,mRNA,2200193,2320177,314,1.00
ptg000469l,662322,662639,317,EVM,mRNA,29403,971886,317,1.00
ptg000472l,1641686,1641978,292,EVM,mRNA,787270,2721361,292,1.00
ptg000474l,269719,270028,309,EVM,mRNA,219409,331727,309,1.00
ptg000481l,1485398,1485676,278,EVM,mRNA,1106905,1767786,278,1.00
ptg000484l,2041662,2041983,321,EVM,mRNA,1514350,2405064,321,1.00
ptg000484l,2252697,2252979,282,EVM,mRNA,1514350,2405064,282,1.00
ptg000484l,2324238,2324537,299,EVM,mRNA,1514350,2405064,299,1.00
ptg000484l,4060683,4060976,293,EVM,mRNA,4007377,5792275,293,1.00
ptg000485l,106280,106602,322,EVM,mRNA,1736,933537,322,1.00
ptg000485l,1444574,1444898,324,EVM,mRNA,1299947,1638018,324,1.00
ptg000489l,1293289,1293608,319,EVM,mRNA,686454,1465681,319,1.00
ptg000490l,566441,566748,307,EVM,mRNA,165586,961189,307,1.00
ptg000490l,731417,731720,303,EVM,mRNA,165586,961189,303,1.00
ptg000490l,2901011,2901337,326,EVM,mRNA,1808115,3195877,326,1.00
ptg000493l,1219390,1219679,289,EVM,mRNA,904648,1456796,289,1.00
ptg000493l,2414882,2415165,283,EVM,mRNA,2396190,2984931,283,1.00
ptg000493l,2583601,2583908,307,EVM,mRNA,2396190,2984931,307,1.00
ptg000493l,4425004,4425263,259,EVM,mRNA,4155820,5270975,259,1.00
ptg000493l,6384223,6384515,292,EVM,mRNA,5997976,7418556,292,1.00
ptg000493l,7139352,7139676,324,EVM,mRNA,5997976,7418556,324,1.00
ptg000495l,2391553,2391841,288,EVM,mRNA,2098906,2797841,288,1.00
ptg000502l,574943,575262,319,EVM,mRNA,527010,1638870,319,1.00
ptg000502l,668696,668954,258,EVM,mRNA,527010,1638870,258,1.00
ptg000502l,948277,948584,307,EVM,mRNA,527010,1638870,307,1.00
ptg000502l,1459729,1460039,310,EVM,mRNA,527010,1638870,310,1.00
ptg000502l,3132792,3133091,299,EVM,mRNA,3092117,3270326,299,1.00
ptg000503l,99655,99989,334,EVM,mRNA,3750,223172,334,1.00
ptg000504l,342191,342456,265,EVM,mRNA,342179,719874,265,1.00
ptg000504l,2308046,2308338,292,EVM,mRNA,1749985,3329104,292,1.00
ptg000504l,3932665,3932957,292,EVM,mRNA,3674917,4930490,292,1.00
ptg000505l,687913,688231,318,EVM,mRNA,485789,775473,318,1.00
ptg000505l,731132,731419,287,EVM,mRNA,485789,775473,287,1.00
ptg000505l,1732508,1732763,255,EVM,mRNA,909557,2299354,255,1.00
ptg000506l,6688449,6688766,317,EVM,mRNA,6394386,6864973,317,1.00
ptg000508l,668428,668734,306,EVM,mRNA,145571,1018035,306,1.00
ptg000508l,697179,697493,314,EVM,mRNA,145571,1018035,314,1.00
ptg000508l,773974,774293,319,EVM,mRNA,145571,1018035,319,1.00
ptg000508l,3540044,3540334,290,EVM,mRNA,3164396,3635688,290,1.00
ptg000508l,3551107,3551384,277,EVM,mRNA,3164396,3635688,277,1.00
ptg000508l,3836830,3837149,319,EVM,mRNA,3660436,4007432,319,1.00
ptg000511l,979969,980292,323,EVM,mRNA,361500,1980261,323,1.00
ptg000511l,2600049,2600365,316,EVM,mRNA,2565462,2737177,316,1.00
ptg000511l,4279411,4279694,283,EVM,mRNA,4203658,4479561,283,1.00
ptg000511l,4326907,4327209,302,EVM,mRNA,4203658,4479561,302,1.00
ptg000511l,5002558,5002886,328,EVM,mRNA,4563444,6248979,328,1.00
ptg000511l,5100835,5101163,328,EVM,mRNA,4563444,6248979,328,1.00
ptg000511l,5140048,5140372,324,EVM,mRNA,4563444,6248979,324,1.00
ptg000511l,5721335,5721650,315,EVM,mRNA,4563444,6248979,315,1.00
ptg000511l,7394803,7395102,299,EVM,mRNA,7005320,7996146,299,1.00
ptg000513l,400734,401048,314,EVM,mRNA,375351,685661,314,1.00
ptg000516l,300459,300777,318,EVM,mRNA,31376,514777,318,1.00
ptg000516l,2069754,2070074,320,EVM,mRNA,1541839,2395107,320,1.00
ptg000517l,1792082,1792371,289,EVM,mRNA,1327091,1797439,289,1.00
ptg000517l,2122118,2122413,295,EVM,mRNA,1964218,2560452,295,1.00
ptg000518l,394938,395208,270,EVM,mRNA,19222,1781273,270,1.00
ptg000518l,855029,855355,326,EVM,mRNA,19222,1781273,326,1.00
ptg000518l,965322,965641,319,EVM,mRNA,19222,1781273,319,1.00
ptg000518l,975291,975568,277,EVM,mRNA,19222,1781273,277,1.00
ptg000519l,218846,219160,314,EVM,mRNA,35623,292306,314,1.00
ptg000519l,1775431,1775752,321,EVM,mRNA,1469839,3656312,321,1.00
ptg000519l,1864349,1864641,292,EVM,mRNA,1469839,3656312,292,1.00
ptg000519l,10501040,10501351,311,EVM,mRNA,7453186,11813495,311,1.00
ptg000519l,10589779,10590075,296,EVM,mRNA,7453186,11813495,296,1.00
ptg000519l,11363923,11364218,295,EVM,mRNA,7453186,11813495,295,1.00
ptg000519l,11611916,11612212,296,EVM,mRNA,7453186,11813495,296,1.00
ptg000523l,573267,573574,307,EVM,mRNA,56,982697,307,1.00
ptg000523l,864712,865033,321,EVM,mRNA,56,982697,321,1.00
ptg000523l,889088,889387,299,EVM,mRNA,56,982697,299,1.00
ptg000523l,3765153,3765477,324,EVM,mRNA,1191777,3918893,324,1.00
ptg000523l,3857662,3857947,285,EVM,mRNA,1191777,3918893,285,1.00
ptg000523l,5527012,5527334,322,EVM,mRNA,5439985,5528699,322,1.00
ptg000523l,5937989,5938303,314,EVM,mRNA,5841872,5991781,314,1.00
ptg000526l,2959731,2960023,292,EVM,mRNA,2605148,3010207,292,1.00
ptg000527l,1288720,1289007,287,EVM,mRNA,1153408,1355175,287,1.00
ptg000528l,2678364,2678699,335,EVM,mRNA,2641276,3791730,335,1.00
ptg000528l,3134192,3134491,299,EVM,mRNA,2641276,3791730,299,1.00
ptg000530l,526598,526908,310,EVM,mRNA,1399,777821,310,1.00
ptg000530l,1695089,1695416,327,EVM,mRNA,1614691,1695764,327,1.00
ptg000539l,793100,793428,328,EVM,mRNA,792437,865736,328,1.00
ptg000539l,1151501,1151821,320,EVM,mRNA,1110579,4367146,320,1.00
ptg000539l,6430618,6430915,297,EVM,mRNA,5889761,6452982,297,1.00
ptg000549l,1102694,1103010,316,EVM,mRNA,882846,3458435,316,1.00
ptg000549l,3047378,3047673,295,EVM,mRNA,882846,3458435,295,1.00
ptg000549l,4092917,4093167,250,EVM,mRNA,4056346,4223771,250,1.00
ptg000550l,2126723,2127025,302,EVM,mRNA,1193654,2985419,302,1.00
ptg000550l,4196132,4196445,313,EVM,mRNA,3923473,4571048,313,1.00
ptg000552l,2054754,2055075,321,EVM,mRNA,1881134,3056320,321,1.00
ptg000552l,2201428,2201722,294,EVM,mRNA,1881134,3056320,294,1.00
ptg000553l,1336901,1337203,302,EVM,mRNA,1323439,1764518,302,1.00
ptg000553l,1569233,1569553,320,EVM,mRNA,1323439,1764518,320,1.00
ptg000553l,1731316,1731618,302,EVM,mRNA,1323439,1764518,302,1.00
ptg000554l,73676,73986,310,EVM,mRNA,24630,146254,310,1.00
ptg000558l,1688340,1688622,282,EVM,mRNA,658040,2304098,282,1.00
ptg000558l,2199271,2199566,295,EVM,mRNA,658040,2304098,295,1.00
ptg000558l,3503073,3503384,311,EVM,mRNA,3354137,4197844,311,1.00
ptg000558l,4072376,4072710,334,EVM,mRNA,3354137,4197844,334,1.00
ptg000558l,6097018,6097320,302,EVM,mRNA,6063623,6176930,302,1.00
ptg000559l,49005,49330,325,EVM,mRNA,654,3545812,325,1.00
ptg000559l,1076265,1076560,295,EVM,mRNA,654,3545812,295,1.00
ptg000559l,1319872,1320174,302,EVM,mRNA,654,3545812,302,1.00
ptg000559l,2440706,2441013,307,EVM,mRNA,654,3545812,307,1.00
ptg000559l,3057066,3057364,298,EVM,mRNA,654,3545812,298,1.00
ptg000561l,184265,184559,294,EVM,mRNA,124753,605364,294,1.00
ptg000563l,419538,419811,273,EVM,mRNA,59348,646360,273,1.00
ptg000563l,1315199,1315489,290,EVM,mRNA,1223655,2335851,290,1.00
ptg000563l,1880383,1880678,295,EVM,mRNA,1223655,2335851,295,1.00
ptg000569l,1503491,1503790,299,EVM,mRNA,1358436,1759554,299,1.00
ptg000570l,915119,915453,334,EVM,mRNA,444810,986130,334,1.00
ptg000572l,133454,133744,290,EVM,mRNA,131990,280979,290,1.00
ptg000573l,334854,335166,312,EVM,mRNA,28364,444369,312,1.00
ptg000576l,983674,983942,268,EVM,mRNA,3504,3040196,268,1.00
ptg000576l,2392607,2392939,332,EVM,mRNA,3504,3040196,332,1.00
ptg000576l,2983739,2984062,323,EVM,mRNA,3504,3040196,323,1.00
ptg000576l,2985820,2986130,310,EVM,mRNA,3504,3040196,310,1.00
ptg000577l,3605394,3605714,320,EVM,mRNA,3470954,4468056,320,1.00
ptg000578l,183240,183544,304,EVM,mRNA,18688,201540,304,1.00
ptg000585l,903220,903536,316,EVM,mRNA,190688,1177243,316,1.00
ptg000585l,1097435,1097719,284,EVM,mRNA,190688,1177243,284,1.00
ptg000585l,1172904,1173229,325,EVM,mRNA,190688,1177243,325,1.00
ptg000585l,2071872,2072178,306,EVM,mRNA,1796609,2265217,306,1.00
ptg000586l,711427,711745,318,EVM,mRNA,335710,978672,318,1.00
ptg000586l,1741141,1741461,320,EVM,mRNA,1488679,1853983,320,1.00
ptg000586l,1798454,1798770,316,EVM,mRNA,1488679,1853983,316,1.00
ptg000588l,1059921,1060239,318,EVM,mRNA,34472,3355635,318,1.00
ptg000588l,3165840,3166164,324,EVM,mRNA,34472,3355635,324,1.00
ptg000590l,943300,943609,309,EVM,mRNA,198774,1108764,309,1.00
ptg000592l,2092360,2092652,292,EVM,mRNA,1565434,2268999,292,1.00
ptg000602l,443307,443626,319,EVM,mRNA,339296,1650691,319,1.00
ptg000602l,1468259,1468564,305,EVM,mRNA,339296,1650691,305,1.00
ptg000604l,2804566,2804833,267,EVM,mRNA,2584231,2811719,267,1.00
ptg000604l,3930531,3930820,289,EVM,mRNA,3690738,4620960,289,1.00
ptg000604l,4396909,4397211,302,EVM,mRNA,3690738,4620960,302,1.00
ptg000606l,1599136,1599453,317,EVM,mRNA,169839,1745771,317,1.00
ptg000607l,6180351,6180628,277,EVM,mRNA,5579610,7144831,277,1.00
ptg000609l,531200,531516,316,EVM,mRNA,220676,1416035,316,1.00
ptg000609l,934831,935143,312,EVM,mRNA,220676,1416035,312,1.00
ptg000611l,1046482,1046766,284,EVM,mRNA,773386,1081777,284,1.00
ptg000613l,1927797,1928096,299,EVM,mRNA,1080758,2265301,299,1.00
ptg000613l,3382092,3382390,298,EVM,mRNA,3237367,3961548,298,1.00
ptg000613l,3668107,3668404,297,EVM,mRNA,3237367,3961548,297,1.00
ptg000613l,5539867,5540148,281,EVM,mRNA,5191741,5877801,281,1.00
ptg000614l,1381065,1381352,287,EVM,mRNA,20699,1867904,287,1.00
ptg000615l,982927,983240,313,EVM,mRNA,285381,1191154,313,1.00
ptg000617l,722292,722612,320,EVM,mRNA,72150,766068,320,1.00
ptg000620l,3012383,3012702,319,EVM,mRNA,2899144,3022897,319,1.00
ptg000620l,4000209,4000524,315,EVM,mRNA,3878865,4070342,315,1.00
ptg000621l,4326182,4326498,316,EVM,mRNA,4042318,4607338,316,1.00
ptg000624l,159422,159734,312,EVM,mRNA,124812,359431,312,1.00
ptg000624l,228771,229089,318,EVM,mRNA,124812,359431,318,1.00
ptg000627l,3740832,3741152,320,EVM,mRNA,3299051,4195008,320,1.00
ptg000627l,5175495,5175816,321,EVM,mRNA,4829285,5227673,321,1.00
ptg000627l,6955914,6956209,295,EVM,mRNA,5471837,9839571,295,1.00
ptg000627l,8326088,8326394,306,EVM,mRNA,5471837,9839571,306,1.00
ptg000627l,9209431,9209730,299,EVM,mRNA,5471837,9839571,299,1.00
ptg000627l,10192383,10192694,311,EVM,mRNA,10080246,10965954,311,1.00
ptg000627l,10328236,10328534,298,EVM,mRNA,10080246,10965954,298,1.00
ptg000629l,809620,809918,298,EVM,mRNA,149945,1026792,298,1.00
ptg000632l,3756754,3757023,269,EVM,mRNA,3755769,4414240,269,1.00
ptg000633l,1811185,1811447,262,EVM,mRNA,912987,1876541,262,1.00
ptg000633l,2663759,2664037,278,EVM,mRNA,2639257,3540973,278,1.00
ptg000633l,2913594,2913921,327,EVM,mRNA,2639257,3540973,327,1.00
ptg000633l,3395706,3396021,315,EVM,mRNA,2639257,3540973,315,1.00
ptg000633l,6436619,6436889,270,EVM,mRNA,6431905,7308216,270,1.00
ptg000637l,2321089,2321369,280,EVM,mRNA,2212671,3568447,280,1.00
ptg000637l,2689396,2689714,318,EVM,mRNA,2212671,3568447,318,1.00
ptg000637l,3086102,3086383,281,EVM,mRNA,2212671,3568447,281,1.00
ptg000639l,444283,444550,267,EVM,mRNA,3103,1101157,267,1.00
ptg000640l,261642,261932,290,EVM,mRNA,41387,916777,290,1.00
ptg000640l,279177,279470,293,EVM,mRNA,41387,916777,293,1.00
ptg000640l,905121,905416,295,EVM,mRNA,41387,916777,295,1.00
ptg000640l,1113203,1113485,282,EVM,mRNA,1112506,1171718,282,1.00
ptg000640l,1435029,1435343,314,EVM,mRNA,1176342,1676269,314,1.00
ptg000642l,1895572,1895871,299,EVM,mRNA,373526,2406551,299,1.00
ptg000642l,3660863,3661143,280,EVM,mRNA,3600651,3767064,280,1.00
ptg000647l,1852676,1852953,277,EVM,mRNA,233926,2294670,277,1.00
ptg000651l,586628,586907,279,EVM,mRNA,32498,1164641,279,1.00
ptg000651l,673971,674299,328,EVM,mRNA,32498,1164641,328,1.00
ptg000652l,173777,174073,296,EVM,mRNA,139525,1524655,296,1.00
ptg000652l,987580,987883,303,EVM,mRNA,139525,1524655,303,1.00
ptg000652l,1140319,1140628,309,EVM,mRNA,139525,1524655,309,1.00
ptg000653l,1927925,1928223,298,EVM,mRNA,1583408,5357291,298,1.00
ptg000653l,2047667,2047970,303,EVM,mRNA,1583408,5357291,303,1.00
ptg000653l,2403068,2403384,316,EVM,mRNA,1583408,5357291,316,1.00
ptg000653l,2550530,2550834,304,EVM,mRNA,1583408,5357291,304,1.00
ptg000653l,2567522,2567841,319,EVM,mRNA,1583408,5357291,319,1.00
ptg000653l,2852792,2853073,281,EVM,mRNA,1583408,5357291,281,1.00
ptg000653l,3926738,3927040,302,EVM,mRNA,1583408,5357291,302,1.00
ptg000653l,4322931,4323235,304,EVM,mRNA,1583408,5357291,304,1.00
ptg000653l,4632703,4633002,299,EVM,mRNA,1583408,5357291,299,1.00
ptg000654l,206838,207137,299,EVM,mRNA,77826,545636,299,1.00
ptg000657l,625074,625374,300,EVM,mRNA,589329,1321065,300,1.00
ptg000657l,977794,978080,286,EVM,mRNA,589329,1321065,286,1.00
ptg000657l,1221610,1221903,293,EVM,mRNA,589329,1321065,293,1.00
ptg000658l,1519684,1519980,296,EVM,mRNA,888622,1880451,296,1.00
ptg000660l,1528598,1528923,325,EVM,mRNA,1002566,1632252,325,1.00
ptg000664l,2530551,2530873,322,EVM,mRNA,2234924,2915836,322,1.00
ptg000664l,2632535,2632818,283,EVM,mRNA,2234924,2915836,283,1.00
ptg000665l,6264220,6264520,300,EVM,mRNA,5085596,8973540,300,1.00
ptg000665l,6562903,6563163,260,EVM,mRNA,5085596,8973540,260,1.00
ptg000665l,7109602,7109892,290,EVM,mRNA,5085596,8973540,290,1.00
ptg000665l,7115189,7115470,281,EVM,mRNA,5085596,8973540,281,1.00
ptg000665l,8693092,8693372,280,EVM,mRNA,5085596,8973540,280,1.00
ptg000670l,173424,173721,297,EVM,mRNA,106581,224643,297,1.00
ptg000670l,192481,192774,293,EVM,mRNA,106581,224643,293,1.00
ptg000675l,134338,134646,308,EVM,mRNA,126197,179686,308,1.00
ptg000677l,1706811,1707120,309,EVM,mRNA,1367857,2349500,309,1.00
ptg000677l,1894591,1894898,307,EVM,mRNA,1367857,2349500,307,1.00
ptg000680l,103273,103543,270,EVM,mRNA,58163,206992,270,1.00
ptg000680l,1069799,1070120,321,EVM,mRNA,227797,3385289,321,1.00
ptg000680l,2999880,3000188,308,EVM,mRNA,227797,3385289,308,1.00
ptg000680l,3349530,3349822,292,EVM,mRNA,227797,3385289,292,1.00
ptg000682l,647779,648114,335,EVM,mRNA,530650,671683,335,1.00
ptg000682l,1253420,1253696,276,EVM,mRNA,1188271,1298613,276,1.00
ptg000682l,1261362,1261683,321,EVM,mRNA,1188271,1298613,321,1.00
ptg000682l,1754167,1754478,311,EVM,mRNA,1712474,1775183,311,1.00
ptg000682l,2998682,2998967,285,EVM,mRNA,2895182,3200852,285,1.00
ptg000684l,490225,490524,299,EVM,mRNA,211502,1092247,299,1.00
ptg000685l,887150,887472,322,EVM,mRNA,879734,938179,322,1.00
ptg000687l,552375,552691,316,EVM,mRNA,62351,962734,316,1.00
ptg000687l,920073,920373,300,EVM,mRNA,62351,962734,300,1.00
ptg000687l,1327858,1328085,227,EVM,mRNA,1327761,1735913,227,1.00
ptg000688l,1791215,1791521,306,EVM,mRNA,1731570,2298074,306,1.00
ptg000688l,2191979,2192283,304,EVM,mRNA,1731570,2298074,304,1.00
ptg000689l,932200,932480,280,EVM,mRNA,839144,1324749,280,1.00
ptg000689l,1063840,1064160,320,EVM,mRNA,839144,1324749,320,1.00
ptg000689l,1069399,1069686,287,EVM,mRNA,839144,1324749,287,1.00
ptg000689l,1780077,1780400,323,EVM,mRNA,1773698,1919782,323,1.00
ptg000689l,2941906,2942215,309,EVM,mRNA,2871124,2999792,309,1.00
ptg000690l,2346654,2346954,300,EVM,mRNA,290215,3208832,300,1.00
ptg000692l,1460303,1460599,296,EVM,mRNA,37692,1876707,296,1.00
ptg000692l,2406485,2406810,325,EVM,mRNA,2006586,2498193,325,1.00
ptg000694l,226188,226494,306,EVM,mRNA,31044,689898,306,1.00
ptg000694l,363052,363356,304,EVM,mRNA,31044,689898,304,1.00
ptg000697l,958319,958588,269,EVM,mRNA,565063,2907976,269,1.00
ptg000697l,3405299,3405586,287,EVM,mRNA,3190557,3567867,287,1.00
ptg000697l,3718777,3719091,314,EVM,mRNA,3705396,5245990,314,1.00
ptg000697l,4045970,4046233,263,EVM,mRNA,3705396,5245990,263,1.00
ptg000697l,4568618,4568908,290,EVM,mRNA,3705396,5245990,290,1.00
ptg000697l,4597993,4598275,282,EVM,mRNA,3705396,5245990,282,1.00
ptg000703l,308016,308290,274,EVM,mRNA,183376,864857,274,1.00
ptg000704l,433472,433769,297,EVM,mRNA,198463,1877538,297,1.00
ptg000704l,552683,552977,294,EVM,mRNA,198463,1877538,294,1.00
ptg000704l,942371,942658,287,EVM,mRNA,198463,1877538,287,1.00
ptg000704l,1039204,1039521,317,EVM,mRNA,198463,1877538,317,1.00
ptg000704l,1351601,1351901,300,EVM,mRNA,198463,1877538,300,1.00
ptg000704l,1378391,1378690,299,EVM,mRNA,198463,1877538,299,1.00
ptg000704l,2765879,2766191,312,EVM,mRNA,2269625,2998580,312,1.00
ptg000711l,1716538,1716858,320,EVM,mRNA,1520577,1910964,320,1.00
ptg000711l,1851764,1852067,303,EVM,mRNA,1520577,1910964,303,1.00
ptg000712l,2089175,2089491,316,EVM,mRNA,1989422,2283830,316,1.00
ptg000713l,75800,76101,301,EVM,mRNA,62062,284265,301,1.00
ptg000713l,547653,547918,265,EVM,mRNA,344881,576477,265,1.00
ptg000719l,2304585,2304899,314,EVM,mRNA,2021235,3515282,314,1.00
ptg000719l,2682558,2682871,313,EVM,mRNA,2021235,3515282,313,1.00
ptg000721l,643185,643460,275,EVM,mRNA,643019,1322016,275,1.00
ptg000721l,1256703,1256994,291,EVM,mRNA,643019,1322016,291,1.00
ptg000722l,1183430,1183716,286,EVM,mRNA,993984,4309275,286,1.00
ptg000723l,2600839,2601133,294,EVM,mRNA,2467212,2788276,294,1.00
ptg000723l,3931098,3931365,267,EVM,mRNA,2858312,4298602,267,1.00
ptg000723l,4105691,4105985,294,EVM,mRNA,2858312,4298602,294,1.00
ptg000723l,4558246,4558553,307,EVM,mRNA,4316963,4962105,307,1.00
ptg000724l,726298,726604,306,EVM,mRNA,652619,953325,306,1.00
ptg000724l,849670,849955,285,EVM,mRNA,652619,953325,285,1.00
ptg000724l,2269580,2269871,291,EVM,mRNA,1098313,2786892,291,1.00
ptg000724l,3070269,3070574,305,EVM,mRNA,2967174,3166472,305,1.00
ptg000724l,3529943,3530269,326,EVM,mRNA,3528770,4152624,326,1.00
ptg000728l,351205,351474,269,EVM,mRNA,190002,389091,269,1.00
ptg000729l,1668609,1668890,281,EVM,mRNA,1657980,2675379,281,1.00
ptg000730l,94608,94936,328,EVM,mRNA,12752,804745,328,1.00
ptg000730l,264971,265287,316,EVM,mRNA,12752,804745,316,1.00
ptg000731l,465370,465665,295,EVM,mRNA,90020,1002297,295,1.00
ptg000731l,2281204,2281529,325,EVM,mRNA,1286624,3244314,325,1.00
ptg000731l,2341614,2341944,330,EVM,mRNA,1286624,3244314,330,1.00
ptg000734l,367538,367854,316,EVM,mRNA,70373,1365637,316,1.00
ptg000735l,525435,525745,310,EVM,mRNA,432580,852289,310,1.00
ptg000736l,129285,129579,294,EVM,mRNA,94459,465116,294,1.00
ptg000736l,203279,203581,302,EVM,mRNA,94459,465116,302,1.00
ptg000738l,416728,417020,292,EVM,mRNA,322081,2072321,292,1.00
ptg000738l,821628,821934,306,EVM,mRNA,322081,2072321,306,1.00
ptg000738l,964736,965045,309,EVM,mRNA,322081,2072321,309,1.00
ptg000738l,1340618,1340914,296,EVM,mRNA,322081,2072321,296,1.00
ptg000738l,1439843,1440150,307,EVM,mRNA,322081,2072321,307,1.00
ptg000739l,139015,139337,322,EVM,mRNA,655,189314,322,1.00
ptg000739l,187761,188027,266,EVM,mRNA,655,189314,266,1.00
ptg000739l,899547,899863,316,EVM,mRNA,537591,1059143,316,1.00
ptg000739l,1901580,1901857,277,EVM,mRNA,1379309,2448506,277,1.00
ptg000739l,3006016,3006327,311,EVM,mRNA,2913522,3124906,311,1.00
ptg000739l,4362778,4363069,291,EVM,mRNA,3337600,4672530,291,1.00
ptg000739l,6569449,6569751,302,EVM,mRNA,5979467,6746525,302,1.00
ptg000740l,129049,129348,299,EVM,mRNA,86350,137502,299,1.00
ptg000740l,1259020,1259304,284,EVM,mRNA,378380,1398244,284,1.00
ptg000741l,948785,949066,281,EVM,mRNA,220828,4438273,281,1.00
ptg000741l,2171591,2171920,329,EVM,mRNA,220828,4438273,329,1.00
ptg000741l,2222067,2222334,267,EVM,mRNA,220828,4438273,267,1.00
ptg000741l,3955552,3955842,290,EVM,mRNA,220828,4438273,290,1.00
ptg000741l,6415296,6415574,278,EVM,mRNA,5170026,7394665,278,1.00
ptg000741l,6824854,6825154,300,EVM,mRNA,5170026,7394665,300,1.00
ptg000741l,7267235,7267530,295,EVM,mRNA,5170026,7394665,295,1.00
ptg000741l,7321499,7321815,316,EVM,mRNA,5170026,7394665,316,1.00
ptg000742l,2923909,2924192,283,EVM,mRNA,2896678,2999044,283,1.00
ptg000742l,2954953,2955262,309,EVM,mRNA,2896678,2999044,309,1.00
ptg000742l,4630777,4631089,312,EVM,mRNA,3601746,4817650,312,1.00
ptg000745l,1238053,1238337,284,EVM,mRNA,14413,2271323,284,1.00
ptg000748l,1225481,1225748,267,EVM,mRNA,898727,2417256,267,1.00
ptg000748l,1843564,1843856,292,EVM,mRNA,898727,2417256,292,1.00
ptg000748l,1917623,1917931,308,EVM,mRNA,898727,2417256,308,1.00
ptg000748l,2068852,2069187,335,EVM,mRNA,898727,2417256,335,1.00
ptg000749l,178524,178808,284,EVM,mRNA,103248,1165248,284,1.00
ptg000749l,1521741,1522067,326,EVM,mRNA,1477380,2496458,326,1.00
ptg000750l,1956450,1956733,283,EVM,mRNA,1234386,2268511,283,1.00
ptg000750l,1994609,1994752,143,EVM,mRNA,1234386,2268511,143,1.00
ptg000750l,2090717,2091050,333,EVM,mRNA,1234386,2268511,333,1.00
ptg000751l,190864,191202,338,EVM,mRNA,94903,263451,338,1.00
ptg000751l,195992,196280,288,EVM,mRNA,94903,263451,288,1.00
ptg000751l,740704,740994,290,EVM,mRNA,642531,4050359,290,1.00
ptg000751l,1195899,1196222,323,EVM,mRNA,642531,4050359,323,1.00
ptg000751l,1573574,1573860,286,EVM,mRNA,642531,4050359,286,1.00
ptg000751l,1576244,1576525,281,EVM,mRNA,642531,4050359,281,1.00
ptg000751l,2233616,2233932,316,EVM,mRNA,642531,4050359,316,1.00
ptg000751l,2748543,2748817,274,EVM,mRNA,642531,4050359,274,1.00
ptg000751l,3734910,3735179,269,EVM,mRNA,642531,4050359,269,1.00
ptg000753l,1970796,1971080,284,EVM,mRNA,1861146,2045365,284,1.00
ptg000759l,1688061,1688343,282,EVM,mRNA,1302464,1718393,282,1.00
ptg000760l,586145,586469,324,EVM,mRNA,559711,720092,324,1.00
ptg000764l,3639774,3640092,318,EVM,mRNA,3558793,3647189,318,1.00
ptg000766l,563765,564038,273,EVM,mRNA,277098,673120,273,1.00
ptg000766l,2290214,2290539,325,EVM,mRNA,1835442,2692021,325,1.00
ptg000766l,2582606,2582907,301,EVM,mRNA,1835442,2692021,301,1.00
ptg000771l,94248,94526,278,EVM,mRNA,34276,909136,278,1.00
ptg000771l,510594,510918,324,EVM,mRNA,34276,909136,324,1.00
ptg000773l,448413,448748,335,EVM,mRNA,326220,458228,335,1.00
ptg000773l,1178192,1178478,286,EVM,mRNA,690972,1362962,286,1.00
ptg000773l,1312134,1312439,305,EVM,mRNA,690972,1362962,305,1.00
ptg000774l,110107,110421,314,EVM,mRNA,4478,360401,314,1.00
ptg000774l,220747,221015,268,EVM,mRNA,4478,360401,268,1.00
ptg000774l,237656,237938,282,EVM,mRNA,4478,360401,282,1.00
ptg000775l,697564,697844,280,EVM,mRNA,284764,897709,280,1.00
ptg000782l,1627425,1627747,322,EVM,mRNA,1376,2407136,322,1.00
ptg000782l,2325976,2326296,320,EVM,mRNA,1376,2407136,320,1.00
ptg000784l,560922,561221,299,EVM,mRNA,7339,3379714,299,1.00
ptg000784l,1958168,1958467,299,EVM,mRNA,7339,3379714,299,1.00
ptg000786l,629344,629661,317,EVM,mRNA,395559,1095518,317,1.00
ptg000786l,905975,906264,289,EVM,mRNA,395559,1095518,289,1.00
ptg000786l,1507733,1508067,334,EVM,mRNA,1231240,1838133,334,1.00
ptg000788l,2827060,2827384,324,EVM,mRNA,2443866,3751364,324,1.00
ptg000788l,3432302,3432589,287,EVM,mRNA,2443866,3751364,287,1.00
ptg000788l,3976635,3976923,288,EVM,mRNA,3809525,4012559,288,1.00
ptg000789l,1684258,1684544,286,EVM,mRNA,1352283,4079739,286,1.00
ptg000789l,3779117,3779433,316,EVM,mRNA,1352283,4079739,316,1.00
ptg000791l,214583,214889,306,EVM,mRNA,108551,394401,306,1.00
ptg000795l,1312689,1312986,297,EVM,mRNA,1302151,2699413,297,1.00
ptg000795l,2200736,2201016,280,EVM,mRNA,1302151,2699413,280,1.00
ptg000795l,2287532,2287790,258,EVM,mRNA,1302151,2699413,258,1.00
ptg000795l,2495872,2496164,292,EVM,mRNA,1302151,2699413,292,1.00
ptg000795l,2651190,2651485,295,EVM,mRNA,1302151,2699413,295,1.00
ptg000797l,265010,265299,289,EVM,mRNA,189829,1162221,289,1.00
ptg000799l,365180,365487,307,EVM,mRNA,162735,1012818,307,1.00
ptg000799l,3825646,3825934,288,EVM,mRNA,3054542,4622848,288,1.00
ptg000801l,1351051,1351343,292,EVM,mRNA,1293635,1564479,292,1.00
ptg000801l,1669578,1669914,336,EVM,mRNA,1669014,1901274,336,1.00
ptg000801l,1670505,1670777,272,EVM,mRNA,1669014,1901274,272,1.00
ptg000802l,454079,454382,303,EVM,mRNA,73950,1627458,303,1.00
ptg000802l,1375649,1375934,285,EVM,mRNA,73950,1627458,285,1.00
ptg000802l,2038918,2039220,302,EVM,mRNA,2004717,3354302,302,1.00
ptg000802l,3047248,3047546,298,EVM,mRNA,2004717,3354302,298,1.00
ptg000802l,7980168,7980436,268,EVM,mRNA,7504179,8542431,268,1.00
ptg000802l,8418266,8418557,291,EVM,mRNA,7504179,8542431,291,1.00
ptg000803l,3376292,3376559,267,EVM,mRNA,2585834,3540853,267,1.00
ptg000805l,446151,446449,298,EVM,mRNA,147658,492904,298,1.00
ptg000805l,1663418,1663737,319,EVM,mRNA,1451174,2363334,319,1.00
ptg000806l,992590,992908,318,EVM,mRNA,987227,1317709,318,1.00
ptg000806l,3797327,3797656,329,EVM,mRNA,3794905,4959693,329,1.00
ptg000806l,3909531,3909812,281,EVM,mRNA,3794905,4959693,281,1.00
ptg000806l,4066292,4066612,320,EVM,mRNA,3794905,4959693,320,1.00
ptg000806l,4202733,4203011,278,EVM,mRNA,3794905,4959693,278,1.00
ptg000808l,676810,677107,297,EVM,mRNA,518962,1754666,297,1.00
ptg000808l,2329855,2330169,314,EVM,mRNA,2120828,2568242,314,1.00
ptg000808l,4133270,4133575,305,EVM,mRNA,3060404,4608571,305,1.00
ptg000810l,598167,598506,339,EVM,mRNA,152,1167264,339,1.00
ptg000814l,759144,759467,323,EVM,mRNA,757193,861652,323,1.00
ptg000814l,794118,794436,318,EVM,mRNA,757193,861652,318,1.00
ptg000817l,1232056,1232372,316,EVM,mRNA,892946,1295187,316,1.00
ptg000817l,6175840,6176133,293,EVM,mRNA,5349244,6264664,293,1.00
ptg000819l,3498245,3498544,299,EVM,mRNA,3459407,5049705,299,1.00
ptg000819l,6489099,6489399,300,EVM,mRNA,6002174,7288756,300,1.00
ptg000819l,6726323,6726625,302,EVM,mRNA,6002174,7288756,302,1.00
ptg000820l,2741822,2742139,317,EVM,mRNA,2653181,2770376,317,1.00
ptg000823l,1565226,1565543,317,EVM,mRNA,20290,1660485,317,1.00
ptg000824l,3476292,3476610,318,EVM,mRNA,3086697,3476481,189,0.59
ptg000826l,297203,297480,277,EVM,mRNA,246895,458516,277,1.00
ptg000830l,295396,295715,319,EVM,mRNA,2401,1428245,319,1.00
ptg000837l,2895861,2896177,316,EVM,mRNA,2869919,3146538,316,1.00
ptg000837l,4727656,4727939,283,EVM,mRNA,4315415,5419345,283,1.00
ptg000837l,4932021,4932315,294,EVM,mRNA,4315415,5419345,294,1.00
ptg000838l,730652,730925,273,EVM,mRNA,543826,994498,273,1.00
ptg000842l,1038718,1039045,327,EVM,mRNA,1010778,1146294,327,1.00
ptg000842l,2307131,2307409,278,EVM,mRNA,2163216,3002714,278,1.00
ptg000842l,2526439,2526763,324,EVM,mRNA,2163216,3002714,324,1.00
ptg000843l,172785,173086,301,EVM,mRNA,97904,1307027,301,1.00
ptg000844l,132296,132608,312,EVM,mRNA,131998,133017,312,1.00
ptg000844l,595871,596138,267,EVM,mRNA,449845,895451,267,1.00
ptg000844l,801093,801369,276,EVM,mRNA,449845,895451,276,1.00
ptg000844l,1124963,1125273,310,EVM,mRNA,952138,1433230,310,1.00
ptg000844l,5817025,5817333,308,EVM,mRNA,4800940,5862425,308,1.00
ptg000845l,935289,935560,271,EVM,mRNA,624733,1729786,271,1.00
ptg000847l,857695,858010,315,EVM,mRNA,60551,3138731,315,1.00
ptg000847l,2092300,2092615,315,EVM,mRNA,60551,3138731,315,1.00
ptg000847l,2907987,2908305,318,EVM,mRNA,60551,3138731,318,1.00
ptg000851l,1034612,1034918,306,EVM,mRNA,437748,3547190,306,1.00
ptg000851l,1258751,1259046,295,EVM,mRNA,437748,3547190,295,1.00
ptg000851l,3181780,3182084,304,EVM,mRNA,437748,3547190,304,1.00
ptg000855l,2972889,2973196,307,EVM,mRNA,2358817,3323972,307,1.00
ptg000855l,5083620,5083910,290,EVM,mRNA,4875210,5117097,290,1.00
ptg000857l,425253,425515,262,EVM,mRNA,287987,671566,262,1.00
ptg000858l,302067,302339,272,EVM,mRNA,204820,820126,272,1.00
ptg000858l,810904,811187,283,EVM,mRNA,204820,820126,283,1.00
ptg000860l,687468,687784,316,EVM,mRNA,653408,910872,316,1.00
ptg000862l,754268,754542,274,EVM,mRNA,673853,1515890,274,1.00
ptg000862l,903890,904214,324,EVM,mRNA,673853,1515890,324,1.00
ptg000867l,268907,269186,279,EVM,mRNA,46686,3215754,279,1.00
ptg000867l,382439,382736,297,EVM,mRNA,46686,3215754,297,1.00
ptg000867l,662503,662800,297,EVM,mRNA,46686,3215754,297,1.00
ptg000867l,1017360,1017657,297,EVM,mRNA,46686,3215754,297,1.00
ptg000867l,1027622,1027902,280,EVM,mRNA,46686,3215754,280,1.00
ptg000867l,1462985,1463299,314,EVM,mRNA,46686,3215754,314,1.00
ptg000867l,2524652,2524947,295,EVM,mRNA,46686,3215754,295,1.00
ptg000867l,2943012,2943306,294,EVM,mRNA,46686,3215754,294,1.00
ptg000867l,3671534,3671813,279,EVM,mRNA,3327071,3702936,279,1.00
ptg000867l,4730290,4730612,322,EVM,mRNA,4110733,5311257,322,1.00
ptg000867l,4992925,4993184,259,EVM,mRNA,4110733,5311257,259,1.00
ptg000868l,529680,529975,295,EVM,mRNA,141432,1395404,295,1.00
ptg000868l,641180,641469,289,EVM,mRNA,141432,1395404,289,1.00
ptg000869l,70106,70396,290,EVM,mRNA,4858,372031,290,1.00
ptg000869l,71860,72150,290,EVM,mRNA,4858,372031,290,1.00
ptg000873l,116761,117068,307,EVM,mRNA,86272,1445472,307,1.00
ptg000873l,864977,865283,306,EVM,mRNA,86272,1445472,306,1.00
ptg000873l,1250107,1250373,266,EVM,mRNA,86272,1445472,266,1.00
ptg000874l,4885351,4885625,274,EVM,mRNA,4465932,5129750,274,1.00
ptg000874l,7567272,7567581,309,EVM,mRNA,7230222,7592038,309,1.00
ptg000875l,1212856,1213160,304,EVM,mRNA,884738,1870255,304,1.00
ptg000875l,6842383,6842672,289,EVM,mRNA,5978172,6872316,289,1.00
ptg000877l,1729437,1729728,291,EVM,mRNA,1623428,2030323,291,1.00
ptg000878l,205749,206051,302,EVM,mRNA,148365,574937,302,1.00
ptg000878l,3809486,3809796,310,EVM,mRNA,3623699,4071216,310,1.00
ptg000878l,5153999,5154299,300,EVM,mRNA,5060756,5260300,300,1.00
ptg000881l,1227928,1228231,303,EVM,mRNA,887919,1252088,303,1.00
ptg000881l,2991933,2992222,289,EVM,mRNA,2943798,3584241,289,1.00
ptg000883l,1122370,1122666,296,EVM,mRNA,593328,1155484,296,1.00
ptg000885l,3415073,3415335,262,EVM,mRNA,3206368,3641772,262,1.00
ptg000885l,3466282,3466575,293,EVM,mRNA,3206368,3641772,293,1.00
ptg000886l,1071114,1071409,295,EVM,mRNA,191164,3306607,295,1.00
ptg000886l,6364546,6364841,295,EVM,mRNA,5803986,6402179,295,1.00
ptg000888l,1766625,1766940,315,EVM,mRNA,1733494,2235927,315,1.00
ptg000889l,2061672,2062004,332,EVM,mRNA,1973343,3145751,332,1.00
ptg000889l,2362370,2362683,313,EVM,mRNA,1973343,3145751,313,1.00
ptg000889l,2485064,2485346,282,EVM,mRNA,1973343,3145751,282,1.00
ptg000890l,649789,650065,276,EVM,mRNA,528530,1300153,276,1.00
ptg000890l,940421,940708,287,EVM,mRNA,528530,1300153,287,1.00
ptg000891l,390832,391132,300,EVM,mRNA,110486,411575,300,1.00
ptg000892l,547552,547855,303,EVM,mRNA,443074,589581,303,1.00
ptg000893l,1553890,1554182,292,EVM,mRNA,1440528,2787594,292,1.00
ptg000893l,1579797,1580104,307,EVM,mRNA,1440528,2787594,307,1.00
ptg000893l,2627244,2627532,288,EVM,mRNA,1440528,2787594,288,1.00
ptg000893l,4384238,4384553,315,EVM,mRNA,3061663,4538852,315,1.00
ptg000893l,4449663,4449948,285,EVM,mRNA,3061663,4538852,285,1.00
ptg000893l,4537373,4537685,312,EVM,mRNA,3061663,4538852,312,1.00
ptg000893l,5043770,5044085,315,EVM,mRNA,4921460,7266480,315,1.00
ptg000893l,5122501,5122809,308,EVM,mRNA,4921460,7266480,308,1.00
ptg000893l,5197124,5197422,298,EVM,mRNA,4921460,7266480,298,1.00
ptg000893l,5480462,5480784,322,EVM,mRNA,4921460,7266480,322,1.00
ptg000893l,6628665,6628988,323,EVM,mRNA,4921460,7266480,323,1.00
ptg000895l,220225,220507,282,EVM,mRNA,98750,2397184,282,1.00
ptg000895l,1535887,1536203,316,EVM,mRNA,98750,2397184,316,1.00
ptg000895l,2156431,2156732,301,EVM,mRNA,98750,2397184,301,1.00
ptg000896l,784532,784806,274,EVM,mRNA,475179,945935,274,1.00
ptg000896l,1727352,1727644,292,EVM,mRNA,1622563,2571686,292,1.00
ptg000896l,2370185,2370498,313,EVM,mRNA,1622563,2571686,313,1.00
ptg000896l,2511257,2511564,307,EVM,mRNA,1622563,2571686,307,1.00
ptg000904l,1283711,1284020,309,EVM,mRNA,583804,2142856,309,1.00
ptg000906l,400558,400850,292,EVM,mRNA,111785,678723,292,1.00
ptg000906l,1672950,1673238,288,EVM,mRNA,1047595,3477523,288,1.00
ptg000906l,1833165,1833479,314,EVM,mRNA,1047595,3477523,314,1.00
ptg000906l,1846504,1846793,289,EVM,mRNA,1047595,3477523,289,1.00
ptg000906l,2243714,2244043,329,EVM,mRNA,1047595,3477523,329,1.00
ptg000906l,2566463,2566776,313,EVM,mRNA,1047595,3477523,313,1.00
ptg000906l,2800809,2801091,282,EVM,mRNA,1047595,3477523,282,1.00
ptg000909l,1116389,1116679,290,EVM,mRNA,417767,1372767,290,1.00
ptg000909l,1276202,1276510,308,EVM,mRNA,417767,1372767,308,1.00
ptg000910l,180086,180383,297,EVM,mRNA,9294,211108,297,1.00
ptg000912l,210965,211253,288,EVM,mRNA,152260,575447,288,1.00
ptg000912l,319231,319513,282,EVM,mRNA,152260,575447,282,1.00
ptg000913l,401662,401956,294,EVM,mRNA,26739,4295696,294,1.00
ptg000913l,2492815,2493110,295,EVM,mRNA,26739,4295696,295,1.00
ptg000913l,3319108,3319427,319,EVM,mRNA,26739,4295696,319,1.00
ptg000913l,4256582,4256885,303,EVM,mRNA,26739,4295696,303,1.00
ptg000913l,7423479,7423735,256,EVM,mRNA,7251632,7482467,256,1.00
ptg000914l,5712387,5712703,316,EVM,mRNA,5669892,5813806,316,1.00
ptg000914l,8767886,8768204,318,EVM,mRNA,6884159,8872864,318,1.00
ptg000915l,2810838,2811165,327,EVM,mRNA,2674400,3578449,327,1.00
ptg000915l,3109087,3109418,331,EVM,mRNA,2674400,3578449,331,1.00
ptg000919l,1162741,1163045,304,EVM,mRNA,266740,1775807,304,1.00
ptg000919l,1225441,1225731,290,EVM,mRNA,266740,1775807,290,1.00
ptg000920l,409334,409634,300,EVM,mRNA,403917,3270645,300,1.00
ptg000920l,978539,978816,277,EVM,mRNA,403917,3270645,277,1.00
ptg000920l,4154239,4154550,311,EVM,mRNA,3906548,4172780,311,1.00
ptg000925l,2371968,2372298,330,EVM,mRNA,1878479,2930936,330,1.00
ptg000925l,2659952,2660283,331,EVM,mRNA,1878479,2930936,331,1.00
ptg000925l,2716393,2716683,290,EVM,mRNA,1878479,2930936,290,1.00
ptg000926l,1325236,1325548,312,EVM,mRNA,1197246,1603802,312,1.00
ptg000926l,1424265,1424592,327,EVM,mRNA,1197246,1603802,327,1.00
ptg000928l,714454,714760,306,EVM,mRNA,714319,887304,306,1.00
ptg000928l,4662333,4662625,292,EVM,mRNA,4603325,5229971,292,1.00
ptg000928l,4784992,4785271,279,EVM,mRNA,4603325,5229971,279,1.00
ptg000929l,335534,335838,304,EVM,mRNA,116769,3420457,304,1.00
ptg000929l,739076,739363,287,EVM,mRNA,116769,3420457,287,1.00
ptg000929l,883907,884212,305,EVM,mRNA,116769,3420457,305,1.00
ptg000929l,965288,965545,257,EVM,mRNA,116769,3420457,257,1.00
ptg000929l,2058214,2058484,270,EVM,mRNA,116769,3420457,270,1.00
ptg000929l,2203330,2203611,281,EVM,mRNA,116769,3420457,281,1.00
ptg000931l,725638,725929,291,EVM,mRNA,359066,773156,291,1.00
ptg000933l,432272,432577,305,EVM,mRNA,291935,493616,305,1.00
ptg000933l,451837,452150,313,EVM,mRNA,291935,493616,313,1.00
ptg000934l,439907,440185,278,EVM,mRNA,210561,1051432,278,1.00
ptg000936l,689488,689791,303,EVM,mRNA,433002,739179,303,1.00
ptg000937l,558304,558620,316,EVM,mRNA,17163,2315760,316,1.00
ptg000937l,969988,970308,320,EVM,mRNA,17163,2315760,320,1.00
ptg000937l,1153433,1153714,281,EVM,mRNA,17163,2315760,281,1.00
ptg000937l,1187206,1187495,289,EVM,mRNA,17163,2315760,289,1.00
ptg000937l,1619765,1620078,313,EVM,mRNA,17163,2315760,313,1.00
ptg000937l,4087502,4087811,309,EVM,mRNA,3938212,6233015,309,1.00
ptg000937l,4743305,4743599,294,EVM,mRNA,3938212,6233015,294,1.00
ptg000937l,5785644,5785927,283,EVM,mRNA,3938212,6233015,283,1.00
ptg000937l,6170147,6170446,299,EVM,mRNA,3938212,6233015,299,1.00
ptg000937l,6197452,6197753,301,EVM,mRNA,3938212,6233015,301,1.00
ptg000940l,3779053,3779345,292,EVM,mRNA,322732,4270554,292,1.00
ptg000942l,524405,524698,293,EVM,mRNA,486665,536837,293,1.00
ptg000942l,1395832,1396124,292,EVM,mRNA,1379933,1588408,292,1.00
ptg000948l,746561,746962,401,EVM,mRNA,651181,1698542,401,1.00
ptg000948l,1275530,1275824,294,EVM,mRNA,651181,1698542,294,1.00
ptg000948l,1281829,1282124,295,EVM,mRNA,651181,1698542,295,1.00
ptg000948l,1598012,1598304,292,EVM,mRNA,651181,1698542,292,1.00
ptg000952l,275477,275790,313,EVM,mRNA,14952,2495819,313,1.00
ptg000953l,791281,791577,296,EVM,mRNA,297954,1197896,296,1.00
ptg000954l,29054,29365,311,EVM,mRNA,17904,259036,311,1.00
ptg000956l,419753,420043,290,EVM,mRNA,170778,1682114,290,1.00
ptg000956l,675084,675389,305,EVM,mRNA,170778,1682114,305,1.00
ptg000956l,867497,867812,315,EVM,mRNA,170778,1682114,315,1.00
ptg000956l,1136981,1137287,306,EVM,mRNA,170778,1682114,306,1.00
ptg000956l,1564845,1565156,311,EVM,mRNA,170778,1682114,311,1.00
ptg000957l,234535,234856,321,EVM,mRNA,125640,358743,321,1.00
ptg000957l,1372542,1372837,295,EVM,mRNA,403461,2032900,295,1.00
ptg000957l,1383350,1383628,278,EVM,mRNA,403461,2032900,278,1.00
ptg000957l,1607808,1608107,299,EVM,mRNA,403461,2032900,299,1.00
ptg000957l,1653668,1653982,314,EVM,mRNA,403461,2032900,314,1.00
ptg000957l,4680972,4681257,285,EVM,mRNA,4679522,4724701,285,1.00
ptg000957l,8114583,8114881,298,EVM,mRNA,7937669,8122542,298,1.00
ptg000958l,205187,205512,325,EVM,mRNA,150872,1814956,325,1.00
ptg000958l,1622932,1623234,302,EVM,mRNA,150872,1814956,302,1.00
ptg000959l,92681,92969,288,EVM,mRNA,92936,2116782,34,0.12
ptg000964l,1041060,1041365,305,EVM,mRNA,929040,1178544,305,1.00
ptg000965l,813992,814298,306,EVM,mRNA,333775,1376349,306,1.00
ptg000965l,4901657,4901985,328,EVM,mRNA,3876170,5275041,328,1.00
ptg000966l,432151,432473,322,EVM,mRNA,13968,1856812,322,1.00
ptg000966l,811969,812282,313,EVM,mRNA,13968,1856812,313,1.00
ptg000966l,988238,988520,282,EVM,mRNA,13968,1856812,282,1.00
ptg000966l,1496485,1496807,322,EVM,mRNA,13968,1856812,322,1.00
ptg000966l,2880317,2880596,279,EVM,mRNA,2411352,4248591,279,1.00
ptg000966l,3009668,3009975,307,EVM,mRNA,2411352,4248591,307,1.00
ptg000966l,3720345,3720623,278,EVM,mRNA,2411352,4248591,278,1.00
ptg000966l,3744784,3745104,320,EVM,mRNA,2411352,4248591,320,1.00
ptg000966l,3973561,3973834,273,EVM,mRNA,2411352,4248591,273,1.00
ptg000967l,2668040,2668357,317,EVM,mRNA,2226464,3020504,317,1.00
ptg000967l,2676587,2676915,328,EVM,mRNA,2226464,3020504,328,1.00
ptg000967l,3950223,3950538,315,EVM,mRNA,3886095,4293740,315,1.00
ptg000967l,4466888,4467201,313,EVM,mRNA,4398364,4552249,313,1.00
ptg000968l,529226,529519,293,EVM,mRNA,84108,1735451,293,1.00
ptg000968l,1363016,1363272,256,EVM,mRNA,84108,1735451,256,1.00
ptg000968l,1504577,1504902,325,EVM,mRNA,84108,1735451,325,1.00
ptg000971l,1765651,1765935,284,EVM,mRNA,1582102,1933100,284,1.00
ptg000972l,63706,64015,309,EVM,mRNA,263,858240,309,1.00
ptg000972l,527001,527273,272,EVM,mRNA,263,858240,272,1.00
ptg000973l,395606,395918,312,EVM,mRNA,314121,1005473,312,1.00
ptg000973l,567117,567398,281,EVM,mRNA,314121,1005473,281,1.00
ptg000973l,574302,574583,281,EVM,mRNA,314121,1005473,281,1.00
ptg000973l,974580,974907,327,EVM,mRNA,314121,1005473,327,1.00
ptg000973l,975566,975859,293,EVM,mRNA,314121,1005473,293,1.00
ptg000975l,917502,917815,313,EVM,mRNA,576208,6393580,313,1.00
ptg000975l,971002,971285,283,EVM,mRNA,576208,6393580,283,1.00
ptg000975l,973295,973590,295,EVM,mRNA,576208,6393580,295,1.00
ptg000975l,1944468,1944791,323,EVM,mRNA,576208,6393580,323,1.00
ptg000975l,1946847,1947178,331,EVM,mRNA,576208,6393580,331,1.00
ptg000975l,2267413,2267718,305,EVM,mRNA,576208,6393580,305,1.00
ptg000975l,3699159,3699482,323,EVM,mRNA,576208,6393580,323,1.00
ptg000975l,4769978,4770258,280,EVM,mRNA,576208,6393580,280,1.00
ptg000975l,6085830,6086143,313,EVM,mRNA,576208,6393580,313,1.00
ptg000975l,6184770,6185065,295,EVM,mRNA,576208,6393580,295,1.00
ptg000975l,6286103,6286377,274,EVM,mRNA,576208,6393580,274,1.00
ptg000977l,988860,989147,287,EVM,mRNA,855345,1263121,287,1.00
ptg000977l,3131548,3131846,298,EVM,mRNA,2594306,3913107,298,1.00
ptg000977l,3484536,3484829,293,EVM,mRNA,2594306,3913107,293,1.00
ptg000978l,1176115,1176433,318,EVM,mRNA,1081771,1871236,318,1.00
ptg000979l,1026757,1027046,289,EVM,mRNA,517915,1056390,289,1.00
ptg000979l,2169414,2169702,288,EVM,mRNA,2050704,2451737,288,1.00
ptg000979l,3293232,3293497,265,EVM,mRNA,2578199,3296481,265,1.00
ptg000980l,548125,548398,273,EVM,mRNA,245100,952649,273,1.00
ptg000980l,751551,751847,296,EVM,mRNA,245100,952649,296,1.00
ptg000980l,2080122,2080417,295,EVM,mRNA,1182390,2596107,295,1.00
ptg000980l,2544305,2544619,314,EVM,mRNA,1182390,2596107,314,1.00
ptg000980l,2854045,2854318,273,EVM,mRNA,2706911,3627862,273,1.00
ptg000980l,3742148,3742420,272,EVM,mRNA,3675689,3746521,272,1.00
ptg000983l,2558216,2558488,272,EVM,mRNA,2364418,2840052,272,1.00
ptg000984l,271131,271452,321,EVM,mRNA,248823,465449,321,1.00
ptg000984l,2659547,2659866,319,EVM,mRNA,2261725,5120259,319,1.00
ptg000984l,5006114,5006441,327,EVM,mRNA,2261725,5120259,327,1.00
ptg000994l,890894,891179,285,EVM,mRNA,605687,1341016,285,1.00
ptg000995l,677933,678248,315,EVM,mRNA,407689,978712,315,1.00
ptg000996l,1123741,1123990,249,EVM,mRNA,1086940,1421209,249,1.00
ptg000996l,1567392,1567674,282,EVM,mRNA,1429292,2854042,282,1.00
ptg000996l,2098633,2098918,285,EVM,mRNA,1429292,2854042,285,1.00
ptg000996l,2239237,2239561,324,EVM,mRNA,1429292,2854042,324,1.00
ptg000996l,3817220,3817525,305,EVM,mRNA,3774335,3993960,305,1.00
ptg000996l,4152793,4153124,331,EVM,mRNA,4054693,4178006,331,1.00
ptg000999l,420704,421022,318,EVM,mRNA,228562,662343,318,1.00
ptg001000l,355796,356088,292,EVM,mRNA,324533,620732,292,1.00
ptg001000l,1026495,1026784,289,EVM,mRNA,925609,1072686,289,1.00
ptg001000l,1144173,1144490,317,EVM,mRNA,1142492,1182674,317,1.00
ptg001001l,3252372,3252648,276,EVM,mRNA,3124244,3577456,276,1.00
ptg001002l,456015,456349,334,EVM,mRNA,67577,822483,334,1.00
ptg001006l,407792,408091,299,EVM,mRNA,198037,1397017,299,1.00
ptg001007l,1704743,1705043,300,EVM,mRNA,1508547,1869799,300,1.00
ptg001008l,1126687,1126983,296,EVM,mRNA,126114,1189363,296,1.00
ptg001010l,316432,316732,300,EVM,mRNA,281651,925480,300,1.00
ptg001010l,609019,609325,306,EVM,mRNA,281651,925480,306,1.00
ptg001010l,736571,736882,311,EVM,mRNA,281651,925480,311,1.00
ptg001010l,1841669,1841981,312,EVM,mRNA,1776428,2109062,312,1.00
ptg001010l,3312953,3313250,297,EVM,mRNA,2566980,3342764,297,1.00
ptg001010l,4139691,4139974,283,EVM,mRNA,3623044,4949863,283,1.00
ptg001010l,5197657,5197935,278,EVM,mRNA,5154506,6540018,278,1.00
ptg001010l,6084491,6084790,299,EVM,mRNA,5154506,6540018,299,1.00
ptg001010l,6390070,6390360,290,EVM,mRNA,5154506,6540018,290,1.00
ptg001012l,941815,942132,317,EVM,mRNA,6969,1261169,317,1.00
ptg001012l,941815,942132,317,GeneWise,mRNA,57636,1261166,317,1.00
ptg001013l,547150,547475,325,EVM,mRNA,495555,564372,325,1.00
ptg001014l,875151,875439,288,EVM,mRNA,2733,1354671,288,1.00
ptg001015l,447051,447354,303,EVM,mRNA,278584,514576,303,1.00
ptg001016l,1181474,1181777,303,EVM,mRNA,1124364,1262985,303,1.00
ptg001017l,806390,806661,271,EVM,mRNA,393970,1406842,271,1.00
ptg001017l,893341,893646,305,EVM,mRNA,393970,1406842,305,1.00
ptg001018l,101562,101904,342,EVM,mRNA,14966,1311171,342,1.00
ptg001018l,156537,156829,292,EVM,mRNA,14966,1311171,292,1.00
ptg001018l,2670963,2671243,280,EVM,mRNA,2647119,3664675,280,1.00
ptg001018l,4182350,4182654,304,EVM,mRNA,4155711,5348968,304,1.00
ptg001018l,5696940,5697255,315,EVM,mRNA,5568872,5701640,315,1.00
ptg001019l,1672323,1672643,320,EVM,mRNA,221075,2374398,320,1.00
ptg001019l,1851575,1851857,282,EVM,mRNA,221075,2374398,282,1.00
ptg001019l,2124034,2124352,318,EVM,mRNA,221075,2374398,318,1.00
ptg001020l,848455,848758,303,EVM,mRNA,364728,1447763,303,1.00
ptg001022l,287938,288248,310,EVM,mRNA,43846,437155,310,1.00
ptg001027l,735290,735589,299,EVM,mRNA,132164,2854759,299,1.00
ptg001027l,1313879,1314211,332,EVM,mRNA,132164,2854759,332,1.00
ptg001028l,594749,595070,321,EVM,mRNA,10143,959225,321,1.00
ptg001028l,855348,855650,302,EVM,mRNA,10143,959225,302,1.00
ptg001029l,2182535,2182834,299,EVM,mRNA,1487015,2304838,299,1.00
ptg001029l,2292839,2293156,317,EVM,mRNA,1487015,2304838,317,1.00
ptg001031l,162562,162851,289,EVM,mRNA,93588,851616,289,1.00
ptg001031l,1173146,1173446,300,EVM,mRNA,1107283,1184129,300,1.00
ptg001039l,860952,861265,313,EVM,mRNA,690898,3074344,313,1.00
ptg001039l,2266484,2266784,300,EVM,mRNA,690898,3074344,300,1.00
ptg001039l,5380212,5380534,322,GeneWise,mRNA,5113430,6022595,322,1.00
ptg001039l,5882294,5882602,308,EVM,mRNA,5740048,6022589,308,1.00
ptg001039l,5882294,5882602,308,GeneWise,mRNA,5113430,6022595,308,1.00
ptg001039l,6004944,6005276,332,EVM,mRNA,5740048,6022589,332,1.00
ptg001039l,6004944,6005276,332,GeneWise,mRNA,5113430,6022595,332,1.00
ptg001040l,1646276,1646595,319,EVM,mRNA,713854,3879598,319,1.00
ptg001040l,2151243,2151511,268,EVM,mRNA,713854,3879598,268,1.00
ptg001040l,2590574,2590890,316,EVM,mRNA,713854,3879598,316,1.00
ptg001040l,3242071,3242397,326,EVM,mRNA,713854,3879598,326,1.00
ptg001041l,581033,581348,315,EVM,mRNA,108613,663581,315,1.00
ptg001041l,893560,893877,317,EVM,mRNA,671556,1992960,317,1.00
ptg001041l,1337339,1337670,331,EVM,mRNA,671556,1992960,331,1.00
ptg001041l,3633422,3633723,301,EVM,mRNA,2302389,3748892,301,1.00
ptg001044l,2911061,2911359,298,EVM,mRNA,1801095,3286622,298,1.00
ptg001046l,664925,665221,296,EVM,mRNA,84746,1391831,296,1.00
ptg001046l,767963,768240,277,EVM,mRNA,84746,1391831,277,1.00
ptg001047l,606236,606556,320,EVM,mRNA,372839,621801,320,1.00
ptg001051l,105565,105846,281,EVM,mRNA,44467,1312731,281,1.00
ptg001051l,112756,113064,308,EVM,mRNA,44467,1312731,308,1.00
ptg001053l,1016434,1016726,292,EVM,mRNA,3219,1492538,292,1.00
ptg001056l,519539,519871,332,EVM,mRNA,198238,2395018,332,1.00
ptg001056l,756354,756653,299,EVM,mRNA,198238,2395018,299,1.00
ptg001056l,1054311,1054634,323,EVM,mRNA,198238,2395018,323,1.00
ptg001056l,2912273,2912603,330,EVM,mRNA,2906492,3963787,330,1.00
ptg001056l,2971082,2971382,300,EVM,mRNA,2906492,3963787,300,1.00
ptg001056l,3075378,3075671,293,EVM,mRNA,2906492,3963787,293,1.00
ptg001056l,3429944,3430245,301,EVM,mRNA,2906492,3963787,301,1.00
ptg001056l,3834634,3834915,281,EVM,mRNA,2906492,3963787,281,1.00
ptg001058l,1856884,1857152,268,EVM,mRNA,1827290,1900031,268,1.00
ptg001059l,5861085,5861390,305,EVM,mRNA,5474692,5909170,305,1.00
ptg001065l,901932,902219,287,EVM,mRNA,20161,1529156,287,1.00
ptg001065l,919808,920074,266,EVM,mRNA,20161,1529156,266,1.00
ptg001065l,1253951,1254284,333,EVM,mRNA,20161,1529156,333,1.00
ptg001068l,2251865,2252183,318,EVM,mRNA,2085731,2526692,318,1.00
ptg001068l,2380160,2380464,304,EVM,mRNA,2085731,2526692,304,1.00
ptg001073l,1970344,1970640,296,EVM,mRNA,1816024,2145279,296,1.00
ptg001075l,1047819,1048102,283,EVM,mRNA,937944,1538813,283,1.00
ptg001077l,482534,482831,297,EVM,mRNA,481204,482562,28,0.09
ptg001077l,756506,756768,262,EVM,mRNA,487150,4403881,262,1.00
ptg001077l,2279195,2279521,326,EVM,mRNA,487150,4403881,326,1.00
ptg001077l,5497588,5497900,312,EVM,mRNA,4907988,5874644,312,1.00
ptg001082l,130882,131210,328,EVM,mRNA,45293,1624191,328,1.00
ptg001082l,933444,933765,321,EVM,mRNA,45293,1624191,321,1.00
ptg001083l,666784,667115,331,EVM,mRNA,593991,804769,331,1.00
ptg001084l,1229438,1229758,320,EVM,mRNA,944214,1405501,320,1.00
ptg001086l,3942459,3942772,313,EVM,mRNA,2767336,4979337,313,1.00
ptg001086l,4078608,4078901,293,EVM,mRNA,2767336,4979337,293,1.00
ptg001093l,887935,888242,307,EVM,mRNA,883175,1556814,307,1.00
ptg001094l,678978,679292,314,EVM,mRNA,72270,1045114,314,1.00
ptg001094l,2664643,2664923,280,EVM,mRNA,2510185,4700598,280,1.00
ptg001094l,3453646,3453945,299,EVM,mRNA,2510185,4700598,299,1.00
ptg001094l,3681516,3681790,274,EVM,mRNA,2510185,4700598,274,1.00
ptg001094l,3736714,3737020,306,EVM,mRNA,2510185,4700598,306,1.00
ptg001095l,603520,603820,300,EVM,mRNA,495089,1939544,300,1.00
ptg001095l,635736,636064,328,EVM,mRNA,495089,1939544,328,1.00
ptg001095l,865074,865360,286,EVM,mRNA,495089,1939544,286,1.00
ptg001095l,1295252,1295555,303,EVM,mRNA,495089,1939544,303,1.00
ptg001101l,547102,547396,294,EVM,mRNA,396938,755515,294,1.00
ptg001101l,618656,618941,285,EVM,mRNA,396938,755515,285,1.00
ptg001101l,1429379,1429662,283,EVM,mRNA,1411646,1866921,283,1.00
ptg001102l,161234,161536,302,EVM,mRNA,186,1804930,302,1.00
ptg001102l,422885,423191,306,EVM,mRNA,186,1804930,306,1.00
ptg001102l,2663021,2663300,279,EVM,mRNA,1985903,5102250,279,1.00
ptg001102l,3810507,3810791,284,EVM,mRNA,1985903,5102250,284,1.00
ptg001102l,4613178,4613486,308,EVM,mRNA,1985903,5102250,308,1.00
ptg001102l,5059152,5059451,299,EVM,mRNA,1985903,5102250,299,1.00
ptg001103l,1177574,1177873,299,EVM,mRNA,1643,2935506,299,1.00
ptg001103l,2135969,2136273,304,EVM,mRNA,1643,2935506,304,1.00
ptg001103l,2209556,2209855,299,EVM,mRNA,1643,2935506,299,1.00
ptg001105l,1242309,1242625,316,EVM,mRNA,1059442,1293502,316,1.00
ptg001106l,1608732,1609016,284,EVM,mRNA,292537,1964883,284,1.00
ptg001106l,2424489,2424820,331,EVM,mRNA,2176063,3442149,331,1.00
ptg001106l,2641912,2642231,319,EVM,mRNA,2176063,3442149,319,1.00
ptg001106l,2746933,2747227,294,EVM,mRNA,2176063,3442149,294,1.00
ptg001106l,5644210,5644507,297,EVM,mRNA,3954239,6087284,297,1.00
ptg001107l,919754,920079,325,EVM,mRNA,608736,949499,325,1.00
ptg001112l,68921,69208,287,EVM,mRNA,32288,146487,287,1.00
ptg001114l,379768,380057,289,EVM,mRNA,209166,414444,289,1.00
ptg001114l,746497,746757,260,EVM,mRNA,666323,1033211,260,1.00
ptg001114l,940223,940516,293,EVM,mRNA,666323,1033211,293,1.00
ptg001130l,1008307,1008607,300,EVM,mRNA,178280,1353164,300,1.00
ptg001130l,1285302,1285580,278,EVM,mRNA,178280,1353164,278,1.00
ptg001131l,2239166,2239428,262,EVM,mRNA,927,5262458,262,1.00
ptg001131l,2709696,2710018,322,EVM,mRNA,927,5262458,322,1.00
ptg001131l,2938266,2938585,319,EVM,mRNA,927,5262458,319,1.00
ptg001131l,3068883,3069185,302,EVM,mRNA,927,5262458,302,1.00
ptg001131l,3523589,3523918,329,EVM,mRNA,927,5262458,329,1.00
ptg001131l,4034940,4035269,329,EVM,mRNA,927,5262458,329,1.00
ptg001131l,4532799,4533099,300,EVM,mRNA,927,5262458,300,1.00
ptg001131l,4719751,4720078,327,EVM,mRNA,927,5262458,327,1.00
ptg001131l,4936243,4936554,311,EVM,mRNA,927,5262458,311,1.00
ptg001133l,170254,170550,296,EVM,mRNA,68805,670013,296,1.00
ptg001133l,1104900,1105192,292,EVM,mRNA,792254,1366182,292,1.00
ptg001136l,1917137,1917426,289,EVM,mRNA,257728,3320368,289,1.00
ptg001138l,1334520,1334840,320,EVM,mRNA,1299454,1444974,320,1.00
ptg001138l,1614152,1614439,287,EVM,mRNA,1456717,2361126,287,1.00
ptg001138l,1940234,1940562,328,EVM,mRNA,1456717,2361126,328,1.00
ptg001143l,1628045,1628337,292,EVM,mRNA,1483602,1704557,292,1.00
ptg001146l,2556630,2556903,273,EVM,mRNA,2521515,2647080,273,1.00
ptg001148l,249661,249969,308,EVM,mRNA,64822,554630,308,1.00
ptg001150l,192082,192396,314,EVM,mRNA,83006,429710,314,1.00
ptg001150l,228433,228749,316,EVM,mRNA,83006,429710,316,1.00
ptg001152l,2151297,2151621,324,EVM,mRNA,1960278,2315321,324,1.00
ptg001154l,910467,910771,304,EVM,mRNA,32293,1413965,304,1.00
ptg001154l,1031712,1031995,283,EVM,mRNA,32293,1413965,283,1.00
ptg001154l,1203544,1203861,317,EVM,mRNA,32293,1413965,317,1.00
ptg001155l,653327,653620,293,EVM,mRNA,15608,1053008,293,1.00
ptg001155l,860227,860526,299,EVM,mRNA,15608,1053008,299,1.00
ptg001155l,1115936,1116228,292,EVM,mRNA,1111659,1579528,292,1.00
ptg001155l,1167853,1168183,330,EVM,mRNA,1111659,1579528,330,1.00
ptg001155l,1545238,1545525,287,EVM,mRNA,1111659,1579528,287,1.00
ptg001156l,353038,353367,329,EVM,mRNA,95085,411885,329,1.00
ptg001161l,1152033,1152301,268,EVM,mRNA,908755,1201437,268,1.00
ptg001161l,1158701,1158993,292,EVM,mRNA,908755,1201437,292,1.00
ptg001161l,3352975,3353260,285,EVM,mRNA,3138162,4579000,285,1.00
ptg001161l,3728335,3728627,292,EVM,mRNA,3138162,4579000,292,1.00
ptg001161l,4487780,4488086,306,EVM,mRNA,3138162,4579000,306,1.00
ptg001162l,1009513,1009807,294,EVM,mRNA,892134,5990883,294,1.00
ptg001162l,1086275,1086565,290,EVM,mRNA,892134,5990883,290,1.00
ptg001162l,2212939,2213245,306,EVM,mRNA,892134,5990883,306,1.00
ptg001162l,4770576,4770873,297,EVM,mRNA,892134,5990883,297,1.00
ptg001162l,5102531,5102845,314,EVM,mRNA,892134,5990883,314,1.00
ptg001162l,5468152,5468486,334,EVM,mRNA,892134,5990883,334,1.00
ptg001162l,5514067,5514335,268,EVM,mRNA,892134,5990883,268,1.00
ptg001162l,5543136,5543468,332,EVM,mRNA,892134,5990883,332,1.00
ptg001162l,5806849,5807170,321,EVM,mRNA,892134,5990883,321,1.00
ptg001162l,5882559,5882867,308,EVM,mRNA,892134,5990883,308,1.00
ptg001164l,589930,590209,279,EVM,mRNA,467364,632538,279,1.00
ptg001166l,1343119,1343416,297,EVM,mRNA,489733,1939347,297,1.00
ptg001166l,1932555,1932862,307,EVM,mRNA,489733,1939347,307,1.00
ptg001171l,1924845,1925149,304,EVM,mRNA,1661908,2115144,304,1.00
ptg001172l,526182,526480,298,EVM,mRNA,1622,1530403,298,1.00
ptg001172l,1103635,1103941,306,EVM,mRNA,1622,1530403,306,1.00
ptg001174l,326461,326768,307,EVM,mRNA,298163,440618,307,1.00
ptg001175l,956071,956388,317,EVM,mRNA,334598,1702793,317,1.00
ptg001175l,1957854,1958127,273,EVM,mRNA,1879651,2655200,273,1.00
ptg001175l,2009413,2009710,297,EVM,mRNA,1879651,2655200,297,1.00
ptg001175l,3844956,3845242,286,EVM,mRNA,3452053,4143803,286,1.00
ptg001177l,2189931,2190243,312,EVM,mRNA,1391292,2241721,312,1.00
ptg001179l,3171998,3172322,324,EVM,mRNA,1118330,3357771,324,1.00
ptg001179l,3695489,3695800,311,EVM,mRNA,3553318,4088727,311,1.00
ptg001179l,3923173,3923453,280,EVM,mRNA,3553318,4088727,280,1.00
ptg001179l,4072374,4072650,276,EVM,mRNA,3553318,4088727,276,1.00
ptg001179l,6898010,6898327,317,EVM,mRNA,6618541,7677907,317,1.00
ptg001180l,330644,330955,311,EVM,mRNA,64124,415322,311,1.00
ptg001181l,354891,355188,297,EVM,mRNA,175943,370243,297,1.00
ptg001185l,1776990,1777288,298,EVM,mRNA,496389,1997437,298,1.00
ptg001192l,1637670,1637990,320,EVM,mRNA,789264,2270019,320,1.00
ptg001193l,3484554,3484850,296,EVM,mRNA,3028522,4953267,296,1.00
ptg001193l,3649900,3650200,300,EVM,mRNA,3028522,4953267,300,1.00
ptg001193l,4854719,4855025,306,EVM,mRNA,3028522,4953267,306,1.00
ptg001194l,1158049,1158342,293,EVM,mRNA,785383,2582248,293,1.00
ptg001194l,2237253,2237589,336,EVM,mRNA,785383,2582248,336,1.00
ptg001194l,2462457,2462766,309,EVM,mRNA,785383,2582248,309,1.00
ptg001200l,653351,653636,285,EVM,mRNA,125376,969240,285,1.00
ptg001204l,1466441,1466719,278,EVM,mRNA,884818,1671015,278,1.00
ptg001208l,158896,159211,315,EVM,mRNA,113163,736263,315,1.00
ptg001208l,1987455,1987735,280,EVM,mRNA,1079145,2117114,280,1.00
ptg001208l,2931871,2932166,295,EVM,mRNA,2655534,2957062,295,1.00
ptg001208l,4850701,4851018,317,EVM,mRNA,4812054,5146981,317,1.00
ptg001208l,4872839,4873145,306,EVM,mRNA,4812054,5146981,306,1.00
ptg001208l,4911147,4911418,271,EVM,mRNA,4812054,5146981,271,1.00
ptg001208l,5698558,5698845,287,EVM,mRNA,5554155,6634680,287,1.00
ptg001212l,1005750,1006040,290,EVM,mRNA,232563,1070857,290,1.00
ptg001215l,6001131,6001453,322,EVM,mRNA,5470267,8594520,322,1.00
ptg001215l,6463604,6463916,312,EVM,mRNA,5470267,8594520,312,1.00
ptg001215l,9654358,9654649,291,EVM,mRNA,9148872,9799754,291,1.00
ptg001216l,740728,741031,303,EVM,mRNA,601304,767475,303,1.00
ptg001217l,413120,413430,310,EVM,mRNA,266298,663011,310,1.00
ptg001218l,1780835,1781128,293,EVM,mRNA,1401197,1964717,293,1.00
ptg001221l,222173,222444,271,EVM,mRNA,51662,562887,271,1.00
ptg001221l,322159,322475,316,EVM,mRNA,51662,562887,316,1.00
ptg001223l,548615,548934,319,EVM,mRNA,395409,610528,319,1.00
ptg001223l,908606,908919,313,EVM,mRNA,814896,1736625,313,1.00
ptg001223l,2438848,2439143,295,EVM,mRNA,2245779,2804804,295,1.00
ptg001223l,4381735,4382039,304,EVM,mRNA,4365075,4912601,304,1.00
ptg001223l,5567444,5567755,311,EVM,mRNA,5249534,5940593,311,1.00
ptg001225l,69221,69519,298,EVM,mRNA,3498,193755,298,1.00
ptg001228l,424914,425228,314,EVM,mRNA,57125,2174572,314,1.00
ptg001229l,817750,818041,291,EVM,mRNA,483782,1077292,291,1.00
ptg001231l,376946,377269,323,EVM,mRNA,109665,1582543,323,1.00
ptg001231l,1278503,1278784,281,EVM,mRNA,109665,1582543,281,1.00
ptg001232l,83311,83612,301,EVM,mRNA,487,231963,301,1.00
ptg001232l,2697095,2697387,292,EVM,mRNA,2599250,3653156,292,1.00
ptg001232l,8405712,8406012,300,EVM,mRNA,8003396,8473573,300,1.00
ptg001232l,9690397,9690712,315,EVM,mRNA,8859145,10437527,315,1.00
ptg001232l,10185400,10185700,300,EVM,mRNA,8859145,10437527,300,1.00
ptg001234l,2360457,2360745,288,EVM,mRNA,2061512,2390557,288,1.00
ptg001234l,4012655,4012940,285,EVM,mRNA,2863768,6223002,285,1.00
ptg001235l,549684,549997,313,EVM,mRNA,540480,899512,313,1.00
ptg001237l,100069,100373,304,EVM,mRNA,6220,174785,304,1.00
ptg001238l,1089949,1090246,297,EVM,mRNA,1009220,2101986,297,1.00
ptg001239l,1299208,1299517,309,EVM,mRNA,1025489,1471466,309,1.00
ptg001240l,1351825,1352152,327,EVM,mRNA,220863,2440696,327,1.00
ptg001242l,224461,224763,302,EVM,mRNA,172853,522876,302,1.00
ptg001244l,254294,254561,267,EVM,mRNA,116629,1173578,267,1.00
ptg001244l,853778,854089,311,EVM,mRNA,116629,1173578,311,1.00
ptg001246l,447849,448145,296,EVM,mRNA,447286,1739074,296,1.00
ptg001246l,2181502,2181818,316,EVM,mRNA,2098637,2248420,316,1.00
ptg001247l,269346,269652,306,EVM,mRNA,92,533902,306,1.00
ptg001248l,2266655,2266985,330,EVM,mRNA,1724299,2497920,330,1.00
ptg001248l,6915470,6915784,314,EVM,mRNA,5946088,8223348,314,1.00
ptg001253l,1231206,1231526,320,EVM,mRNA,1009602,1761719,320,1.00
ptg001253l,1234225,1234523,298,EVM,mRNA,1009602,1761719,298,1.00
ptg001254l,733678,733962,284,EVM,mRNA,260828,1194495,284,1.00
ptg001256l,140306,140612,306,EVM,mRNA,33970,224408,306,1.00
ptg001256l,1565832,1566110,278,EVM,mRNA,1206561,1700823,278,1.00
ptg001260l,176514,176791,277,EVM,mRNA,71819,324869,277,1.00
ptg001260l,464646,464931,285,EVM,mRNA,370919,2150472,285,1.00
ptg001260l,1651457,1651749,292,EVM,mRNA,370919,2150472,292,1.00
ptg001260l,2119886,2120199,313,EVM,mRNA,370919,2150472,313,1.00
ptg001261l,3503460,3503769,309,EVM,mRNA,3256878,3978272,309,1.00
ptg001261l,5120368,5120643,275,EVM,mRNA,4266755,5401786,275,1.00
ptg001262l,376195,376506,311,EVM,mRNA,339688,544186,311,1.00
ptg001262l,387977,388288,311,EVM,mRNA,339688,544186,311,1.00
ptg001262l,428768,429080,312,EVM,mRNA,339688,544186,312,1.00
ptg001262l,1318725,1319014,289,EVM,mRNA,1243422,2133665,289,1.00
ptg001262l,2277837,2278136,299,EVM,mRNA,2136774,3966873,299,1.00
ptg001262l,2573404,2573722,318,EVM,mRNA,2136774,3966873,318,1.00
ptg001262l,3561969,3562259,290,EVM,mRNA,2136774,3966873,290,1.00
ptg001264l,615065,615353,288,EVM,mRNA,4767,1793573,288,1.00
ptg001264l,1534968,1535286,318,EVM,mRNA,4767,1793573,318,1.00
ptg001269l,1734295,1734586,291,EVM,mRNA,803109,2349310,291,1.00
ptg001270l,1177027,1177362,335,EVM,mRNA,815090,1443168,335,1.00
ptg001270l,1262446,1262755,309,EVM,mRNA,815090,1443168,309,1.00
ptg001272l,37439,37744,305,EVM,mRNA,22077,1603599,305,1.00
ptg001272l,98487,98782,295,EVM,mRNA,22077,1603599,295,1.00
ptg001272l,388986,389285,299,EVM,mRNA,22077,1603599,299,1.00
ptg001279l,1141062,1141351,289,EVM,mRNA,820082,1303226,289,1.00
ptg001282l,1151183,1151464,281,EVM,mRNA,1124462,1535069,281,1.00
ptg001282l,1426457,1426734,277,EVM,mRNA,1124462,1535069,277,1.00
ptg001282l,1533772,1534078,306,EVM,mRNA,1124462,1535069,306,1.00
ptg001284l,3457359,3457670,311,EVM,mRNA,1205936,3576995,311,1.00
ptg001284l,3835037,3835343,306,EVM,mRNA,3717081,4261823,306,1.00
ptg001288l,2334253,2334534,281,EVM,mRNA,1113222,2727428,281,1.00
ptg001288l,2376888,2377193,305,EVM,mRNA,1113222,2727428,305,1.00
ptg001289l,204407,204681,274,EVM,mRNA,2495,421388,274,1.00
ptg001290l,2744504,2744787,283,EVM,mRNA,2591271,2854001,283,1.00
ptg001290l,3702369,3702695,326,EVM,mRNA,3281262,3727695,326,1.00
ptg001292l,688199,688484,285,EVM,mRNA,510246,757269,285,1.00
ptg001292l,4047550,4047879,329,EVM,mRNA,3812438,4837712,329,1.00
ptg001292l,4380939,4381242,303,EVM,mRNA,3812438,4837712,303,1.00
ptg001293l,1440115,1440257,142,EVM,mRNA,1026138,2293810,142,1.00
ptg001294l,479780,480099,319,EVM,mRNA,241022,931608,319,1.00
ptg001294l,708798,709110,312,EVM,mRNA,241022,931608,312,1.00
ptg001294l,1443071,1443346,275,EVM,mRNA,1364981,1454808,275,1.00
ptg001295l,226746,227058,312,EVM,mRNA,18217,852037,312,1.00
ptg001298l,215048,215331,283,EVM,mRNA,13555,620160,283,1.00
ptg001302l,2325628,2325928,300,EVM,mRNA,2090705,2547655,300,1.00
ptg001302l,4197426,4197721,295,EVM,mRNA,4002614,4772371,295,1.00
ptg001302l,4378503,4378796,293,EVM,mRNA,4002614,4772371,293,1.00
ptg001304l,237288,237575,287,EVM,mRNA,156519,382093,287,1.00
ptg001305l,472553,472836,283,EVM,mRNA,388792,758391,283,1.00
ptg001305l,1594617,1594907,290,EVM,mRNA,1123465,2544169,290,1.00
ptg001305l,1655475,1655778,303,EVM,mRNA,1123465,2544169,303,1.00
ptg001305l,1998006,1998286,280,EVM,mRNA,1123465,2544169,280,1.00
ptg001305l,3142714,3142996,282,EVM,mRNA,2871906,3456882,282,1.00
ptg001305l,4947163,4947462,299,EVM,mRNA,4750061,6425934,299,1.00
ptg001305l,6114539,6114838,299,EVM,mRNA,4750061,6425934,299,1.00
ptg001305l,7204746,7205060,314,EVM,mRNA,6966755,7619281,314,1.00
ptg001307l,1605455,1605780,325,EVM,mRNA,704123,1820467,325,1.00
ptg001307l,2089941,2090238,297,EVM,mRNA,2074515,2713438,297,1.00
ptg001308l,1228572,1228835,263,EVM,mRNA,819895,1512019,263,1.00
ptg001309l,981920,982245,325,EVM,mRNA,797032,1797758,325,1.00
ptg001309l,1372571,1372884,313,EVM,mRNA,797032,1797758,313,1.00
ptg001310l,667360,667670,310,EVM,mRNA,39605,1223209,310,1.00
ptg001310l,2698643,2698925,282,EVM,mRNA,2488024,2827039,282,1.00
ptg001313l,3674349,3674665,316,EVM,mRNA,3523467,4601123,316,1.00
ptg001313l,3697826,3698139,313,EVM,mRNA,3523467,4601123,313,1.00
ptg001313l,3941431,3941741,310,EVM,mRNA,3523467,4601123,310,1.00
ptg001313l,4092779,4093074,295,EVM,mRNA,3523467,4601123,295,1.00
ptg001313l,4395266,4395580,314,EVM,mRNA,3523467,4601123,314,1.00
ptg001313l,4493682,4493992,310,EVM,mRNA,3523467,4601123,310,1.00
ptg001316l,1921161,1921460,299,EVM,mRNA,1618249,2792118,299,1.00
ptg001316l,2569479,2569768,289,EVM,mRNA,1618249,2792118,289,1.00
ptg001316l,5091745,5092012,267,EVM,mRNA,4842334,5108850,267,1.00
ptg001317l,1464777,1465054,277,EVM,mRNA,1389107,1813920,277,1.00
ptg001321l,1029811,1030102,291,EVM,mRNA,1003839,1063103,291,1.00
ptg001323l,2013833,2014114,281,EVM,mRNA,72526,2676060,281,1.00
ptg001326l,733161,733477,316,EVM,mRNA,301173,897010,316,1.00
ptg001332l,284160,284477,317,EVM,mRNA,116141,314580,317,1.00
ptg001334l,2323778,2324067,289,EVM,mRNA,1682544,2964785,289,1.00
ptg001334l,2815534,2815807,273,EVM,mRNA,1682544,2964785,273,1.00
ptg001335l,438672,438963,291,EVM,mRNA,184181,1215099,291,1.00
ptg001335l,508671,509025,354,EVM,mRNA,184181,1215099,354,1.00
ptg001336l,2072593,2072905,312,EVM,mRNA,1559101,2445696,312,1.00
ptg001337l,1045394,1045689,295,EVM,mRNA,23595,1323546,295,1.00
ptg001339l,2612176,2612483,307,EVM,mRNA,2602416,2851066,307,1.00
ptg001339l,5894305,5894626,321,EVM,mRNA,5739879,6320793,321,1.00
ptg001342l,858240,858555,315,EVM,mRNA,673884,888559,315,1.00
ptg001344l,596799,597110,311,EVM,mRNA,235969,763440,311,1.00
ptg001344l,1252795,1253093,298,EVM,mRNA,949886,1962955,298,1.00
ptg001344l,1643328,1643627,299,EVM,mRNA,949886,1962955,299,1.00
ptg001347l,174876,175153,277,EVM,mRNA,348,426607,277,1.00
ptg001350l,2100732,2101062,330,EVM,mRNA,1787686,2170004,330,1.00
ptg001351l,2934114,2934402,288,EVM,mRNA,2925407,3167230,288,1.00
ptg001352l,210138,210454,316,EVM,mRNA,147357,542841,316,1.00
ptg001353l,2016964,2017261,297,EVM,mRNA,1563892,2967616,297,1.00
ptg001353l,2888545,2888835,290,EVM,mRNA,1563892,2967616,290,1.00
ptg001354l,973161,973455,294,EVM,mRNA,184452,1867575,294,1.00
ptg001354l,1489784,1490103,319,EVM,mRNA,184452,1867575,319,1.00
ptg001358l,614871,615178,307,EVM,mRNA,614236,1919958,307,1.00
ptg001358l,1379038,1379324,286,EVM,mRNA,614236,1919958,286,1.00
ptg001358l,3530390,3530677,287,EVM,mRNA,2392418,4856495,287,1.00
ptg001358l,3969545,3969850,305,EVM,mRNA,2392418,4856495,305,1.00
ptg001358l,5449749,5450071,322,EVM,mRNA,5430417,6226231,322,1.00
ptg001361l,577728,578033,305,EVM,mRNA,283676,1284663,305,1.00
ptg001363l,28523,28827,304,EVM,mRNA,4056,64517,304,1.00
ptg001363l,2248173,2248478,305,EVM,mRNA,1366972,2703414,305,1.00
ptg001363l,4460188,4460474,286,EVM,mRNA,2756145,4669140,286,1.00
ptg001369l,477457,477772,315,EVM,mRNA,87708,1482616,315,1.00
ptg001369l,588603,588893,290,EVM,mRNA,87708,1482616,290,1.00
ptg001369l,1156208,1156503,295,EVM,mRNA,87708,1482616,295,1.00
ptg001369l,1369378,1369688,310,EVM,mRNA,87708,1482616,310,1.00
ptg001369l,1372209,1372534,325,EVM,mRNA,87708,1482616,325,1.00
ptg001369l,2927434,2927752,318,EVM,mRNA,2865182,3270444,318,1.00
ptg001369l,3501683,3501989,306,EVM,mRNA,3306406,3695726,306,1.00
ptg001369l,4399558,4399844,286,EVM,mRNA,4320195,4433998,286,1.00
ptg001369l,5793944,5794263,319,EVM,mRNA,4463882,5902082,319,1.00
ptg001369l,5835185,5835464,279,EVM,mRNA,4463882,5902082,279,1.00
ptg001371l,1458051,1458357,306,EVM,mRNA,752368,4759327,306,1.00
ptg001371l,1491128,1491441,313,EVM,mRNA,752368,4759327,313,1.00
ptg001371l,1682676,1682956,280,EVM,mRNA,752368,4759327,280,1.00
ptg001371l,2019012,2019286,274,EVM,mRNA,752368,4759327,274,1.00
ptg001371l,2653820,2654157,337,EVM,mRNA,752368,4759327,337,1.00
ptg001371l,2662126,2662427,301,EVM,mRNA,752368,4759327,301,1.00
ptg001371l,2723176,2723480,304,EVM,mRNA,752368,4759327,304,1.00
ptg001371l,2867128,2867447,319,EVM,mRNA,752368,4759327,319,1.00
ptg001371l,3444114,3444410,296,EVM,mRNA,752368,4759327,296,1.00
ptg001371l,3732460,3732761,301,EVM,mRNA,752368,4759327,301,1.00
ptg001371l,3835348,3835683,335,EVM,mRNA,752368,4759327,335,1.00
ptg001371l,3945019,3945329,310,EVM,mRNA,752368,4759327,310,1.00
ptg001371l,3957868,3958195,327,EVM,mRNA,752368,4759327,327,1.00
ptg001371l,4508281,4508568,287,EVM,mRNA,752368,4759327,287,1.00
ptg001371l,5969829,5970158,329,EVM,mRNA,5821510,5986693,329,1.00
ptg001371l,10883691,10883964,273,EVM,mRNA,10697894,11144373,273,1.00
ptg001371l,11776574,11776907,333,EVM,mRNA,11478820,11870818,333,1.00
ptg001371l,12299802,12300086,284,EVM,mRNA,11998967,12307638,284,1.00
ptg001372l,427564,427883,319,EVM,mRNA,19128,434390,319,1.00
ptg001372l,1890627,1890916,289,EVM,mRNA,1200978,2871381,289,1.00
ptg001377l,376435,376748,313,EVM,mRNA,367000,769193,313,1.00
ptg001377l,635794,636117,323,EVM,mRNA,367000,769193,323,1.00
ptg001379l,777401,777735,334,EVM,mRNA,707644,806515,334,1.00
ptg001379l,1265066,1265383,317,EVM,mRNA,1024523,1519613,317,1.00
ptg001379l,2307468,2307766,298,EVM,mRNA,2204457,2723397,298,1.00
ptg001379l,2323414,2323693,279,EVM,mRNA,2204457,2723397,279,1.00
ptg001379l,2598387,2598694,307,EVM,mRNA,2204457,2723397,307,1.00
ptg001381l,1925037,1925304,267,EVM,mRNA,1868494,2468840,267,1.00
ptg001381l,3178110,3178438,328,EVM,mRNA,2602821,3417638,328,1.00
ptg001381l,6239244,6239576,332,EVM,mRNA,5968931,6551478,332,1.00
ptg001381l,6260545,6260871,326,EVM,mRNA,5968931,6551478,326,1.00
ptg001382l,367198,367471,273,EVM,mRNA,344613,1138492,273,1.00
ptg001382l,402649,402950,301,EVM,mRNA,344613,1138492,301,1.00
ptg001382l,502523,502837,314,EVM,mRNA,344613,1138492,314,1.00
ptg001382l,740442,740741,299,EVM,mRNA,344613,1138492,299,1.00
ptg001385l,1579733,1580018,285,EVM,mRNA,988680,2192696,285,1.00
ptg001387l,3724462,3724781,319,EVM,mRNA,3426964,3763639,319,1.00
ptg001387l,5477128,5477426,298,EVM,mRNA,5241361,5688720,298,1.00
ptg001390l,969038,969366,328,EVM,mRNA,507729,1557260,328,1.00
ptg001390l,2776570,2776856,286,EVM,mRNA,2577610,2811186,286,1.00
ptg001390l,3166778,3167075,297,EVM,mRNA,3039563,5140169,297,1.00
ptg001390l,4490130,4490447,317,EVM,mRNA,3039563,5140169,317,1.00
ptg001390l,4808697,4809011,314,EVM,mRNA,3039563,5140169,314,1.00
ptg001391l,225662,225921,259,EVM,mRNA,6153,389323,259,1.00
ptg001393l,1373419,1373733,314,EVM,mRNA,803522,1458942,314,1.00
ptg001393l,1962671,1962970,299,EVM,mRNA,1625928,2921351,299,1.00
ptg001400l,1593236,1593555,319,EVM,mRNA,960689,2003075,319,1.00
ptg001406l,1263671,1263971,300,EVM,mRNA,702884,1307726,300,1.00
ptg001406l,3270617,3270925,308,EVM,mRNA,3183140,3653412,308,1.00
ptg001409l,215860,216141,281,EVM,mRNA,6354,501369,281,1.00
ptg001409l,879201,879509,308,EVM,mRNA,521918,906032,308,1.00
ptg001410l,294667,294979,312,EVM,mRNA,292260,708986,312,1.00
ptg001414l,2498169,2498479,310,EVM,mRNA,1037401,2686404,310,1.00
ptg001417l,519125,519411,286,EVM,mRNA,4591,1455529,286,1.00
ptg001417l,2988475,2988769,294,EVM,mRNA,2972711,3460754,294,1.00
ptg001417l,3326640,3326962,322,EVM,mRNA,2972711,3460754,322,1.00
ptg001419l,524554,524831,277,EVM,mRNA,335981,718071,277,1.00
ptg001419l,2388830,2389111,281,EVM,mRNA,2041801,3089380,281,1.00
ptg001419l,2396032,2396313,281,EVM,mRNA,2041801,3089380,281,1.00
ptg001422l,1908703,1909019,316,EVM,mRNA,137085,3163013,316,1.00
ptg001422l,2270844,2271143,299,EVM,mRNA,137085,3163013,299,1.00
ptg001424l,824016,824302,286,EVM,mRNA,288,2860924,286,1.00
ptg001424l,1109008,1109287,279,EVM,mRNA,288,2860924,279,1.00
ptg001424l,1115426,1115758,332,EVM,mRNA,288,2860924,332,1.00
ptg001424l,2850346,2850649,303,EVM,mRNA,288,2860924,303,1.00
ptg001425l,208845,209141,296,EVM,mRNA,123273,240693,296,1.00
ptg001426l,3165612,3165915,303,EVM,mRNA,912908,3444298,303,1.00
ptg001426l,4266128,4266413,285,EVM,mRNA,3685305,4722585,285,1.00
ptg001426l,4336961,4337252,291,EVM,mRNA,3685305,4722585,291,1.00
ptg001426l,4699349,4699667,318,EVM,mRNA,3685305,4722585,318,1.00
ptg001427l,634742,635042,300,EVM,mRNA,547616,679554,300,1.00
ptg001427l,1316558,1316864,306,EVM,mRNA,1284834,2558938,306,1.00
ptg001427l,1551406,1551726,320,EVM,mRNA,1284834,2558938,320,1.00
ptg001427l,1595153,1595451,298,EVM,mRNA,1284834,2558938,298,1.00
ptg001427l,1703118,1703418,300,EVM,mRNA,1284834,2558938,300,1.00
ptg001429l,1794303,1794593,290,EVM,mRNA,1784214,2957940,290,1.00
ptg001429l,1898261,1898588,327,EVM,mRNA,1784214,2957940,327,1.00
ptg001429l,3667746,3668039,293,EVM,mRNA,3048540,4309798,293,1.00
ptg001430l,164381,164667,286,EVM,mRNA,68419,668540,286,1.00
ptg001430l,911504,911826,322,EVM,mRNA,702729,1447698,322,1.00
ptg001431l,1356238,1356540,302,EVM,mRNA,119212,1429658,302,1.00
ptg001432l,1841588,1841907,319,EVM,mRNA,1285352,1945450,319,1.00
ptg001433l,438946,439246,300,EVM,mRNA,156592,1666992,300,1.00
ptg001433l,812480,812749,269,EVM,mRNA,156592,1666992,269,1.00
ptg001434l,785978,786284,306,EVM,mRNA,262995,1156877,306,1.00
ptg001437l,1402459,1402770,311,EVM,mRNA,924767,3566296,311,1.00
ptg001437l,2417832,2418120,288,EVM,mRNA,924767,3566296,288,1.00
ptg001437l,2669999,2670293,294,EVM,mRNA,924767,3566296,294,1.00
ptg001438l,2252141,2252459,318,EVM,mRNA,2240513,2253675,318,1.00
ptg001441l,269632,269946,314,EVM,mRNA,266495,876719,314,1.00
ptg001441l,1620674,1620952,278,EVM,mRNA,897128,2633199,278,1.00
ptg001448l,747680,747946,266,EVM,mRNA,690905,873375,266,1.00
ptg001448l,932209,932492,283,EVM,mRNA,873854,935764,283,1.00
ptg001451l,1521991,1522290,299,EVM,mRNA,1293313,2382661,299,1.00
ptg001451l,2148049,2148381,332,EVM,mRNA,1293313,2382661,332,1.00
ptg001456l,1602796,1603060,264,EVM,mRNA,1367697,1893329,264,1.00
ptg001456l,1641027,1641312,285,EVM,mRNA,1367697,1893329,285,1.00
ptg001456l,1778226,1778562,336,EVM,mRNA,1367697,1893329,336,1.00
ptg001457l,923265,923545,280,EVM,mRNA,640155,1496837,280,1.00
ptg001457l,1339982,1340264,282,EVM,mRNA,640155,1496837,282,1.00
ptg001459l,781956,782264,308,EVM,mRNA,779581,1011338,308,1.00
ptg001460l,922015,922320,305,EVM,mRNA,67,2089890,305,1.00
ptg001461l,1603044,1603343,299,EVM,mRNA,697022,1880996,299,1.00
ptg001464l,827079,827406,327,EVM,mRNA,738401,944740,327,1.00
ptg001466l,1001571,1001853,282,EVM,mRNA,889730,5192823,282,1.00
ptg001466l,1540399,1540722,323,EVM,mRNA,889730,5192823,323,1.00
ptg001466l,1904944,1905227,283,EVM,mRNA,889730,5192823,283,1.00
ptg001466l,2427064,2427351,287,EVM,mRNA,889730,5192823,287,1.00
ptg001466l,2595471,2595785,314,EVM,mRNA,889730,5192823,314,1.00
ptg001466l,3801365,3801646,281,EVM,mRNA,889730,5192823,281,1.00
ptg001466l,4235432,4235747,315,EVM,mRNA,889730,5192823,315,1.00
ptg001466l,4933473,4933745,272,EVM,mRNA,889730,5192823,272,1.00
ptg001472l,1735571,1735855,284,EVM,mRNA,1514040,1742317,284,1.00
ptg001475l,48591,48890,299,EVM,mRNA,2128,813762,299,1.00
ptg001475l,464862,465179,317,EVM,mRNA,2128,813762,317,1.00
ptg001475l,519428,519726,298,EVM,mRNA,2128,813762,298,1.00
ptg001480l,1738664,1738945,281,EVM,mRNA,1623596,3377326,281,1.00
ptg001480l,2404780,2405092,312,EVM,mRNA,1623596,3377326,312,1.00
ptg001481l,2241479,2241791,312,EVM,mRNA,1569937,2949955,312,1.00
ptg001481l,2336748,2337069,321,EVM,mRNA,1569937,2949955,321,1.00
ptg001481l,2568146,2568458,312,EVM,mRNA,1569937,2949955,312,1.00
ptg001481l,2661096,2661418,322,EVM,mRNA,1569937,2949955,322,1.00
ptg001481l,2897075,2897403,328,EVM,mRNA,1569937,2949955,328,1.00
ptg001487l,3202542,3202816,274,EVM,mRNA,3138124,3249029,274,1.00
ptg001490l,646941,647260,319,EVM,mRNA,215174,2193269,319,1.00
ptg001490l,1048991,1049284,293,EVM,mRNA,215174,2193269,293,1.00
ptg001490l,3343807,3344090,283,EVM,mRNA,2635209,3468168,283,1.00
ptg001492l,740475,740773,298,EVM,mRNA,99296,1605368,298,1.00
ptg001492l,1224803,1225096,293,EVM,mRNA,99296,1605368,293,1.00
ptg001492l,1392307,1392606,299,EVM,mRNA,99296,1605368,299,1.00
ptg001495l,124842,125146,304,EVM,mRNA,57617,308362,304,1.00
ptg001495l,657389,657679,290,EVM,mRNA,502221,844533,290,1.00
ptg001499l,1199175,1199467,292,EVM,mRNA,1168490,1778729,292,1.00
ptg001500l,1069404,1069707,303,EVM,mRNA,984646,1199189,303,1.00
ptg001502l,1075232,1075527,295,EVM,mRNA,972905,1958096,295,1.00
ptg001502l,1714630,1714914,284,EVM,mRNA,972905,1958096,284,1.00
ptg001502l,3127398,3127705,307,EVM,mRNA,2974180,3207793,307,1.00
ptg001505l,1688305,1688597,292,EVM,mRNA,1512477,2535871,292,1.00
ptg001505l,4100269,4100527,258,EVM,mRNA,4087374,4688740,258,1.00
ptg001505l,4573635,4573911,276,EVM,mRNA,4087374,4688740,276,1.00
ptg001505l,6312245,6312568,323,EVM,mRNA,6001916,6364014,323,1.00
ptg001505l,7031994,7032249,255,EVM,mRNA,6657916,7600307,255,1.00
ptg001505l,7343121,7343426,305,EVM,mRNA,6657916,7600307,305,1.00
ptg001505l,8610945,8611283,338,EVM,mRNA,8206350,8612108,338,1.00
ptg001505l,9079988,9080290,302,EVM,mRNA,8843377,9608360,302,1.00
ptg001505l,9282378,9282680,302,EVM,mRNA,8843377,9608360,302,1.00
ptg001506l,1683134,1683433,299,EVM,mRNA,1681672,1744624,299,1.00
ptg001509l,583440,583755,315,EVM,mRNA,286,1575494,315,1.00
ptg001512l,139499,139803,304,EVM,mRNA,62586,770727,304,1.00
ptg001512l,158859,159167,308,EVM,mRNA,62586,770727,308,1.00
ptg001512l,564375,564667,292,EVM,mRNA,62586,770727,292,1.00
ptg001512l,938176,938464,288,EVM,mRNA,936973,1474529,288,1.00
ptg001513l,360905,361210,305,EVM,mRNA,524,366424,305,1.00
ptg001513l,1196835,1197115,280,EVM,mRNA,518993,1837847,280,1.00
ptg001513l,1687898,1688223,325,EVM,mRNA,518993,1837847,325,1.00
ptg001513l,2334948,2335240,292,EVM,mRNA,2031742,2465289,292,1.00
ptg001513l,2964836,2965139,303,EVM,mRNA,2656725,3311912,303,1.00
ptg001513l,4055150,4055459,309,EVM,mRNA,3655488,4382362,309,1.00
ptg001515l,606136,606461,325,EVM,mRNA,479345,816175,325,1.00
ptg001515l,754105,754376,271,EVM,mRNA,479345,816175,271,1.00
ptg001516l,1795468,1795756,288,EVM,mRNA,120,2255767,288,1.00
ptg001516l,1801531,1801842,311,EVM,mRNA,120,2255767,311,1.00
ptg001517l,1764369,1764634,265,EVM,mRNA,1702299,2429292,265,1.00
ptg001517l,3203092,3203405,313,EVM,mRNA,2760421,4052053,313,1.00
ptg001517l,3969107,3969391,284,EVM,mRNA,2760421,4052053,284,1.00
ptg001518l,2909100,2909386,286,EVM,mRNA,2561348,5520499,286,1.00
ptg001518l,3067486,3067790,304,EVM,mRNA,2561348,5520499,304,1.00
ptg001518l,4260837,4261155,318,EVM,mRNA,2561348,5520499,318,1.00
ptg001518l,5376441,5376734,293,EVM,mRNA,2561348,5520499,293,1.00
ptg001518l,6538179,6538446,267,EVM,mRNA,6293791,8770216,267,1.00
ptg001518l,7100918,7101177,259,EVM,mRNA,6293791,8770216,259,1.00
ptg001518l,7603885,7604162,277,EVM,mRNA,6293791,8770216,277,1.00
ptg001518l,7754088,7754402,314,EVM,mRNA,6293791,8770216,314,1.00
ptg001518l,8122030,8122309,279,EVM,mRNA,6293791,8770216,279,1.00
ptg001519l,1699658,1699934,276,EVM,mRNA,1615899,3794769,276,1.00
ptg001519l,1715238,1715567,329,EVM,mRNA,1615899,3794769,329,1.00
ptg001519l,2343686,2343991,305,EVM,mRNA,1615899,3794769,305,1.00
ptg001519l,2892565,2892845,280,EVM,mRNA,1615899,3794769,280,1.00
ptg001519l,3264739,3265055,316,EVM,mRNA,1615899,3794769,316,1.00
ptg001525l,1942730,1943019,289,EVM,mRNA,1510489,2794134,289,1.00
ptg001525l,2715424,2715725,301,EVM,mRNA,1510489,2794134,301,1.00
ptg001527l,1181497,1181812,315,EVM,mRNA,493617,2236826,315,1.00
ptg001527l,1845404,1845736,332,EVM,mRNA,493617,2236826,332,1.00
ptg001530l,1455827,1456087,260,EVM,mRNA,1447721,1522880,260,1.00
ptg001531l,2062964,2063238,274,EVM,mRNA,2022632,4506740,274,1.00
ptg001531l,2309252,2309531,279,EVM,mRNA,2022632,4506740,279,1.00
ptg001531l,3147302,3147589,287,EVM,mRNA,2022632,4506740,287,1.00
ptg001531l,3405959,3406260,301,EVM,mRNA,2022632,4506740,301,1.00
ptg001531l,3512999,3513294,295,EVM,mRNA,2022632,4506740,295,1.00
ptg001531l,4308028,4308304,276,EVM,mRNA,2022632,4506740,276,1.00
ptg001531l,5716207,5716508,301,EVM,mRNA,5667014,5881927,301,1.00
ptg001533l,3504301,3504568,267,EVM,mRNA,3213071,4048690,267,1.00
ptg001535l,1363787,1364063,276,EVM,mRNA,464919,1958048,276,1.00
ptg001536l,2405959,2406252,293,EVM,mRNA,1747466,2426124,293,1.00
ptg001537l,487319,487621,302,EVM,mRNA,330712,726748,302,1.00
ptg001551l,3513545,3513832,287,EVM,mRNA,2889767,4206518,287,1.00
ptg001551l,3695381,3695694,313,EVM,mRNA,2889767,4206518,313,1.00
ptg001553l,799675,799991,316,EVM,mRNA,379669,1328527,316,1.00
ptg001560l,3112003,3112328,325,EVM,mRNA,2549224,3668424,325,1.00
ptg001560l,4604723,4605030,307,EVM,mRNA,4592457,5942897,307,1.00
ptg001562l,380967,381287,320,EVM,mRNA,25895,1766541,320,1.00
ptg001562l,496968,497242,274,EVM,mRNA,25895,1766541,274,1.00
ptg001562l,682953,683240,287,EVM,mRNA,25895,1766541,287,1.00
ptg001562l,1619500,1619812,312,EVM,mRNA,25895,1766541,312,1.00
ptg001564l,573626,573950,324,EVM,mRNA,573389,1200550,324,1.00
ptg001564l,2293270,2293574,304,EVM,mRNA,1393595,2716529,304,1.00
ptg001567l,2649582,2649880,298,EVM,mRNA,2062031,2698144,298,1.00
ptg001567l,2663106,2663367,261,EVM,mRNA,2062031,2698144,261,1.00
ptg001567l,4100837,4101132,295,EVM,mRNA,3984180,4399985,295,1.00
ptg001569l,1359181,1359491,310,EVM,mRNA,1337512,1510055,310,1.00
ptg001570l,631015,631330,315,EVM,mRNA,573910,656816,315,1.00
ptg001571l,78545,78831,286,EVM,mRNA,391,865005,286,1.00
ptg001571l,503748,504051,303,EVM,mRNA,391,865005,303,1.00
ptg001571l,3412272,3412560,288,EVM,mRNA,2694031,3513574,288,1.00
ptg001574l,400281,400595,314,EVM,mRNA,152237,2981657,314,1.00
ptg001575l,238756,239041,285,EVM,mRNA,194698,257930,285,1.00
ptg001575l,1714510,1714804,294,EVM,mRNA,1626857,1761355,294,1.00
ptg001575l,1847246,1847569,323,EVM,mRNA,1814542,2540801,323,1.00
ptg001575l,2261733,2262031,298,EVM,mRNA,1814542,2540801,298,1.00
ptg001575l,6444938,6445231,293,EVM,mRNA,4154471,8552828,293,1.00
ptg001575l,6820735,6821021,286,EVM,mRNA,4154471,8552828,286,1.00
ptg001577l,2249622,2249898,276,EVM,mRNA,2020544,3526444,276,1.00
ptg001577l,3029896,3030184,288,EVM,mRNA,2020544,3526444,288,1.00
ptg001577l,4234432,4234718,286,EVM,mRNA,3528164,5152800,286,1.00
ptg001577l,4433908,4434190,282,EVM,mRNA,3528164,5152800,282,1.00
ptg001579l,2495724,2496028,304,EVM,mRNA,103573,2866248,304,1.00
ptg001581l,1185506,1185806,300,EVM,mRNA,9434,2099139,300,1.00
ptg001582l,78713,79004,291,EVM,mRNA,55775,1245700,291,1.00
ptg001582l,1598307,1598613,306,EVM,mRNA,1392557,1598351,44,0.14
ptg001585l,189461,189771,310,EVM,mRNA,5810,871996,310,1.00
ptg001585l,2184254,2184545,291,EVM,mRNA,1127518,2748281,291,1.00
ptg001585l,2571965,2572265,300,EVM,mRNA,1127518,2748281,300,1.00
ptg001585l,4424630,4424944,314,EVM,mRNA,4088241,6938321,314,1.00
ptg001585l,5019214,5019497,283,EVM,mRNA,4088241,6938321,283,1.00
ptg001585l,5215898,5216212,314,EVM,mRNA,4088241,6938321,314,1.00
ptg001585l,6527270,6527557,287,EVM,mRNA,4088241,6938321,287,1.00
ptg001588l,154241,154543,302,EVM,mRNA,86754,723243,302,1.00
ptg001589l,2571024,2571325,301,EVM,mRNA,2562940,2583020,301,1.00
ptg001590l,2132460,2132725,265,EVM,mRNA,2064810,2321990,265,1.00
ptg001590l,2598248,2598571,323,EVM,mRNA,2374214,2606883,323,1.00
ptg001592l,188159,188452,293,EVM,mRNA,109445,779376,293,1.00
ptg001592l,203482,203789,307,EVM,mRNA,109445,779376,307,1.00
ptg001592l,503426,503710,284,EVM,mRNA,109445,779376,284,1.00
ptg001592l,741564,741904,340,EVM,mRNA,109445,779376,340,1.00
ptg001596l,810702,811004,302,EVM,mRNA,656126,1010387,302,1.00
ptg001598l,890680,890988,308,EVM,mRNA,374623,1889229,308,1.00
ptg001598l,1377217,1377536,319,EVM,mRNA,374623,1889229,319,1.00
ptg001599l,1436717,1437021,304,EVM,mRNA,938251,1595987,304,1.00
ptg001600l,249541,249857,316,EVM,mRNA,38835,830598,316,1.00
ptg001600l,828755,829038,283,EVM,mRNA,38835,830598,283,1.00
ptg001600l,1107689,1107988,299,EVM,mRNA,967952,1187084,299,1.00
ptg001601l,474402,474688,286,EVM,mRNA,172065,540617,286,1.00
ptg001601l,1783846,1784146,300,EVM,mRNA,1521293,3401750,300,1.00
ptg001601l,2626743,2627054,311,EVM,mRNA,1521293,3401750,311,1.00
ptg001602l,3745909,3746203,294,EVM,mRNA,3633855,4337757,294,1.00
ptg001605l,1085073,1085359,286,EVM,mRNA,1049828,1172033,286,1.00
ptg001606l,19664,19976,312,EVM,mRNA,10881,104234,312,1.00
ptg001606l,1651929,1652255,326,EVM,mRNA,1568201,1854903,326,1.00
ptg001607l,324980,325268,288,EVM,mRNA,31249,991020,288,1.00
ptg001607l,900811,901125,314,EVM,mRNA,31249,991020,314,1.00
ptg001614l,140730,141011,281,EVM,mRNA,63798,177119,281,1.00
ptg001615l,3645279,3645570,291,EVM,mRNA,3568635,3735092,291,1.00
ptg001616l,478546,478859,313,EVM,mRNA,200740,515124,313,1.00
ptg001616l,2449708,2450008,300,EVM,mRNA,1737520,4525120,300,1.00
ptg001616l,2594938,2595251,313,EVM,mRNA,1737520,4525120,313,1.00
ptg001616l,2795728,2796017,289,EVM,mRNA,1737520,4525120,289,1.00
ptg001616l,3406035,3406329,294,EVM,mRNA,1737520,4525120,294,1.00
ptg001616l,3434878,3435178,300,EVM,mRNA,1737520,4525120,300,1.00
ptg001616l,4216117,4216430,313,EVM,mRNA,1737520,4525120,313,1.00
ptg001620l,1099515,1099818,303,EVM,mRNA,590081,4231251,303,1.00
ptg001620l,1250872,1251159,287,EVM,mRNA,590081,4231251,287,1.00
ptg001620l,2246851,2247148,297,EVM,mRNA,590081,4231251,297,1.00
ptg001620l,3168910,3169219,309,EVM,mRNA,590081,4231251,309,1.00
ptg001625l,824395,824737,342,EVM,mRNA,355487,1289554,342,1.00
ptg001627l,2108311,2108620,309,EVM,mRNA,120240,2256902,309,1.00
ptg001628l,686423,686747,324,EVM,mRNA,664816,787074,324,1.00
ptg001628l,870214,870528,314,EVM,mRNA,798440,1757040,314,1.00
ptg001628l,877038,877319,281,EVM,mRNA,798440,1757040,281,1.00
ptg001629l,1585815,1586116,301,EVM,mRNA,1322093,2141172,301,1.00
ptg001630l,468175,468492,317,EVM,mRNA,5837,3182133,317,1.00
ptg001630l,1552743,1553059,316,EVM,mRNA,5837,3182133,316,1.00
ptg001630l,2656920,2657229,309,EVM,mRNA,5837,3182133,309,1.00
ptg001631l,2077023,2077313,290,EVM,mRNA,907156,4046629,290,1.00
ptg001631l,2752300,2752587,287,EVM,mRNA,907156,4046629,287,1.00
ptg001631l,3673855,3674154,299,EVM,mRNA,907156,4046629,299,1.00
ptg001631l,3720398,3720700,302,EVM,mRNA,907156,4046629,302,1.00
ptg001631l,3954745,3955029,284,EVM,mRNA,907156,4046629,284,1.00
ptg001631l,5655121,5655429,308,EVM,mRNA,5171853,8386270,308,1.00
ptg001631l,6137287,6137606,319,EVM,mRNA,5171853,8386270,319,1.00
ptg001631l,6206546,6206846,300,EVM,mRNA,5171853,8386270,300,1.00
ptg001631l,7841433,7841711,278,EVM,mRNA,5171853,8386270,278,1.00
ptg001631l,8314441,8314752,311,EVM,mRNA,5171853,8386270,311,1.00
ptg001635l,1191976,1192275,299,EVM,mRNA,647132,1469529,299,1.00
ptg001635l,2881349,2881675,326,EVM,mRNA,2867364,3890266,326,1.00
ptg001636l,429315,429614,299,EVM,mRNA,22122,1562027,299,1.00
ptg001638l,236066,236377,311,EVM,mRNA,77260,1702087,311,1.00
ptg001639l,1540648,1540914,266,EVM,mRNA,751813,2849629,266,1.00
ptg001640l,822736,823057,321,EVM,mRNA,37961,2219364,321,1.00
ptg001641l,1466222,1466529,307,EVM,mRNA,1349694,2352520,307,1.00
ptg001641l,1905702,1905992,290,EVM,mRNA,1349694,2352520,290,1.00
ptg001641l,2204271,2204644,373,EVM,mRNA,1349694,2352520,373,1.00
ptg001642l,671589,671887,298,EVM,mRNA,495085,705867,298,1.00
ptg001642l,2266139,2266462,323,EVM,mRNA,2207221,2961649,323,1.00
ptg001643l,3351162,3351453,291,EVM,mRNA,2714552,3384782,291,1.00
ptg001646l,506931,507238,307,EVM,mRNA,462120,743424,307,1.00
ptg001646l,507874,508150,276,EVM,mRNA,462120,743424,276,1.00
ptg001646l,1557304,1557594,290,EVM,mRNA,829639,1569750,290,1.00
ptg001649l,719531,719825,294,EVM,mRNA,453153,1092314,294,1.00
ptg001649l,1273200,1273443,243,EVM,mRNA,1233395,1573124,243,1.00
ptg001652l,801841,802140,299,EVM,mRNA,270771,850296,299,1.00
ptg001656l,365270,365571,301,EVM,mRNA,3089,6288769,301,1.00
ptg001656l,950706,951025,319,EVM,mRNA,3089,6288769,319,1.00
ptg001656l,1761273,1761570,297,EVM,mRNA,3089,6288769,297,1.00
ptg001656l,3665076,3665374,298,EVM,mRNA,3089,6288769,298,1.00
ptg001656l,4271710,4272042,332,EVM,mRNA,3089,6288769,332,1.00
ptg001656l,4342561,4342872,311,EVM,mRNA,3089,6288769,311,1.00
ptg001656l,4527782,4528069,287,EVM,mRNA,3089,6288769,287,1.00
ptg001656l,4808364,4808670,306,EVM,mRNA,3089,6288769,306,1.00
ptg001656l,5420965,5421240,275,EVM,mRNA,3089,6288769,275,1.00
ptg001657l,2325756,2326042,286,EVM,mRNA,1672929,2642990,286,1.00
ptg001657l,2353847,2354148,301,EVM,mRNA,1672929,2642990,301,1.00
ptg001657l,2846924,2847227,303,EVM,mRNA,2814233,4415920,303,1.00
ptg001657l,3742118,3742412,294,EVM,mRNA,2814233,4415920,294,1.00
ptg001657l,4090717,4091002,285,EVM,mRNA,2814233,4415920,285,1.00
ptg001659l,1097619,1097901,282,EVM,mRNA,1079170,2302807,282,1.00
ptg001659l,2185266,2185573,307,EVM,mRNA,1079170,2302807,307,1.00
ptg001660l,638488,638802,314,EVM,mRNA,582048,901533,314,1.00
ptg001660l,2825457,2825770,313,EVM,mRNA,1443192,3022866,313,1.00
ptg001660l,5124930,5125228,298,EVM,mRNA,4333411,6515332,298,1.00
ptg001660l,5525111,5525425,314,EVM,mRNA,4333411,6515332,314,1.00
ptg001660l,5568826,5569111,285,EVM,mRNA,4333411,6515332,285,1.00
ptg001660l,5932630,5932943,313,EVM,mRNA,4333411,6515332,313,1.00
ptg001661l,2007013,2007302,289,EVM,mRNA,1426716,2414301,289,1.00
ptg001661l,2669749,2670016,267,EVM,mRNA,2623991,3164303,267,1.00
ptg001663l,1712463,1712775,312,EVM,mRNA,954000,2187885,312,1.00
ptg001663l,1953438,1953733,295,EVM,mRNA,954000,2187885,295,1.00
ptg001663l,8953076,8953366,290,EVM,mRNA,8687502,9142565,290,1.00
ptg001663l,9999855,10000148,293,EVM,mRNA,9423538,12039608,293,1.00
ptg001663l,10578310,10578616,306,EVM,mRNA,9423538,12039608,306,1.00
ptg001663l,11269074,11269380,306,EVM,mRNA,9423538,12039608,306,1.00
ptg001666l,1061234,1061502,268,EVM,mRNA,126168,2239943,268,1.00
ptg001666l,3490159,3490456,297,EVM,mRNA,3121317,3710928,297,1.00
ptg001666l,5719771,5720062,291,EVM,mRNA,5691549,5876774,291,1.00
ptg001666l,6933230,6933502,272,EVM,mRNA,6651727,7104998,272,1.00
ptg001671l,217723,218017,294,EVM,mRNA,116569,309763,294,1.00
ptg001671l,949359,949663,304,EVM,mRNA,729959,1875967,304,1.00
ptg001671l,2696549,2696874,325,EVM,mRNA,2571967,2725151,325,1.00
ptg001671l,6940671,6940970,299,EVM,mRNA,6846638,7630247,299,1.00
ptg001671l,7299359,7299647,288,EVM,mRNA,6846638,7630247,288,1.00
ptg001671l,7385280,7385580,300,EVM,mRNA,6846638,7630247,300,1.00
ptg001671l,7522288,7522591,303,EVM,mRNA,6846638,7630247,303,1.00
ptg001672l,1064821,1065124,303,EVM,mRNA,445172,2183086,303,1.00
ptg001672l,4197229,4197512,283,EVM,mRNA,4012628,5249834,283,1.00
ptg001676l,1660173,1660498,325,EVM,mRNA,1259412,1714121,325,1.00
ptg001677l,354354,354670,316,EVM,mRNA,163660,396530,316,1.00
ptg001677l,849454,849754,300,EVM,mRNA,528102,2242255,300,1.00
ptg001677l,953041,953345,304,EVM,mRNA,528102,2242255,304,1.00
ptg001677l,1139937,1140234,297,EVM,mRNA,528102,2242255,297,1.00
ptg001679l,1375098,1375380,282,EVM,mRNA,1357594,1722368,282,1.00
ptg001679l,1546059,1546354,295,EVM,mRNA,1357594,1722368,295,1.00
ptg001681l,2449951,2450244,293,EVM,mRNA,1545209,3698039,293,1.00
ptg001681l,3067619,3067909,290,EVM,mRNA,1545209,3698039,290,1.00
ptg001681l,3222905,3223218,313,EVM,mRNA,1545209,3698039,313,1.00
ptg001682l,4884801,4885095,294,EVM,mRNA,4527532,5549222,294,1.00
ptg001682l,6598355,6598655,300,EVM,mRNA,6078607,6885408,300,1.00
ptg001682l,6646528,6646843,315,EVM,mRNA,6078607,6885408,315,1.00
ptg001682l,6707486,6707782,296,EVM,mRNA,6078607,6885408,296,1.00
ptg001684l,1609994,1610281,287,EVM,mRNA,1296862,1610875,287,1.00
ptg001685l,1774366,1774684,318,EVM,mRNA,921375,4087738,318,1.00
ptg001685l,1791972,1792234,262,EVM,mRNA,921375,4087738,262,1.00
ptg001685l,2420057,2420372,315,EVM,mRNA,921375,4087738,315,1.00
ptg001685l,3321656,3321973,317,EVM,mRNA,921375,4087738,317,1.00
ptg001685l,3448702,3449005,303,EVM,mRNA,921375,4087738,303,1.00
ptg001685l,3575008,3575360,352,EVM,mRNA,921375,4087738,352,1.00
ptg001685l,3930346,3930646,300,EVM,mRNA,921375,4087738,300,1.00
ptg001685l,4035058,4035373,315,EVM,mRNA,921375,4087738,315,1.00
ptg001687l,1939548,1939844,296,EVM,mRNA,1818751,2551071,296,1.00
ptg001687l,5630518,5630829,311,EVM,mRNA,4937245,5937238,311,1.00
ptg001687l,6088570,6088892,322,EVM,mRNA,5944983,8061845,322,1.00
ptg001692l,1358709,1359009,300,EVM,mRNA,1226322,1444538,300,1.00
ptg001692l,9190667,9190938,271,EVM,mRNA,8721022,9298794,271,1.00
ptg001692l,9210550,9210883,333,EVM,mRNA,8721022,9298794,333,1.00
ptg001701l,3212946,3213227,281,EVM,mRNA,2048872,3418776,281,1.00
ptg001702l,2136254,2136559,305,EVM,mRNA,94065,2188582,305,1.00
ptg001702l,6238729,6239017,288,EVM,mRNA,4226338,7075156,288,1.00
ptg001704l,3208004,3208279,275,EVM,mRNA,1154653,6525265,275,1.00
ptg001704l,4297811,4298115,304,EVM,mRNA,1154653,6525265,304,1.00
ptg001704l,5743196,5743481,285,EVM,mRNA,1154653,6525265,285,1.00
ptg001704l,6416072,6416365,293,EVM,mRNA,1154653,6525265,293,1.00
ptg001708l,1685876,1686138,262,EVM,mRNA,1096548,3708057,262,1.00
ptg001708l,2134627,2134900,273,EVM,mRNA,1096548,3708057,273,1.00
ptg001708l,2222669,2222983,314,EVM,mRNA,1096548,3708057,314,1.00
ptg001708l,3064311,3064646,335,EVM,mRNA,1096548,3708057,335,1.00
ptg001708l,3188183,3188497,314,EVM,mRNA,1096548,3708057,314,1.00
ptg001708l,3378861,3379167,306,EVM,mRNA,1096548,3708057,306,1.00
ptg001711l,177824,178132,308,EVM,mRNA,94564,218805,308,1.00
ptg001711l,1208758,1209040,282,EVM,mRNA,1200193,2062617,282,1.00
ptg001711l,1355595,1355866,271,EVM,mRNA,1200193,2062617,271,1.00
ptg001711l,4674249,4674535,286,EVM,mRNA,4317243,4908483,286,1.00
ptg001712l,1076212,1076506,294,EVM,mRNA,2189,2564626,294,1.00
ptg001712l,1694368,1694652,284,EVM,mRNA,2189,2564626,284,1.00
ptg001712l,5593102,5593389,287,EVM,mRNA,5551656,5598972,287,1.00
ptg001713l,2140817,2141117,300,EVM,mRNA,1859438,3627966,300,1.00
ptg001713l,3268715,3269011,296,EVM,mRNA,1859438,3627966,296,1.00
ptg001714l,656176,656456,280,EVM,mRNA,164228,683877,280,1.00
ptg001714l,1130043,1130342,299,EVM,mRNA,904207,2930926,299,1.00
ptg001714l,1343374,1343667,293,EVM,mRNA,904207,2930926,293,1.00
ptg001714l,1960348,1960623,275,EVM,mRNA,904207,2930926,275,1.00
ptg001714l,2000621,2000906,285,EVM,mRNA,904207,2930926,285,1.00
ptg001714l,2095798,2096095,297,EVM,mRNA,904207,2930926,297,1.00
ptg001716l,440841,441132,291,EVM,mRNA,402343,630885,291,1.00
ptg001716l,520044,520327,283,EVM,mRNA,402343,630885,283,1.00
ptg001716l,520705,521005,300,EVM,mRNA,402343,630885,300,1.00
ptg001717l,1954389,1954686,297,EVM,mRNA,1915582,2358669,297,1.00
ptg001720l,271719,271996,277,EVM,mRNA,11487,402040,277,1.00
ptg001720l,532793,533102,309,EVM,mRNA,452446,1970383,309,1.00
ptg001723l,316051,316370,319,EVM,mRNA,2785,690236,319,1.00
ptg001723l,426478,426773,295,EVM,mRNA,2785,690236,295,1.00
ptg001723l,603090,603392,302,EVM,mRNA,2785,690236,302,1.00
ptg001724l,1586563,1586897,334,EVM,mRNA,1585400,1692882,334,1.00
ptg001726l,1165684,1165996,312,EVM,mRNA,578370,1341032,312,1.00
ptg001732l,1080290,1080584,294,EVM,mRNA,737447,4636131,294,1.00
ptg001732l,1833594,1833887,293,EVM,mRNA,737447,4636131,293,1.00
ptg001732l,1915463,1915749,286,EVM,mRNA,737447,4636131,286,1.00
ptg001732l,3231169,3231445,276,EVM,mRNA,737447,4636131,276,1.00
ptg001732l,3824607,3824891,284,EVM,mRNA,737447,4636131,284,1.00
ptg001733l,774039,774338,299,EVM,mRNA,4469,2658699,299,1.00
ptg001733l,855106,855402,296,EVM,mRNA,4469,2658699,296,1.00
ptg001733l,1043095,1043394,299,EVM,mRNA,4469,2658699,299,1.00
ptg001733l,2105284,2105583,299,EVM,mRNA,4469,2658699,299,1.00
ptg001733l,2400296,2400607,311,EVM,mRNA,4469,2658699,311,1.00
ptg001733l,2416229,2416540,311,EVM,mRNA,4469,2658699,311,1.00
ptg001733l,2521029,2521334,305,EVM,mRNA,4469,2658699,305,1.00
ptg001733l,2575116,2575415,299,EVM,mRNA,4469,2658699,299,1.00
ptg001736l,279887,280219,332,EVM,mRNA,126561,369495,332,1.00
ptg001736l,773797,774081,284,EVM,mRNA,703586,1222963,284,1.00
ptg001737l,1177930,1178224,294,EVM,mRNA,540802,1537155,294,1.00
ptg001737l,1221332,1221641,309,EVM,mRNA,540802,1537155,309,1.00
ptg001738l,205118,205438,320,EVM,mRNA,72124,1092444,320,1.00
ptg001739l,2721594,2721861,267,EVM,mRNA,2197427,2804064,267,1.00
ptg001739l,2755341,2755628,287,EVM,mRNA,2197427,2804064,287,1.00
ptg001740l,338877,339158,281,EVM,mRNA,230741,764283,281,1.00
ptg001740l,1637689,1637963,274,EVM,mRNA,1610411,2742390,274,1.00
ptg001740l,2327954,2328288,334,EVM,mRNA,1610411,2742390,334,1.00
ptg001740l,2563988,2564288,300,EVM,mRNA,1610411,2742390,300,1.00
ptg001740l,2671237,2671515,278,EVM,mRNA,1610411,2742390,278,1.00
ptg001741l,671061,671358,297,EVM,mRNA,208110,1568945,297,1.00
ptg001741l,2733223,2733499,276,EVM,mRNA,1570973,3555941,276,1.00
ptg001742l,677383,677689,306,EVM,mRNA,330230,1183812,306,1.00
ptg001742l,859176,859504,328,EVM,mRNA,330230,1183812,328,1.00
ptg001746l,67202,67501,299,EVM,mRNA,6583,996589,299,1.00
ptg001746l,1263248,1263544,296,EVM,mRNA,1040059,1383672,296,1.00
ptg001746l,1938241,1938551,310,EVM,mRNA,1515258,1976968,310,1.00
ptg001746l,2335978,2336286,308,EVM,mRNA,2192638,3247878,308,1.00
ptg001746l,2874651,2874967,316,EVM,mRNA,2192638,3247878,316,1.00
ptg001746l,5067240,5067548,308,EVM,mRNA,3872603,5879419,308,1.00
ptg001746l,5864694,5864963,269,EVM,mRNA,3872603,5879419,269,1.00
ptg001748l,3820618,3820908,290,EVM,mRNA,2996699,4118072,290,1.00
ptg001749l,917267,917563,296,EVM,mRNA,43996,2367185,296,1.00
ptg001751l,2493342,2493634,292,EVM,mRNA,650031,2927164,292,1.00
ptg001752l,1063946,1064246,300,EVM,mRNA,1063879,2167721,300,1.00
ptg001759l,814140,814444,304,EVM,mRNA,400,3298289,304,1.00
ptg001759l,1647013,1647314,301,EVM,mRNA,400,3298289,301,1.00
ptg001762l,471338,471627,289,EVM,mRNA,218251,1656832,289,1.00
ptg001762l,3531607,3531884,277,EVM,mRNA,3113173,4527277,277,1.00
ptg001764l,1948286,1948565,279,EVM,mRNA,1761692,2141320,279,1.00
ptg001764l,2340663,2340950,287,EVM,mRNA,2240196,2470252,287,1.00
ptg001767l,338952,339253,301,EVM,mRNA,53528,604942,301,1.00
ptg001767l,443571,443893,322,EVM,mRNA,53528,604942,322,1.00
ptg001771l,4655459,4655722,263,EVM,mRNA,3825007,5047598,263,1.00
ptg001773l,2825739,2826021,282,EVM,mRNA,2718526,3016036,282,1.00
ptg001774l,1353247,1353531,284,EVM,mRNA,784753,1376620,284,1.00
ptg001776l,287009,287297,288,EVM,mRNA,149736,824169,288,1.00
ptg001782l,1286281,1286599,318,EVM,mRNA,1049931,1601349,318,1.00
ptg001785l,2297209,2297523,314,EVM,mRNA,2170058,2313740,314,1.00
ptg001786l,948797,949113,316,EVM,mRNA,920693,975112,316,1.00
ptg001786l,3175229,3175547,318,EVM,mRNA,3065933,3318971,318,1.00
ptg001786l,4384857,4385154,297,EVM,mRNA,4192499,4425723,297,1.00
ptg001786l,5733869,5734184,315,EVM,mRNA,5732849,5735713,315,1.00
ptg001789l,181115,181385,270,EVM,mRNA,54302,182280,270,1.00
ptg001790l,597141,597440,299,EVM,mRNA,576938,1264298,299,1.00
ptg001791l,3306044,3306359,315,EVM,mRNA,3282428,3306594,315,1.00
ptg001792l,1785288,1785580,292,EVM,mRNA,1166149,4741656,292,1.00
ptg001792l,2422448,2422728,280,EVM,mRNA,1166149,4741656,280,1.00
ptg001792l,2444639,2444946,307,EVM,mRNA,1166149,4741656,307,1.00
ptg001792l,3782448,3782715,267,EVM,mRNA,1166149,4741656,267,1.00
ptg001792l,4488517,4488829,312,EVM,mRNA,1166149,4741656,312,1.00
ptg001792l,5227573,5227900,327,EVM,mRNA,5116453,5660343,327,1.00
ptg001793l,439502,439834,332,EVM,mRNA,310030,1267244,332,1.00
ptg001793l,797630,797924,294,EVM,mRNA,310030,1267244,294,1.00
ptg001793l,1069622,1069939,317,EVM,mRNA,310030,1267244,317,1.00
ptg001793l,1166818,1167118,300,EVM,mRNA,310030,1267244,300,1.00
ptg001794l,1097551,1097834,283,EVM,mRNA,1051609,1219225,283,1.00
ptg001796l,794484,794799,315,EVM,mRNA,477241,1391671,315,1.00
ptg001796l,1294156,1294474,318,EVM,mRNA,477241,1391671,318,1.00
ptg001797l,107434,107748,314,EVM,mRNA,72080,1382464,314,1.00
ptg001798l,86308,86610,302,EVM,mRNA,612,1294620,302,1.00
ptg001804l,189744,190057,313,EVM,mRNA,55758,231220,313,1.00
ptg001812l,813577,813896,319,EVM,mRNA,214797,921190,319,1.00
ptg001812l,912319,912581,262,EVM,mRNA,214797,921190,262,1.00
ptg001812l,2054965,2055259,294,EVM,mRNA,1091086,5263312,294,1.00
ptg001812l,2260735,2261028,293,EVM,mRNA,1091086,5263312,293,1.00
ptg001812l,2649338,2649652,314,EVM,mRNA,1091086,5263312,314,1.00
ptg001812l,3525661,3525958,297,EVM,mRNA,1091086,5263312,297,1.00
ptg001812l,3573324,3573615,291,EVM,mRNA,1091086,5263312,291,1.00
ptg001812l,5263222,5263523,301,EVM,mRNA,1091086,5263312,90,0.30
ptg001813l,1089611,1089920,309,EVM,mRNA,80185,1272952,309,1.00
ptg001814l,4046359,4046672,313,EVM,mRNA,3993113,4903437,313,1.00
ptg001814l,4086322,4086593,271,EVM,mRNA,3993113,4903437,271,1.00
ptg001814l,4229151,4229460,309,EVM,mRNA,3993113,4903437,309,1.00
ptg001814l,4270189,4270517,328,EVM,mRNA,3993113,4903437,328,1.00
ptg001814l,4875741,4876058,317,EVM,mRNA,3993113,4903437,317,1.00
ptg001814l,5874853,5875134,281,EVM,mRNA,5159231,7105866,281,1.00
ptg001814l,6145476,6145767,291,EVM,mRNA,5159231,7105866,291,1.00
ptg001815l,2146170,2146475,305,EVM,mRNA,1881276,4188409,305,1.00
ptg001815l,4073257,4073545,288,EVM,mRNA,1881276,4188409,288,1.00
ptg001816l,5117005,5117317,312,EVM,mRNA,5116620,5240370,312,1.00
ptg001820l,2248049,2248360,311,EVM,mRNA,1377877,2640153,311,1.00
ptg001820l,3156215,3156523,308,EVM,mRNA,2640370,3761314,308,1.00
ptg001820l,4246876,4247160,284,EVM,mRNA,4087537,5573151,284,1.00
ptg001820l,4939019,4939282,263,EVM,mRNA,4087537,5573151,263,1.00
ptg001820l,5437928,5438197,269,EVM,mRNA,4087537,5573151,269,1.00
ptg001821l,780883,781189,306,EVM,mRNA,206076,2531540,306,1.00
ptg001821l,3422238,3422516,278,EVM,mRNA,3285365,5469818,278,1.00
ptg001821l,4780826,4781123,297,EVM,mRNA,3285365,5469818,297,1.00
ptg001826l,960594,960914,320,EVM,mRNA,523755,1343336,320,1.00
ptg001826l,971849,972140,291,EVM,mRNA,523755,1343336,291,1.00
ptg001826l,1275754,1276038,284,EVM,mRNA,523755,1343336,284,1.00
ptg001826l,2221955,2222261,306,EVM,mRNA,1858292,2680149,306,1.00
ptg001826l,4586228,4586551,323,EVM,mRNA,2781843,4947314,323,1.00
ptg001827l,101306,101622,316,EVM,mRNA,34882,2016689,316,1.00
ptg001827l,1528520,1528838,318,EVM,mRNA,34882,2016689,318,1.00
ptg001828l,936328,936631,303,EVM,mRNA,857221,1665343,303,1.00
ptg001829l,471708,472000,292,EVM,mRNA,460288,553243,292,1.00
ptg001830l,584702,585029,327,EVM,mRNA,171220,686220,327,1.00
ptg001832l,840064,840382,318,EVM,mRNA,813428,910763,318,1.00
ptg001833l,468967,469248,281,EVM,mRNA,27174,1668239,281,1.00
ptg001834l,2455161,2455475,314,EVM,mRNA,1695653,3173375,314,1.00
ptg001835l,480915,481202,287,EVM,mRNA,360527,813878,287,1.00
ptg001836l,1102034,1102321,287,EVM,mRNA,399706,1134757,287,1.00
ptg001836l,2494555,2494832,277,EVM,mRNA,2423624,3085280,277,1.00
ptg001837l,1655051,1655342,291,EVM,mRNA,1263946,2108478,291,1.00
ptg001837l,2580256,2580569,313,EVM,mRNA,2473628,3219637,313,1.00
ptg001837l,2624315,2624604,289,EVM,mRNA,2473628,3219637,289,1.00
ptg001837l,2934312,2934597,285,EVM,mRNA,2473628,3219637,285,1.00
ptg001839l,266344,266634,290,EVM,mRNA,18912,404191,290,1.00
ptg001840l,92039,92307,268,EVM,mRNA,72329,141403,268,1.00
ptg001842l,1313908,1314206,298,EVM,mRNA,4115,2457578,298,1.00
ptg001844l,1308110,1308418,308,EVM,mRNA,874221,1492405,308,1.00
ptg001845l,277044,277351,307,EVM,mRNA,24730,502760,307,1.00
ptg001845l,481178,481485,307,EVM,mRNA,24730,502760,307,1.00
ptg001848l,1793114,1793412,298,EVM,mRNA,1714637,2669002,298,1.00
ptg001848l,2072890,2073198,308,EVM,mRNA,1714637,2669002,308,1.00
ptg001850l,187566,187857,291,EVM,mRNA,500,2066080,291,1.00
ptg001850l,253966,254232,266,EVM,mRNA,500,2066080,266,1.00
ptg001850l,400133,400428,295,EVM,mRNA,500,2066080,295,1.00
ptg001850l,790201,790496,295,EVM,mRNA,500,2066080,295,1.00
ptg001850l,1661114,1661380,266,EVM,mRNA,500,2066080,266,1.00
ptg001851l,365808,366140,332,EVM,mRNA,300621,381403,332,1.00
ptg001851l,1279043,1279364,321,EVM,mRNA,1119723,2475796,321,1.00
ptg001851l,3322164,3322480,316,EVM,mRNA,3029555,5173891,316,1.00
ptg001851l,4057996,4058290,294,EVM,mRNA,3029555,5173891,294,1.00
ptg001851l,4237165,4237449,284,EVM,mRNA,3029555,5173891,284,1.00
ptg001851l,4897457,4897726,269,EVM,mRNA,3029555,5173891,269,1.00
ptg001852l,1554073,1554349,276,EVM,mRNA,1422766,2114131,276,1.00
ptg001854l,1065243,1065537,294,EVM,mRNA,139765,1092645,294,1.00
ptg001854l,2249346,2249629,283,EVM,mRNA,1822728,2249407,61,0.22
ptg001858l,5391474,5391775,301,EVM,mRNA,4662854,6624845,301,1.00
ptg001859l,1182309,1182641,332,EVM,mRNA,626205,1376607,332,1.00
ptg001859l,1188322,1188649,327,EVM,mRNA,626205,1376607,327,1.00
ptg001863l,2418319,2418620,301,EVM,mRNA,1918482,3452456,301,1.00
ptg001863l,4584909,4585222,313,EVM,mRNA,4403858,4699837,313,1.00
ptg001863l,6274971,6275261,290,EVM,mRNA,6234380,6370801,290,1.00
ptg001863l,7218962,7219246,284,EVM,mRNA,6735118,8874986,284,1.00
ptg001863l,7350286,7350582,296,EVM,mRNA,6735118,8874986,296,1.00
ptg001863l,7839968,7840255,287,EVM,mRNA,6735118,8874986,287,1.00
ptg001863l,8719722,8720052,330,EVM,mRNA,6735118,8874986,330,1.00
ptg001863l,9560626,9560925,299,EVM,mRNA,9202779,10258793,299,1.00
ptg001863l,10142237,10142505,268,EVM,mRNA,9202779,10258793,268,1.00
ptg001864l,241185,241509,324,EVM,mRNA,213856,322980,324,1.00
ptg001864l,1102943,1103271,328,EVM,mRNA,340602,1135214,328,1.00
ptg001864l,1191598,1191897,299,EVM,mRNA,1159075,1488663,299,1.00
ptg001867l,696221,696521,300,EVM,mRNA,336861,2630336,300,1.00
ptg001867l,901625,901910,285,EVM,mRNA,336861,2630336,285,1.00
ptg001867l,955793,956084,291,EVM,mRNA,336861,2630336,291,1.00
ptg001867l,1827722,1828009,287,EVM,mRNA,336861,2630336,287,1.00
ptg001867l,2184717,2185032,315,EVM,mRNA,336861,2630336,315,1.00
ptg001868l,1040485,1040782,297,EVM,mRNA,1028052,1089606,297,1.00
ptg001874l,1014063,1014373,310,EVM,mRNA,942658,1090725,310,1.00
ptg001874l,1652451,1652775,324,EVM,mRNA,1614645,1782525,324,1.00
ptg001875l,3949194,3949482,288,EVM,mRNA,3828050,4278420,288,1.00
ptg001875l,4060343,4060613,270,EVM,mRNA,3828050,4278420,270,1.00
ptg001876l,1418135,1418428,293,EVM,mRNA,10928,2043860,293,1.00
ptg001877l,1524557,1524871,314,EVM,mRNA,1182614,1557866,314,1.00
ptg001877l,1545920,1546244,324,EVM,mRNA,1182614,1557866,324,1.00
ptg001878l,5424529,5424824,295,EVM,mRNA,3853227,6780809,295,1.00
ptg001878l,5460237,5460532,295,EVM,mRNA,3853227,6780809,295,1.00
ptg001878l,6483202,6483498,296,EVM,mRNA,3853227,6780809,296,1.00
ptg001878l,9440207,9440509,302,EVM,mRNA,9193093,9678826,302,1.00
ptg001885l,1595752,1596027,275,EVM,mRNA,573990,1793756,275,1.00
ptg001887l,1089747,1090055,308,EVM,mRNA,5822,1526969,308,1.00
ptg001888l,1843357,1843692,335,EVM,mRNA,1803224,1847271,335,1.00
ptg001889l,727834,728107,273,EVM,mRNA,437522,734233,273,1.00
ptg001890l,545386,545704,318,EVM,mRNA,515481,633872,318,1.00
ptg001890l,651179,651493,314,EVM,mRNA,650960,651583,314,1.00
ptg001891l,3001626,3001949,323,EVM,mRNA,876859,5733881,323,1.00
ptg001891l,3031054,3031313,259,EVM,mRNA,876859,5733881,259,1.00
ptg001891l,3698450,3698735,285,EVM,mRNA,876859,5733881,285,1.00
ptg001891l,4959418,4959694,276,EVM,mRNA,876859,5733881,276,1.00
ptg001899l,2173292,2173590,298,EVM,mRNA,2023200,3000698,298,1.00
ptg001899l,2408944,2409227,283,EVM,mRNA,2023200,3000698,283,1.00
ptg001899l,2594545,2594870,325,EVM,mRNA,2023200,3000698,325,1.00
ptg001899l,2752205,2752507,302,EVM,mRNA,2023200,3000698,302,1.00
ptg001901l,108346,108650,304,EVM,mRNA,99766,675998,304,1.00
ptg001901l,317952,318275,323,EVM,mRNA,99766,675998,323,1.00
ptg001901l,580331,580651,320,EVM,mRNA,99766,675998,320,1.00
ptg001904l,822485,822794,309,EVM,mRNA,589995,967189,309,1.00
ptg001906l,3166528,3166814,286,EVM,mRNA,2697445,3732901,286,1.00
ptg001908l,1265452,1265742,290,EVM,mRNA,1112505,1384847,290,1.00
ptg001909l,1576498,1576822,324,EVM,mRNA,320093,2294583,324,1.00
ptg001910l,1080995,1081299,304,EVM,mRNA,851835,1752255,304,1.00
ptg001910l,1394339,1394616,277,EVM,mRNA,851835,1752255,277,1.00
ptg001910l,1429030,1429351,321,EVM,mRNA,851835,1752255,321,1.00
ptg001910l,1449228,1449520,292,EVM,mRNA,851835,1752255,292,1.00
ptg001911l,1003365,1003693,328,EVM,mRNA,190328,1868541,328,1.00
ptg001914l,3878221,3878528,307,EVM,mRNA,3869457,5010792,307,1.00
ptg001914l,4923170,4923460,290,EVM,mRNA,3869457,5010792,290,1.00
ptg001914l,9478585,9478884,299,EVM,mRNA,9432507,9578842,299,1.00
ptg001920l,1088310,1088609,299,EVM,mRNA,972415,1211165,299,1.00
ptg001925l,3330105,3330403,298,EVM,mRNA,3314202,3684784,298,1.00
ptg001931l,1859753,1860044,291,EVM,mRNA,1410748,2467359,291,1.00
ptg001933l,1483798,1484110,312,EVM,mRNA,1249840,1963413,312,1.00
ptg001933l,1509027,1509321,294,EVM,mRNA,1249840,1963413,294,1.00
ptg001933l,2239405,2239708,303,EVM,mRNA,2026545,2679843,303,1.00
ptg001933l,2389504,2389759,255,EVM,mRNA,2026545,2679843,255,1.00
ptg001934l,786249,786558,309,EVM,mRNA,243664,1163572,309,1.00
ptg001934l,989521,989834,313,EVM,mRNA,243664,1163572,313,1.00
ptg001935l,378152,378458,306,EVM,mRNA,357805,847703,306,1.00
ptg001936l,917340,917600,260,EVM,mRNA,347721,2056706,260,1.00
ptg001936l,927512,927823,311,EVM,mRNA,347721,2056706,311,1.00
ptg001936l,2211860,2212143,283,EVM,mRNA,2088104,2369666,283,1.00
ptg001936l,4098060,4098376,316,EVM,mRNA,3863262,4142124,316,1.00
ptg001936l,4585100,4585405,305,EVM,mRNA,4307447,4671721,305,1.00
ptg001936l,5261219,5261505,286,EVM,mRNA,5217201,5267176,286,1.00
ptg001936l,5652090,5652401,311,EVM,mRNA,5330202,5662316,311,1.00
ptg001937l,327757,328032,275,EVM,mRNA,79405,404614,275,1.00
ptg001938l,1090342,1090628,286,EVM,mRNA,620835,1118053,286,1.00
ptg001938l,1887164,1887492,328,EVM,mRNA,1823577,4376447,328,1.00
ptg001938l,3275318,3275629,311,EVM,mRNA,1823577,4376447,311,1.00
ptg001938l,4135005,4135291,286,EVM,mRNA,1823577,4376447,286,1.00
ptg001940l,1762945,1763239,294,EVM,mRNA,1167803,1841380,294,1.00
ptg001940l,2595057,2595358,301,EVM,mRNA,2548330,2628184,301,1.00
ptg001943l,552840,553109,269,EVM,mRNA,490422,2911216,269,1.00
ptg001943l,762549,762838,289,EVM,mRNA,490422,2911216,289,1.00
ptg001943l,978633,978932,299,EVM,mRNA,490422,2911216,299,1.00
ptg001943l,1123358,1123660,302,EVM,mRNA,490422,2911216,302,1.00
ptg001943l,1223963,1224284,321,EVM,mRNA,490422,2911216,321,1.00
ptg001943l,1592488,1592794,306,EVM,mRNA,490422,2911216,306,1.00
ptg001943l,1843953,1844230,277,EVM,mRNA,490422,2911216,277,1.00
ptg001943l,1971472,1971759,287,EVM,mRNA,490422,2911216,287,1.00
ptg001943l,2139488,2139800,312,EVM,mRNA,490422,2911216,312,1.00
ptg001943l,2300725,2301004,279,EVM,mRNA,490422,2911216,279,1.00
ptg001943l,2533802,2534122,320,EVM,mRNA,490422,2911216,320,1.00
ptg001943l,3912293,3912587,294,EVM,mRNA,3608479,4062310,294,1.00
ptg001943l,3916839,3917152,313,EVM,mRNA,3608479,4062310,313,1.00
ptg001944l,68713,69030,317,EVM,mRNA,24186,83141,317,1.00
ptg001944l,82901,83212,311,EVM,mRNA,24186,83141,240,0.77
ptg001944l,1174087,1174407,320,EVM,mRNA,998219,1542550,320,1.00
ptg001954l,686717,687004,287,EVM,mRNA,527928,892949,287,1.00
ptg001954l,4019790,4020109,319,EVM,mRNA,3894968,5960629,319,1.00
ptg001954l,4769250,4769526,276,EVM,mRNA,3894968,5960629,276,1.00
ptg001954l,4825246,4825549,303,EVM,mRNA,3894968,5960629,303,1.00
ptg001956l,1107772,1108057,285,EVM,mRNA,715541,1570507,285,1.00
ptg001956l,1513880,1514181,301,EVM,mRNA,715541,1570507,301,1.00
ptg001957l,973467,973750,283,EVM,mRNA,722413,1198242,283,1.00
ptg001957l,2668725,2669049,324,EVM,mRNA,1928781,3183104,324,1.00
ptg001959l,606951,607232,281,EVM,mRNA,578777,1288272,281,1.00
ptg001959l,651276,651588,312,EVM,mRNA,578777,1288272,312,1.00
ptg001959l,1081252,1081536,284,EVM,mRNA,578777,1288272,284,1.00
ptg001964l,1259538,1259833,295,EVM,mRNA,1135134,1822095,295,1.00
ptg001964l,1572198,1572530,332,EVM,mRNA,1135134,1822095,332,1.00
ptg001964l,2183390,2183689,299,EVM,mRNA,1966400,3119675,299,1.00
ptg001965l,547252,547559,307,EVM,mRNA,94119,980784,307,1.00
ptg001965l,1686239,1686509,270,EVM,mRNA,1522029,1885997,270,1.00
ptg001965l,2472151,2472448,297,EVM,mRNA,2009358,3012090,297,1.00
ptg001965l,5966632,5966932,300,EVM,mRNA,4798979,6023408,300,1.00
ptg001967l,629983,630301,318,EVM,mRNA,387912,1000610,318,1.00
ptg001969l,1108916,1109238,322,EVM,mRNA,926511,1298626,322,1.00
ptg001969l,1139389,1139676,287,EVM,mRNA,926511,1298626,287,1.00
ptg001971l,947693,947974,281,EVM,mRNA,819765,1185995,281,1.00
ptg001971l,959309,959592,283,EVM,mRNA,819765,1185995,283,1.00
ptg001972l,351373,351676,303,EVM,mRNA,35426,423613,303,1.00
ptg001972l,1962878,1963157,279,EVM,mRNA,1217146,3227572,279,1.00
ptg001972l,2353565,2353846,281,EVM,mRNA,1217146,3227572,281,1.00
ptg001972l,5605758,5606072,314,EVM,mRNA,4796722,5622751,314,1.00
ptg001974l,2041385,2041691,306,EVM,mRNA,1961542,2646171,306,1.00
ptg001979l,1281058,1281344,286,EVM,mRNA,1828,2400777,286,1.00
ptg001981l,322886,323185,299,EVM,mRNA,141379,398736,299,1.00
ptg001982l,509314,509614,300,EVM,mRNA,285047,2030422,300,1.00
ptg001982l,989195,989516,321,EVM,mRNA,285047,2030422,321,1.00
ptg001982l,1781831,1782153,322,EVM,mRNA,285047,2030422,322,1.00
ptg001985l,2399776,2400050,274,EVM,mRNA,2105399,2820855,274,1.00
ptg001985l,2812130,2812426,296,EVM,mRNA,2105399,2820855,296,1.00
ptg001985l,3288013,3288316,303,EVM,mRNA,3016367,4471853,303,1.00
ptg001985l,3931726,3932052,326,EVM,mRNA,3016367,4471853,326,1.00
ptg001988l,517032,517305,273,EVM,mRNA,111046,1218202,273,1.00
ptg001988l,765394,765691,297,EVM,mRNA,111046,1218202,297,1.00
ptg001988l,1180047,1180334,287,EVM,mRNA,111046,1218202,287,1.00
ptg001992l,711388,711671,283,EVM,mRNA,206197,2543248,283,1.00
ptg001992l,1282357,1282651,294,EVM,mRNA,206197,2543248,294,1.00
ptg001992l,1451393,1451691,298,EVM,mRNA,206197,2543248,298,1.00
ptg001992l,1800299,1800606,307,EVM,mRNA,206197,2543248,307,1.00
ptg001993l,758012,758312,300,EVM,mRNA,7248,976369,300,1.00
ptg001993l,790171,790486,315,EVM,mRNA,7248,976369,315,1.00
ptg001993l,836985,837298,313,EVM,mRNA,7248,976369,313,1.00
ptg001993l,1647710,1648011,301,EVM,mRNA,1409224,3234167,301,1.00
ptg001993l,1859283,1859605,322,EVM,mRNA,1409224,3234167,322,1.00
ptg001993l,2072098,2072430,332,EVM,mRNA,1409224,3234167,332,1.00
ptg001993l,2190148,2190470,322,EVM,mRNA,1409224,3234167,322,1.00
ptg001993l,2648608,2648915,307,EVM,mRNA,1409224,3234167,307,1.00
ptg001994l,123405,123736,331,EVM,mRNA,78918,639833,331,1.00
ptg001996l,805762,806032,270,EVM,mRNA,609972,1443106,270,1.00
ptg001999l,656443,656737,294,EVM,mRNA,42242,1135921,294,1.00
ptg001999l,998204,998530,326,EVM,mRNA,42242,1135921,326,1.00
ptg002000l,834855,835171,316,EVM,mRNA,18595,888482,316,1.00
ptg002000l,886362,886650,288,EVM,mRNA,18595,888482,288,1.00
ptg002004l,273816,274135,319,EVM,mRNA,7,284823,319,1.00
ptg002004l,624737,625021,284,EVM,mRNA,488138,1472152,284,1.00
ptg002004l,759687,760005,318,EVM,mRNA,488138,1472152,318,1.00
ptg002004l,1034047,1034333,286,EVM,mRNA,488138,1472152,286,1.00
ptg002006l,665070,665389,319,EVM,mRNA,293450,2504415,319,1.00
ptg002010l,732796,733119,323,EVM,mRNA,680668,759037,323,1.00
ptg002011l,1206594,1206908,314,EVM,mRNA,1087904,1401749,314,1.00
ptg002011l,1387108,1387406,298,EVM,mRNA,1087904,1401749,298,1.00
ptg002011l,4094883,4095166,283,EVM,mRNA,4045248,4235614,283,1.00
ptg002011l,4944081,4944399,318,EVM,mRNA,4437727,4951291,318,1.00
ptg002013l,845277,845595,318,EVM,mRNA,291755,2038464,318,1.00
ptg002014l,2138173,2138475,302,EVM,mRNA,2058424,2201098,302,1.00
ptg002015l,419700,419999,299,EVM,mRNA,190835,944569,299,1.00
ptg002015l,3194095,3194373,278,EVM,mRNA,2958045,3408751,278,1.00
ptg002015l,3266516,3266813,297,EVM,mRNA,2958045,3408751,297,1.00
ptg002022l,5924088,5924376,288,EVM,mRNA,5907644,6366654,288,1.00
ptg002022l,5987665,5987973,308,EVM,mRNA,5907644,6366654,308,1.00
ptg002027l,1493395,1493710,315,EVM,mRNA,1207558,3289175,315,1.00
ptg002027l,2050294,2050588,294,EVM,mRNA,1207558,3289175,294,1.00
ptg002027l,2057669,2057964,295,EVM,mRNA,1207558,3289175,295,1.00
ptg002027l,2600849,2601166,317,EVM,mRNA,1207558,3289175,317,1.00
ptg002027l,2829701,2829980,279,EVM,mRNA,1207558,3289175,279,1.00
ptg002030l,524716,525002,286,EVM,mRNA,333316,638388,286,1.00
ptg002036l,320296,320562,266,EVM,mRNA,25642,1636507,266,1.00
ptg002036l,1957615,1957916,301,EVM,mRNA,1843347,2135041,301,1.00
ptg002036l,3184069,3184363,294,EVM,mRNA,2737273,3216614,294,1.00
ptg002043l,467914,468208,294,EVM,mRNA,190081,2895450,294,1.00
ptg002043l,680654,680931,277,EVM,mRNA,190081,2895450,277,1.00
ptg002043l,1614935,1615244,309,EVM,mRNA,190081,2895450,309,1.00
ptg002043l,1720769,1721068,299,EVM,mRNA,190081,2895450,299,1.00
ptg002043l,4217143,4217426,283,EVM,mRNA,4075390,4354700,283,1.00
ptg002043l,5640851,5641127,276,EVM,mRNA,4783586,6665530,276,1.00
ptg002048l,1562559,1562869,310,EVM,mRNA,1519966,2275439,310,1.00
ptg002049l,1322707,1323017,310,EVM,mRNA,1115020,1400723,310,1.00
ptg002051l,3132756,3133039,283,EVM,mRNA,2377159,3326118,283,1.00
ptg002051l,3239040,3239344,304,EVM,mRNA,2377159,3326118,304,1.00
ptg002054l,567236,567518,282,EVM,mRNA,393407,600380,282,1.00
ptg002054l,984264,984561,297,EVM,mRNA,746669,1103512,297,1.00
ptg002055l,3278553,3278837,284,EVM,mRNA,2812401,3426734,284,1.00
ptg002057l,114715,115027,312,EVM,mRNA,4674,732146,312,1.00
ptg002058l,841363,841662,299,EVM,mRNA,767202,1438692,299,1.00
ptg002058l,1295128,1295423,295,EVM,mRNA,767202,1438692,295,1.00
ptg002058l,1331215,1331507,292,EVM,mRNA,767202,1438692,292,1.00
ptg002059l,1243448,1243744,296,EVM,mRNA,532197,1673758,296,1.00
ptg002063l,1483138,1483419,281,EVM,mRNA,642141,1899204,281,1.00
ptg002063l,1523736,1524071,335,EVM,mRNA,642141,1899204,335,1.00
ptg002063l,1705985,1706292,307,EVM,mRNA,642141,1899204,307,1.00
ptg002063l,1804148,1804451,303,EVM,mRNA,642141,1899204,303,1.00
ptg002064l,841598,841882,284,EVM,mRNA,755489,1182742,284,1.00
ptg002064l,2876518,2876811,293,EVM,mRNA,2647149,3879032,293,1.00
ptg002064l,3242582,3242899,317,EVM,mRNA,2647149,3879032,317,1.00
ptg002064l,3330691,3330975,284,EVM,mRNA,2647149,3879032,284,1.00
ptg002064l,3369393,3369697,304,EVM,mRNA,2647149,3879032,304,1.00
ptg002064l,4751995,4752274,279,EVM,mRNA,4730416,4838455,279,1.00
ptg002065l,3329862,3330146,284,EVM,mRNA,3158011,3395017,284,1.00
ptg002068l,645869,646132,263,EVM,mRNA,194562,1113077,263,1.00
ptg002068l,1043917,1044227,310,EVM,mRNA,194562,1113077,310,1.00
ptg002068l,1091023,1091299,276,EVM,mRNA,194562,1113077,276,1.00
ptg002069l,303171,303461,290,EVM,mRNA,201720,590934,290,1.00
ptg002069l,575900,576216,316,EVM,mRNA,201720,590934,316,1.00
ptg002070l,269015,269309,294,EVM,mRNA,36596,535508,294,1.00
ptg002070l,1214042,1214356,314,EVM,mRNA,970704,1564908,314,1.00
ptg002071l,651801,652100,299,EVM,mRNA,650613,1113682,299,1.00
ptg002073l,1750355,1750654,299,EVM,mRNA,1013975,2549833,299,1.00
ptg002074l,1758878,1759177,299,EVM,mRNA,1298504,3782553,299,1.00
ptg002074l,1882256,1882570,314,EVM,mRNA,1298504,3782553,314,1.00
ptg002074l,3299765,3300052,287,EVM,mRNA,1298504,3782553,287,1.00
ptg002074l,4400145,4400452,307,EVM,mRNA,4304220,4501807,307,1.00
ptg002075l,1037294,1037593,299,EVM,mRNA,903020,1354245,299,1.00
ptg002075l,2084865,2085159,294,EVM,mRNA,1610761,2485737,294,1.00
ptg002077l,225957,226255,298,EVM,mRNA,11390,251670,298,1.00
ptg002077l,233564,233841,277,EVM,mRNA,11390,251670,277,1.00
ptg002077l,288644,288931,287,EVM,mRNA,284164,396374,287,1.00
ptg002079l,1025537,1025835,298,EVM,mRNA,961780,2195692,298,1.00
ptg002079l,2881616,2881921,305,EVM,mRNA,2711185,2926555,305,1.00
ptg002079l,3152501,3152813,312,EVM,mRNA,3058412,3330857,312,1.00
ptg002081l,214748,215067,319,EVM,mRNA,31292,512076,319,1.00
ptg002083l,4466148,4466466,318,EVM,mRNA,1515298,4912739,318,1.00
ptg002084l,802548,802857,309,EVM,mRNA,509902,1014881,309,1.00
ptg002085l,2730162,2730460,298,EVM,mRNA,185916,3034373,298,1.00
ptg002085l,7735547,7735831,284,EVM,mRNA,7657044,8512102,284,1.00
ptg002085l,8097714,8098036,322,EVM,mRNA,7657044,8512102,322,1.00
ptg002085l,8146716,8147035,319,EVM,mRNA,7657044,8512102,319,1.00
ptg002085l,8366022,8366335,313,EVM,mRNA,7657044,8512102,313,1.00
ptg002086l,1659241,1659542,301,EVM,mRNA,1201512,2080579,301,1.00
ptg002086l,2060845,2061126,281,EVM,mRNA,1201512,2080579,281,1.00
ptg002086l,3367744,3368021,277,EVM,mRNA,3214491,3604640,277,1.00
ptg002088l,1610717,1611024,307,EVM,mRNA,804157,1658884,307,1.00
ptg002089l,601294,601609,315,EVM,mRNA,512291,1908298,315,1.00
ptg002089l,2512272,2512598,326,EVM,mRNA,2343712,3474895,326,1.00
ptg002089l,2744030,2744294,264,EVM,mRNA,2343712,3474895,264,1.00
ptg002089l,3370271,3370595,324,EVM,mRNA,2343712,3474895,324,1.00
ptg002089l,3397951,3398273,322,EVM,mRNA,2343712,3474895,322,1.00
ptg002089l,3402624,3402924,300,EVM,mRNA,2343712,3474895,300,1.00
ptg002100l,1207486,1207777,291,EVM,mRNA,1101739,2050280,291,1.00
ptg002100l,1699763,1700069,306,EVM,mRNA,1101739,2050280,306,1.00
ptg002100l,1946601,1946871,270,EVM,mRNA,1101739,2050280,270,1.00
ptg002100l,4202842,4203168,326,EVM,mRNA,4181114,5531526,326,1.00
ptg002100l,4919159,4919460,301,EVM,mRNA,4181114,5531526,301,1.00
ptg002100l,5145492,5145776,284,EVM,mRNA,4181114,5531526,284,1.00
ptg002100l,5281334,5281624,290,EVM,mRNA,4181114,5531526,290,1.00
ptg002101l,817177,817501,324,EVM,mRNA,758732,818456,324,1.00
ptg002102l,805454,805756,302,EVM,mRNA,525860,1163331,302,1.00
ptg002102l,2648306,2648576,270,EVM,mRNA,2442736,3157494,270,1.00
ptg002102l,2848993,2849291,298,EVM,mRNA,2442736,3157494,298,1.00
ptg002102l,2964812,2965093,281,EVM,mRNA,2442736,3157494,281,1.00
ptg002104l,543242,543543,301,EVM,mRNA,65294,2202545,301,1.00
ptg002104l,1747367,1747688,321,EVM,mRNA,65294,2202545,321,1.00
ptg002104l,2041388,2041696,308,EVM,mRNA,65294,2202545,308,1.00
ptg002106l,1247903,1248213,310,EVM,mRNA,556343,1759312,310,1.00
ptg002106l,1261103,1261402,299,EVM,mRNA,556343,1759312,299,1.00
ptg002109l,416130,416431,301,EVM,mRNA,357828,470511,301,1.00
ptg002109l,1640226,1640516,290,EVM,mRNA,1529477,1659239,290,1.00
ptg002116l,1917066,1917391,325,EVM,mRNA,1417928,2797461,325,1.00
ptg002116l,2043986,2044275,289,EVM,mRNA,1417928,2797461,289,1.00
ptg002116l,2655686,2655986,300,EVM,mRNA,1417928,2797461,300,1.00
ptg002120l,1291129,1291437,308,EVM,mRNA,585286,1513272,308,1.00
ptg002130l,3937169,3937454,285,EVM,mRNA,3878263,4389363,285,1.00
ptg002130l,4019502,4019817,315,EVM,mRNA,3878263,4389363,315,1.00
ptg002130l,4272603,4272878,275,EVM,mRNA,3878263,4389363,275,1.00
ptg002131l,402941,403269,328,EVM,mRNA,19605,445824,328,1.00
ptg002133l,773171,773474,303,EVM,mRNA,68578,951234,303,1.00
ptg002134l,2448504,2448818,314,EVM,mRNA,2045771,2537803,314,1.00
ptg002134l,3744951,3745250,299,EVM,mRNA,3342531,4490318,299,1.00
ptg002139l,1380334,1380664,330,EVM,mRNA,435390,1707135,330,1.00
ptg002140l,1896723,1896992,269,EVM,mRNA,1512924,2021079,269,1.00
ptg002141l,1937083,1937402,319,EVM,mRNA,693717,3475888,319,1.00
ptg002141l,2669244,2669553,309,EVM,mRNA,693717,3475888,309,1.00
ptg002141l,3475700,3476031,331,EVM,mRNA,693717,3475888,188,0.57
ptg002142l,659103,659414,311,EVM,mRNA,85071,1881405,311,1.00
ptg002142l,1863302,1863570,268,EVM,mRNA,85071,1881405,268,1.00
ptg002142l,2844644,2844942,298,EVM,mRNA,2817779,2853205,298,1.00
ptg002143l,993471,993769,298,EVM,mRNA,723853,1705789,298,1.00
ptg002143l,1578427,1578699,272,EVM,mRNA,723853,1705789,272,1.00
ptg002143l,3044579,3044898,319,EVM,mRNA,2170204,3362042,319,1.00
ptg002143l,3876072,3876342,270,EVM,mRNA,3840724,5152526,270,1.00
ptg002143l,4304456,4304763,307,EVM,mRNA,3840724,5152526,307,1.00
ptg002143l,4793221,4793560,339,EVM,mRNA,3840724,5152526,339,1.00
ptg002147l,3035358,3035665,307,EVM,mRNA,2871205,3058297,307,1.00
ptg002147l,3189102,3189402,300,EVM,mRNA,3142783,3382838,300,1.00
ptg002150l,92174,92492,318,EVM,mRNA,35289,275288,318,1.00
ptg002150l,1772705,1772985,280,EVM,mRNA,1680639,2892477,280,1.00
ptg002150l,2081333,2081611,278,EVM,mRNA,1680639,2892477,278,1.00
ptg002150l,2147868,2148177,309,EVM,mRNA,1680639,2892477,309,1.00
ptg002154l,532281,532552,271,EVM,mRNA,199601,889662,271,1.00
ptg002154l,542428,542712,284,EVM,mRNA,199601,889662,284,1.00
ptg002159l,4580746,4581053,307,EVM,mRNA,4071310,4623257,307,1.00
ptg002163l,3276873,3277158,285,EVM,mRNA,1187367,3319412,285,1.00
ptg002164l,919328,919612,284,EVM,mRNA,475704,1603457,284,1.00
ptg002165l,1172735,1173039,304,EVM,mRNA,712508,1185376,304,1.00
ptg002165l,2049121,2049422,301,EVM,mRNA,1852248,2128402,301,1.00
ptg002167l,147834,148148,314,EVM,mRNA,399,439891,314,1.00
ptg002169l,2005470,2005769,299,EVM,mRNA,1689548,2082189,299,1.00
ptg002171l,838049,838375,326,EVM,mRNA,818699,850515,326,1.00
ptg002173l,357938,358262,324,EVM,mRNA,321271,418499,324,1.00
ptg002173l,1129817,1130122,305,EVM,mRNA,964195,1160033,305,1.00
ptg002173l,2365255,2365552,297,EVM,mRNA,2111884,2703890,297,1.00
ptg002174l,1056841,1057126,285,EVM,mRNA,373067,1268708,285,1.00
ptg002178l,1177407,1177686,279,EVM,mRNA,886513,1585318,279,1.00
ptg002178l,1250633,1250912,279,EVM,mRNA,886513,1585318,279,1.00
ptg002178l,1447774,1448071,297,EVM,mRNA,886513,1585318,297,1.00
ptg002180l,387126,387464,338,EVM,mRNA,29143,706591,338,1.00
ptg002180l,1898805,1899123,318,EVM,mRNA,1017809,1905774,318,1.00
ptg002181l,2766129,2766440,311,EVM,mRNA,2741841,2840375,311,1.00
ptg002183l,806534,806849,315,EVM,mRNA,87111,1339517,315,1.00
ptg002184l,1673331,1673605,274,EVM,mRNA,1037513,2904846,274,1.00
ptg002186l,404979,405284,305,EVM,mRNA,378593,1193687,305,1.00
ptg002186l,1048375,1048683,308,EVM,mRNA,378593,1193687,308,1.00
ptg002187l,501208,501503,295,EVM,mRNA,110026,936648,295,1.00
ptg002187l,709337,709644,307,EVM,mRNA,110026,936648,307,1.00
ptg002188l,1358868,1359174,306,EVM,mRNA,1116598,2366049,306,1.00
ptg002188l,1969137,1969437,300,EVM,mRNA,1116598,2366049,300,1.00
ptg002188l,2151565,2151895,330,EVM,mRNA,1116598,2366049,330,1.00
ptg002191l,276840,277145,305,EVM,mRNA,57151,738953,305,1.00
ptg002191l,512240,512541,301,EVM,mRNA,57151,738953,301,1.00
ptg002192l,1499524,1499827,303,EVM,mRNA,634065,1730025,303,1.00
ptg002193l,618421,618723,302,EVM,mRNA,192926,1875578,302,1.00
ptg002193l,822986,823272,286,EVM,mRNA,192926,1875578,286,1.00
ptg002193l,1607033,1607332,299,EVM,mRNA,192926,1875578,299,1.00
ptg002193l,2117567,2117868,301,EVM,mRNA,1930651,2234063,301,1.00
ptg002195l,1465717,1466026,309,EVM,mRNA,1451821,1492836,309,1.00
ptg002196l,475696,475976,280,EVM,mRNA,159278,524196,280,1.00
ptg002197l,1634775,1635081,306,EVM,mRNA,106781,2103063,306,1.00
ptg002197l,1728788,1729075,287,EVM,mRNA,106781,2103063,287,1.00
ptg002197l,1799387,1799686,299,EVM,mRNA,106781,2103063,299,1.00
ptg002198l,1483088,1483359,271,EVM,mRNA,1215011,1547812,271,1.00
ptg002200l,306567,306853,286,EVM,mRNA,130869,870458,286,1.00
ptg002203l,1123297,1123589,292,EVM,mRNA,937501,1137685,292,1.00
ptg002205l,2453116,2453397,281,EVM,mRNA,1762654,2587428,281,1.00
ptg002213l,120591,120865,274,EVM,mRNA,35830,351905,274,1.00
ptg002213l,123119,123452,333,EVM,mRNA,35830,351905,333,1.00
ptg002217l,2600883,2601160,277,EVM,mRNA,2373317,2775579,277,1.00
ptg002221l,5876474,5876751,277,EVM,mRNA,5598384,5918540,277,1.00
ptg002224l,494639,494932,293,EVM,mRNA,472672,1488434,293,1.00
ptg002224l,860303,860618,315,EVM,mRNA,472672,1488434,315,1.00
ptg002224l,1155802,1156101,299,EVM,mRNA,472672,1488434,299,1.00
ptg002225l,1798965,1799246,281,EVM,mRNA,1534788,1813439,281,1.00
ptg002225l,2572098,2572400,302,EVM,mRNA,2325155,3193604,302,1.00
ptg002225l,2674505,2674794,289,EVM,mRNA,2325155,3193604,289,1.00
ptg002226l,176432,176731,299,EVM,mRNA,50326,305219,299,1.00
ptg002226l,679830,680136,306,EVM,mRNA,615243,1081268,306,1.00
ptg002226l,5275537,5275847,310,EVM,mRNA,1902207,5466428,310,1.00
ptg002226l,5830095,5830404,309,EVM,mRNA,5810872,5839152,309,1.00
ptg002226l,6226148,6226440,292,EVM,mRNA,5950370,6646519,292,1.00
ptg002226l,8972079,8972379,300,EVM,mRNA,8885846,9312984,300,1.00
ptg002228l,106248,106545,297,EVM,mRNA,46211,269126,297,1.00
ptg002229l,1977996,1978276,280,EVM,mRNA,1457449,2946949,280,1.00
ptg002233l,412167,412436,269,EVM,mRNA,273233,419232,269,1.00
ptg002233l,3103767,3104065,298,EVM,mRNA,3007038,3285868,298,1.00
ptg002233l,4105087,4105393,306,EVM,mRNA,3926419,4183042,306,1.00
ptg002233l,5508826,5509104,278,EVM,mRNA,5026037,5817559,278,1.00
ptg002236l,532108,532404,296,EVM,mRNA,112944,672790,296,1.00
ptg002240l,227151,227453,302,EVM,mRNA,366,373682,302,1.00
ptg002240l,1474276,1474559,283,EVM,mRNA,1258751,1594409,283,1.00
ptg002240l,1563784,1564090,306,EVM,mRNA,1258751,1594409,306,1.00
ptg002241l,89611,89927,316,EVM,mRNA,25619,2554558,316,1.00
ptg002241l,957839,958125,286,EVM,mRNA,25619,2554558,286,1.00
ptg002241l,1054903,1055201,298,EVM,mRNA,25619,2554558,298,1.00
ptg002241l,1715823,1716137,314,EVM,mRNA,25619,2554558,314,1.00
ptg002241l,1787292,1787589,297,EVM,mRNA,25619,2554558,297,1.00
ptg002241l,2057615,2057931,316,EVM,mRNA,25619,2554558,316,1.00
ptg002243l,570009,570298,289,EVM,mRNA,219788,1664022,289,1.00
ptg002243l,901193,901489,296,EVM,mRNA,219788,1664022,296,1.00
ptg002243l,1528537,1528857,320,EVM,mRNA,219788,1664022,320,1.00
ptg002244l,1287096,1287388,292,EVM,mRNA,805635,1843180,292,1.00
ptg002244l,3963431,3963725,294,EVM,mRNA,3858927,4108909,294,1.00
ptg002245l,613824,614121,297,EVM,mRNA,55812,947135,297,1.00
ptg002249l,1408283,1408563,280,EVM,mRNA,62544,2467563,280,1.00
ptg002249l,2080909,2081234,325,EVM,mRNA,62544,2467563,325,1.00
ptg002249l,2165591,2165874,283,EVM,mRNA,62544,2467563,283,1.00
ptg002252l,975329,975644,315,EVM,mRNA,913057,1081128,315,1.00
ptg002253l,2045642,2045952,310,EVM,mRNA,1970265,2155895,310,1.00
ptg002257l,285734,286019,285,EVM,mRNA,3486,1576957,285,1.00
ptg002257l,689921,690219,298,EVM,mRNA,3486,1576957,298,1.00
ptg002257l,2626335,2626639,304,EVM,mRNA,2547576,2651822,304,1.00
ptg002260l,442128,442418,290,EVM,mRNA,263247,521267,290,1.00
ptg002260l,2302452,2302786,334,EVM,mRNA,2228613,2313869,334,1.00
ptg002262l,1953866,1954163,297,EVM,mRNA,70922,2661203,297,1.00
ptg002262l,3890015,3890304,289,EVM,mRNA,3375074,3933242,289,1.00
ptg002263l,919670,919998,328,EVM,mRNA,243451,1349528,328,1.00
ptg002263l,1017628,1017935,307,EVM,mRNA,243451,1349528,307,1.00
ptg002268l,1658433,1658744,311,EVM,mRNA,94885,2748429,311,1.00
ptg002269l,269240,269527,287,EVM,mRNA,246,544716,287,1.00
ptg002269l,272433,272724,291,EVM,mRNA,246,544716,291,1.00
ptg002269l,362273,362565,292,EVM,mRNA,246,544716,292,1.00
ptg002272l,927515,927813,298,EVM,mRNA,73707,1354638,298,1.00
ptg002272l,1060180,1060502,322,EVM,mRNA,73707,1354638,322,1.00
ptg002272l,1246035,1246356,321,EVM,mRNA,73707,1354638,321,1.00
ptg002276l,671004,671289,285,EVM,mRNA,2357,2513643,285,1.00
ptg002276l,1197113,1197428,315,EVM,mRNA,2357,2513643,315,1.00
ptg002276l,1228649,1228935,286,EVM,mRNA,2357,2513643,286,1.00
ptg002276l,1402390,1402684,294,EVM,mRNA,2357,2513643,294,1.00
ptg002277l,629889,630204,315,EVM,mRNA,1729,1491947,315,1.00
ptg002277l,802413,802730,317,EVM,mRNA,1729,1491947,317,1.00
ptg002277l,1055185,1055467,282,EVM,mRNA,1729,1491947,282,1.00
ptg002277l,1435019,1435300,281,EVM,mRNA,1729,1491947,281,1.00
ptg002277l,1442211,1442502,291,EVM,mRNA,1729,1491947,291,1.00
ptg002277l,1450617,1450932,315,EVM,mRNA,1729,1491947,315,1.00
ptg002280l,642530,642848,318,EVM,mRNA,112937,642726,196,0.62
ptg002280l,1616759,1617052,293,EVM,mRNA,1554927,1639812,293,1.00
ptg002284l,1982223,1982522,299,EVM,mRNA,1915275,2263457,299,1.00
ptg002284l,2074689,2075012,323,EVM,mRNA,1915275,2263457,323,1.00
ptg002284l,2082261,2082583,322,EVM,mRNA,1915275,2263457,322,1.00
ptg002285l,221143,221423,280,EVM,mRNA,47211,317505,280,1.00
ptg002285l,298696,298978,282,EVM,mRNA,47211,317505,282,1.00
ptg002285l,915601,915914,313,EVM,mRNA,614617,1095231,313,1.00
ptg002290l,1234691,1235004,313,EVM,mRNA,130,1661513,313,1.00
ptg002290l,2142847,2143131,284,EVM,mRNA,1781051,2352510,284,1.00
ptg002291l,537692,537981,289,EVM,mRNA,246150,1055164,289,1.00
ptg002291l,1481258,1481556,298,EVM,mRNA,1389073,2175406,298,1.00
ptg002291l,2117221,2117498,277,EVM,mRNA,1389073,2175406,277,1.00
ptg002297l,433767,434066,299,EVM,mRNA,389136,529102,299,1.00
ptg002297l,2036985,2037259,274,EVM,mRNA,678070,2812289,274,1.00
ptg002297l,3118311,3118635,324,EVM,mRNA,2937067,5416790,324,1.00
ptg002297l,3212422,3212722,300,EVM,mRNA,2937067,5416790,300,1.00
ptg002297l,3345444,3345758,314,EVM,mRNA,2937067,5416790,314,1.00
ptg002297l,3658977,3659300,323,EVM,mRNA,2937067,5416790,323,1.00
ptg002297l,5015696,5015986,290,EVM,mRNA,2937067,5416790,290,1.00
ptg002297l,5238719,5239049,330,EVM,mRNA,2937067,5416790,330,1.00
ptg002297l,6522731,6523027,296,EVM,mRNA,6128934,6609468,296,1.00
ptg002299l,48758,49053,295,EVM,mRNA,8699,2461352,295,1.00
ptg002299l,839345,839645,300,EVM,mRNA,8699,2461352,300,1.00
ptg002302l,975580,975905,325,EVM,mRNA,691380,1111907,325,1.00
ptg002303l,467430,467724,294,EVM,mRNA,71368,1413122,294,1.00
ptg002303l,1085806,1086134,328,EVM,mRNA,71368,1413122,328,1.00
ptg002303l,1870950,1871259,309,EVM,mRNA,1654534,1976038,309,1.00
ptg002303l,2912035,2912336,301,EVM,mRNA,2578219,3523418,301,1.00
ptg002305l,1386851,1387212,361,EVM,mRNA,1372726,1911533,361,1.00
ptg002305l,1680201,1680474,273,EVM,mRNA,1372726,1911533,273,1.00
ptg002306l,2162908,2163213,305,EVM,mRNA,1845525,2461516,305,1.00
ptg002306l,3175331,3175614,283,EVM,mRNA,3008561,3247704,283,1.00
ptg002308l,1936771,1937079,308,EVM,mRNA,1069726,5194375,308,1.00
ptg002308l,2124538,2124858,320,EVM,mRNA,1069726,5194375,320,1.00
ptg002308l,2489743,2490062,319,EVM,mRNA,1069726,5194375,319,1.00
ptg002308l,2687244,2687569,325,EVM,mRNA,1069726,5194375,325,1.00
ptg002308l,2980708,2980997,289,EVM,mRNA,1069726,5194375,289,1.00
ptg002308l,4658983,4659253,270,EVM,mRNA,1069726,5194375,270,1.00
ptg002308l,5768303,5768616,313,EVM,mRNA,5710135,6221547,313,1.00
ptg002308l,6079890,6080183,293,EVM,mRNA,5710135,6221547,293,1.00
ptg002309l,448772,449066,294,EVM,mRNA,271682,869843,294,1.00
ptg002309l,493603,493851,248,EVM,mRNA,271682,869843,248,1.00
ptg002309l,586256,586555,299,EVM,mRNA,271682,869843,299,1.00
ptg002309l,1856368,1856656,288,EVM,mRNA,1212088,2961156,288,1.00
ptg002309l,2617781,2618107,326,EVM,mRNA,1212088,2961156,326,1.00
ptg002311l,785483,785791,308,EVM,mRNA,338428,901940,308,1.00
ptg002311l,1657835,1658131,296,EVM,mRNA,1181199,4409110,296,1.00
ptg002311l,3220497,3220823,326,EVM,mRNA,1181199,4409110,326,1.00
ptg002311l,3293107,3293393,286,EVM,mRNA,1181199,4409110,286,1.00
ptg002312l,1594868,1595180,312,EVM,mRNA,1475936,1656001,312,1.00
ptg002312l,1617254,1617553,299,EVM,mRNA,1475936,1656001,299,1.00
ptg002315l,403167,403489,322,EVM,mRNA,229661,2186661,322,1.00
ptg002315l,492429,492737,308,EVM,mRNA,229661,2186661,308,1.00
ptg002315l,698726,699005,279,EVM,mRNA,229661,2186661,279,1.00
ptg002315l,1589718,1590023,305,EVM,mRNA,229661,2186661,305,1.00
ptg002315l,1607829,1608141,312,EVM,mRNA,229661,2186661,312,1.00
ptg002315l,2151376,2151677,301,EVM,mRNA,229661,2186661,301,1.00
ptg002317l,918266,918582,316,EVM,mRNA,809604,947089,316,1.00
ptg002319l,2914613,2914913,300,EVM,mRNA,2153087,2929421,300,1.00
ptg002320l,734576,734859,283,EVM,mRNA,659959,1492184,283,1.00
ptg002321l,866000,866319,319,EVM,mRNA,600900,1354544,319,1.00
ptg002321l,880829,881142,313,EVM,mRNA,600900,1354544,313,1.00
ptg002323l,962821,963146,325,EVM,mRNA,230386,1294341,325,1.00
ptg002323l,1691793,1692102,309,EVM,mRNA,1443342,2350140,309,1.00
ptg002323l,3962537,3962819,282,EVM,mRNA,3714124,4022579,282,1.00
ptg002323l,4525241,4525529,288,EVM,mRNA,4065042,4836201,288,1.00
ptg002325l,1400291,1400589,298,EVM,mRNA,777591,2223168,298,1.00
ptg002325l,3535874,3536155,281,EVM,mRNA,2261354,4281173,281,1.00
ptg002330l,1105974,1106273,299,EVM,mRNA,1057116,1218388,299,1.00
ptg002330l,1197014,1197318,304,EVM,mRNA,1057116,1218388,304,1.00
ptg002332l,1529293,1529590,297,EVM,mRNA,1376024,3857707,297,1.00
ptg002332l,5558481,5558772,291,EVM,mRNA,5341264,5716545,291,1.00
ptg002333l,842770,843062,292,EVM,mRNA,546570,1139355,292,1.00
ptg002336l,1006818,1007149,331,EVM,mRNA,928043,2191411,331,1.00
ptg002338l,4309944,4310239,295,EVM,mRNA,4064412,6212986,295,1.00
ptg002338l,4593299,4593598,299,EVM,mRNA,4064412,6212986,299,1.00
ptg002338l,5545187,5545480,293,EVM,mRNA,4064412,6212986,293,1.00
ptg002341l,597325,597637,312,EVM,mRNA,244236,972929,312,1.00
ptg002341l,905442,905765,323,EVM,mRNA,244236,972929,323,1.00
ptg002342l,418303,418605,302,EVM,mRNA,384580,524396,302,1.00
ptg002344l,704627,704903,276,EVM,mRNA,626074,906906,276,1.00
ptg002345l,1958250,1958562,312,EVM,mRNA,1465601,2631861,312,1.00
ptg002345l,2028446,2028728,282,EVM,mRNA,1465601,2631861,282,1.00
ptg002345l,2198537,2198794,257,EVM,mRNA,1465601,2631861,257,1.00
ptg002345l,2269812,2270153,341,EVM,mRNA,1465601,2631861,341,1.00
ptg002345l,2500055,2500378,323,EVM,mRNA,1465601,2631861,323,1.00
ptg002345l,2568668,2569002,334,EVM,mRNA,1465601,2631861,334,1.00
ptg002345l,3641372,3641692,320,EVM,mRNA,3603327,3680066,320,1.00
ptg002347l,873235,873544,309,EVM,mRNA,719694,1031831,309,1.00
ptg002347l,889627,889891,264,EVM,mRNA,719694,1031831,264,1.00
ptg002347l,1647195,1647496,301,EVM,mRNA,1224586,2971002,301,1.00
ptg002347l,4552885,4553173,288,EVM,mRNA,3912745,4688356,288,1.00
ptg002351l,569680,569995,315,EVM,mRNA,273853,2358572,315,1.00
ptg002351l,574691,575021,330,EVM,mRNA,273853,2358572,330,1.00
ptg002351l,1085400,1085707,307,EVM,mRNA,273853,2358572,307,1.00
ptg002351l,1191444,1191776,332,EVM,mRNA,273853,2358572,332,1.00
ptg002351l,1330848,1331184,336,EVM,mRNA,273853,2358572,336,1.00
ptg002351l,1951340,1951672,332,EVM,mRNA,273853,2358572,332,1.00
ptg002351l,4251715,4252003,288,EVM,mRNA,2687631,4593491,288,1.00
ptg002351l,4590821,4591134,313,EVM,mRNA,2687631,4593491,313,1.00
ptg002354l,876910,877203,293,EVM,mRNA,490864,1255166,293,1.00
ptg002356l,2160175,2160482,307,EVM,mRNA,2083776,2202864,307,1.00
ptg002358l,2500734,2501054,320,EVM,mRNA,2304285,2584068,320,1.00
ptg002358l,6255430,6255717,287,EVM,mRNA,5680459,6557999,287,1.00
ptg002359l,251146,251458,312,EVM,mRNA,160563,523139,312,1.00
ptg002360l,1537667,1537930,263,EVM,mRNA,282313,1642259,263,1.00
ptg002369l,1048830,1049137,307,EVM,mRNA,673725,2307110,307,1.00
ptg002374l,1438159,1438459,300,EVM,mRNA,1046141,1446181,300,1.00
ptg002374l,1659226,1659497,271,EVM,mRNA,1567914,1811034,271,1.00
ptg002374l,2038492,2038808,316,EVM,mRNA,1848222,2109113,316,1.00
ptg002374l,2806862,2807178,316,EVM,mRNA,2753521,4101175,316,1.00
ptg002375l,2192553,2192859,306,EVM,mRNA,623912,2685359,306,1.00
ptg002375l,5044116,5044432,316,EVM,mRNA,4648042,7191711,316,1.00
ptg002375l,7094591,7094909,318,EVM,mRNA,4648042,7191711,318,1.00
ptg002376l,2141810,2142102,292,EVM,mRNA,1045780,3521544,292,1.00
ptg002376l,2537972,2538262,290,EVM,mRNA,1045780,3521544,290,1.00
ptg002376l,3209389,3209702,313,EVM,mRNA,1045780,3521544,313,1.00
ptg002378l,994950,995221,271,EVM,mRNA,94069,2499576,271,1.00
ptg002378l,1399238,1399547,309,EVM,mRNA,94069,2499576,309,1.00
ptg002380l,502577,502863,286,EVM,mRNA,417173,957636,286,1.00
ptg002380l,887731,888018,287,EVM,mRNA,417173,957636,287,1.00
ptg002380l,2293436,2293759,323,EVM,mRNA,2243461,2427302,323,1.00
ptg002380l,2957260,2957542,282,EVM,mRNA,2573846,3436880,282,1.00
ptg002380l,3271951,3272218,267,EVM,mRNA,2573846,3436880,267,1.00
ptg002381l,771646,771936,290,EVM,mRNA,253859,1061283,290,1.00
ptg002383l,1326424,1326738,314,EVM,mRNA,1203771,1623592,314,1.00
ptg002384l,398893,399217,324,EVM,mRNA,319654,1097230,324,1.00
ptg002384l,922144,922418,274,EVM,mRNA,319654,1097230,274,1.00
ptg002384l,1024742,1025055,313,EVM,mRNA,319654,1097230,313,1.00
ptg002385l,1596707,1596995,288,EVM,mRNA,1596330,2655460,288,1.00
ptg002385l,2446744,2447055,311,EVM,mRNA,1596330,2655460,311,1.00
ptg002387l,742339,742641,302,EVM,mRNA,604898,841578,302,1.00
ptg002387l,1889032,1889345,313,EVM,mRNA,1607207,3179763,313,1.00
ptg002387l,3116980,3117275,295,EVM,mRNA,1607207,3179763,295,1.00
ptg002391l,767151,767466,315,EVM,mRNA,351184,2078431,315,1.00
ptg002391l,1056494,1056822,328,EVM,mRNA,351184,2078431,328,1.00
ptg002391l,1845709,1845993,284,EVM,mRNA,351184,2078431,284,1.00
ptg002397l,3613657,3613940,283,EVM,mRNA,3597234,4883337,283,1.00
ptg002397l,3950932,3951237,305,EVM,mRNA,3597234,4883337,305,1.00
ptg002397l,4347073,4347378,305,EVM,mRNA,3597234,4883337,305,1.00
ptg002399l,953423,953717,294,EVM,mRNA,900198,2993061,294,1.00
ptg002399l,1420017,1420342,325,EVM,mRNA,900198,2993061,325,1.00
ptg002399l,1890635,1890946,311,EVM,mRNA,900198,2993061,311,1.00
ptg002399l,2520294,2520614,320,EVM,mRNA,900198,2993061,320,1.00
ptg002400l,428053,428356,303,EVM,mRNA,66253,465225,303,1.00
ptg002403l,2099419,2099732,313,EVM,mRNA,2013375,2135184,313,1.00
ptg002406l,222627,222918,291,EVM,mRNA,55273,809113,291,1.00
ptg002411l,838724,839033,309,EVM,mRNA,545642,1340373,309,1.00
ptg002411l,995353,995644,291,EVM,mRNA,545642,1340373,291,1.00
ptg002411l,1104208,1104489,281,EVM,mRNA,545642,1340373,281,1.00
ptg002411l,1249587,1249914,327,EVM,mRNA,545642,1340373,327,1.00
ptg002414l,1641378,1641689,311,EVM,mRNA,239144,1712746,311,1.00
ptg002415l,327609,327900,291,EVM,mRNA,231687,531844,291,1.00
ptg002415l,1863531,1863813,282,EVM,mRNA,1156321,2233491,282,1.00
ptg002415l,2099597,2099916,319,EVM,mRNA,1156321,2233491,319,1.00
ptg002417l,2481452,2481760,308,EVM,mRNA,2241432,2872178,308,1.00
ptg002417l,2528107,2528397,290,EVM,mRNA,2241432,2872178,290,1.00
ptg002417l,3247046,3247342,296,EVM,mRNA,3247142,3247900,201,0.68
ptg002417l,4762310,4762632,322,EVM,mRNA,4729207,5101485,322,1.00
ptg002417l,5076567,5076873,306,EVM,mRNA,4729207,5101485,306,1.00
ptg002417l,8431228,8431516,288,EVM,mRNA,8135916,8593718,288,1.00
ptg002418l,827323,827604,281,EVM,mRNA,624361,1080308,281,1.00
ptg002419l,898502,898784,282,EVM,mRNA,801376,1204667,282,1.00
ptg002419l,1081449,1081750,301,EVM,mRNA,801376,1204667,301,1.00
ptg002424l,3402004,3402320,316,EVM,mRNA,3279052,3513639,316,1.00
ptg002425l,252218,252517,299,EVM,mRNA,128017,1142997,299,1.00
ptg002425l,474972,475266,294,EVM,mRNA,128017,1142997,294,1.00
ptg002427l,833193,833485,292,EVM,mRNA,204009,1792584,292,1.00
ptg002428l,2236213,2236500,287,EVM,mRNA,1273068,3910691,287,1.00
ptg002428l,4282797,4283115,318,EVM,mRNA,4196617,4340788,318,1.00
ptg002431l,1501853,1502180,327,EVM,mRNA,1415330,2185911,327,1.00
ptg002431l,3772212,3772528,316,EVM,mRNA,3755658,4221789,316,1.00
ptg002433l,192660,192951,291,EVM,mRNA,3567,192977,291,1.00
ptg002433l,1401329,1401610,281,EVM,mRNA,501541,1648248,281,1.00
ptg002434l,380747,381027,280,EVM,mRNA,172482,400644,280,1.00
ptg002442l,1108052,1108372,320,EVM,mRNA,1053316,1463334,320,1.00
ptg002442l,2772617,2772907,290,EVM,mRNA,2613779,2888670,290,1.00
ptg002444l,1447606,1447894,288,EVM,mRNA,868756,3385828,288,1.00
ptg002444l,2052865,2053137,272,EVM,mRNA,868756,3385828,272,1.00
ptg002444l,3281602,3281894,292,EVM,mRNA,868756,3385828,292,1.00
ptg002444l,3919171,3919451,280,EVM,mRNA,3800632,4037750,280,1.00
ptg002444l,5427177,5427489,312,EVM,mRNA,5420644,6356644,312,1.00
ptg002444l,5868945,5869254,309,EVM,mRNA,5420644,6356644,309,1.00
ptg002452l,1685484,1685792,308,EVM,mRNA,957875,1818442,308,1.00
ptg002452l,2973896,2974188,292,EVM,mRNA,2640238,3063692,292,1.00
ptg002454l,2210465,2210788,323,EVM,mRNA,1971073,2211487,323,1.00
ptg002455l,418455,418749,294,EVM,mRNA,154915,1049439,294,1.00
ptg002459l,638882,639217,335,EVM,mRNA,300418,2691759,335,1.00
ptg002459l,1217155,1217463,308,EVM,mRNA,300418,2691759,308,1.00
ptg002468l,1457477,1457774,297,EVM,mRNA,1388174,4053439,297,1.00
ptg002471l,1565285,1565571,286,EVM,mRNA,949932,3148208,286,1.00
ptg002472l,429013,429306,293,EVM,mRNA,173848,439291,293,1.00
ptg002473l,2711773,2712079,306,EVM,mRNA,1689616,3153715,306,1.00
ptg002473l,5738166,5738468,302,EVM,mRNA,4664323,6301357,302,1.00
ptg002473l,5951025,5951342,317,EVM,mRNA,4664323,6301357,317,1.00
ptg002473l,6129386,6129672,286,EVM,mRNA,4664323,6301357,286,1.00
ptg002474l,157836,158153,317,EVM,mRNA,41109,1578703,317,1.00
ptg002474l,196714,197033,319,EVM,mRNA,41109,1578703,319,1.00
ptg002474l,900748,901061,313,EVM,mRNA,41109,1578703,313,1.00
ptg002476l,500073,500363,290,EVM,mRNA,320337,904390,290,1.00
ptg002476l,883451,883750,299,EVM,mRNA,320337,904390,299,1.00
ptg002476l,1209348,1209652,304,EVM,mRNA,1090960,1437972,304,1.00
ptg002476l,4432377,4432691,314,EVM,mRNA,4080785,4838660,314,1.00
ptg002476l,5312344,5312650,306,EVM,mRNA,4865429,5325134,306,1.00
ptg002485l,81955,82261,306,EVM,mRNA,24858,249827,306,1.00
ptg002485l,616878,617207,329,EVM,mRNA,541300,2142695,329,1.00
ptg002485l,1570478,1570803,325,EVM,mRNA,541300,2142695,325,1.00
ptg002488l,1473040,1473341,301,EVM,mRNA,1287124,3681740,301,1.00
ptg002488l,3466368,3466628,260,EVM,mRNA,1287124,3681740,260,1.00
ptg002489l,464635,464934,299,EVM,mRNA,315906,2839045,299,1.00
ptg002489l,1634647,1634959,312,EVM,mRNA,315906,2839045,312,1.00
ptg002494l,404845,405141,296,EVM,mRNA,159594,1237247,296,1.00
ptg002494l,940560,940876,316,EVM,mRNA,159594,1237247,316,1.00
ptg002495l,700051,700328,277,EVM,mRNA,301946,754364,277,1.00
ptg002496l,282997,283292,295,EVM,mRNA,145035,333707,295,1.00
ptg002497l,395775,396073,298,EVM,mRNA,110501,736068,298,1.00
ptg002497l,1589845,1590166,321,EVM,mRNA,1048152,2530467,321,1.00
ptg002497l,1757569,1757881,312,EVM,mRNA,1048152,2530467,312,1.00
ptg002497l,1821488,1821788,300,EVM,mRNA,1048152,2530467,300,1.00
ptg002497l,2411953,2412281,328,EVM,mRNA,1048152,2530467,328,1.00
ptg002499l,2680092,2680403,311,EVM,mRNA,2655842,2798925,311,1.00
ptg002501l,130263,130577,314,EVM,mRNA,13168,330937,314,1.00
ptg002502l,738998,739328,330,EVM,mRNA,1550,1647316,330,1.00
ptg002502l,1179906,1180230,324,EVM,mRNA,1550,1647316,324,1.00
ptg002504l,2141818,2142138,320,EVM,mRNA,1890759,2236287,320,1.00
ptg002504l,4872189,4872484,295,EVM,mRNA,3583260,5031469,295,1.00
ptg002506l,690886,691166,280,EVM,mRNA,657191,753082,280,1.00
ptg002510l,4378614,4378920,306,EVM,mRNA,4010994,5387573,306,1.00
ptg002510l,6235040,6235344,304,EVM,mRNA,6176679,6285466,304,1.00
ptg002510l,6628237,6628524,287,EVM,mRNA,6438778,8239652,287,1.00
ptg002510l,7834689,7835011,322,EVM,mRNA,6438778,8239652,322,1.00
ptg002512l,713574,713861,287,EVM,mRNA,680129,947039,287,1.00
ptg002515l,705843,706143,300,EVM,mRNA,525577,1531027,300,1.00
ptg002515l,1200600,1200897,297,EVM,mRNA,525577,1531027,297,1.00
ptg002516l,262297,262613,316,EVM,mRNA,103000,627277,316,1.00
ptg002516l,1299318,1299597,279,EVM,mRNA,1281946,1931523,279,1.00
ptg002516l,1776537,1776840,303,EVM,mRNA,1281946,1931523,303,1.00
ptg002516l,1801476,1801809,333,EVM,mRNA,1281946,1931523,333,1.00
ptg002516l,2139605,2139921,316,EVM,mRNA,2139580,2300872,316,1.00
ptg002517l,2007602,2007906,304,EVM,mRNA,2007126,2069199,304,1.00
ptg002517l,2043304,2043607,303,EVM,mRNA,2007126,2069199,303,1.00
ptg002517l,3000050,3000335,285,EVM,mRNA,2392344,3252193,285,1.00
ptg002517l,3872959,3873292,333,EVM,mRNA,3831304,3923595,333,1.00
ptg002520l,418645,418960,315,EVM,mRNA,316442,856984,315,1.00
ptg002521l,856377,856666,289,EVM,mRNA,665152,2298043,289,1.00
ptg002523l,1126671,1126949,278,EVM,mRNA,1015301,1258416,278,1.00
ptg002526l,379597,379888,291,EVM,mRNA,6392,830909,291,1.00
ptg002526l,1813718,1814020,302,EVM,mRNA,1786525,2219628,302,1.00
ptg002527l,649653,649934,281,EVM,mRNA,639873,1209722,281,1.00
ptg002527l,764727,765016,289,EVM,mRNA,639873,1209722,289,1.00
ptg002527l,873340,873650,310,EVM,mRNA,639873,1209722,310,1.00
ptg002527l,2309063,2309343,280,EVM,mRNA,2165184,2314391,280,1.00
ptg002527l,5274584,5274888,304,EVM,mRNA,2766293,6090753,304,1.00
ptg002527l,5376536,5376820,284,EVM,mRNA,2766293,6090753,284,1.00
ptg002527l,5646311,5646576,265,EVM,mRNA,2766293,6090753,265,1.00
ptg002528l,706686,707002,316,EVM,mRNA,464951,717784,316,1.00
ptg002528l,1321112,1321445,333,EVM,mRNA,1317013,1394109,333,1.00
ptg002528l,2259680,2260012,332,EVM,mRNA,2259547,2854686,332,1.00
ptg002528l,2811959,2812234,275,EVM,mRNA,2259547,2854686,275,1.00
ptg002529l,1664739,1665050,311,EVM,mRNA,1513775,2243745,311,1.00
ptg002533l,2990026,2990340,314,EVM,mRNA,2703046,3084103,314,1.00
ptg002534l,794449,794754,305,EVM,mRNA,362564,2183166,305,1.00
ptg002534l,801818,802123,305,EVM,mRNA,362564,2183166,305,1.00
ptg002534l,3233174,3233456,282,EVM,mRNA,2952136,4116437,282,1.00
ptg002536l,811347,811651,304,EVM,mRNA,275179,867424,304,1.00
ptg002540l,336945,337227,282,EVM,mRNA,248887,496735,282,1.00
ptg002540l,691886,692158,272,EVM,mRNA,689261,835697,272,1.00
ptg002548l,1194396,1194671,275,EVM,mRNA,386,1262807,275,1.00
ptg002549l,728677,728973,296,EVM,mRNA,194767,1043839,296,1.00
ptg002549l,769598,769924,326,EVM,mRNA,194767,1043839,326,1.00
ptg002551l,287777,288073,296,EVM,mRNA,6725,918781,296,1.00
ptg002551l,7147620,7147933,313,EVM,mRNA,6295177,7197121,313,1.00
ptg002552l,1428098,1428386,288,EVM,mRNA,984227,2476125,288,1.00
ptg002552l,1749433,1749682,249,EVM,mRNA,984227,2476125,249,1.00
ptg002552l,2043358,2043653,295,EVM,mRNA,984227,2476125,295,1.00
ptg002552l,2052148,2052429,281,EVM,mRNA,984227,2476125,281,1.00
ptg002552l,2236360,2236672,312,EVM,mRNA,984227,2476125,312,1.00
ptg002559l,752558,752851,293,EVM,mRNA,671723,776217,293,1.00
ptg002559l,2134700,2135026,326,EVM,mRNA,1986097,2163806,326,1.00
ptg002563l,71663,71972,309,EVM,mRNA,18859,869829,309,1.00
ptg002563l,763719,763997,278,EVM,mRNA,18859,869829,278,1.00
ptg002564l,1034672,1034916,244,EVM,mRNA,198135,2325840,244,1.00
ptg002564l,1047071,1047370,299,EVM,mRNA,198135,2325840,299,1.00
ptg002564l,1557077,1557385,308,EVM,mRNA,198135,2325840,308,1.00
ptg002564l,2109440,2109756,316,EVM,mRNA,198135,2325840,316,1.00
ptg002564l,2213856,2214146,290,EVM,mRNA,198135,2325840,290,1.00
ptg002564l,4025124,4025403,279,EVM,mRNA,3688795,4830685,279,1.00
ptg002565l,2007933,2008206,273,EVM,mRNA,1134975,2211626,273,1.00
ptg002567l,227240,227521,281,EVM,mRNA,25909,731560,281,1.00
ptg002567l,513446,513735,289,EVM,mRNA,25909,731560,289,1.00
ptg002567l,516286,516586,300,EVM,mRNA,25909,731560,300,1.00
ptg002568l,965849,966121,272,EVM,mRNA,874198,1092409,272,1.00
ptg002571l,633510,633815,305,EVM,mRNA,555504,814300,305,1.00
ptg002571l,640289,640588,299,EVM,mRNA,555504,814300,299,1.00
ptg002573l,2044304,2044611,307,EVM,mRNA,2020743,2245660,307,1.00
ptg002573l,2230190,2230497,307,EVM,mRNA,2020743,2245660,307,1.00
ptg002573l,3799724,3800018,294,EVM,mRNA,3167551,4993988,294,1.00
ptg002573l,5549556,5549861,305,EVM,mRNA,5144968,5864008,305,1.00
ptg002573l,7056617,7056922,305,EVM,mRNA,7010004,8097666,305,1.00
ptg002575l,2723556,2723841,285,EVM,mRNA,2719625,4523537,285,1.00
ptg002575l,3293961,3294274,313,EVM,mRNA,2719625,4523537,313,1.00
ptg002575l,3850017,3850324,307,EVM,mRNA,2719625,4523537,307,1.00
ptg002575l,4194715,4195035,320,EVM,mRNA,2719625,4523537,320,1.00
ptg002578l,22749,23048,299,EVM,mRNA,208,592646,299,1.00
ptg002578l,105755,106054,299,EVM,mRNA,208,592646,299,1.00
ptg002578l,468216,468515,299,EVM,mRNA,208,592646,299,1.00
ptg002578l,521121,521404,283,EVM,mRNA,208,592646,283,1.00
ptg002579l,815301,815582,281,EVM,mRNA,773637,2019447,281,1.00
ptg002579l,1519144,1519447,303,EVM,mRNA,773637,2019447,303,1.00
ptg002583l,3254096,3254393,297,EVM,mRNA,3229730,4983128,297,1.00
ptg002583l,4274756,4275041,285,EVM,mRNA,3229730,4983128,285,1.00
ptg002583l,4738266,4738563,297,EVM,mRNA,3229730,4983128,297,1.00
ptg002583l,4941431,4941726,295,EVM,mRNA,3229730,4983128,295,1.00
ptg002583l,5331549,5331873,324,EVM,mRNA,5200505,5499930,324,1.00
ptg002583l,6021199,6021503,304,EVM,mRNA,5781182,6063700,304,1.00
ptg002585l,143026,143304,278,EVM,mRNA,26620,392072,278,1.00
ptg002585l,628185,628514,329,EVM,mRNA,600421,3123261,329,1.00
ptg002585l,2401467,2401777,310,EVM,mRNA,600421,3123261,310,1.00
ptg002585l,3228121,3228406,285,EVM,mRNA,3173956,3467925,285,1.00
ptg002585l,3404369,3404681,312,EVM,mRNA,3173956,3467925,312,1.00
ptg002586l,3282313,3282591,278,EVM,mRNA,1166401,4712445,278,1.00
ptg002586l,5817790,5818102,312,EVM,mRNA,5430617,6296234,312,1.00
ptg002588l,18646,18904,258,EVM,mRNA,2726,1563924,258,1.00
ptg002588l,2433477,2433754,277,EVM,mRNA,2000980,2939427,277,1.00
ptg002589l,754604,754898,294,EVM,mRNA,3774,803646,294,1.00
ptg002590l,393035,393340,305,EVM,mRNA,178160,588947,305,1.00
ptg002590l,489558,489878,320,EVM,mRNA,178160,588947,320,1.00
ptg002594l,989351,989647,296,EVM,mRNA,562046,4251977,296,1.00
ptg002594l,1899491,1899812,321,EVM,mRNA,562046,4251977,321,1.00
ptg002594l,3854469,3854740,271,EVM,mRNA,562046,4251977,271,1.00
ptg002596l,4651830,4652100,270,EVM,mRNA,2512455,4750000,270,1.00
ptg002597l,18503,18809,306,EVM,mRNA,3774,513509,306,1.00
ptg002601l,631188,631483,295,EVM,mRNA,429976,2620040,295,1.00
ptg002601l,1217743,1218052,309,EVM,mRNA,429976,2620040,309,1.00
ptg002605l,4075426,4075720,294,EVM,mRNA,3358366,4157170,294,1.00
ptg002605l,4089170,4089455,285,EVM,mRNA,3358366,4157170,285,1.00
ptg002605l,4559947,4560255,308,EVM,mRNA,4285965,6184742,308,1.00
ptg002605l,4712475,4712787,312,EVM,mRNA,4285965,6184742,312,1.00
ptg002605l,5540470,5540789,319,EVM,mRNA,4285965,6184742,319,1.00
ptg002606l,741113,741427,314,EVM,mRNA,234041,2022363,314,1.00
ptg002606l,1088619,1088918,299,EVM,mRNA,234041,2022363,299,1.00
ptg002606l,1891488,1891801,313,EVM,mRNA,234041,2022363,313,1.00
ptg002609l,4087730,4088034,304,EVM,mRNA,2637618,4534659,304,1.00
ptg002609l,4844961,4845261,300,EVM,mRNA,4798475,5607888,300,1.00
ptg002609l,5508307,5508579,272,EVM,mRNA,4798475,5607888,272,1.00
ptg002610l,165222,165519,297,EVM,mRNA,79749,205325,297,1.00
ptg002611l,6270002,6270295,293,EVM,mRNA,5636292,7130229,293,1.00
ptg002613l,104242,104542,300,EVM,mRNA,80760,944725,300,1.00
ptg002614l,1911708,1912004,296,EVM,mRNA,301188,2527226,296,1.00
ptg002614l,2316394,2316704,310,EVM,mRNA,301188,2527226,310,1.00
ptg002614l,2473421,2473720,299,EVM,mRNA,301188,2527226,299,1.00
ptg002616l,1468747,1469060,313,EVM,mRNA,1389628,1717229,313,1.00
ptg002617l,72373,72691,318,EVM,mRNA,147,1954343,318,1.00
ptg002617l,156757,157041,284,EVM,mRNA,147,1954343,284,1.00
ptg002617l,241562,241896,334,EVM,mRNA,147,1954343,334,1.00
ptg002617l,781184,781512,328,EVM,mRNA,147,1954343,328,1.00
ptg002617l,1286856,1287178,322,EVM,mRNA,147,1954343,322,1.00
ptg002617l,1855437,1855729,292,EVM,mRNA,147,1954343,292,1.00
ptg002620l,549757,550087,330,EVM,mRNA,468470,670252,330,1.00
ptg002621l,1524701,1525009,308,EVM,mRNA,1489189,1760740,308,1.00
ptg002621l,1910557,1910871,314,EVM,mRNA,1799307,1969296,314,1.00
ptg002621l,2439754,2440073,319,EVM,mRNA,1974757,4914103,319,1.00
ptg002621l,3389845,3390112,267,EVM,mRNA,1974757,4914103,267,1.00
ptg002621l,3485947,3486244,297,EVM,mRNA,1974757,4914103,297,1.00
ptg002621l,4049078,4049413,335,EVM,mRNA,1974757,4914103,335,1.00
ptg002621l,6716505,6716815,310,EVM,mRNA,6621612,8696468,310,1.00
ptg002621l,7000265,7000597,332,EVM,mRNA,6621612,8696468,332,1.00
ptg002621l,7293478,7293758,280,EVM,mRNA,6621612,8696468,280,1.00
ptg002621l,7305481,7305797,316,EVM,mRNA,6621612,8696468,316,1.00
ptg002621l,7411148,7411468,320,EVM,mRNA,6621612,8696468,320,1.00
ptg002621l,7600911,7601168,257,EVM,mRNA,6621612,8696468,257,1.00
ptg002621l,7746474,7746770,296,EVM,mRNA,6621612,8696468,296,1.00
ptg002622l,542671,542963,292,EVM,mRNA,91087,2308186,292,1.00
ptg002622l,1092784,1093067,283,EVM,mRNA,91087,2308186,283,1.00
ptg002622l,3149601,3149915,314,EVM,mRNA,2877303,4323066,314,1.00
ptg002623l,1310654,1310949,295,EVM,mRNA,720575,1463183,295,1.00
ptg002623l,1355720,1356019,299,EVM,mRNA,720575,1463183,299,1.00
ptg002624l,1333638,1333924,286,EVM,mRNA,1292978,1429143,286,1.00
ptg002625l,420013,420299,286,EVM,mRNA,121185,958926,286,1.00
ptg002625l,762959,763269,310,EVM,mRNA,121185,958926,310,1.00
ptg002625l,2609093,2609391,298,EVM,mRNA,2320684,2957565,298,1.00
ptg002626l,1965731,1966064,333,EVM,mRNA,1872364,2190087,333,1.00
ptg002628l,1070585,1070870,285,EVM,mRNA,674372,1109951,285,1.00
ptg002628l,2618278,2618596,318,EVM,mRNA,2598559,2813407,318,1.00
ptg002629l,589794,590066,272,EVM,mRNA,215270,2142603,272,1.00
ptg002629l,2495344,2495643,299,EVM,mRNA,2226848,2629416,299,1.00
ptg002637l,177301,177566,265,EVM,mRNA,152156,214559,265,1.00
ptg002641l,1099516,1099811,295,EVM,mRNA,95148,1532674,295,1.00
ptg002643l,346970,347304,334,EVM,mRNA,20735,519659,334,1.00
ptg002646l,170636,170895,259,EVM,mRNA,6642,230619,259,1.00
ptg002646l,793205,793492,287,EVM,mRNA,666550,1091667,287,1.00
ptg002647l,351307,351614,307,EVM,mRNA,215135,521898,307,1.00
ptg002648l,151204,151468,264,EVM,mRNA,11879,239955,264,1.00
ptg002649l,280583,280861,278,EVM,mRNA,129176,340923,278,1.00
ptg002650l,1521754,1522056,302,EVM,mRNA,1429122,1617884,302,1.00
ptg002653l,2091739,2092057,318,EVM,mRNA,1901038,2380648,318,1.00
ptg002654l,3690996,3691295,299,EVM,mRNA,3449073,3999879,299,1.00
ptg002654l,3805228,3805527,299,EVM,mRNA,3449073,3999879,299,1.00
ptg002654l,5208439,5208734,295,EVM,mRNA,5205733,5760264,295,1.00
ptg002654l,5343182,5343477,295,EVM,mRNA,5205733,5760264,295,1.00
ptg002655l,535169,535438,269,EVM,mRNA,354505,648216,269,1.00
ptg002655l,2159526,2159828,302,EVM,mRNA,1131977,2178804,302,1.00
ptg002657l,440507,440803,296,EVM,mRNA,413954,684363,296,1.00
ptg002658l,54607,54928,321,EVM,mRNA,32044,794085,321,1.00
ptg002658l,467232,467519,287,EVM,mRNA,32044,794085,287,1.00
ptg002658l,478535,478825,290,EVM,mRNA,32044,794085,290,1.00
ptg002658l,542913,543218,305,EVM,mRNA,32044,794085,305,1.00
ptg002659l,2915609,2915912,303,EVM,mRNA,836126,3762699,303,1.00
ptg002659l,3419905,3420222,317,EVM,mRNA,836126,3762699,317,1.00
ptg002659l,4738704,4739019,315,EVM,mRNA,4715675,5399132,315,1.00
ptg002660l,4114785,4115070,285,EVM,mRNA,4091517,4167655,285,1.00
ptg002660l,4890687,4890999,312,EVM,mRNA,4261792,5793097,312,1.00
ptg002666l,2017787,2018065,278,EVM,mRNA,1665578,2225930,278,1.00
ptg002666l,2907994,2908248,254,EVM,mRNA,2742994,3253621,254,1.00
ptg002666l,3041153,3041426,273,EVM,mRNA,2742994,3253621,273,1.00
ptg002676l,786582,786917,335,EVM,mRNA,557780,831869,335,1.00
ptg002677l,4263011,4263294,283,EVM,mRNA,4262607,4316593,283,1.00
ptg002680l,1714257,1714542,285,EVM,mRNA,1209395,2610465,285,1.00
ptg002680l,2179162,2179461,299,EVM,mRNA,1209395,2610465,299,1.00
ptg002687l,3339948,3340212,264,EVM,mRNA,3288883,3462501,264,1.00
ptg002688l,169275,169593,318,EVM,mRNA,65023,202544,318,1.00
ptg002690l,4064052,4064331,279,EVM,mRNA,3492293,5576840,279,1.00
ptg002690l,4112968,4113279,311,EVM,mRNA,3492293,5576840,311,1.00
ptg002690l,5048520,5048816,296,EVM,mRNA,3492293,5576840,296,1.00
ptg002692l,20299,20614,315,EVM,mRNA,8924,970959,315,1.00
ptg002692l,417758,418074,316,EVM,mRNA,8924,970959,316,1.00
ptg002692l,832934,833261,327,EVM,mRNA,8924,970959,327,1.00
ptg002692l,839824,840094,270,EVM,mRNA,8924,970959,270,1.00
ptg002695l,623991,624320,329,EVM,mRNA,594335,1022962,329,1.00
ptg002696l,190820,191099,279,EVM,mRNA,90702,763785,279,1.00
ptg002696l,193983,194272,289,EVM,mRNA,90702,763785,289,1.00
ptg002699l,805543,805840,297,EVM,mRNA,15483,3518738,297,1.00
ptg002699l,2328326,2328611,285,EVM,mRNA,15483,3518738,285,1.00
ptg002702l,386759,387079,320,EVM,mRNA,91176,1567031,320,1.00
ptg002702l,698242,698571,329,EVM,mRNA,91176,1567031,329,1.00
ptg002702l,2100062,2100376,314,EVM,mRNA,1715197,2782891,314,1.00
ptg002704l,683920,684225,305,EVM,mRNA,661611,704298,305,1.00
ptg002704l,2208226,2208516,290,EVM,mRNA,836261,3189756,290,1.00
ptg002706l,854174,854480,306,EVM,mRNA,686501,970379,306,1.00
ptg002707l,581375,581656,281,EVM,mRNA,16503,5079774,281,1.00
ptg002707l,1538060,1538359,299,EVM,mRNA,16503,5079774,299,1.00
ptg002707l,2730002,2730323,321,EVM,mRNA,16503,5079774,321,1.00
ptg002707l,2853019,2853337,318,EVM,mRNA,16503,5079774,318,1.00
ptg002707l,2931831,2932124,293,EVM,mRNA,16503,5079774,293,1.00
ptg002707l,3300968,3301266,298,EVM,mRNA,16503,5079774,298,1.00
ptg002707l,3587740,3588045,305,EVM,mRNA,16503,5079774,305,1.00
ptg002708l,937863,938152,289,EVM,mRNA,854016,1279500,289,1.00
ptg002708l,1155728,1156007,279,EVM,mRNA,854016,1279500,279,1.00
ptg002708l,1222141,1222458,317,EVM,mRNA,854016,1279500,317,1.00
ptg002708l,3105356,3105653,297,EVM,mRNA,2682657,3476461,297,1.00
ptg002708l,3277895,3278194,299,EVM,mRNA,2682657,3476461,299,1.00
ptg002709l,980686,980995,309,EVM,mRNA,447355,1078384,309,1.00
ptg002714l,564325,564625,300,EVM,mRNA,507462,753290,300,1.00
ptg002719l,546384,546692,308,EVM,mRNA,496095,586837,308,1.00
ptg002723l,987389,987666,277,EVM,mRNA,133767,2123211,277,1.00
ptg002723l,1521140,1521430,290,EVM,mRNA,133767,2123211,290,1.00
ptg002723l,1598384,1598701,317,EVM,mRNA,133767,2123211,317,1.00
ptg002723l,1690968,1691282,314,EVM,mRNA,133767,2123211,314,1.00
ptg002723l,1895900,1896194,294,EVM,mRNA,133767,2123211,294,1.00
ptg002725l,3819535,3819834,299,EVM,mRNA,2078683,4546186,299,1.00
ptg002732l,1597018,1597331,313,EVM,mRNA,45017,1892859,313,1.00
ptg002732l,3370432,3370714,282,EVM,mRNA,2117844,3750837,282,1.00
ptg002732l,4816463,4816749,286,EVM,mRNA,4496792,4966914,286,1.00
ptg002732l,5246029,5246357,328,EVM,mRNA,5050011,6623957,328,1.00
ptg002732l,5634244,5634518,274,EVM,mRNA,5050011,6623957,274,1.00
ptg002732l,9207767,9208081,314,EVM,mRNA,8825776,9396887,314,1.00
ptg002733l,1655829,1656128,299,EVM,mRNA,1047771,2093143,299,1.00
ptg002738l,429347,429665,318,EVM,mRNA,132848,1234824,318,1.00
ptg002739l,461555,461884,329,EVM,mRNA,180556,1500456,329,1.00
ptg002739l,745552,745880,328,EVM,mRNA,180556,1500456,328,1.00
ptg002741l,1025231,1025511,280,EVM,mRNA,49509,1589784,280,1.00
ptg002741l,2216241,2216522,281,EVM,mRNA,2055619,2262161,281,1.00
ptg002741l,2229937,2230224,287,EVM,mRNA,2055619,2262161,287,1.00
ptg002746l,1091766,1092068,302,EVM,mRNA,410305,2357362,302,1.00
ptg002746l,3551698,3552010,312,EVM,mRNA,2927722,3691994,312,1.00
ptg002747l,2312979,2313302,323,EVM,mRNA,2301830,4560647,323,1.00
ptg002747l,3552385,3552666,281,EVM,mRNA,2301830,4560647,281,1.00
ptg002748l,3931321,3931638,317,EVM,mRNA,3297360,4175049,317,1.00
ptg002749l,1003821,1004117,296,EVM,mRNA,947969,1644325,296,1.00
ptg002749l,1944077,1944356,279,EVM,mRNA,1721076,3743623,279,1.00
ptg002749l,2748114,2748414,300,EVM,mRNA,1721076,3743623,300,1.00
ptg002749l,2857832,2858126,294,EVM,mRNA,1721076,3743623,294,1.00
ptg002749l,3138031,3138343,312,EVM,mRNA,1721076,3743623,312,1.00
ptg002749l,3668940,3669257,317,EVM,mRNA,1721076,3743623,317,1.00
ptg002749l,4906737,4907050,313,EVM,mRNA,4872447,6316180,313,1.00
ptg002749l,5153898,5154180,282,EVM,mRNA,4872447,6316180,282,1.00
ptg002749l,6084778,6085102,324,EVM,mRNA,4872447,6316180,324,1.00
ptg002750l,481502,481803,301,EVM,mRNA,451773,620600,301,1.00
ptg002751l,178989,179257,268,EVM,mRNA,255,279823,268,1.00
ptg002753l,691653,691959,306,EVM,mRNA,387039,810205,306,1.00
ptg002753l,754423,754705,282,EVM,mRNA,387039,810205,282,1.00
ptg002756l,850286,850612,326,EVM,mRNA,826436,927214,326,1.00
ptg002761l,154309,154623,314,EVM,mRNA,95243,283725,314,1.00
ptg002766l,1098235,1098549,314,EVM,mRNA,880299,1105330,314,1.00
ptg002766l,1969780,1970094,314,EVM,mRNA,1965257,2081663,314,1.00
ptg002766l,2045524,2045836,312,EVM,mRNA,1965257,2081663,312,1.00
ptg002768l,753702,754003,301,EVM,mRNA,59111,1345484,301,1.00
ptg002768l,966905,967234,329,EVM,mRNA,59111,1345484,329,1.00
ptg002769l,389926,390241,315,EVM,mRNA,7911,853929,315,1.00
ptg002769l,503772,504066,294,EVM,mRNA,7911,853929,294,1.00
ptg002769l,1157974,1158257,283,EVM,mRNA,1063771,2707791,283,1.00
ptg002769l,1351316,1351585,269,EVM,mRNA,1063771,2707791,269,1.00
ptg002770l,91201,91518,317,EVM,mRNA,29248,649900,317,1.00
ptg002771l,6944611,6944912,301,EVM,mRNA,6927884,7606888,301,1.00
ptg002771l,7380214,7380545,331,EVM,mRNA,6927884,7606888,331,1.00
ptg002772l,759772,760087,315,EVM,mRNA,46496,799428,315,1.00
ptg002772l,6371567,6371892,325,EVM,mRNA,6035783,6814225,325,1.00
ptg002772l,8915008,8915292,284,EVM,mRNA,8476567,10097147,284,1.00
ptg002773l,771243,771524,281,EVM,mRNA,18651,1022380,281,1.00
ptg002773l,818307,818642,335,EVM,mRNA,18651,1022380,335,1.00
ptg002773l,892052,892367,315,EVM,mRNA,18651,1022380,315,1.00
ptg002773l,1006381,1006709,328,EVM,mRNA,18651,1022380,328,1.00
ptg002773l,4165911,4166205,294,EVM,mRNA,3371507,4366952,294,1.00
ptg002773l,4244086,4244410,324,EVM,mRNA,3371507,4366952,324,1.00
ptg002785l,2137864,2138181,317,EVM,mRNA,97573,2833764,317,1.00
ptg002785l,2260647,2260932,285,EVM,mRNA,97573,2833764,285,1.00
ptg002785l,2770451,2770735,284,EVM,mRNA,97573,2833764,284,1.00
ptg002785l,2828476,2828751,275,EVM,mRNA,97573,2833764,275,1.00
ptg002786l,1260835,1261150,315,EVM,mRNA,472426,2580910,315,1.00
ptg002788l,294574,294890,316,EVM,mRNA,4355,386584,316,1.00
ptg002789l,3563864,3564149,285,EVM,mRNA,3329183,3909251,285,1.00
ptg002789l,3668114,3668400,286,EVM,mRNA,3329183,3909251,286,1.00
ptg002789l,4366780,4367061,281,EVM,mRNA,4304786,4729021,281,1.00
ptg002789l,7393915,7394219,304,EVM,mRNA,7366512,7464724,304,1.00
ptg002790l,442262,442564,302,EVM,mRNA,237641,620398,302,1.00
ptg002790l,617250,617546,296,EVM,mRNA,237641,620398,296,1.00
ptg002801l,4167167,4167492,325,EVM,mRNA,3989770,5015835,325,1.00
ptg002808l,521369,521694,325,EVM,mRNA,145520,1021763,325,1.00
ptg002808l,598720,599005,285,EVM,mRNA,145520,1021763,285,1.00
ptg002813l,2724295,2724584,289,EVM,mRNA,2381861,3496639,289,1.00
ptg002813l,3014577,3014876,299,EVM,mRNA,2381861,3496639,299,1.00
ptg002814l,22134,22407,273,EVM,mRNA,10089,47021,273,1.00
ptg002814l,412714,413005,291,EVM,mRNA,376939,3856468,291,1.00
ptg002814l,2896592,2896892,300,EVM,mRNA,376939,3856468,300,1.00
ptg002814l,3032888,3033184,296,EVM,mRNA,376939,3856468,296,1.00
ptg002814l,3845361,3845658,297,EVM,mRNA,376939,3856468,297,1.00
ptg002818l,2850875,2851168,293,EVM,mRNA,2467269,4225179,293,1.00
ptg002818l,3506650,3506949,299,EVM,mRNA,2467269,4225179,299,1.00
ptg002818l,3922340,3922646,306,EVM,mRNA,2467269,4225179,306,1.00
ptg002818l,3925889,3926184,295,EVM,mRNA,2467269,4225179,295,1.00
ptg002818l,4131620,4131932,312,EVM,mRNA,2467269,4225179,312,1.00
ptg002823l,351255,351582,327,EVM,mRNA,292884,1077911,327,1.00
ptg002823l,816757,817052,295,EVM,mRNA,292884,1077911,295,1.00
ptg002825l,1264507,1264802,295,EVM,mRNA,1097828,1767023,295,1.00
ptg002828l,1520156,1520481,325,EVM,mRNA,566256,1741125,325,1.00
ptg002829l,1956213,1956494,281,EVM,mRNA,1944447,3053818,281,1.00
ptg002829l,2286997,2287267,270,EVM,mRNA,1944447,3053818,270,1.00
ptg002829l,2692712,2693010,298,EVM,mRNA,1944447,3053818,298,1.00
ptg002829l,3593181,3593450,269,EVM,mRNA,3249797,3846311,269,1.00
ptg002831l,1166578,1166892,314,EVM,mRNA,449817,1483281,314,1.00
ptg002831l,2071973,2072257,284,EVM,mRNA,1948152,2131860,284,1.00
ptg002833l,1484890,1485202,312,EVM,mRNA,1405613,2611769,312,1.00
ptg002833l,2041337,2041638,301,EVM,mRNA,1405613,2611769,301,1.00
ptg002833l,3585462,3585790,328,EVM,mRNA,3494054,4144676,328,1.00
ptg002834l,1403722,1404034,312,EVM,mRNA,1233199,2805954,312,1.00
ptg002834l,1810491,1810791,300,EVM,mRNA,1233199,2805954,300,1.00
ptg002836l,346406,346676,270,EVM,mRNA,2098,826655,270,1.00
ptg002836l,2638072,2638338,266,EVM,mRNA,2078799,4152490,266,1.00
ptg002839l,2258503,2258825,322,EVM,mRNA,2132295,2823634,322,1.00
ptg002845l,1164457,1164759,302,EVM,mRNA,428729,1443725,302,1.00
ptg002848l,345057,345364,307,EVM,mRNA,203455,657661,307,1.00
ptg002848l,443375,443688,313,EVM,mRNA,203455,657661,313,1.00
ptg002851l,267352,267644,292,EVM,mRNA,90743,452612,292,1.00
ptg002852l,1952037,1952362,325,EVM,mRNA,1899070,3167491,325,1.00
ptg002852l,2381762,2382026,264,EVM,mRNA,1899070,3167491,264,1.00
ptg002852l,2474601,2474919,318,EVM,mRNA,1899070,3167491,318,1.00
ptg002852l,3166804,3167119,315,EVM,mRNA,1899070,3167491,315,1.00
ptg002856l,2259712,2260033,321,EVM,mRNA,1879784,2409110,321,1.00
ptg002858l,947795,948082,287,EVM,mRNA,831831,1074651,287,1.00
ptg002858l,1856220,1856505,285,EVM,mRNA,1781108,2240536,285,1.00
ptg002858l,1906480,1906785,305,EVM,mRNA,1781108,2240536,305,1.00
ptg002858l,3954819,3955100,281,EVM,mRNA,3920347,4256014,281,1.00
ptg002858l,3957187,3957482,295,EVM,mRNA,3920347,4256014,295,1.00
ptg002860l,1207935,1208235,300,EVM,mRNA,1122264,1251480,300,1.00
ptg002862l,1754973,1755287,314,EVM,mRNA,1245887,2301308,314,1.00
ptg002862l,4429540,4429828,288,EVM,mRNA,3914763,4566200,288,1.00
ptg002864l,677038,677361,323,EVM,mRNA,643807,784379,323,1.00
ptg002867l,1188754,1189062,308,EVM,mRNA,754083,2348055,308,1.00
ptg002871l,161944,162235,291,EVM,mRNA,35998,603010,291,1.00
ptg002871l,1677597,1677906,309,EVM,mRNA,814351,1903272,309,1.00
ptg002873l,38306,38590,284,EVM,mRNA,10301,97504,284,1.00
ptg002877l,1167737,1168042,305,EVM,mRNA,1109026,1223127,305,1.00
ptg002877l,1206318,1206624,306,EVM,mRNA,1109026,1223127,306,1.00
ptg002877l,2025234,2025543,309,EVM,mRNA,1663130,3627108,309,1.00
ptg002878l,236146,236448,302,EVM,mRNA,78548,467809,302,1.00
ptg002879l,1945683,1945972,289,EVM,mRNA,1182179,1996452,289,1.00
ptg002879l,2694237,2694511,274,EVM,mRNA,2277414,2874720,274,1.00
ptg002879l,2753415,2753697,282,EVM,mRNA,2277414,2874720,282,1.00
ptg002879l,2820948,2821252,304,EVM,mRNA,2277414,2874720,304,1.00
ptg002880l,269098,269384,286,EVM,mRNA,980,530567,286,1.00
ptg002880l,881543,881848,305,EVM,mRNA,780874,2645420,305,1.00
ptg002880l,1228252,1228559,307,EVM,mRNA,780874,2645420,307,1.00
ptg002880l,1817009,1817303,294,EVM,mRNA,780874,2645420,294,1.00
ptg002880l,3265545,3265865,320,EVM,mRNA,2657456,5108135,320,1.00
ptg002880l,3802180,3802502,322,EVM,mRNA,2657456,5108135,322,1.00
ptg002880l,4785153,4785427,274,EVM,mRNA,2657456,5108135,274,1.00
ptg002880l,4855105,4855411,306,EVM,mRNA,2657456,5108135,306,1.00
ptg002886l,462472,462791,319,EVM,mRNA,109352,1640636,319,1.00
ptg002888l,1071704,1072013,309,EVM,mRNA,1068610,1274284,309,1.00
ptg002889l,452106,452397,291,EVM,mRNA,16126,511565,291,1.00
ptg002890l,1081700,1082028,328,EVM,mRNA,608,4059706,328,1.00
ptg002890l,2782499,2782823,324,EVM,mRNA,608,4059706,324,1.00
ptg002890l,3276291,3276586,295,EVM,mRNA,608,4059706,295,1.00
ptg002890l,4080637,4080951,314,EVM,mRNA,4059906,4626429,314,1.00
ptg002894l,2002101,2002408,307,EVM,mRNA,1355303,2813393,307,1.00
ptg002894l,2092402,2092685,283,EVM,mRNA,1355303,2813393,283,1.00
ptg002894l,2406089,2406381,292,EVM,mRNA,1355303,2813393,292,1.00
ptg002903l,6605061,6605349,288,EVM,mRNA,4849384,8449242,288,1.00
ptg002906l,854344,854604,260,EVM,mRNA,46735,2453674,260,1.00
ptg002906l,1659877,1660186,309,EVM,mRNA,46735,2453674,309,1.00
ptg002908l,2180568,2180878,310,EVM,mRNA,2177979,4913691,310,1.00
ptg002908l,4077339,4077631,292,EVM,mRNA,2177979,4913691,292,1.00
ptg002909l,675695,676027,332,EVM,mRNA,670655,879975,332,1.00
ptg002913l,316398,316688,290,EVM,mRNA,28872,604792,290,1.00
ptg002914l,1556627,1556917,290,EVM,mRNA,1222918,1919416,290,1.00
ptg002915l,511161,511459,298,EVM,mRNA,426389,579162,298,1.00
ptg002916l,1848388,1848713,325,EVM,mRNA,1367142,2315465,325,1.00
ptg002916l,1889232,1889505,273,EVM,mRNA,1367142,2315465,273,1.00
ptg002916l,2233266,2233573,307,EVM,mRNA,1367142,2315465,307,1.00
ptg002918l,795153,795445,292,EVM,mRNA,713825,843392,292,1.00
ptg002920l,5571806,5572114,308,EVM,mRNA,3000671,6938327,308,1.00
ptg002925l,694067,694362,295,EVM,mRNA,681400,824789,295,1.00
ptg002926l,243767,244040,273,EVM,mRNA,8115,788692,273,1.00
ptg002926l,358784,359104,320,EVM,mRNA,8115,788692,320,1.00
ptg002926l,382493,382802,309,EVM,mRNA,8115,788692,309,1.00
ptg002927l,340561,340832,271,EVM,mRNA,230943,516114,271,1.00
ptg002927l,475546,475866,320,EVM,mRNA,230943,516114,320,1.00
ptg002928l,1316794,1317117,323,EVM,mRNA,1251275,1707106,323,1.00
ptg002931l,860849,861183,334,EVM,mRNA,847944,1081317,334,1.00
ptg002932l,345522,345831,309,EVM,mRNA,169313,509618,309,1.00
ptg002932l,2314225,2314475,250,EVM,mRNA,1390116,3569400,250,1.00
ptg002932l,2869368,2869693,325,EVM,mRNA,1390116,3569400,325,1.00
ptg002932l,3289525,3289809,284,EVM,mRNA,1390116,3569400,284,1.00
ptg002932l,5232132,5232407,275,EVM,mRNA,4533205,8623942,275,1.00
ptg002932l,5926120,5926407,287,EVM,mRNA,4533205,8623942,287,1.00
ptg002932l,6379859,6380143,284,EVM,mRNA,4533205,8623942,284,1.00
ptg002932l,6983562,6983872,310,EVM,mRNA,4533205,8623942,310,1.00
ptg002936l,578656,578949,293,EVM,mRNA,508640,1026673,293,1.00
ptg002937l,1029177,1029447,270,EVM,mRNA,769173,1274679,270,1.00
ptg002937l,1170206,1170539,333,EVM,mRNA,769173,1274679,333,1.00
ptg002937l,1192554,1192856,302,EVM,mRNA,769173,1274679,302,1.00
ptg002938l,78633,78931,298,EVM,mRNA,45939,396017,298,1.00
ptg002938l,2366589,2366877,288,EVM,mRNA,2137126,2553350,288,1.00
ptg002941l,1374077,1374391,314,EVM,mRNA,1167658,1375188,314,1.00
ptg002941l,2187032,2187319,287,EVM,mRNA,2017189,2188387,287,1.00
ptg002944l,77105,77408,303,EVM,mRNA,63633,2750341,303,1.00
ptg002944l,1149118,1149446,328,EVM,mRNA,63633,2750341,328,1.00
ptg002944l,1304869,1305179,310,EVM,mRNA,63633,2750341,310,1.00
ptg002944l,2485216,2485528,312,EVM,mRNA,63633,2750341,312,1.00
ptg002945l,489306,489604,298,EVM,mRNA,35038,494595,298,1.00
ptg002949l,44146,44473,327,EVM,mRNA,33662,960882,327,1.00
ptg002949l,851083,851400,317,EVM,mRNA,33662,960882,317,1.00
ptg002949l,1554478,1554772,294,EVM,mRNA,1467770,4012873,294,1.00
ptg002949l,1570933,1571229,296,EVM,mRNA,1467770,4012873,296,1.00
ptg002949l,2479387,2479702,315,EVM,mRNA,1467770,4012873,315,1.00
ptg002949l,2825951,2826249,298,EVM,mRNA,1467770,4012873,298,1.00
ptg002949l,3191746,3192038,292,EVM,mRNA,1467770,4012873,292,1.00
ptg002949l,3498045,3498361,316,EVM,mRNA,1467770,4012873,316,1.00
ptg002949l,3561377,3561693,316,EVM,mRNA,1467770,4012873,316,1.00
ptg002951l,860432,860751,319,EVM,mRNA,492673,1132040,319,1.00
ptg002953l,1075610,1075943,333,EVM,mRNA,544415,1219228,333,1.00
ptg002954l,20868,21164,296,EVM,mRNA,3455,2215164,296,1.00
ptg002954l,416329,416628,299,EVM,mRNA,3455,2215164,299,1.00
ptg002954l,784716,785015,299,EVM,mRNA,3455,2215164,299,1.00
ptg002954l,1388124,1388434,310,EVM,mRNA,3455,2215164,310,1.00
ptg002954l,1410467,1410755,288,EVM,mRNA,3455,2215164,288,1.00
ptg002957l,420980,421305,325,EVM,mRNA,397749,666740,325,1.00
ptg002959l,1094111,1094413,302,EVM,mRNA,834349,2103732,302,1.00
ptg002959l,1118159,1118457,298,EVM,mRNA,834349,2103732,298,1.00
ptg002959l,1322740,1323047,307,EVM,mRNA,834349,2103732,307,1.00
ptg002959l,1588508,1588805,297,EVM,mRNA,834349,2103732,297,1.00
ptg002964l,802494,802795,301,EVM,mRNA,774759,825073,301,1.00
ptg002965l,1263351,1263667,316,EVM,mRNA,344798,1294912,316,1.00
ptg002967l,303025,303321,296,EVM,mRNA,226390,804102,296,1.00
ptg002968l,1536147,1536431,284,EVM,mRNA,1176663,2199746,284,1.00
ptg002976l,535484,535772,288,EVM,mRNA,351619,1763409,288,1.00
ptg002976l,1396946,1397262,316,EVM,mRNA,351619,1763409,316,1.00
ptg002976l,2147564,2147842,278,EVM,mRNA,1996305,2419388,278,1.00
ptg002977l,266600,266881,281,EVM,mRNA,13464,497583,281,1.00
ptg002978l,2381941,2382239,298,EVM,mRNA,2331766,2684400,298,1.00
ptg002978l,2391465,2391742,277,EVM,mRNA,2331766,2684400,277,1.00
ptg002978l,2795583,2795910,327,EVM,mRNA,2686659,3121055,327,1.00
ptg002978l,2866371,2866684,313,EVM,mRNA,2686659,3121055,313,1.00
ptg002980l,349901,350222,321,EVM,mRNA,320217,859851,321,1.00
ptg002981l,1697221,1697510,289,EVM,mRNA,1529899,4208719,289,1.00
ptg002981l,2029439,2029731,292,EVM,mRNA,1529899,4208719,292,1.00
ptg002981l,3079642,3079955,313,EVM,mRNA,1529899,4208719,313,1.00
ptg002981l,3510969,3511277,308,EVM,mRNA,1529899,4208719,308,1.00
ptg002981l,4398502,4398812,310,EVM,mRNA,4365340,4446199,310,1.00
ptg002982l,1499141,1499433,292,EVM,mRNA,303429,1899958,292,1.00
ptg002990l,4055546,4055866,320,EVM,mRNA,2827800,4095588,320,1.00
ptg002991l,417469,417778,309,EVM,mRNA,22299,2737167,309,1.00
ptg002991l,600282,600581,299,EVM,mRNA,22299,2737167,299,1.00
ptg002991l,1034991,1035276,285,EVM,mRNA,22299,2737167,285,1.00
ptg002991l,1208953,1209229,276,EVM,mRNA,22299,2737167,276,1.00
ptg002991l,1455692,1455997,305,EVM,mRNA,22299,2737167,305,1.00
ptg002991l,2022003,2022274,271,EVM,mRNA,22299,2737167,271,1.00
ptg002991l,2116700,2116982,282,EVM,mRNA,22299,2737167,282,1.00
ptg002991l,2215477,2215790,313,EVM,mRNA,22299,2737167,313,1.00
ptg002992l,551273,551601,328,EVM,mRNA,538908,621485,328,1.00
ptg002994l,161453,161745,292,EVM,mRNA,6860,442196,292,1.00
ptg002994l,437655,437985,330,EVM,mRNA,6860,442196,330,1.00
ptg002995l,882222,882516,294,EVM,mRNA,876581,906277,294,1.00
ptg002996l,1417496,1417820,324,EVM,mRNA,993418,1711529,324,1.00
ptg002996l,3059907,3060225,318,EVM,mRNA,3004066,3395162,318,1.00
ptg002996l,3256233,3256548,315,EVM,mRNA,3004066,3395162,315,1.00
ptg002997l,713317,713637,320,EVM,mRNA,75771,723680,320,1.00
ptg002997l,1794728,1795006,278,EVM,mRNA,1648235,2197839,278,1.00
ptg002999l,867443,867761,318,EVM,mRNA,807779,1739889,318,1.00
ptg002999l,1008494,1008815,321,EVM,mRNA,807779,1739889,321,1.00
ptg002999l,1032790,1033088,298,EVM,mRNA,807779,1739889,298,1.00
ptg002999l,1168431,1168736,305,EVM,mRNA,807779,1739889,305,1.00
ptg003000l,1254407,1254730,323,EVM,mRNA,723804,1291058,323,1.00
ptg003000l,1289106,1289434,328,EVM,mRNA,723804,1291058,328,1.00
ptg003001l,1338369,1338694,325,EVM,mRNA,434354,1930309,325,1.00
ptg003006l,224604,224894,290,EVM,mRNA,83674,2311165,290,1.00
ptg003006l,272946,273260,314,EVM,mRNA,83674,2311165,314,1.00
ptg003006l,591014,591331,317,EVM,mRNA,83674,2311165,317,1.00
ptg003006l,871394,871678,284,EVM,mRNA,83674,2311165,284,1.00
ptg003006l,1017086,1017391,305,EVM,mRNA,83674,2311165,305,1.00
ptg003006l,1770329,1770656,327,EVM,mRNA,83674,2311165,327,1.00
ptg003006l,2074211,2074512,301,EVM,mRNA,83674,2311165,301,1.00
ptg003006l,2129131,2129445,314,EVM,mRNA,83674,2311165,314,1.00
ptg003015l,1184951,1185234,283,EVM,mRNA,260574,1998065,283,1.00
ptg003015l,1855866,1856184,318,EVM,mRNA,260574,1998065,318,1.00
ptg003015l,1887454,1887742,288,EVM,mRNA,260574,1998065,288,1.00
ptg003015l,1976603,1976918,315,EVM,mRNA,260574,1998065,315,1.00
ptg003016l,1581601,1581913,312,EVM,mRNA,1073851,1741383,312,1.00
ptg003024l,1879152,1879455,303,EVM,mRNA,1609672,2922223,303,1.00
ptg003025l,250610,250909,299,EVM,mRNA,172048,404207,299,1.00
ptg003025l,320877,321168,291,EVM,mRNA,172048,404207,291,1.00
ptg003029l,954485,954796,311,EVM,mRNA,159950,1042237,311,1.00
ptg003029l,1705380,1705684,304,EVM,mRNA,1474759,2616541,304,1.00
ptg003036l,965569,965887,318,EVM,mRNA,805367,1102297,318,1.00
ptg003045l,1094285,1094582,297,EVM,mRNA,1058481,1119873,297,1.00
ptg003047l,110028,110333,305,EVM,mRNA,15957,310093,305,1.00
ptg003047l,1931578,1931887,309,EVM,mRNA,1169704,2569033,309,1.00
ptg003047l,2359183,2359480,297,EVM,mRNA,1169704,2569033,297,1.00
ptg003049l,759400,759715,315,EVM,mRNA,502092,2038477,315,1.00
ptg003050l,639144,639419,275,EVM,mRNA,615343,967136,275,1.00
ptg003050l,1897304,1897599,295,EVM,mRNA,1843432,2998531,295,1.00
ptg003050l,2244742,2245035,293,EVM,mRNA,1843432,2998531,293,1.00
ptg003050l,2262351,2262650,299,EVM,mRNA,1843432,2998531,299,1.00
ptg003050l,2742633,2742931,298,EVM,mRNA,1843432,2998531,298,1.00
ptg003050l,2781645,2781944,299,EVM,mRNA,1843432,2998531,299,1.00
ptg003050l,2971839,2972138,299,EVM,mRNA,1843432,2998531,299,1.00
ptg003051l,1040282,1040569,287,EVM,mRNA,922149,2467843,287,1.00
ptg003051l,1308687,1308981,294,EVM,mRNA,922149,2467843,294,1.00
ptg003051l,5401594,5401911,317,EVM,mRNA,5282914,5837652,317,1.00
ptg003052l,210700,211017,317,EVM,mRNA,4544,799141,317,1.00
ptg003053l,124757,125070,313,EVM,mRNA,8521,149057,313,1.00
ptg003056l,193121,193405,284,EVM,mRNA,31115,550464,284,1.00
ptg003058l,868255,868552,297,EVM,mRNA,229850,1550984,297,1.00
ptg003061l,800013,800307,294,EVM,mRNA,502665,2288333,294,1.00
ptg003061l,805905,806199,294,EVM,mRNA,502665,2288333,294,1.00
ptg003061l,866201,866481,280,EVM,mRNA,502665,2288333,280,1.00
ptg003061l,2063114,2063425,311,EVM,mRNA,502665,2288333,311,1.00
ptg003061l,3707439,3707727,288,EVM,mRNA,2361139,4418137,288,1.00
ptg003061l,4304659,4304942,283,EVM,mRNA,2361139,4418137,283,1.00
ptg003062l,118210,118502,292,EVM,mRNA,90691,254788,292,1.00
ptg003064l,2135786,2136109,323,EVM,mRNA,1776954,2702653,323,1.00
ptg003065l,159529,159857,328,EVM,mRNA,26054,269304,328,1.00
ptg003068l,359707,360016,309,EVM,mRNA,34015,1327688,309,1.00
ptg003069l,2950717,2951015,298,EVM,mRNA,2156982,4314823,298,1.00
ptg003069l,4052199,4052495,296,EVM,mRNA,2156982,4314823,296,1.00
ptg003069l,4821675,4821968,293,EVM,mRNA,4819120,4831689,293,1.00
ptg003074l,2859427,2859738,311,EVM,mRNA,2799404,3213165,311,1.00
ptg003074l,3439425,3439700,275,EVM,mRNA,3423482,3767265,275,1.00
ptg003074l,4199085,4199382,297,EVM,mRNA,4072348,5576546,297,1.00
ptg003075l,2671797,2672078,281,EVM,mRNA,1729347,2859338,281,1.00
ptg003076l,255184,255484,300,EVM,mRNA,239559,329680,300,1.00
ptg003078l,322959,323260,301,EVM,mRNA,106581,384713,301,1.00
ptg003078l,742171,742481,310,EVM,mRNA,527552,1144218,310,1.00
ptg003078l,1018362,1018658,296,EVM,mRNA,527552,1144218,296,1.00
ptg003080l,4442685,4442976,291,EVM,mRNA,4305798,5213877,291,1.00
ptg003080l,4675617,4675922,305,EVM,mRNA,4305798,5213877,305,1.00
ptg003081l,1233974,1234268,294,EVM,mRNA,499209,2073285,294,1.00
ptg003081l,4451206,4451473,267,EVM,mRNA,3256606,4791093,267,1.00
ptg003081l,5162878,5163198,320,EVM,mRNA,5097813,5221197,320,1.00
ptg003083l,912254,912540,286,EVM,mRNA,899150,2638026,286,1.00
ptg003084l,1146078,1146399,321,EVM,mRNA,675716,1394242,321,1.00
ptg003088l,3585601,3585884,283,EVM,mRNA,3302307,3944471,283,1.00
ptg003090l,1311991,1312281,290,EVM,mRNA,1093808,1453094,290,1.00
ptg003090l,1424416,1424706,290,EVM,mRNA,1093808,1453094,290,1.00
ptg003091l,1106126,1106460,334,EVM,mRNA,929289,1113983,334,1.00
ptg003093l,103483,103812,329,EVM,mRNA,66984,198860,329,1.00
ptg003098l,1445679,1446000,321,EVM,mRNA,1154935,1604677,321,1.00
ptg003098l,3767214,3767527,313,EVM,mRNA,2156771,4725030,313,1.00
ptg003099l,898377,898704,327,EVM,mRNA,894507,2072483,327,1.00
ptg003099l,1515394,1515717,323,EVM,mRNA,894507,2072483,323,1.00
ptg003102l,2020199,2020509,310,EVM,mRNA,1636509,2234073,310,1.00
ptg003103l,142412,142716,304,EVM,mRNA,3758,346958,304,1.00
ptg003104l,618629,618897,268,EVM,mRNA,393841,746411,268,1.00
ptg003106l,339234,339549,315,EVM,mRNA,70,708219,315,1.00
ptg003106l,405698,406030,332,EVM,mRNA,70,708219,332,1.00
ptg003106l,1600946,1601254,308,EVM,mRNA,1468916,2031559,308,1.00
ptg003106l,1767986,1768298,312,EVM,mRNA,1468916,2031559,312,1.00
ptg003106l,1895424,1895750,326,EVM,mRNA,1468916,2031559,326,1.00
ptg003107l,178764,179076,312,EVM,mRNA,72839,268737,312,1.00
ptg003114l,101076,101386,310,EVM,mRNA,1720,106435,310,1.00
ptg003114l,456594,456891,297,EVM,mRNA,445874,606919,297,1.00
ptg003115l,1624062,1624359,297,EVM,mRNA,808329,3425527,297,1.00
ptg003115l,1681405,1681669,264,EVM,mRNA,808329,3425527,264,1.00
ptg003115l,2227484,2227794,310,EVM,mRNA,808329,3425527,310,1.00
ptg003115l,2278383,2278667,284,EVM,mRNA,808329,3425527,284,1.00
ptg003115l,2504494,2504814,320,EVM,mRNA,808329,3425527,320,1.00
ptg003115l,2689598,2689923,325,EVM,mRNA,808329,3425527,325,1.00
ptg003115l,2842886,2843212,326,EVM,mRNA,808329,3425527,326,1.00
ptg003115l,3183553,3183854,301,EVM,mRNA,808329,3425527,301,1.00
ptg003118l,1350119,1350448,329,EVM,mRNA,295827,1555649,329,1.00
ptg003118l,2982526,2982826,300,EVM,mRNA,2877640,4135746,300,1.00
ptg003119l,566167,566481,314,EVM,mRNA,508818,1074704,314,1.00
ptg003120l,303865,304171,306,EVM,mRNA,41490,1189539,306,1.00
ptg003121l,2005130,2005426,296,EVM,mRNA,1539898,2293409,296,1.00
ptg003121l,2043770,2044069,299,EVM,mRNA,1539898,2293409,299,1.00
ptg003122l,500483,500815,332,EVM,mRNA,377060,544123,332,1.00
ptg003124l,4260485,4260772,287,EVM,mRNA,3322145,5623219,287,1.00
ptg003124l,4365299,4365601,302,EVM,mRNA,3322145,5623219,302,1.00
ptg003125l,316101,316371,270,EVM,mRNA,78638,1605497,270,1.00
ptg003125l,747190,747497,307,EVM,mRNA,78638,1605497,307,1.00
ptg003125l,1034088,1034364,276,EVM,mRNA,78638,1605497,276,1.00
ptg003125l,3235310,3235624,314,EVM,mRNA,3032935,3368279,314,1.00
ptg003126l,1243320,1243604,284,EVM,mRNA,191024,1360227,284,1.00
ptg003126l,1727933,1728197,264,EVM,mRNA,1456815,1974669,264,1.00
ptg003134l,3787393,3787652,259,EVM,mRNA,3737658,3976048,259,1.00
ptg003134l,3962061,3962356,295,EVM,mRNA,3737658,3976048,295,1.00
ptg003135l,210786,211095,309,EVM,mRNA,13727,1558910,309,1.00
ptg003135l,531192,531491,299,EVM,mRNA,13727,1558910,299,1.00
ptg003136l,1911372,1911707,335,EVM,mRNA,1877573,3982724,335,1.00
ptg003136l,4719146,4719434,288,EVM,mRNA,4373567,5566762,288,1.00
ptg003137l,2713489,2713812,323,EVM,mRNA,2415411,2730687,323,1.00
ptg003139l,74484,74797,313,EVM,mRNA,2387,126749,313,1.00
ptg003140l,2320875,2321185,310,EVM,mRNA,899699,3179196,310,1.00
ptg003140l,2616137,2616486,349,EVM,mRNA,899699,3179196,349,1.00
ptg003140l,2927566,2927869,303,EVM,mRNA,899699,3179196,303,1.00
ptg003140l,3158292,3158562,270,EVM,mRNA,899699,3179196,270,1.00
ptg003142l,359422,359708,286,EVM,mRNA,123750,915595,286,1.00
ptg003142l,699757,700054,297,EVM,mRNA,123750,915595,297,1.00
ptg003143l,319854,320158,304,EVM,mRNA,8631,491435,304,1.00
ptg003143l,3942088,3942376,288,EVM,mRNA,3805576,4090926,288,1.00
ptg003145l,501580,501874,294,EVM,mRNA,496996,696385,294,1.00
ptg003145l,2106922,2107202,280,EVM,mRNA,783907,2178859,280,1.00
ptg003145l,2803524,2803823,299,EVM,mRNA,2565469,3909200,299,1.00
ptg003145l,2853877,2854202,325,EVM,mRNA,2565469,3909200,325,1.00
ptg003145l,3079973,3080215,242,EVM,mRNA,2565469,3909200,242,1.00
ptg003145l,3731393,3731710,317,EVM,mRNA,2565469,3909200,317,1.00
ptg003146l,924504,924833,329,EVM,mRNA,323408,1933850,329,1.00
ptg003147l,395277,395580,303,EVM,mRNA,9776,414898,303,1.00
ptg003147l,1192738,1193035,297,EVM,mRNA,987297,2721045,297,1.00
ptg003147l,4230410,4230680,270,EVM,mRNA,4046981,5965489,270,1.00
ptg003147l,4732110,4732434,324,EVM,mRNA,4046981,5965489,324,1.00
ptg003147l,5829510,5829824,314,EVM,mRNA,4046981,5965489,314,1.00
ptg003151l,311268,311566,298,EVM,mRNA,186112,332585,298,1.00
ptg003153l,489006,489330,324,EVM,mRNA,210922,686554,324,1.00
ptg003155l,957530,957832,302,EVM,mRNA,512116,1122293,302,1.00
ptg003156l,379995,380294,299,EVM,mRNA,175104,1820790,299,1.00
ptg003156l,702567,702866,299,EVM,mRNA,175104,1820790,299,1.00
ptg003156l,3293439,3293755,316,EVM,mRNA,3043475,5166948,316,1.00
ptg003156l,3921105,3921431,326,EVM,mRNA,3043475,5166948,326,1.00
ptg003156l,4070245,4070560,315,EVM,mRNA,3043475,5166948,315,1.00
ptg003156l,4708260,4708528,268,EVM,mRNA,3043475,5166948,268,1.00
ptg003156l,4985505,4985815,310,EVM,mRNA,3043475,5166948,310,1.00
ptg003158l,588310,588624,314,EVM,mRNA,466441,665779,314,1.00
ptg003159l,585315,585622,307,EVM,mRNA,204,1683921,307,1.00
ptg003159l,702397,702728,331,EVM,mRNA,204,1683921,331,1.00
ptg003159l,889809,890105,296,EVM,mRNA,204,1683921,296,1.00
ptg003159l,1680270,1680567,297,EVM,mRNA,204,1683921,297,1.00
ptg003162l,2294726,2295027,301,EVM,mRNA,1912310,3222480,301,1.00
ptg003162l,2570828,2571140,312,EVM,mRNA,1912310,3222480,312,1.00
ptg003162l,2849647,2849968,321,EVM,mRNA,1912310,3222480,321,1.00
ptg003162l,2967908,2968224,316,EVM,mRNA,1912310,3222480,316,1.00
ptg003164l,888180,888467,287,EVM,mRNA,262396,1921710,287,1.00
ptg003164l,1298350,1298633,283,EVM,mRNA,262396,1921710,283,1.00
ptg003169l,1920039,1920356,317,EVM,mRNA,1877099,2009035,317,1.00
ptg003171l,1448629,1448930,301,EVM,mRNA,1226834,2875905,301,1.00
ptg003171l,2717130,2717446,316,EVM,mRNA,1226834,2875905,316,1.00
ptg003173l,867649,867962,313,EVM,mRNA,108340,1408083,313,1.00
ptg003173l,1183488,1183770,282,EVM,mRNA,108340,1408083,282,1.00
ptg003173l,1190951,1191234,283,EVM,mRNA,108340,1408083,283,1.00
ptg003173l,1370357,1370662,305,EVM,mRNA,108340,1408083,305,1.00
ptg003174l,599373,599675,302,EVM,mRNA,89708,802916,302,1.00
ptg003175l,749572,749861,289,EVM,mRNA,168976,1415513,289,1.00
ptg003175l,1175637,1175947,310,EVM,mRNA,168976,1415513,310,1.00
ptg003176l,2257056,2257341,285,EVM,mRNA,2044283,2497184,285,1.00
ptg003176l,2779297,2779614,317,EVM,mRNA,2554006,2819091,317,1.00
ptg003181l,45242,45530,288,EVM,mRNA,201,268950,288,1.00
ptg003186l,570733,571043,310,EVM,mRNA,316096,1143398,310,1.00
ptg003186l,2375997,2376283,286,EVM,mRNA,2352696,2543305,286,1.00
ptg003187l,3715216,3715520,304,EVM,mRNA,3554041,3842472,304,1.00
ptg003193l,247612,247930,318,EVM,mRNA,207002,294461,318,1.00
ptg003194l,1633346,1633659,313,EVM,mRNA,1526172,3200488,313,1.00
ptg003197l,1421408,1421722,314,EVM,mRNA,1209874,1573451,314,1.00
ptg003198l,537093,537419,326,EVM,mRNA,510611,758152,326,1.00
ptg003198l,872224,872537,313,EVM,mRNA,845339,1242519,313,1.00
ptg003199l,661039,661321,282,EVM,mRNA,585259,1661312,282,1.00
ptg003200l,808229,808542,313,EVM,mRNA,584995,1151739,313,1.00
ptg003202l,2311292,2311614,322,EVM,mRNA,1990569,2335239,322,1.00
ptg003202l,3169486,3169792,306,EVM,mRNA,2973170,4866433,306,1.00
ptg003202l,4321797,4322098,301,EVM,mRNA,2973170,4866433,301,1.00
ptg003203l,423691,424004,313,EVM,mRNA,38522,848245,313,1.00
ptg003204l,95454,95752,298,EVM,mRNA,8474,443124,298,1.00
ptg003204l,723931,724254,323,EVM,mRNA,499089,1649308,323,1.00
ptg003204l,1202368,1202649,281,EVM,mRNA,499089,1649308,281,1.00
ptg003204l,1209533,1209842,309,EVM,mRNA,499089,1649308,309,1.00
ptg003207l,2750072,2750361,289,EVM,mRNA,1948269,3071140,289,1.00
ptg003209l,1393199,1393513,314,EVM,mRNA,881243,1412574,314,1.00
ptg003211l,1714104,1714377,273,EVM,mRNA,1713981,1761999,273,1.00
ptg003214l,299149,299468,319,EVM,mRNA,19294,774247,319,1.00
ptg003214l,505777,506059,282,EVM,mRNA,19294,774247,282,1.00
ptg003215l,1239519,1239818,299,EVM,mRNA,494995,3567641,299,1.00
ptg003215l,1531943,1532238,295,EVM,mRNA,494995,3567641,295,1.00
ptg003215l,1549048,1549337,289,EVM,mRNA,494995,3567641,289,1.00
ptg003215l,1708688,1708991,303,EVM,mRNA,494995,3567641,303,1.00
ptg003215l,3232355,3232654,299,EVM,mRNA,494995,3567641,299,1.00
ptg003215l,4249554,4249829,275,EVM,mRNA,3897126,4569947,275,1.00
ptg003215l,4259436,4259760,324,EVM,mRNA,3897126,4569947,324,1.00
ptg003215l,4697278,4697566,288,EVM,mRNA,4651836,4757115,288,1.00
ptg003216l,381920,382204,284,EVM,mRNA,360886,782282,284,1.00
ptg003216l,421741,422017,276,EVM,mRNA,360886,782282,276,1.00
ptg003216l,611931,612266,335,EVM,mRNA,360886,782282,335,1.00
ptg003217l,621086,621382,296,EVM,mRNA,335912,3250493,296,1.00
ptg003217l,943846,944131,285,EVM,mRNA,335912,3250493,285,1.00
ptg003217l,2224453,2224771,318,EVM,mRNA,335912,3250493,318,1.00
ptg003217l,2234582,2234890,308,EVM,mRNA,335912,3250493,308,1.00
ptg003217l,3055451,3055766,315,EVM,mRNA,335912,3250493,315,1.00
ptg003218l,391554,391843,289,EVM,mRNA,18955,1070928,289,1.00
ptg003219l,2605318,2605610,292,EVM,mRNA,2523964,3480111,292,1.00
ptg003219l,3229135,3229451,316,EVM,mRNA,2523964,3480111,316,1.00
ptg003221l,788185,788478,293,EVM,mRNA,407751,1060865,293,1.00
ptg003225l,28025,28338,313,EVM,mRNA,1828,1719440,313,1.00
ptg003225l,322305,322589,284,EVM,mRNA,1828,1719440,284,1.00
ptg003228l,1959232,1959534,302,EVM,mRNA,1958936,2421929,302,1.00
ptg003230l,2761190,2761506,316,EVM,mRNA,2028563,3233261,316,1.00
ptg003230l,5758101,5758397,296,EVM,mRNA,4971641,5768327,296,1.00
ptg003232l,2093809,2094122,313,EVM,mRNA,90697,2496347,313,1.00
ptg003232l,3758305,3758631,326,EVM,mRNA,3692975,3829437,326,1.00
ptg003232l,4464504,4464838,334,EVM,mRNA,3899189,5061769,334,1.00
ptg003236l,1251457,1251743,286,EVM,mRNA,1105631,1356767,286,1.00
ptg003236l,1790015,1790318,303,EVM,mRNA,1482278,1828098,303,1.00
ptg003236l,2799778,2800088,310,EVM,mRNA,2741918,3180404,310,1.00
ptg003236l,2851819,2852146,327,EVM,mRNA,2741918,3180404,327,1.00
ptg003236l,3022253,3022562,309,EVM,mRNA,2741918,3180404,309,1.00
ptg003236l,3360099,3360389,290,EVM,mRNA,3229420,4980000,290,1.00
ptg003236l,4016463,4016787,324,EVM,mRNA,3229420,4980000,324,1.00
ptg003236l,4173089,4173378,289,EVM,mRNA,3229420,4980000,289,1.00
ptg003236l,4870272,4870587,315,EVM,mRNA,3229420,4980000,315,1.00
ptg003238l,1946587,1946869,282,EVM,mRNA,968290,3052305,282,1.00
ptg003238l,3014541,3014836,295,EVM,mRNA,968290,3052305,295,1.00
ptg003240l,287406,287708,302,EVM,mRNA,63475,811928,302,1.00
ptg003240l,754598,754915,317,EVM,mRNA,63475,811928,317,1.00
ptg003245l,1023515,1023833,318,EVM,mRNA,675129,1076594,318,1.00
ptg003245l,1472361,1472689,328,EVM,mRNA,1163389,2283846,328,1.00
ptg003245l,2008287,2008583,296,EVM,mRNA,1163389,2283846,296,1.00
ptg003245l,2171424,2171720,296,EVM,mRNA,1163389,2283846,296,1.00
ptg003245l,2950102,2950388,286,EVM,mRNA,2437452,3315008,286,1.00
ptg003245l,3178752,3179051,299,EVM,mRNA,2437452,3315008,299,1.00
ptg003245l,5850520,5850829,309,EVM,mRNA,5537295,5855464,309,1.00
ptg003245l,6005563,6005834,271,EVM,mRNA,5900141,6065794,271,1.00
ptg003247l,783964,784234,270,EVM,mRNA,742021,907618,270,1.00
ptg003247l,1179016,1179316,300,EVM,mRNA,1132444,1247082,300,1.00
ptg003252l,390007,390307,300,EVM,mRNA,28170,480200,300,1.00
ptg003252l,396041,396341,300,EVM,mRNA,28170,480200,300,1.00
ptg003254l,607749,608022,273,EVM,mRNA,558889,1571687,273,1.00
ptg003254l,888815,889144,329,EVM,mRNA,558889,1571687,329,1.00
ptg003254l,990215,990496,281,EVM,mRNA,558889,1571687,281,1.00
ptg003255l,53278,53575,297,EVM,mRNA,7623,785764,297,1.00
ptg003255l,1366188,1366487,299,EVM,mRNA,1172883,1527943,299,1.00
ptg003261l,2119036,2119335,299,EVM,mRNA,241150,2933825,299,1.00
ptg003261l,3555232,3555558,326,EVM,mRNA,3067201,3863674,326,1.00
ptg003264l,5300909,5301219,310,EVM,mRNA,4589305,5491079,310,1.00
ptg003264l,5471901,5472198,297,EVM,mRNA,4589305,5491079,297,1.00
ptg003264l,6320113,6320414,301,EVM,mRNA,5815320,6509184,301,1.00
ptg003265l,2716439,2716743,304,EVM,mRNA,2650564,3302999,304,1.00
ptg003266l,860317,860598,281,EVM,mRNA,90450,1219912,281,1.00
ptg003268l,1805849,1806173,324,EVM,mRNA,1698287,2173305,324,1.00
ptg003268l,3769826,3770158,332,EVM,mRNA,3346582,3811902,332,1.00
ptg003268l,4292879,4293178,299,EVM,mRNA,4256727,5484955,299,1.00
ptg003268l,4389765,4390045,280,EVM,mRNA,4256727,5484955,280,1.00
ptg003271l,438339,438652,313,EVM,mRNA,373824,2024978,313,1.00
ptg003276l,54690,54995,305,EVM,mRNA,2519,462155,305,1.00
ptg003276l,2827247,2827512,265,EVM,mRNA,2826874,2881398,265,1.00
ptg003280l,2601052,2601325,273,EVM,mRNA,956997,3363203,273,1.00
ptg003280l,3345757,3346081,324,EVM,mRNA,956997,3363203,324,1.00
ptg003283l,359669,359951,282,EVM,mRNA,51475,853471,282,1.00
ptg003283l,6031725,6032019,294,EVM,mRNA,6006867,6260868,294,1.00
ptg003283l,6162587,6162911,324,EVM,mRNA,6006867,6260868,324,1.00
ptg003283l,6326472,6326797,325,EVM,mRNA,6270491,6340989,325,1.00
ptg003286l,906901,907181,280,EVM,mRNA,893768,925493,280,1.00
ptg003286l,914063,914343,280,EVM,mRNA,893768,925493,280,1.00
ptg003289l,266649,266976,327,EVM,mRNA,197183,516278,327,1.00
ptg003290l,3524513,3524847,334,EVM,mRNA,3000291,3889640,334,1.00
ptg003290l,5019504,5019787,283,EVM,mRNA,4711229,6190413,283,1.00
ptg003290l,5056118,5056390,272,EVM,mRNA,4711229,6190413,272,1.00
ptg003290l,5879345,5879628,283,EVM,mRNA,4711229,6190413,283,1.00
ptg003291l,435324,435608,284,EVM,mRNA,284348,466577,284,1.00
ptg003291l,925167,925484,317,EVM,mRNA,921315,1857930,317,1.00
ptg003291l,1337145,1337465,320,EVM,mRNA,921315,1857930,320,1.00
ptg003291l,1611921,1612209,288,EVM,mRNA,921315,1857930,288,1.00
ptg003291l,1698052,1698366,314,EVM,mRNA,921315,1857930,314,1.00
ptg003291l,3356019,3356332,313,EVM,mRNA,2350553,3470430,313,1.00
ptg003294l,3012637,3012941,304,EVM,mRNA,1466627,3355468,304,1.00
ptg003297l,620926,621226,300,EVM,mRNA,477872,1080629,300,1.00
ptg003300l,446101,446391,290,EVM,mRNA,10691,1165625,290,1.00
ptg003308l,343564,343885,321,EVM,mRNA,59261,364213,321,1.00
ptg003309l,739807,740087,280,EVM,mRNA,38920,1524119,280,1.00
ptg003310l,1512660,1512935,275,EVM,mRNA,1211896,1795340,275,1.00
ptg003311l,633601,633917,316,EVM,mRNA,156490,1091217,316,1.00
ptg003311l,709009,709308,299,EVM,mRNA,156490,1091217,299,1.00
ptg003311l,2057638,2057937,299,EVM,mRNA,1649836,3835508,299,1.00
ptg003311l,3399112,3399414,302,EVM,mRNA,1649836,3835508,302,1.00
ptg003312l,2052323,2052602,279,EVM,mRNA,1990882,2612500,279,1.00
ptg003312l,4356797,4357120,323,EVM,mRNA,4229609,4764829,323,1.00
ptg003312l,4719700,4719981,281,EVM,mRNA,4229609,4764829,281,1.00
ptg003312l,5817217,5817541,324,EVM,mRNA,5392587,6059366,324,1.00
ptg003312l,7623115,7623423,308,EVM,mRNA,7507171,7671951,308,1.00
ptg003312l,8618260,8618518,258,EVM,mRNA,8598812,8850343,258,1.00
ptg003312l,9215544,9215856,312,EVM,mRNA,9119322,9257253,312,1.00
ptg003314l,312268,312556,288,EVM,mRNA,27340,753024,288,1.00
ptg003314l,324530,324811,281,EVM,mRNA,27340,753024,281,1.00
ptg003315l,808325,808611,286,EVM,mRNA,402195,3039399,286,1.00
ptg003315l,1748073,1748378,305,EVM,mRNA,402195,3039399,305,1.00
ptg003317l,3112404,3112691,287,EVM,mRNA,2631746,4330305,287,1.00
ptg003317l,3151476,3151751,275,EVM,mRNA,2631746,4330305,275,1.00
ptg003317l,3545700,3546004,304,EVM,mRNA,2631746,4330305,304,1.00
ptg003317l,4197486,4197804,318,EVM,mRNA,2631746,4330305,318,1.00
ptg003319l,1420786,1421117,331,EVM,mRNA,916512,1570731,331,1.00
ptg003321l,515916,516210,294,EVM,mRNA,377585,1072580,294,1.00
ptg003321l,3395686,3396013,327,EVM,mRNA,3345329,3572808,327,1.00
ptg003321l,3423691,3423983,292,EVM,mRNA,3345329,3572808,292,1.00
ptg003321l,3496025,3496357,332,EVM,mRNA,3345329,3572808,332,1.00
ptg003323l,467027,467353,326,EVM,mRNA,401075,856414,326,1.00
ptg003324l,1098539,1098828,289,EVM,mRNA,1022757,1261609,289,1.00
ptg003324l,1369542,1369861,319,EVM,mRNA,1300944,1617400,319,1.00
ptg003325l,527114,527398,284,EVM,mRNA,227828,669715,284,1.00
ptg003325l,894746,895028,282,EVM,mRNA,770032,1144037,282,1.00
ptg003325l,1852151,1852475,324,EVM,mRNA,1554766,2212552,324,1.00
ptg003326l,369139,369455,316,EVM,mRNA,2687,625674,316,1.00
ptg003329l,1757895,1758207,312,EVM,mRNA,37708,3112473,312,1.00
ptg003329l,2370521,2370813,292,EVM,mRNA,37708,3112473,292,1.00
ptg003329l,2480369,2480657,288,EVM,mRNA,37708,3112473,288,1.00
ptg003329l,2768467,2768766,299,EVM,mRNA,37708,3112473,299,1.00
ptg003343l,516520,516784,264,EVM,mRNA,508359,516947,264,1.00
ptg003349l,1488046,1488360,314,EVM,mRNA,1336114,1508559,314,1.00
ptg003349l,3111698,3112017,319,EVM,mRNA,3060031,3158110,319,1.00
ptg003351l,1911759,1912080,321,EVM,mRNA,1810918,4560651,321,1.00
ptg003351l,2282219,2282523,304,EVM,mRNA,1810918,4560651,304,1.00
ptg003351l,2889096,2889402,306,EVM,mRNA,1810918,4560651,306,1.00
ptg003352l,2137564,2137851,287,EVM,mRNA,2019406,2169571,287,1.00
ptg003353l,129467,129756,289,EVM,mRNA,69264,231562,289,1.00
ptg003354l,956318,956588,270,EVM,mRNA,861366,961295,270,1.00
ptg003355l,1809671,1809983,312,EVM,mRNA,1555885,2474620,312,1.00
ptg003355l,1882631,1882946,315,EVM,mRNA,1555885,2474620,315,1.00
ptg003355l,2411237,2411535,298,EVM,mRNA,1555885,2474620,298,1.00
ptg003364l,731073,731372,299,EVM,mRNA,20742,896136,299,1.00
ptg003364l,1479321,1479602,281,EVM,mRNA,1384280,2008835,281,1.00
ptg003366l,109807,110094,287,EVM,mRNA,28551,149286,287,1.00
ptg003366l,366407,366713,306,EVM,mRNA,296522,391022,306,1.00
ptg003368l,33011,33309,298,EVM,mRNA,8646,62501,298,1.00
ptg003369l,315090,315401,311,EVM,mRNA,60735,393039,311,1.00
ptg003369l,3518914,3519188,274,EVM,mRNA,3468218,3595530,274,1.00
ptg003375l,551535,551823,288,EVM,mRNA,48313,660897,288,1.00
ptg003376l,2206928,2207253,325,EVM,mRNA,1897114,2866588,325,1.00
ptg003376l,2853251,2853566,315,EVM,mRNA,1897114,2866588,315,1.00
ptg003381l,1560878,1561166,288,EVM,mRNA,241229,1674083,288,1.00
ptg003383l,293759,294037,278,EVM,mRNA,136252,2901580,278,1.00
ptg003383l,1583427,1583733,306,EVM,mRNA,136252,2901580,306,1.00
ptg003383l,1758876,1759158,282,EVM,mRNA,136252,2901580,282,1.00
ptg003383l,1982252,1982530,278,EVM,mRNA,136252,2901580,278,1.00
ptg003383l,2717710,2717997,287,EVM,mRNA,136252,2901580,287,1.00
ptg003383l,2897317,2897630,313,EVM,mRNA,136252,2901580,313,1.00
ptg003383l,3068153,3068474,321,EVM,mRNA,3005436,3218771,321,1.00
ptg003387l,2410446,2410757,311,EVM,mRNA,2407635,2569604,311,1.00
ptg003389l,1762957,1763251,294,EVM,mRNA,1635816,1840937,294,1.00
ptg003391l,1641193,1641475,282,EVM,mRNA,1331857,2324025,282,1.00
ptg003391l,1808946,1809235,289,EVM,mRNA,1331857,2324025,289,1.00
ptg003391l,2629644,2629986,342,EVM,mRNA,2595987,3720656,342,1.00
ptg003391l,3289034,3289307,273,EVM,mRNA,2595987,3720656,273,1.00
ptg003391l,3571429,3571748,319,EVM,mRNA,2595987,3720656,319,1.00
ptg003391l,3712132,3712420,288,EVM,mRNA,2595987,3720656,288,1.00
ptg003394l,426262,426572,310,EVM,mRNA,7141,1546183,310,1.00
ptg003394l,964191,964506,315,EVM,mRNA,7141,1546183,315,1.00
ptg003394l,2833840,2834171,331,EVM,mRNA,2754281,3915805,331,1.00
ptg003396l,1425376,1425665,289,EVM,mRNA,5645,1868264,289,1.00
ptg003398l,1788045,1788372,327,EVM,mRNA,1260956,2771504,327,1.00
ptg003398l,3444573,3444851,278,EVM,mRNA,2926026,4057996,278,1.00
ptg003399l,243963,244273,310,EVM,mRNA,128386,1990323,310,1.00
ptg003399l,599904,600231,327,EVM,mRNA,128386,1990323,327,1.00
ptg003399l,1878509,1878828,319,EVM,mRNA,128386,1990323,319,1.00
ptg003404l,2867804,2868110,306,EVM,mRNA,1614751,5160580,306,1.00
ptg003404l,3361235,3361532,297,EVM,mRNA,1614751,5160580,297,1.00
ptg003405l,859778,860064,286,EVM,mRNA,724689,4353516,286,1.00
ptg003405l,1401735,1402026,291,EVM,mRNA,724689,4353516,291,1.00
ptg003405l,2242194,2242456,262,EVM,mRNA,724689,4353516,262,1.00
ptg003405l,3709940,3710220,280,EVM,mRNA,724689,4353516,280,1.00
ptg003405l,4962983,4963278,295,EVM,mRNA,4658356,4964135,295,1.00
ptg003406l,1549366,1549633,267,EVM,mRNA,281497,1771443,267,1.00
ptg003408l,673624,673948,324,EVM,mRNA,609066,833776,324,1.00
ptg003408l,3395205,3395503,298,EVM,mRNA,2980000,4179875,298,1.00
ptg003408l,3671823,3672133,310,EVM,mRNA,2980000,4179875,310,1.00
ptg003408l,3856006,3856275,269,EVM,mRNA,2980000,4179875,269,1.00
ptg003408l,3906261,3906565,304,EVM,mRNA,2980000,4179875,304,1.00
ptg003408l,4997697,4998022,325,EVM,mRNA,4902194,5078640,325,1.00
ptg003410l,1136751,1137058,307,EVM,mRNA,203704,1346882,307,1.00
ptg003410l,1576082,1576354,272,EVM,mRNA,1528750,1592081,272,1.00
ptg003411l,652022,652343,321,EVM,mRNA,523729,1332206,321,1.00
ptg003411l,764857,765140,283,EVM,mRNA,523729,1332206,283,1.00
ptg003411l,1170370,1170688,318,EVM,mRNA,523729,1332206,318,1.00
ptg003412l,869221,869521,300,EVM,mRNA,193360,1329559,300,1.00
ptg003412l,2956365,2956631,266,EVM,mRNA,2820750,3189680,266,1.00
ptg003412l,4669665,4669987,322,EVM,mRNA,3827392,5633563,322,1.00
ptg003412l,4913935,4914231,296,EVM,mRNA,3827392,5633563,296,1.00
ptg003412l,5048132,5048452,320,EVM,mRNA,3827392,5633563,320,1.00
ptg003412l,5292309,5292608,299,EVM,mRNA,3827392,5633563,299,1.00
ptg003412l,5544985,5545306,321,EVM,mRNA,3827392,5633563,321,1.00
ptg003412l,6571169,6571509,340,EVM,mRNA,6546883,6730761,340,1.00
ptg003413l,999899,1000197,298,EVM,mRNA,621649,1460463,298,1.00
ptg003414l,976012,976303,291,EVM,mRNA,249127,4253993,291,1.00
ptg003414l,2248243,2248554,311,EVM,mRNA,249127,4253993,311,1.00
ptg003414l,2452318,2452627,309,EVM,mRNA,249127,4253993,309,1.00
ptg003414l,2625287,2625599,312,EVM,mRNA,249127,4253993,312,1.00
ptg003414l,3742598,3742916,318,EVM,mRNA,249127,4253993,318,1.00
ptg003417l,664352,664648,296,EVM,mRNA,16428,1037128,296,1.00
ptg003426l,1394270,1394571,301,EVM,mRNA,229997,4118547,301,1.00
ptg003426l,1429364,1429661,297,EVM,mRNA,229997,4118547,297,1.00
ptg003426l,1850039,1850354,315,EVM,mRNA,229997,4118547,315,1.00
ptg003426l,2111211,2111503,292,EVM,mRNA,229997,4118547,292,1.00
ptg003426l,2905107,2905405,298,EVM,mRNA,229997,4118547,298,1.00
ptg003426l,3976963,3977283,320,EVM,mRNA,229997,4118547,320,1.00
ptg003429l,1260819,1261135,316,EVM,mRNA,1222392,1751387,316,1.00
ptg003438l,540607,540907,300,EVM,mRNA,314412,839621,300,1.00
ptg003439l,268935,269257,322,EVM,mRNA,5091,962755,322,1.00
ptg003439l,834003,834309,306,EVM,mRNA,5091,962755,306,1.00
ptg003439l,1868387,1868690,303,EVM,mRNA,1097920,2696099,303,1.00
ptg003439l,2677999,2678307,308,EVM,mRNA,1097920,2696099,308,1.00
ptg003445l,450060,450336,276,EVM,mRNA,177616,1081843,276,1.00
ptg003445l,635710,636024,314,EVM,mRNA,177616,1081843,314,1.00
ptg003446l,1949423,1949702,279,EVM,mRNA,1362795,2431090,279,1.00
ptg003446l,2409200,2409509,309,EVM,mRNA,1362795,2431090,309,1.00
ptg003446l,4953767,4954068,301,EVM,mRNA,2616582,6271182,301,1.00
ptg003449l,343146,343486,340,EVM,mRNA,2721,1548092,340,1.00
ptg003449l,748440,748763,323,EVM,mRNA,2721,1548092,323,1.00
ptg003449l,754904,755213,309,EVM,mRNA,2721,1548092,309,1.00
ptg003455l,1396150,1396477,327,EVM,mRNA,321344,3404345,327,1.00
ptg003455l,1979299,1979611,312,EVM,mRNA,321344,3404345,312,1.00
ptg003455l,2036392,2036672,280,EVM,mRNA,321344,3404345,280,1.00
ptg003456l,696563,696846,283,EVM,mRNA,399614,1592904,283,1.00
ptg003456l,970017,970332,315,EVM,mRNA,399614,1592904,315,1.00
ptg003456l,1047477,1047764,287,EVM,mRNA,399614,1592904,287,1.00
ptg003457l,1034357,1034640,283,EVM,mRNA,997749,1553187,283,1.00
ptg003457l,1815457,1815783,326,EVM,mRNA,1628166,2194239,326,1.00
ptg003457l,2449959,2450264,305,EVM,mRNA,2330790,3127730,305,1.00
ptg003457l,5882528,5882818,290,EVM,mRNA,5471693,6763049,290,1.00
ptg003457l,6271173,6271498,325,EVM,mRNA,5471693,6763049,325,1.00
ptg003458l,36556,36874,318,EVM,mRNA,2237,529044,318,1.00
ptg003458l,3710022,3710285,263,EVM,mRNA,3554727,3752051,263,1.00
ptg003461l,1038049,1038360,311,EVM,mRNA,914314,1083099,311,1.00
ptg003461l,1476215,1476540,325,EVM,mRNA,1281397,1580346,325,1.00
ptg003462l,292757,293072,315,EVM,mRNA,36192,1266159,315,1.00
ptg003462l,299242,299568,326,EVM,mRNA,36192,1266159,326,1.00
ptg003462l,524886,525217,331,EVM,mRNA,36192,1266159,331,1.00
ptg003463l,809800,810116,316,EVM,mRNA,114983,2025044,316,1.00
ptg003463l,1240432,1240753,321,EVM,mRNA,114983,2025044,321,1.00
ptg003463l,1485534,1485832,298,EVM,mRNA,114983,2025044,298,1.00
ptg003463l,1957048,1957363,315,EVM,mRNA,114983,2025044,315,1.00
ptg003464l,597872,598189,317,EVM,mRNA,547509,1362909,317,1.00
ptg003464l,1155564,1155878,314,EVM,mRNA,547509,1362909,314,1.00
ptg003464l,1414965,1415261,296,EVM,mRNA,1413513,2011601,296,1.00
ptg003465l,1306858,1307163,305,EVM,mRNA,1294768,1544250,305,1.00
ptg003465l,1372540,1372856,316,EVM,mRNA,1294768,1544250,316,1.00
ptg003468l,1621912,1622209,297,EVM,mRNA,1544713,1858231,297,1.00
ptg003469l,1200490,1200815,325,EVM,mRNA,1198733,1794118,325,1.00
ptg003469l,1758900,1759192,292,EVM,mRNA,1198733,1794118,292,1.00
ptg003470l,2699879,2700181,302,EVM,mRNA,131542,2710682,302,1.00
ptg003471l,3200320,3200590,270,EVM,mRNA,3030415,3924532,270,1.00
ptg003471l,3357566,3357875,309,EVM,mRNA,3030415,3924532,309,1.00
ptg003471l,3425612,3425893,281,EVM,mRNA,3030415,3924532,281,1.00
ptg003472l,100518,100836,318,EVM,mRNA,3412,200111,318,1.00
ptg003472l,109918,110241,323,EVM,mRNA,3412,200111,323,1.00
ptg003472l,1778599,1778894,295,EVM,mRNA,1614240,2479134,295,1.00
ptg003472l,2099825,2100120,295,EVM,mRNA,1614240,2479134,295,1.00
ptg003472l,2127643,2127950,307,EVM,mRNA,1614240,2479134,307,1.00
ptg003473l,1111597,1111871,274,EVM,mRNA,46184,1152347,274,1.00
ptg003473l,2710033,2710315,282,EVM,mRNA,1327890,4448765,282,1.00
ptg003473l,2870165,2870476,311,EVM,mRNA,1327890,4448765,311,1.00
ptg003473l,3850485,3850785,300,EVM,mRNA,1327890,4448765,300,1.00
ptg003474l,2993667,2993963,296,EVM,mRNA,2953888,3054658,296,1.00
ptg003474l,2995719,2995999,280,EVM,mRNA,2953888,3054658,280,1.00
ptg003474l,4646339,4646629,290,EVM,mRNA,4554104,4848502,290,1.00
ptg003479l,649738,650064,326,EVM,mRNA,440519,1233224,326,1.00
ptg003479l,725418,725707,289,EVM,mRNA,440519,1233224,289,1.00
ptg003481l,516252,516543,291,EVM,mRNA,24678,680382,291,1.00
ptg003482l,2395913,2396205,292,EVM,mRNA,2104776,2768641,292,1.00
ptg003482l,2593946,2594259,313,EVM,mRNA,2104776,2768641,313,1.00
ptg003482l,2692951,2693256,305,EVM,mRNA,2104776,2768641,305,1.00
ptg003482l,2739563,2739888,325,EVM,mRNA,2104776,2768641,325,1.00
ptg003482l,3503485,3503765,280,EVM,mRNA,2838010,3652902,280,1.00
ptg003482l,4468046,4468327,281,EVM,mRNA,4024097,4580725,281,1.00
ptg003482l,5546766,5547086,320,EVM,mRNA,5324069,6025231,320,1.00
ptg003486l,222785,223087,302,EVM,mRNA,11495,228226,302,1.00
ptg003486l,222791,223087,296,EVM,mRNA,11495,228226,296,1.00
ptg003486l,1190582,1190867,285,EVM,mRNA,1190658,1364521,210,0.74
ptg003489l,1545312,1545604,292,EVM,mRNA,271548,2437554,292,1.00
ptg003492l,532092,532429,337,EVM,mRNA,216608,1200573,337,1.00
ptg003492l,836138,836443,305,EVM,mRNA,216608,1200573,305,1.00
ptg003492l,1912651,1912923,272,EVM,mRNA,1474621,2076799,272,1.00
ptg003492l,4914786,4915081,295,EVM,mRNA,4890295,5170234,295,1.00
ptg003492l,6683963,6684278,315,EVM,mRNA,6280405,6823019,315,1.00
ptg003492l,6799392,6799706,314,EVM,mRNA,6280405,6823019,314,1.00
ptg003495l,639877,640168,291,EVM,mRNA,882,1377223,291,1.00
ptg003496l,1360476,1360769,293,EVM,mRNA,1241641,1904555,293,1.00
ptg003496l,1899929,1900235,306,EVM,mRNA,1241641,1904555,306,1.00
ptg003497l,592194,592472,278,EVM,mRNA,25167,596362,278,1.00
ptg003501l,840431,840744,313,EVM,mRNA,832312,1086246,313,1.00
ptg003505l,2985112,2985403,291,EVM,mRNA,2776292,3004816,291,1.00
ptg003506l,482643,482935,292,EVM,mRNA,33714,970267,292,1.00
ptg003509l,1766474,1766743,269,EVM,mRNA,1394992,1991684,269,1.00
ptg003509l,1923291,1923572,281,EVM,mRNA,1394992,1991684,281,1.00
ptg003513l,353233,353525,292,EVM,mRNA,270682,2434603,292,1.00
ptg003513l,1225135,1225437,302,EVM,mRNA,270682,2434603,302,1.00
ptg003513l,1426855,1427150,295,EVM,mRNA,270682,2434603,295,1.00
ptg003513l,1538105,1538406,301,EVM,mRNA,270682,2434603,301,1.00
ptg003514l,549405,549721,316,EVM,mRNA,278218,697968,316,1.00
ptg003517l,1535586,1535889,303,EVM,mRNA,1497633,2744119,303,1.00
ptg003517l,1971176,1971435,259,EVM,mRNA,1497633,2744119,259,1.00
ptg003517l,2316245,2316543,298,EVM,mRNA,1497633,2744119,298,1.00
ptg003517l,2500612,2500940,328,EVM,mRNA,1497633,2744119,328,1.00
ptg003519l,1872260,1872574,314,EVM,mRNA,1570940,3005058,314,1.00
ptg003519l,2393080,2393379,299,EVM,mRNA,1570940,3005058,299,1.00
ptg003519l,2442428,2442712,284,EVM,mRNA,1570940,3005058,284,1.00
ptg003519l,2545816,2546098,282,EVM,mRNA,1570940,3005058,282,1.00
ptg003519l,3409816,3410093,277,EVM,mRNA,3294557,4548795,277,1.00
ptg003519l,3636422,3636706,284,EVM,mRNA,3294557,4548795,284,1.00
ptg003523l,1331097,1331388,291,EVM,mRNA,1330871,1353642,291,1.00
ptg003523l,3261547,3261859,312,EVM,mRNA,2034384,3842084,312,1.00
ptg003525l,468776,469084,308,EVM,mRNA,6701,563414,308,1.00
ptg003526l,391507,391828,321,EVM,mRNA,391390,391542,35,0.11
ptg003526l,693706,694002,296,EVM,mRNA,401055,1700677,296,1.00
ptg003526l,938118,938399,281,EVM,mRNA,401055,1700677,281,1.00
ptg003526l,2414888,2415178,290,EVM,mRNA,2134913,2622862,290,1.00
ptg003526l,4086583,4086859,276,EVM,mRNA,3981206,4150063,276,1.00
ptg003526l,5113358,5113656,298,EVM,mRNA,4843907,5221052,298,1.00
ptg003529l,397923,398259,336,EVM,mRNA,288967,1936957,336,1.00
ptg003529l,1026122,1026435,313,EVM,mRNA,288967,1936957,313,1.00
ptg003529l,1167848,1168123,275,EVM,mRNA,288967,1936957,275,1.00
ptg003529l,3092831,3093153,322,EVM,mRNA,2994189,3093757,322,1.00
ptg003530l,718625,718929,304,EVM,mRNA,703518,2511449,304,1.00
ptg003530l,3754025,3754293,268,EVM,mRNA,3488641,3970534,268,1.00
ptg003532l,482693,482988,295,EVM,mRNA,174450,487393,295,1.00
ptg003532l,483700,484011,311,EVM,mRNA,174450,487393,311,1.00
ptg003534l,951531,951826,295,EVM,mRNA,829949,2219861,295,1.00
ptg003534l,1656608,1656929,321,EVM,mRNA,829949,2219861,321,1.00
ptg003534l,1771661,1771939,278,EVM,mRNA,829949,2219861,278,1.00
ptg003534l,3332063,3332321,258,EVM,mRNA,2666696,3353715,258,1.00
ptg003534l,7054078,7054357,279,EVM,mRNA,6298359,7358442,279,1.00
ptg003534l,7136243,7136545,302,EVM,mRNA,6298359,7358442,302,1.00
ptg003534l,12307554,12307878,324,EVM,mRNA,12112721,12626818,324,1.00
ptg003534l,12360906,12361167,261,EVM,mRNA,12112721,12626818,261,1.00
ptg003537l,1567221,1567517,296,EVM,mRNA,1114434,1737494,296,1.00
ptg003537l,1662721,1663021,300,EVM,mRNA,1114434,1737494,300,1.00
ptg003539l,1753310,1753639,329,EVM,mRNA,762,1767680,329,1.00
ptg003544l,2682636,2682933,297,EVM,mRNA,2218541,2699554,297,1.00
ptg003547l,116843,117109,266,EVM,mRNA,719,330673,266,1.00
ptg003547l,834426,834721,295,EVM,mRNA,409675,871054,295,1.00
ptg003547l,910403,910717,314,EVM,mRNA,890066,1395165,314,1.00
ptg003548l,966247,966548,301,EVM,mRNA,960079,1096673,301,1.00
ptg003548l,1499163,1499445,282,EVM,mRNA,1396375,1513977,282,1.00
ptg003551l,416361,416672,311,EVM,mRNA,9194,1203669,311,1.00
ptg003551l,623345,623647,302,EVM,mRNA,9194,1203669,302,1.00
ptg003553l,815487,815814,327,EVM,mRNA,63698,954567,327,1.00
ptg003553l,5727288,5727617,329,EVM,mRNA,5402318,5876732,329,1.00
ptg003554l,3992781,3993064,283,EVM,mRNA,3805298,4041466,283,1.00
ptg003559l,1000673,1000953,280,EVM,mRNA,959975,1161175,280,1.00
ptg003561l,2971016,2971313,297,EVM,mRNA,2906829,2975800,297,1.00
ptg003572l,251000,251282,282,EVM,mRNA,236443,1194487,282,1.00
ptg003572l,254124,254418,294,EVM,mRNA,236443,1194487,294,1.00
ptg003572l,395452,395781,329,EVM,mRNA,236443,1194487,329,1.00
ptg003572l,639930,640253,323,EVM,mRNA,236443,1194487,323,1.00
ptg003572l,861766,862101,335,EVM,mRNA,236443,1194487,335,1.00
ptg003575l,179685,180008,323,EVM,mRNA,53368,405935,323,1.00
ptg003577l,930899,931195,296,EVM,mRNA,874475,1051561,296,1.00
ptg003577l,951704,951974,270,EVM,mRNA,874475,1051561,270,1.00
ptg003580l,1724243,1724555,312,EVM,mRNA,219653,1807597,312,1.00
ptg003582l,297832,298153,321,EVM,mRNA,238609,365958,321,1.00
ptg003588l,213166,213500,334,EVM,mRNA,148971,698880,334,1.00
ptg003588l,306529,306830,301,EVM,mRNA,148971,698880,301,1.00
ptg003588l,1749315,1749628,313,EVM,mRNA,1436031,1790334,313,1.00
ptg003590l,560327,560632,305,EVM,mRNA,141357,1877869,305,1.00
ptg003590l,1204385,1204692,307,EVM,mRNA,141357,1877869,307,1.00
ptg003590l,1708099,1708402,303,EVM,mRNA,141357,1877869,303,1.00
ptg003590l,1793968,1794267,299,EVM,mRNA,141357,1877869,299,1.00
ptg003590l,2664631,2664940,309,EVM,mRNA,2076256,4114576,309,1.00
ptg003590l,3670290,3670594,304,EVM,mRNA,2076256,4114576,304,1.00
ptg003591l,214344,214655,311,EVM,mRNA,52988,1120472,311,1.00
ptg003597l,837800,838096,296,EVM,mRNA,683004,994110,296,1.00
ptg003601l,1656655,1656936,281,EVM,mRNA,1081125,1891455,281,1.00
ptg003601l,1666701,1666982,281,EVM,mRNA,1081125,1891455,281,1.00
ptg003601l,3965698,3966021,323,EVM,mRNA,3953366,4559472,323,1.00
ptg003606l,3808245,3808540,295,EVM,mRNA,3786231,4025686,295,1.00
ptg003607l,1028691,1028984,293,EVM,mRNA,16106,1894768,293,1.00
ptg003607l,2177570,2177879,309,EVM,mRNA,1989245,3199002,309,1.00
ptg003607l,2557842,2558148,306,EVM,mRNA,1989245,3199002,306,1.00
ptg003610l,1554169,1554455,286,EVM,mRNA,56807,1554545,286,1.00
ptg003610l,1916754,1917051,297,EVM,mRNA,1865321,2745421,297,1.00
ptg003611l,42755,43049,294,EVM,mRNA,1635,1278431,294,1.00
ptg003611l,657043,657335,292,EVM,mRNA,1635,1278431,292,1.00
ptg003614l,615192,615476,284,EVM,mRNA,285710,757317,284,1.00
ptg003617l,1310860,1311148,288,EVM,mRNA,862382,1432460,288,1.00
ptg003617l,3178786,3179076,290,EVM,mRNA,2334619,3241484,290,1.00
ptg003620l,2850168,2850467,299,EVM,mRNA,2750672,3726947,299,1.00
ptg003633l,927596,927876,280,EVM,mRNA,843036,1042241,280,1.00
ptg003634l,1903208,1903528,320,EVM,mRNA,1835568,2865101,320,1.00
ptg003634l,4170811,4171109,298,EVM,mRNA,4057895,4526127,298,1.00
ptg003634l,4404716,4405018,302,EVM,mRNA,4057895,4526127,302,1.00
ptg003634l,6632543,6632839,296,EVM,mRNA,6137155,7815512,296,1.00
ptg003634l,7413957,7414243,286,EVM,mRNA,6137155,7815512,286,1.00
ptg003634l,7712051,7712352,301,EVM,mRNA,6137155,7815512,301,1.00
ptg003634l,8573641,8573960,319,EVM,mRNA,8128224,8813595,319,1.00
ptg003634l,8637485,8637769,284,EVM,mRNA,8128224,8813595,284,1.00
ptg003634l,9397219,9397529,310,EVM,mRNA,9379576,9430851,310,1.00
ptg003634l,10146068,10146371,303,EVM,mRNA,10082247,10323913,303,1.00
ptg003641l,870185,870464,279,EVM,mRNA,789337,1690599,279,1.00
ptg003641l,984911,985215,304,EVM,mRNA,789337,1690599,304,1.00
ptg003641l,993121,993413,292,EVM,mRNA,789337,1690599,292,1.00
ptg003643l,1494259,1494537,278,EVM,mRNA,1442986,1535589,278,1.00
ptg003649l,378657,378952,295,EVM,mRNA,336249,772624,295,1.00
ptg003649l,423579,423880,301,EVM,mRNA,336249,772624,301,1.00
ptg003651l,849344,849633,289,EVM,mRNA,1111,1250015,289,1.00
ptg003651l,857789,858066,277,EVM,mRNA,1111,1250015,277,1.00
ptg003652l,987287,987591,304,EVM,mRNA,145365,2449554,304,1.00
ptg003652l,1245707,1245986,279,EVM,mRNA,145365,2449554,279,1.00
ptg003652l,2202931,2203235,304,EVM,mRNA,145365,2449554,304,1.00
ptg003652l,2287806,2288104,298,EVM,mRNA,145365,2449554,298,1.00
ptg003652l,2313913,2314188,275,EVM,mRNA,145365,2449554,275,1.00
ptg003659l,820886,821194,308,EVM,mRNA,250,828354,308,1.00
ptg003665l,1453080,1453403,323,EVM,mRNA,787042,2446699,323,1.00
ptg003665l,2611591,2611881,290,EVM,mRNA,2602860,2634209,290,1.00
ptg003666l,2346394,2346704,310,EVM,mRNA,2092428,2907098,310,1.00
ptg003666l,2668481,2668771,290,EVM,mRNA,2092428,2907098,290,1.00
ptg003667l,111937,112225,288,EVM,mRNA,30286,1653223,288,1.00
ptg003667l,111937,112225,288,GeMoMa,mRNA,32779,1467598,288,1.00
ptg003667l,1299917,1300230,313,EVM,mRNA,30286,1653223,313,1.00
ptg003667l,1299917,1300230,313,GeMoMa,mRNA,32779,1467598,313,1.00
ptg003668l,842923,843223,300,EVM,mRNA,541442,1623348,300,1.00
ptg003670l,1226256,1226546,290,EVM,mRNA,629825,1295150,290,1.00
ptg003673l,227563,227851,288,EVM,mRNA,775,328697,288,1.00
ptg003677l,2734772,2735085,313,EVM,mRNA,2408368,3666841,313,1.00
ptg003678l,1388577,1388886,309,EVM,mRNA,1295325,1519930,309,1.00
ptg003681l,2486051,2486326,275,EVM,mRNA,2134560,2531081,275,1.00
ptg003683l,1339727,1340016,289,EVM,mRNA,1244603,2020225,289,1.00
ptg003683l,1865895,1866168,273,EVM,mRNA,1244603,2020225,273,1.00
ptg003693l,274140,274449,309,EVM,mRNA,12505,1098478,309,1.00
ptg003698l,910486,910742,256,EVM,mRNA,579464,918572,256,1.00
ptg003699l,3977291,3977566,275,EVM,mRNA,3919493,4161799,275,1.00
ptg003700l,2294282,2294586,304,EVM,mRNA,2275885,2423743,304,1.00
ptg003700l,2308195,2308456,261,EVM,mRNA,2275885,2423743,261,1.00
ptg003703l,557126,557438,312,EVM,mRNA,144484,712056,312,1.00
ptg003704l,122342,122616,274,EVM,mRNA,102921,672315,274,1.00
ptg003704l,642352,642655,303,EVM,mRNA,102921,672315,303,1.00
ptg003707l,1017576,1017894,318,EVM,mRNA,966147,1106978,318,1.00
ptg003715l,899285,899562,277,EVM,mRNA,848297,1088896,277,1.00
ptg003721l,245384,245714,330,EVM,mRNA,22822,922549,330,1.00
ptg003721l,2156126,2156419,293,EVM,mRNA,1935591,3627580,293,1.00
ptg003721l,2199631,2199939,308,EVM,mRNA,1935591,3627580,308,1.00
ptg003721l,3091753,3092048,295,EVM,mRNA,1935591,3627580,295,1.00
ptg003721l,3804238,3804554,316,EVM,mRNA,3803123,3946969,316,1.00
ptg003721l,4584053,4584354,301,EVM,mRNA,4448645,4698924,301,1.00
ptg003722l,2426015,2426339,324,EVM,mRNA,2393238,3021882,324,1.00
ptg003722l,2731811,2732111,300,EVM,mRNA,2393238,3021882,300,1.00
ptg003722l,2988124,2988411,287,EVM,mRNA,2393238,3021882,287,1.00
ptg003723l,1209821,1210158,337,EVM,mRNA,841896,1642685,337,1.00
ptg003723l,1337320,1337632,312,EVM,mRNA,841896,1642685,312,1.00
ptg003723l,1543655,1543976,321,EVM,mRNA,841896,1642685,321,1.00
ptg003724l,1042797,1043060,263,EVM,mRNA,971921,1378836,263,1.00
ptg003724l,2068081,2068379,298,EVM,mRNA,1537642,2215356,298,1.00
ptg003726l,1484203,1484476,273,EVM,mRNA,106307,1485759,273,1.00
ptg003728l,1676843,1677165,322,EVM,mRNA,1215874,2138328,322,1.00
ptg003737l,598498,598787,289,EVM,mRNA,449164,599258,289,1.00
ptg003737l,4093791,4094076,285,EVM,mRNA,3712006,4095135,285,1.00
ptg003737l,5179458,5179767,309,EVM,mRNA,4981557,6446729,309,1.00
ptg003737l,5766535,5766837,302,EVM,mRNA,4981557,6446729,302,1.00
ptg003747l,1630439,1630772,333,EVM,mRNA,1323120,2230389,333,1.00
ptg003748l,820826,821149,323,EVM,mRNA,351526,1372158,323,1.00
ptg003748l,2367737,2368041,304,EVM,mRNA,1485685,2788577,304,1.00
ptg003748l,2692747,2693074,327,EVM,mRNA,1485685,2788577,327,1.00
ptg003749l,5207256,5207543,287,EVM,mRNA,4350891,8044840,287,1.00
ptg003749l,5775956,5776257,301,EVM,mRNA,4350891,8044840,301,1.00
ptg003749l,7255572,7255905,333,EVM,mRNA,4350891,8044840,333,1.00
ptg003749l,7667867,7668143,276,EVM,mRNA,4350891,8044840,276,1.00
ptg003751l,1345450,1345775,325,EVM,mRNA,1007194,1365345,325,1.00
ptg003752l,1324102,1324417,315,EVM,mRNA,1239649,1577867,315,1.00
ptg003753l,1961919,1962229,310,EVM,mRNA,1162955,1996133,310,1.00
ptg003753l,2241183,2241481,298,EVM,mRNA,2046727,2362935,298,1.00
ptg003753l,2590781,2591082,301,EVM,mRNA,2590814,3108932,269,0.89
ptg003753l,3057154,3057437,283,EVM,mRNA,2590814,3108932,283,1.00
ptg003754l,1390165,1390457,292,EVM,mRNA,843495,2035679,292,1.00
ptg003755l,174566,174890,324,EVM,mRNA,47905,1692079,324,1.00
ptg003755l,441000,441316,316,EVM,mRNA,47905,1692079,316,1.00
ptg003755l,784722,784988,266,EVM,mRNA,47905,1692079,266,1.00
ptg003755l,1642154,1642473,319,EVM,mRNA,47905,1692079,319,1.00
ptg003764l,532445,532755,310,EVM,mRNA,376165,821151,310,1.00
ptg003770l,2375915,2376199,284,EVM,mRNA,2079285,2840274,284,1.00
ptg003770l,2376266,2376586,320,EVM,mRNA,2079285,2840274,320,1.00
ptg003772l,286216,286491,275,EVM,mRNA,21894,418658,275,1.00
ptg003772l,556834,557139,305,EVM,mRNA,514126,793213,305,1.00
ptg003774l,455730,456029,299,EVM,mRNA,14731,932769,299,1.00
ptg003774l,568497,568797,300,EVM,mRNA,14731,932769,300,1.00
ptg003774l,858375,858681,306,EVM,mRNA,14731,932769,306,1.00
ptg003774l,1300444,1300726,282,EVM,mRNA,1158098,1509868,282,1.00
ptg003778l,445113,445404,291,EVM,mRNA,199834,590718,291,1.00
ptg003779l,2333117,2333404,287,EVM,mRNA,10196,2501419,287,1.00
ptg003779l,3051159,3051500,341,EVM,mRNA,2873369,3245987,341,1.00
ptg003782l,1296089,1296365,276,EVM,mRNA,1259094,1349950,276,1.00
ptg003783l,3795046,3795349,303,EVM,mRNA,1564393,4367621,303,1.00
ptg003784l,802451,802717,266,EVM,mRNA,671801,2236019,266,1.00
ptg003784l,844367,844655,288,EVM,mRNA,671801,2236019,288,1.00
ptg003784l,1144929,1145255,326,EVM,mRNA,671801,2236019,326,1.00
ptg003784l,1879745,1880055,310,EVM,mRNA,671801,2236019,310,1.00
ptg003784l,1966771,1967031,260,EVM,mRNA,671801,2236019,260,1.00
ptg003785l,451060,451354,294,EVM,mRNA,425754,458045,294,1.00
ptg003786l,1698679,1699008,329,EVM,mRNA,435557,2112982,329,1.00
ptg003788l,132142,132460,318,EVM,mRNA,81689,146511,318,1.00
ptg003793l,1332244,1332525,281,EVM,mRNA,165014,1970818,281,1.00
ptg003793l,1627443,1627770,327,EVM,mRNA,165014,1970818,327,1.00
ptg003795l,1071119,1071427,308,EVM,mRNA,958915,5290743,308,1.00
ptg003795l,1932920,1933212,292,EVM,mRNA,958915,5290743,292,1.00
ptg003795l,2177084,2177401,317,EVM,mRNA,958915,5290743,317,1.00
ptg003796l,2905040,2905349,309,EVM,mRNA,2038511,4038936,309,1.00
ptg003796l,3707635,3707926,291,EVM,mRNA,2038511,4038936,291,1.00
ptg003798l,73356,73669,313,EVM,mRNA,45324,122567,313,1.00
ptg003798l,762259,762578,319,EVM,mRNA,281565,860845,319,1.00
ptg003804l,1411734,1412058,324,EVM,mRNA,972506,1858723,324,1.00
ptg003804l,1456882,1457205,323,EVM,mRNA,972506,1858723,323,1.00
ptg003804l,2071532,2071819,287,EVM,mRNA,2030427,2302022,287,1.00
ptg003804l,2193833,2194129,296,EVM,mRNA,2030427,2302022,296,1.00
ptg003808l,1191609,1191929,320,EVM,mRNA,849773,1525329,320,1.00
ptg003808l,1519740,1520024,284,EVM,mRNA,849773,1525329,284,1.00
ptg003809l,130296,130560,264,EVM,mRNA,20627,353235,264,1.00
ptg003812l,67355,67632,277,EVM,mRNA,10205,3132902,277,1.00
ptg003814l,1091956,1092271,315,EVM,mRNA,176153,1643309,315,1.00
ptg003824l,1128732,1129012,280,EVM,mRNA,993751,2106051,280,1.00
ptg003824l,1357011,1357330,319,EVM,mRNA,993751,2106051,319,1.00
ptg003824l,1358149,1358442,293,EVM,mRNA,993751,2106051,293,1.00
ptg003824l,2081882,2082182,300,EVM,mRNA,993751,2106051,300,1.00
ptg003825l,202672,202952,280,EVM,mRNA,2929,329237,280,1.00
ptg003829l,997212,997507,295,EVM,mRNA,973287,1193825,295,1.00
ptg003830l,1890711,1891039,328,EVM,mRNA,1362731,2946289,328,1.00
ptg003830l,1892357,1892650,293,EVM,mRNA,1362731,2946289,293,1.00
ptg003831l,1620755,1621057,302,EVM,mRNA,1018858,2390849,302,1.00
ptg003833l,604134,604418,284,EVM,mRNA,26018,818056,284,1.00
ptg003833l,2784850,2785132,282,EVM,mRNA,2603749,2837812,282,1.00
ptg003833l,2975887,2976181,294,EVM,mRNA,2839781,3079460,294,1.00
ptg003833l,3518362,3518659,297,EVM,mRNA,3474563,3814311,297,1.00
ptg003833l,3542409,3542729,320,EVM,mRNA,3474563,3814311,320,1.00
ptg003836l,138308,138627,319,EVM,mRNA,3460,308782,319,1.00
ptg003837l,504002,504297,295,EVM,mRNA,154716,1175062,295,1.00
ptg003837l,794744,795038,294,EVM,mRNA,154716,1175062,294,1.00
ptg003837l,1544917,1545198,281,EVM,mRNA,1490459,1715371,281,1.00
ptg003839l,2370548,2370863,315,EVM,mRNA,1469513,2372085,315,1.00
ptg003839l,2866925,2867221,296,EVM,mRNA,2662702,3190296,296,1.00
ptg003839l,3382815,3383127,312,EVM,mRNA,3280037,4474787,312,1.00
ptg003839l,4200768,4201056,288,EVM,mRNA,3280037,4474787,288,1.00
ptg003839l,4304716,4305037,321,EVM,mRNA,3280037,4474787,321,1.00
ptg003839l,5051061,5051357,296,EVM,mRNA,4889096,8552082,296,1.00
ptg003839l,6118645,6118923,278,EVM,mRNA,4889096,8552082,278,1.00
ptg003839l,6965410,6965712,302,EVM,mRNA,4889096,8552082,302,1.00
ptg003839l,7082011,7082309,298,EVM,mRNA,4889096,8552082,298,1.00
ptg003839l,7382413,7382703,290,EVM,mRNA,4889096,8552082,290,1.00
ptg003839l,8042362,8042670,308,EVM,mRNA,4889096,8552082,308,1.00
ptg003841l,1964356,1964656,300,EVM,mRNA,1773529,2336197,300,1.00
ptg003843l,420825,421119,294,EVM,mRNA,273735,754278,294,1.00
ptg003843l,1635485,1635792,307,EVM,mRNA,1361904,1664953,307,1.00
ptg003843l,2583381,2583688,307,EVM,mRNA,2560049,3775462,307,1.00
ptg003843l,3253988,3254272,284,EVM,mRNA,2560049,3775462,284,1.00
ptg003846l,204068,204330,262,EVM,mRNA,149963,2480807,262,1.00
ptg003846l,1949537,1949841,304,EVM,mRNA,149963,2480807,304,1.00
ptg003849l,154699,155013,314,EVM,mRNA,113182,365527,314,1.00
ptg003850l,3339489,3339781,292,EVM,mRNA,2154758,3541983,292,1.00
ptg003850l,7298270,7298581,311,EVM,mRNA,7089186,7620259,311,1.00
ptg003857l,3484277,3484597,320,EVM,mRNA,1894790,3826450,320,1.00
ptg003859l,423316,423605,289,EVM,mRNA,4040,1405720,289,1.00
ptg003859l,622470,622777,307,EVM,mRNA,4040,1405720,307,1.00
ptg003859l,926877,927193,316,EVM,mRNA,4040,1405720,316,1.00
ptg003867l,318345,318627,282,EVM,mRNA,177705,1053223,282,1.00
ptg003872l,810315,810614,299,EVM,mRNA,697760,1949171,299,1.00
ptg003872l,1791615,1791914,299,EVM,mRNA,697760,1949171,299,1.00
ptg003873l,3868366,3868653,287,EVM,mRNA,3749734,3909113,287,1.00
ptg003876l,1321563,1321842,279,EVM,mRNA,1235778,1326304,279,1.00
ptg003878l,1588331,1588593,262,EVM,mRNA,1184499,1791476,262,1.00
ptg003878l,4929057,4929369,312,EVM,mRNA,4580882,5148269,312,1.00
ptg003879l,118966,119223,257,EVM,mRNA,10224,327412,257,1.00
ptg003879l,185937,186220,283,EVM,mRNA,10224,327412,283,1.00
ptg003881l,100053,100345,292,EVM,mRNA,37487,229787,292,1.00
ptg003884l,285519,285832,313,EVM,mRNA,68268,530221,313,1.00
ptg003887l,959603,959876,273,EVM,mRNA,485391,1562086,273,1.00
ptg003887l,1232544,1232816,272,EVM,mRNA,485391,1562086,272,1.00
ptg003888l,323454,323781,327,EVM,mRNA,269515,573723,327,1.00
ptg003889l,279710,280024,314,EVM,mRNA,153313,447040,314,1.00
ptg003889l,994749,995061,312,EVM,mRNA,930576,1135339,312,1.00
ptg003889l,1603848,1604123,275,EVM,mRNA,1248756,1716631,275,1.00
ptg003892l,98174,98479,305,EVM,mRNA,23082,302250,305,1.00
ptg003894l,986113,986431,318,EVM,mRNA,896059,1135369,318,1.00
ptg003894l,1039792,1040123,331,EVM,mRNA,896059,1135369,331,1.00
ptg003897l,1784986,1785278,292,EVM,mRNA,1055955,2091900,292,1.00
ptg003897l,1925409,1925695,286,EVM,mRNA,1055955,2091900,286,1.00
ptg003897l,2091113,2091397,284,EVM,mRNA,1055955,2091900,284,1.00
ptg003897l,2601689,2601995,306,EVM,mRNA,2419254,2615834,306,1.00
ptg003898l,1736452,1736716,264,EVM,mRNA,1102548,2494433,264,1.00
ptg003898l,1771019,1771309,290,EVM,mRNA,1102548,2494433,290,1.00
ptg003898l,1988703,1989011,308,EVM,mRNA,1102548,2494433,308,1.00
ptg003898l,2003997,2004281,284,EVM,mRNA,1102548,2494433,284,1.00
ptg003899l,1104430,1104713,283,EVM,mRNA,807721,1440929,283,1.00
ptg003900l,1088051,1088377,326,EVM,mRNA,238527,1631184,326,1.00
ptg003901l,122774,123075,301,EVM,mRNA,2667,181409,301,1.00
ptg003901l,803289,803593,304,EVM,mRNA,244810,2628848,304,1.00
ptg003901l,1892613,1892906,293,EVM,mRNA,244810,2628848,293,1.00
ptg003901l,2302255,2302559,304,EVM,mRNA,244810,2628848,304,1.00
ptg003906l,420699,420990,291,EVM,mRNA,289485,893299,291,1.00
ptg003906l,769695,769983,288,EVM,mRNA,289485,893299,288,1.00
ptg003906l,786946,787234,288,EVM,mRNA,289485,893299,288,1.00
ptg003911l,374284,374573,289,EVM,mRNA,318262,626557,289,1.00
ptg003911l,382954,383282,328,EVM,mRNA,318262,626557,328,1.00
ptg003911l,550126,550441,315,EVM,mRNA,318262,626557,315,1.00
ptg003912l,1294398,1294696,298,EVM,mRNA,1013185,3889444,298,1.00
ptg003912l,1823359,1823660,301,EVM,mRNA,1013185,3889444,301,1.00
ptg003912l,2200289,2200578,289,EVM,mRNA,1013185,3889444,289,1.00
ptg003912l,3611962,3612242,280,EVM,mRNA,1013185,3889444,280,1.00
ptg003915l,236041,236339,298,EVM,mRNA,235746,488977,298,1.00
ptg003916l,197529,197843,314,EVM,mRNA,50764,1117740,314,1.00
ptg003916l,310548,310837,289,EVM,mRNA,50764,1117740,289,1.00
ptg003916l,867269,867574,305,EVM,mRNA,50764,1117740,305,1.00
ptg003916l,2510673,2510946,273,EVM,mRNA,1830498,3453044,273,1.00
ptg003917l,1509407,1509711,304,EVM,mRNA,1127717,1744718,304,1.00
ptg003921l,1614055,1614339,284,EVM,mRNA,214989,2977211,284,1.00
ptg003921l,1991198,1991499,301,EVM,mRNA,214989,2977211,301,1.00
ptg003921l,2205823,2206117,294,EVM,mRNA,214989,2977211,294,1.00
ptg003921l,2766786,2767101,315,EVM,mRNA,214989,2977211,315,1.00
ptg003922l,150373,150638,265,EVM,mRNA,8093,150474,101,0.38
ptg003923l,505797,506088,291,EVM,mRNA,213435,914314,291,1.00
ptg003923l,506920,507252,332,EVM,mRNA,213435,914314,332,1.00
ptg003926l,955726,956060,334,EVM,mRNA,918770,1130404,334,1.00
ptg003927l,160677,160973,296,EVM,mRNA,14490,1333847,296,1.00
ptg003927l,409550,409827,277,EVM,mRNA,14490,1333847,277,1.00
ptg003927l,664155,664451,296,EVM,mRNA,14490,1333847,296,1.00
ptg003927l,875297,875580,283,EVM,mRNA,14490,1333847,283,1.00
ptg003927l,1190418,1190724,306,EVM,mRNA,14490,1333847,306,1.00
ptg003930l,1250595,1250907,312,EVM,mRNA,1022919,1554659,312,1.00
ptg003930l,1497084,1497373,289,EVM,mRNA,1022919,1554659,289,1.00
ptg003934l,600792,601086,294,EVM,mRNA,307487,3311871,294,1.00
ptg003934l,1092660,1092985,325,EVM,mRNA,307487,3311871,325,1.00
ptg003934l,1432827,1433141,314,EVM,mRNA,307487,3311871,314,1.00
ptg003934l,1979848,1980119,271,EVM,mRNA,307487,3311871,271,1.00
ptg003934l,2011675,2012008,333,EVM,mRNA,307487,3311871,333,1.00
ptg003934l,2451343,2451631,288,EVM,mRNA,307487,3311871,288,1.00
ptg003934l,2888406,2888692,286,EVM,mRNA,307487,3311871,286,1.00
ptg003934l,3154582,3154897,315,EVM,mRNA,307487,3311871,315,1.00
ptg003935l,2498139,2498443,304,EVM,mRNA,358611,4727752,304,1.00
ptg003936l,2064474,2064799,325,EVM,mRNA,2052928,3217084,325,1.00
ptg003936l,2664147,2664428,281,EVM,mRNA,2052928,3217084,281,1.00
ptg003936l,2671278,2671559,281,EVM,mRNA,2052928,3217084,281,1.00
ptg003938l,617010,617322,312,EVM,mRNA,368757,842570,312,1.00
ptg003938l,1474265,1474580,315,EVM,mRNA,1474003,4020624,315,1.00
ptg003938l,1861918,1862210,292,EVM,mRNA,1474003,4020624,292,1.00
ptg003938l,2186843,2187127,284,EVM,mRNA,1474003,4020624,284,1.00
ptg003938l,3253352,3253643,291,EVM,mRNA,1474003,4020624,291,1.00
ptg003938l,3436039,3436348,309,EVM,mRNA,1474003,4020624,309,1.00
ptg003940l,1249546,1249853,307,EVM,mRNA,272214,3036012,307,1.00
ptg003940l,1539684,1539984,300,EVM,mRNA,272214,3036012,300,1.00
ptg003940l,2452382,2452696,314,EVM,mRNA,272214,3036012,314,1.00
ptg003940l,2486035,2486330,295,EVM,mRNA,272214,3036012,295,1.00
ptg003941l,914465,914751,286,EVM,mRNA,648508,1338034,286,1.00
ptg003944l,807789,808082,293,EVM,mRNA,598698,1360094,293,1.00
ptg003944l,957630,957957,327,EVM,mRNA,598698,1360094,327,1.00
ptg003944l,1022487,1022779,292,EVM,mRNA,598698,1360094,292,1.00
ptg003944l,2495137,2495464,327,EVM,mRNA,2388080,4207825,327,1.00
ptg003944l,2863192,2863503,311,EVM,mRNA,2388080,4207825,311,1.00
ptg003945l,1897065,1897369,304,EVM,mRNA,313159,2715322,304,1.00
ptg003945l,2106578,2106896,318,EVM,mRNA,313159,2715322,318,1.00
ptg003949l,570168,570497,329,EVM,mRNA,538610,635689,329,1.00
ptg003950l,2909704,2910027,323,EVM,mRNA,2810249,3598809,323,1.00
ptg003950l,6972496,6972771,275,EVM,mRNA,5866180,7061522,275,1.00
ptg003950l,7040302,7040615,313,EVM,mRNA,5866180,7061522,313,1.00
ptg003951l,1593407,1593723,316,EVM,mRNA,299919,3007965,316,1.00
ptg003952l,475755,476073,318,EVM,mRNA,411550,504104,318,1.00
ptg003957l,897376,897691,315,EVM,mRNA,217384,1003697,315,1.00
ptg003959l,1425031,1425330,299,EVM,mRNA,1400248,1750474,299,1.00
ptg003960l,340344,340654,310,EVM,mRNA,315757,1100473,310,1.00
ptg003960l,1072080,1072374,294,EVM,mRNA,315757,1100473,294,1.00
ptg003964l,1186190,1186483,293,EVM,mRNA,1041552,1341597,293,1.00
ptg003964l,1806598,1806893,295,EVM,mRNA,1451872,3063529,295,1.00
ptg003964l,2777707,2778010,303,EVM,mRNA,1451872,3063529,303,1.00
ptg003964l,3824032,3824349,317,EVM,mRNA,3419115,3862228,317,1.00
ptg003964l,4270026,4270347,321,EVM,mRNA,3969588,4483786,321,1.00
ptg003967l,3224794,3225102,308,EVM,mRNA,3099526,3453647,308,1.00
ptg003968l,1876687,1876984,297,EVM,mRNA,1780692,2460338,297,1.00
ptg003968l,2655091,2655360,269,EVM,mRNA,2537859,2879883,269,1.00
ptg003970l,397780,398092,312,EVM,mRNA,343611,492277,312,1.00
ptg003982l,444318,444603,285,EVM,mRNA,231714,675014,285,1.00
ptg003982l,1518260,1518574,314,EVM,mRNA,1405906,2387106,314,1.00
ptg003982l,1953342,1953644,302,EVM,mRNA,1405906,2387106,302,1.00
ptg003987l,466296,466574,278,EVM,mRNA,68,726290,278,1.00
ptg003990l,2179051,2179323,272,EVM,mRNA,2022820,2936929,272,1.00
ptg003990l,2616907,2617240,333,EVM,mRNA,2022820,2936929,333,1.00
ptg003990l,2878701,2878994,293,EVM,mRNA,2022820,2936929,293,1.00
ptg003994l,2943505,2943826,321,EVM,mRNA,1174023,3808701,321,1.00
ptg003994l,3632998,3633290,292,EVM,mRNA,1174023,3808701,292,1.00
ptg003994l,4846156,4846443,287,EVM,mRNA,4036065,6600473,287,1.00
ptg003994l,5569471,5569748,277,EVM,mRNA,4036065,6600473,277,1.00
ptg003994l,6568245,6568567,322,EVM,mRNA,4036065,6600473,322,1.00
ptg003994l,6572384,6572709,325,EVM,mRNA,4036065,6600473,325,1.00
ptg003998l,2826818,2827133,315,EVM,mRNA,469703,3292644,315,1.00
ptg004000l,89694,90018,324,EVM,mRNA,4320,852513,324,1.00
ptg004001l,722447,722718,271,EVM,mRNA,435428,1120050,271,1.00
ptg004004l,45907,46185,278,EVM,mRNA,611,65045,278,1.00
ptg004007l,324510,324789,279,EVM,mRNA,122355,417382,279,1.00
ptg004007l,1158187,1158468,281,EVM,mRNA,1040485,1248196,281,1.00
ptg004007l,1442125,1442438,313,EVM,mRNA,1346877,1454554,313,1.00
ptg004008l,3341443,3341733,290,EVM,mRNA,2748106,5809795,290,1.00
ptg004008l,4431862,4432134,272,EVM,mRNA,2748106,5809795,272,1.00
ptg004008l,5575377,5575687,310,EVM,mRNA,2748106,5809795,310,1.00
ptg004008l,7411711,7412006,295,EVM,mRNA,6879856,8219911,295,1.00
ptg004008l,8187902,8188176,274,EVM,mRNA,6879856,8219911,274,1.00
ptg004009l,4213602,4213927,325,EVM,mRNA,3331367,5450873,325,1.00
ptg004009l,5841406,5841714,308,EVM,mRNA,5794624,8603401,308,1.00
ptg004009l,6457363,6457692,329,EVM,mRNA,5794624,8603401,329,1.00
ptg004009l,6598088,6598383,295,EVM,mRNA,5794624,8603401,295,1.00
ptg004009l,10743210,10743510,300,EVM,mRNA,10713006,10744495,300,1.00
ptg004010l,835549,835884,335,EVM,mRNA,666710,1283192,335,1.00
ptg004010l,844256,844529,273,EVM,mRNA,666710,1283192,273,1.00
ptg004012l,1112998,1113326,328,EVM,mRNA,424597,1477528,328,1.00
ptg004012l,2585530,2585785,255,EVM,mRNA,2577275,4449036,255,1.00
ptg004012l,3337233,3337527,294,EVM,mRNA,2577275,4449036,294,1.00
ptg004013l,389121,389442,321,EVM,mRNA,296224,399316,321,1.00
ptg004013l,1743557,1743820,263,EVM,mRNA,1608480,1972225,263,1.00
ptg004014l,93351,93654,303,EVM,mRNA,91453,234388,303,1.00
ptg004014l,1944225,1944500,275,EVM,mRNA,1841612,2098893,275,1.00
ptg004014l,4068709,4068990,281,EVM,mRNA,3977168,4119364,281,1.00
ptg004014l,5199064,5199353,289,EVM,mRNA,5034866,5560932,289,1.00
ptg004014l,5375084,5375375,291,EVM,mRNA,5034866,5560932,291,1.00
ptg004016l,590558,590862,304,EVM,mRNA,52311,1102168,304,1.00
ptg004016l,3106434,3106704,270,EVM,mRNA,2729083,3890725,270,1.00
ptg004016l,3452880,3453151,271,EVM,mRNA,2729083,3890725,271,1.00
ptg004016l,3767347,3767622,275,EVM,mRNA,2729083,3890725,275,1.00
ptg004016l,4240206,4240522,316,EVM,mRNA,4132855,5839420,316,1.00
ptg004016l,4569629,4569945,316,EVM,mRNA,4132855,5839420,316,1.00
ptg004016l,4908470,4908726,256,EVM,mRNA,4132855,5839420,256,1.00
ptg004017l,796722,797024,302,EVM,mRNA,666682,901904,302,1.00
ptg004022l,191389,191689,300,EVM,mRNA,57095,231478,300,1.00
ptg004022l,210451,210764,313,EVM,mRNA,57095,231478,313,1.00
ptg004022l,1793017,1793330,313,EVM,mRNA,1758357,2408889,313,1.00
ptg004022l,2035524,2035844,320,EVM,mRNA,1758357,2408889,320,1.00
ptg004022l,4245380,4245704,324,EVM,mRNA,2994458,5377577,324,1.00
ptg004022l,4712966,4713241,275,EVM,mRNA,2994458,5377577,275,1.00
ptg004022l,4886144,4886412,268,EVM,mRNA,2994458,5377577,268,1.00
ptg004026l,1110174,1110446,272,EVM,mRNA,818507,1401714,272,1.00
ptg004026l,1369578,1369881,303,EVM,mRNA,818507,1401714,303,1.00
ptg004029l,653200,653519,319,EVM,mRNA,201695,911869,319,1.00
ptg004030l,1395102,1395419,317,EVM,mRNA,896575,1566280,317,1.00
ptg004033l,863151,863423,272,EVM,mRNA,451751,1129458,272,1.00
ptg004033l,864417,864727,310,EVM,mRNA,451751,1129458,310,1.00
ptg004033l,2092116,2092391,275,EVM,mRNA,1688768,2102719,275,1.00
ptg004033l,3050024,3050342,318,EVM,mRNA,2925464,3611515,318,1.00
ptg004033l,3447382,3447698,316,EVM,mRNA,2925464,3611515,316,1.00
ptg004033l,4863542,4863866,324,EVM,mRNA,4360432,5680505,324,1.00
ptg004033l,4909568,4909886,318,EVM,mRNA,4360432,5680505,318,1.00
ptg004033l,5191568,5191875,307,EVM,mRNA,4360432,5680505,307,1.00
ptg004033l,5595432,5595696,264,EVM,mRNA,4360432,5680505,264,1.00
ptg004033l,5867230,5867556,326,EVM,mRNA,5764684,5906869,326,1.00
ptg004033l,7575763,7576045,282,EVM,mRNA,5914587,7658177,282,1.00
ptg004033l,9262967,9263262,295,EVM,mRNA,9064190,9429530,295,1.00
ptg004033l,9865594,9865896,302,EVM,mRNA,9844117,10382327,302,1.00
ptg004035l,549410,549714,304,EVM,mRNA,471321,676193,304,1.00
ptg004036l,798346,798646,300,EVM,mRNA,157811,4263700,300,1.00
ptg004036l,1081470,1081787,317,EVM,mRNA,157811,4263700,317,1.00
ptg004036l,2244691,2244833,142,EVM,mRNA,157811,4263700,142,1.00
ptg004036l,2846524,2846831,307,EVM,mRNA,157811,4263700,307,1.00
ptg004036l,4220517,4220765,248,EVM,mRNA,157811,4263700,248,1.00
ptg004037l,1246931,1247229,298,EVM,mRNA,1203306,1728081,298,1.00
ptg004040l,586220,586503,283,EVM,mRNA,537157,1293927,283,1.00
ptg004049l,2470112,2470405,293,EVM,mRNA,2058039,2921543,293,1.00
ptg004049l,2790366,2790645,279,EVM,mRNA,2058039,2921543,279,1.00
ptg004057l,378328,378618,290,EVM,mRNA,234928,809788,290,1.00
ptg004057l,538644,538955,311,EVM,mRNA,234928,809788,311,1.00
ptg004058l,146009,146306,297,EVM,mRNA,858,1237656,297,1.00
ptg004058l,342808,343117,309,EVM,mRNA,858,1237656,309,1.00
ptg004058l,1230939,1231262,323,EVM,mRNA,858,1237656,323,1.00
ptg004059l,400345,400648,303,EVM,mRNA,68003,742297,303,1.00
ptg004060l,787828,788133,305,EVM,mRNA,3530,793573,305,1.00
ptg004060l,4878221,4878520,299,EVM,mRNA,4554222,4958666,299,1.00
ptg004061l,284549,284826,277,EVM,mRNA,191442,322614,277,1.00
ptg004061l,1490723,1491037,314,EVM,mRNA,573607,2153584,314,1.00
ptg004061l,1815017,1815315,298,EVM,mRNA,573607,2153584,298,1.00
ptg004062l,606191,606516,325,EVM,mRNA,301773,1462119,325,1.00
ptg004064l,480144,480453,309,EVM,mRNA,11612,1683676,309,1.00
ptg004065l,1593470,1593794,324,EVM,mRNA,168202,2716464,324,1.00
ptg004067l,1203677,1203931,254,EVM,mRNA,409134,1481384,254,1.00
ptg004068l,487377,487657,280,EVM,mRNA,358603,654346,280,1.00
ptg004069l,1662383,1662705,322,EVM,mRNA,1491059,2042583,322,1.00
ptg004070l,880697,880974,277,EVM,mRNA,618241,1017002,277,1.00
ptg004070l,1864148,1864419,271,EVM,mRNA,1812503,2047442,271,1.00
ptg004071l,226688,227018,330,EVM,mRNA,224963,821445,330,1.00
ptg004071l,2369131,2369432,301,EVM,mRNA,2317616,2824458,301,1.00
ptg004071l,2409859,2410138,279,EVM,mRNA,2317616,2824458,279,1.00
ptg004072l,2691382,2691670,288,EVM,mRNA,2561920,2899285,288,1.00
ptg004072l,2880754,2881024,270,EVM,mRNA,2561920,2899285,270,1.00
ptg004074l,57409,57675,266,EVM,mRNA,54828,707927,266,1.00
ptg004080l,1017448,1017759,311,EVM,mRNA,106396,1095234,311,1.00
ptg004080l,3162610,3162932,322,EVM,mRNA,2769604,4990873,322,1.00
ptg004080l,4335879,4336193,314,EVM,mRNA,2769604,4990873,314,1.00
ptg004082l,2479579,2479858,279,EVM,mRNA,2392651,3888349,279,1.00
ptg004082l,2614869,2615175,306,EVM,mRNA,2392651,3888349,306,1.00
ptg004082l,3671362,3671659,297,EVM,mRNA,2392651,3888349,297,1.00
ptg004082l,7228146,7228419,273,EVM,mRNA,6849981,7412775,273,1.00
ptg004083l,1853854,1854170,316,EVM,mRNA,1691105,2008657,316,1.00
ptg004085l,433156,433437,281,EVM,mRNA,301940,527091,281,1.00
ptg004086l,928571,928873,302,EVM,mRNA,918733,1185038,302,1.00
ptg004088l,1149224,1149520,296,EVM,mRNA,887634,2834187,296,1.00
ptg004091l,440318,440654,336,EVM,mRNA,434907,841257,336,1.00
ptg004091l,731039,731343,304,EVM,mRNA,434907,841257,304,1.00
ptg004091l,826406,826721,315,EVM,mRNA,434907,841257,315,1.00
ptg004091l,1735418,1735720,302,EVM,mRNA,1201523,1989519,302,1.00
ptg004092l,1412753,1413065,312,EVM,mRNA,1229577,2073329,312,1.00
ptg004092l,1989169,1989454,285,EVM,mRNA,1229577,2073329,285,1.00
ptg004092l,3463035,3463341,306,EVM,mRNA,3367607,3692475,306,1.00
ptg004092l,3464626,3464914,288,EVM,mRNA,3367607,3692475,288,1.00
ptg004093l,880209,880494,285,EVM,mRNA,721016,1018815,285,1.00
ptg004103l,288330,288619,289,EVM,mRNA,10115,499516,289,1.00
ptg004103l,304874,305175,301,EVM,mRNA,10115,499516,301,1.00
ptg004104l,169794,170091,297,EVM,mRNA,96851,492615,297,1.00
ptg004104l,240932,241228,296,EVM,mRNA,96851,492615,296,1.00
ptg004107l,904781,905062,281,EVM,mRNA,486294,1361953,281,1.00
ptg004107l,1649955,1650242,287,EVM,mRNA,1425708,2086060,287,1.00
ptg004107l,4728333,4728623,290,EVM,mRNA,4327980,5368134,290,1.00
ptg004107l,4918793,4919100,307,EVM,mRNA,4327980,5368134,307,1.00
ptg004107l,5271012,5271321,309,EVM,mRNA,4327980,5368134,309,1.00
ptg004109l,1381613,1381912,299,EVM,mRNA,1298189,1957676,299,1.00
ptg004109l,1583467,1583761,294,EVM,mRNA,1298189,1957676,294,1.00
ptg004109l,1619956,1620248,292,EVM,mRNA,1298189,1957676,292,1.00
ptg004109l,1632429,1632728,299,EVM,mRNA,1298189,1957676,299,1.00
ptg004109l,1639717,1640008,291,EVM,mRNA,1298189,1957676,291,1.00
ptg004109l,1756463,1756790,327,EVM,mRNA,1298189,1957676,327,1.00
ptg004111l,1750461,1750750,289,EVM,mRNA,892833,3215844,289,1.00
ptg004111l,2296753,2297044,291,EVM,mRNA,892833,3215844,291,1.00
ptg004111l,2469899,2470204,305,EVM,mRNA,892833,3215844,305,1.00
ptg004111l,2793569,2793875,306,EVM,mRNA,892833,3215844,306,1.00
ptg004111l,2938034,2938357,323,EVM,mRNA,892833,3215844,323,1.00
ptg004111l,3002860,3003161,301,EVM,mRNA,892833,3215844,301,1.00
ptg004113l,543854,544136,282,EVM,mRNA,520872,1077175,282,1.00
ptg004113l,1757987,1758275,288,EVM,mRNA,1283664,1844996,288,1.00
ptg004115l,868374,868676,302,EVM,mRNA,4053,1689964,302,1.00
ptg004115l,2000413,2000674,261,EVM,mRNA,2000419,2475707,256,0.98
ptg004118l,1960465,1960787,322,EVM,mRNA,1842888,3532470,322,1.00
ptg004119l,2371690,2371971,281,EVM,mRNA,2362614,2742548,281,1.00
ptg004119l,4199363,4199654,291,EVM,mRNA,3996896,5629942,291,1.00
ptg004119l,6595269,6595568,299,EVM,mRNA,5820369,6822884,299,1.00
ptg004119l,6777543,6777838,295,EVM,mRNA,5820369,6822884,295,1.00
ptg004121l,617692,618005,313,EVM,mRNA,248937,1742635,313,1.00
ptg004121l,813118,813408,290,EVM,mRNA,248937,1742635,290,1.00
ptg004121l,1568579,1568887,308,EVM,mRNA,248937,1742635,308,1.00
ptg004122l,502774,503048,274,EVM,mRNA,118581,828206,274,1.00
ptg004123l,141096,141423,327,EVM,mRNA,35490,353228,327,1.00
ptg004129l,900179,900485,306,EVM,mRNA,607687,1346304,306,1.00
ptg004129l,1324245,1324572,327,EVM,mRNA,607687,1346304,327,1.00
ptg004132l,3142946,3143255,309,EVM,mRNA,2039099,3169456,309,1.00
ptg004132l,3151963,3152241,278,EVM,mRNA,2039099,3169456,278,1.00
ptg004135l,947619,947947,328,EVM,mRNA,30819,1892973,328,1.00
ptg004136l,514724,515023,299,EVM,mRNA,505809,1190124,299,1.00
ptg004136l,1056465,1056751,286,EVM,mRNA,505809,1190124,286,1.00
ptg004136l,1557741,1558072,331,EVM,mRNA,1372251,2595482,331,1.00
ptg004136l,2063520,2063845,325,EVM,mRNA,1372251,2595482,325,1.00
ptg004137l,35574,35876,302,EVM,mRNA,467,1284279,302,1.00
ptg004137l,293764,294080,316,EVM,mRNA,467,1284279,316,1.00
ptg004137l,1619104,1619414,310,EVM,mRNA,1443587,1905400,310,1.00
ptg004137l,3014030,3014321,291,EVM,mRNA,2124677,3338133,291,1.00
ptg004139l,3467447,3467762,315,EVM,mRNA,2326963,3540108,315,1.00
ptg004145l,765781,766057,276,EVM,mRNA,698467,3413002,276,1.00
ptg004145l,2340389,2340663,274,EVM,mRNA,698467,3413002,274,1.00
ptg004145l,2622702,2623014,312,EVM,mRNA,698467,3413002,312,1.00
ptg004148l,308454,308766,312,EVM,mRNA,179791,1333576,312,1.00
ptg004148l,1018039,1018363,324,EVM,mRNA,179791,1333576,324,1.00
ptg004148l,1117775,1118085,310,EVM,mRNA,179791,1333576,310,1.00
ptg004149l,2097443,2097743,300,EVM,mRNA,2074744,2136436,300,1.00
ptg004153l,7982,8300,318,EVM,mRNA,7776,8243,261,0.82
ptg004157l,1906609,1906882,273,EVM,mRNA,1607559,3048693,273,1.00
ptg004158l,1437264,1437570,306,EVM,mRNA,942146,1853576,306,1.00
ptg004162l,3152651,3152959,308,EVM,mRNA,2234382,3208124,308,1.00
ptg004164l,388074,388385,311,EVM,mRNA,316259,1155892,311,1.00
ptg004164l,554917,555255,338,EVM,mRNA,316259,1155892,338,1.00
ptg004164l,557358,557665,307,EVM,mRNA,316259,1155892,307,1.00
ptg004164l,1497492,1497767,275,EVM,mRNA,1281726,1502778,275,1.00
ptg004165l,664577,664894,317,EVM,mRNA,298662,1629681,317,1.00
ptg004165l,1244527,1244851,324,EVM,mRNA,298662,1629681,324,1.00
ptg004167l,903683,903960,277,EVM,mRNA,796348,1057633,277,1.00
ptg004167l,1039419,1039746,327,EVM,mRNA,796348,1057633,327,1.00
ptg004172l,1319711,1320055,344,EVM,mRNA,1005368,1324970,344,1.00
ptg004172l,1813600,1813893,293,EVM,mRNA,1738919,2060631,293,1.00
ptg004172l,2052010,2052312,302,EVM,mRNA,1738919,2060631,302,1.00
ptg004172l,4557814,4558090,276,EVM,mRNA,4463414,4713024,276,1.00
ptg004174l,385763,386037,274,EVM,mRNA,260322,830930,274,1.00
ptg004180l,775865,776164,299,EVM,mRNA,4014,1390470,299,1.00
ptg004180l,803316,803603,287,EVM,mRNA,4014,1390470,287,1.00
ptg004183l,749420,749729,309,EVM,mRNA,522891,1580684,309,1.00
ptg004187l,310894,311206,312,EVM,mRNA,18388,919885,312,1.00
ptg004189l,552493,552797,304,EVM,mRNA,334570,944113,304,1.00
ptg004189l,837043,837355,312,EVM,mRNA,334570,944113,312,1.00
ptg004189l,3242653,3242962,309,EVM,mRNA,3103707,3507020,309,1.00
ptg004189l,4293130,4293445,315,EVM,mRNA,3790233,4527711,315,1.00
ptg004192l,1298139,1298441,302,EVM,mRNA,717658,2626707,302,1.00
ptg004192l,1485029,1485331,302,EVM,mRNA,717658,2626707,302,1.00
ptg004192l,1511803,1512095,292,EVM,mRNA,717658,2626707,292,1.00
ptg004192l,4086783,4087107,324,EVM,mRNA,2865708,4486234,324,1.00
ptg004194l,2631489,2631788,299,EVM,mRNA,2544320,3097677,299,1.00
ptg004194l,2670837,2671132,295,EVM,mRNA,2544320,3097677,295,1.00
ptg004194l,3077733,3078037,304,EVM,mRNA,2544320,3097677,304,1.00
ptg004199l,6672602,6672890,288,EVM,mRNA,6579632,6887844,288,1.00
ptg004200l,2792174,2792490,316,EVM,mRNA,2652301,2975621,316,1.00
ptg004200l,3657672,3657959,287,EVM,mRNA,3478132,4222780,287,1.00
ptg004200l,3898486,3898789,303,EVM,mRNA,3478132,4222780,303,1.00
ptg004200l,4124304,4124612,308,EVM,mRNA,3478132,4222780,308,1.00
ptg004206l,1055638,1055954,316,EVM,mRNA,926341,1962110,316,1.00
ptg004206l,1087693,1088000,307,EVM,mRNA,926341,1962110,307,1.00
ptg004208l,295945,296217,272,EVM,mRNA,110571,1268601,272,1.00
ptg004208l,552800,553118,318,EVM,mRNA,110571,1268601,318,1.00
ptg004208l,683906,684213,307,EVM,mRNA,110571,1268601,307,1.00
ptg004208l,1205929,1206236,307,EVM,mRNA,110571,1268601,307,1.00
ptg004208l,1672930,1673243,313,EVM,mRNA,1477809,6042696,313,1.00
ptg004208l,2252497,2252780,283,EVM,mRNA,1477809,6042696,283,1.00
ptg004208l,2572233,2572550,317,EVM,mRNA,1477809,6042696,317,1.00
ptg004208l,3237307,3237587,280,EVM,mRNA,1477809,6042696,280,1.00
ptg004208l,3975609,3975935,326,EVM,mRNA,1477809,6042696,326,1.00
ptg004208l,4047987,4048301,314,EVM,mRNA,1477809,6042696,314,1.00
ptg004208l,4077252,4077542,290,EVM,mRNA,1477809,6042696,290,1.00
ptg004208l,4710281,4710582,301,EVM,mRNA,1477809,6042696,301,1.00
ptg004208l,5579613,5579891,278,EVM,mRNA,1477809,6042696,278,1.00
ptg004208l,5755314,5755622,308,EVM,mRNA,1477809,6042696,308,1.00
ptg004208l,5792279,5792556,277,EVM,mRNA,1477809,6042696,277,1.00
ptg004208l,5801256,5801544,288,EVM,mRNA,1477809,6042696,288,1.00
ptg004214l,772057,772395,338,EVM,mRNA,741850,809922,338,1.00
ptg004214l,1570854,1571169,315,EVM,mRNA,1566966,1580198,315,1.00
ptg004218l,574433,574729,296,EVM,mRNA,481956,1283403,296,1.00
ptg004222l,602174,602470,296,EVM,mRNA,40810,2897900,296,1.00
ptg004222l,1211936,1212199,263,EVM,mRNA,40810,2897900,263,1.00
ptg004222l,2199782,2200064,282,EVM,mRNA,40810,2897900,282,1.00
ptg004222l,2823546,2823832,286,EVM,mRNA,40810,2897900,286,1.00
ptg004225l,374544,374866,322,EVM,mRNA,8589,1075856,322,1.00
ptg004231l,78465,78751,286,EVM,mRNA,984,387544,286,1.00
ptg004233l,4283327,4283620,293,EVM,mRNA,4231467,4453980,293,1.00
ptg004233l,4909462,4909757,295,EVM,mRNA,4808962,4961364,295,1.00
ptg004234l,978823,979129,306,EVM,mRNA,789142,1057872,306,1.00
ptg004239l,693236,693533,297,EVM,mRNA,576859,1246483,297,1.00
ptg004239l,2043572,2043853,281,EVM,mRNA,1292522,2758841,281,1.00
ptg004243l,528341,528607,266,EVM,mRNA,285625,645945,266,1.00
ptg004245l,192608,192908,300,EVM,mRNA,167583,2927682,300,1.00
ptg004245l,679467,679779,312,EVM,mRNA,167583,2927682,312,1.00
ptg004245l,2366598,2366883,285,EVM,mRNA,167583,2927682,285,1.00
ptg004245l,3334680,3334983,303,EVM,mRNA,3264963,3403390,303,1.00
ptg004248l,445472,445748,276,EVM,mRNA,408746,648758,276,1.00
ptg004248l,849526,849846,320,EVM,mRNA,846021,1052939,320,1.00
ptg004253l,138871,139156,285,EVM,mRNA,43310,418028,285,1.00
ptg004257l,840783,841089,306,EVM,mRNA,757474,1397895,306,1.00
ptg004261l,1800201,1800461,260,EVM,mRNA,1145946,1865563,260,1.00
ptg004262l,185141,185424,283,EVM,mRNA,16795,318230,283,1.00
ptg004262l,226586,226891,305,EVM,mRNA,16795,318230,305,1.00
ptg004262l,538147,538441,294,EVM,mRNA,336933,977305,294,1.00
ptg004263l,1165108,1165403,295,EVM,mRNA,1069906,1428589,295,1.00
ptg004263l,1246944,1247259,315,EVM,mRNA,1069906,1428589,315,1.00
ptg004264l,485874,486162,288,EVM,mRNA,7050,860983,288,1.00
ptg004265l,691354,691665,311,EVM,mRNA,356955,691991,311,1.00
ptg004270l,412285,412573,288,EVM,mRNA,340629,489419,288,1.00
ptg004272l,422685,423012,327,EVM,mRNA,166256,427609,327,1.00
ptg004277l,757504,757817,313,EVM,mRNA,614921,860009,313,1.00
ptg004277l,765187,765474,287,EVM,mRNA,614921,860009,287,1.00
ptg004277l,1258263,1258547,284,EVM,mRNA,1254227,2778674,284,1.00
ptg004277l,1388792,1389098,306,EVM,mRNA,1254227,2778674,306,1.00
ptg004277l,1389170,1389495,325,EVM,mRNA,1254227,2778674,325,1.00
ptg004279l,491787,492114,327,EVM,mRNA,86880,739302,327,1.00
ptg004288l,2019620,2019929,309,EVM,mRNA,1701172,2339458,309,1.00
ptg004290l,352351,352641,290,EVM,mRNA,302242,568583,290,1.00
ptg004291l,2864236,2864523,287,EVM,mRNA,2835802,4120390,287,1.00
ptg004291l,3060865,3061143,278,EVM,mRNA,2835802,4120390,278,1.00
ptg004291l,3268408,3268723,315,EVM,mRNA,2835802,4120390,315,1.00
ptg004294l,2726432,2726717,285,EVM,mRNA,2016236,3672230,285,1.00
ptg004296l,812030,812356,326,EVM,mRNA,457020,1523775,326,1.00
ptg004298l,508583,508883,300,EVM,mRNA,94580,3090353,300,1.00
ptg004298l,2925985,2926266,281,EVM,mRNA,94580,3090353,281,1.00
ptg004300l,1778520,1778801,281,EVM,mRNA,1627300,3555035,281,1.00
ptg004300l,2163283,2163583,300,EVM,mRNA,1627300,3555035,300,1.00
ptg004300l,2565313,2565617,304,EVM,mRNA,1627300,3555035,304,1.00
ptg004300l,2884169,2884449,280,EVM,mRNA,1627300,3555035,280,1.00
ptg004300l,4170943,4171256,313,EVM,mRNA,3947927,4272601,313,1.00
ptg004302l,2907648,2907927,279,EVM,mRNA,1139525,3700933,279,1.00
ptg004302l,3083481,3083801,320,EVM,mRNA,1139525,3700933,320,1.00
ptg004302l,3299106,3299374,268,EVM,mRNA,1139525,3700933,268,1.00
ptg004303l,5477959,5478261,302,EVM,mRNA,5163616,5597528,302,1.00
ptg004308l,2552605,2552912,307,EVM,mRNA,2550059,2648891,307,1.00
ptg004317l,276639,276943,304,EVM,mRNA,260034,278092,304,1.00
ptg004317l,1912628,1912954,326,EVM,mRNA,1579360,3877451,326,1.00
ptg004317l,2758271,2758567,296,EVM,mRNA,1579360,3877451,296,1.00
ptg004317l,3162204,3162502,298,EVM,mRNA,1579360,3877451,298,1.00
ptg004319l,2916713,2917016,303,EVM,mRNA,2697766,3552174,303,1.00
ptg004319l,3439364,3439668,304,EVM,mRNA,2697766,3552174,304,1.00
ptg004321l,4042246,4042551,305,EVM,mRNA,3762395,4080851,305,1.00
ptg004323l,2641461,2641767,306,EVM,mRNA,2234433,3009892,306,1.00
ptg004326l,3195647,3195947,300,EVM,mRNA,1017044,4222598,300,1.00
ptg004327l,1154908,1155196,288,EVM,mRNA,422499,2129628,288,1.00
ptg004327l,1160563,1160871,308,EVM,mRNA,422499,2129628,308,1.00
ptg004327l,1896576,1896893,317,EVM,mRNA,422499,2129628,317,1.00
ptg004327l,3626830,3627098,268,EVM,mRNA,2716114,3677866,268,1.00
ptg004327l,4701978,4702245,267,EVM,mRNA,4372377,4783242,267,1.00
ptg004328l,3699404,3699702,298,EVM,mRNA,2646989,4696891,298,1.00
ptg004328l,3903136,3903453,317,EVM,mRNA,2646989,4696891,317,1.00
ptg004328l,4312796,4313081,285,EVM,mRNA,2646989,4696891,285,1.00
ptg004338l,741080,741405,325,EVM,mRNA,460911,2032574,325,1.00
ptg004338l,1380049,1380357,308,EVM,mRNA,460911,2032574,308,1.00
ptg004338l,1667743,1668059,316,EVM,mRNA,460911,2032574,316,1.00
ptg004342l,79646,79926,280,EVM,mRNA,194,110224,280,1.00
ptg004342l,455838,456140,302,EVM,mRNA,424358,659271,302,1.00
ptg004343l,1429372,1429680,308,EVM,mRNA,3569,1486021,308,1.00
ptg004344l,184934,185215,281,EVM,mRNA,19046,526037,281,1.00
ptg004346l,1366398,1366699,301,EVM,mRNA,1215074,1381314,301,1.00
ptg004348l,431041,431367,326,EVM,mRNA,15343,768059,326,1.00
ptg004348l,743909,744203,294,EVM,mRNA,15343,768059,294,1.00
ptg004349l,1435108,1435371,263,EVM,mRNA,1013080,1611886,263,1.00
ptg004351l,819118,819435,317,EVM,mRNA,3430,2194788,317,1.00
ptg004351l,1284429,1284712,283,EVM,mRNA,3430,2194788,283,1.00
ptg004351l,1699313,1699594,281,EVM,mRNA,3430,2194788,281,1.00
ptg004358l,266436,266759,323,EVM,mRNA,69930,411584,323,1.00
ptg004358l,2889203,2889525,322,EVM,mRNA,1860744,3295280,322,1.00
ptg004358l,3597651,3597953,302,EVM,mRNA,3296666,3653098,302,1.00
ptg004362l,1123278,1123562,284,EVM,mRNA,567233,1657623,284,1.00
ptg004362l,1219360,1219675,315,EVM,mRNA,567233,1657623,315,1.00
ptg004362l,3192405,3192717,312,EVM,mRNA,2757684,3433046,312,1.00
ptg004362l,3404811,3405114,303,EVM,mRNA,2757684,3433046,303,1.00
ptg004362l,4502439,4502711,272,EVM,mRNA,3696979,6906988,272,1.00
ptg004362l,5417582,5417917,335,EVM,mRNA,3696979,6906988,335,1.00
ptg004362l,5853303,5853598,295,EVM,mRNA,3696979,6906988,295,1.00
ptg004362l,6842967,6843240,273,EVM,mRNA,3696979,6906988,273,1.00
ptg004368l,881649,881942,293,EVM,mRNA,790872,2602256,293,1.00
ptg004374l,1439629,1439942,313,EVM,mRNA,1385662,1572161,313,1.00
ptg004376l,1036275,1036550,275,EVM,mRNA,167618,1110188,275,1.00
ptg004376l,1971088,1971400,312,EVM,mRNA,1868224,2169030,312,1.00
ptg004379l,1221395,1221697,302,EVM,mRNA,767166,1360068,302,1.00
ptg004382l,3380912,3381228,316,EVM,mRNA,2813238,5228051,316,1.00
ptg004383l,1328265,1328580,315,EVM,mRNA,447004,1681414,315,1.00
ptg004384l,369461,369732,271,EVM,mRNA,64812,639039,271,1.00
ptg004386l,912269,912590,321,EVM,mRNA,441961,1848222,321,1.00
ptg004387l,1139464,1139745,281,EVM,mRNA,414079,1433406,281,1.00
ptg004387l,1421561,1421889,328,EVM,mRNA,414079,1433406,328,1.00
ptg004388l,188020,188346,326,EVM,mRNA,6964,828494,326,1.00
ptg004388l,602740,603044,304,EVM,mRNA,6964,828494,304,1.00
ptg004392l,515297,515596,299,EVM,mRNA,470986,1117484,299,1.00
ptg004392l,871193,871493,300,EVM,mRNA,470986,1117484,300,1.00
ptg004394l,1131171,1131453,282,EVM,mRNA,20964,1131486,282,1.00
ptg004398l,1639387,1639703,316,EVM,mRNA,1524864,1896439,316,1.00
ptg004399l,3107238,3107525,287,EVM,mRNA,3006210,3146230,287,1.00
ptg004399l,3823067,3823349,282,EVM,mRNA,3752908,4018006,282,1.00
ptg004401l,531319,531613,294,EVM,mRNA,412296,558288,294,1.00
ptg004402l,1065788,1066090,302,EVM,mRNA,748555,1391789,302,1.00
ptg004402l,1378849,1379160,311,EVM,mRNA,748555,1391789,311,1.00
ptg004404l,400603,400893,290,EVM,mRNA,354477,2114912,290,1.00
ptg004404l,1089704,1090008,304,EVM,mRNA,354477,2114912,304,1.00
ptg004409l,1561620,1561934,314,EVM,mRNA,1117916,2896105,314,1.00
ptg004409l,2409042,2409328,286,EVM,mRNA,1117916,2896105,286,1.00
ptg004410l,971326,971614,288,EVM,mRNA,62962,1031651,288,1.00
ptg004411l,1871814,1872116,302,EVM,mRNA,1788734,1916620,302,1.00
ptg004412l,1022264,1022602,338,EVM,mRNA,999985,1308781,338,1.00
ptg004416l,818959,819293,334,EVM,mRNA,716467,971516,334,1.00
ptg004417l,1014667,1014953,286,EVM,mRNA,890490,1559544,286,1.00
ptg004421l,1406727,1407035,308,EVM,mRNA,1222123,1641557,308,1.00
ptg004428l,1550627,1550944,317,EVM,mRNA,1263214,2437437,317,1.00
ptg004428l,2366788,2367100,312,EVM,mRNA,1263214,2437437,312,1.00
ptg004429l,1224799,1225093,294,EVM,mRNA,1091185,1481191,294,1.00
ptg004429l,1383675,1383974,299,EVM,mRNA,1091185,1481191,299,1.00
ptg004431l,439275,439570,295,EVM,mRNA,6039,768088,295,1.00
ptg004434l,1907087,1907369,282,EVM,mRNA,814260,2191099,282,1.00
ptg004434l,3944517,3944820,303,EVM,mRNA,3237593,4351762,303,1.00
ptg004434l,4529240,4529547,307,EVM,mRNA,4479443,7901610,307,1.00
ptg004434l,5192737,5193026,289,EVM,mRNA,4479443,7901610,289,1.00
ptg004439l,189309,189615,306,EVM,mRNA,11127,558373,306,1.00
ptg004439l,194146,194452,306,EVM,mRNA,11127,558373,306,1.00
ptg004439l,421339,421626,287,EVM,mRNA,11127,558373,287,1.00
ptg004439l,469800,470099,299,EVM,mRNA,11127,558373,299,1.00
ptg004441l,191050,191328,278,EVM,mRNA,88742,200855,278,1.00
ptg004443l,498805,499105,300,EVM,mRNA,469639,697700,300,1.00
ptg004443l,608016,608318,302,EVM,mRNA,469639,697700,302,1.00
ptg004443l,684645,684968,323,EVM,mRNA,469639,697700,323,1.00
ptg004445l,34888,35202,314,EVM,mRNA,40,168558,314,1.00
ptg004445l,382018,382338,320,EVM,mRNA,269066,414177,320,1.00
ptg004445l,3876918,3877217,299,EVM,mRNA,3559126,4350054,299,1.00
ptg004445l,4154627,4154909,282,EVM,mRNA,3559126,4350054,282,1.00
ptg004446l,1186527,1186813,286,EVM,mRNA,1148729,1431503,286,1.00
ptg004447l,249518,249812,294,EVM,mRNA,206032,430536,294,1.00
ptg004447l,796993,797282,289,EVM,mRNA,757661,924603,289,1.00
ptg004449l,333747,334075,328,EVM,mRNA,267730,392671,328,1.00
ptg004449l,809236,809490,254,EVM,mRNA,572277,2620580,254,1.00
ptg004449l,1840468,1840789,321,EVM,mRNA,572277,2620580,321,1.00
ptg004449l,1913143,1913468,325,EVM,mRNA,572277,2620580,325,1.00
ptg004449l,2074809,2075101,292,EVM,mRNA,572277,2620580,292,1.00
ptg004449l,2509633,2509946,313,EVM,mRNA,572277,2620580,313,1.00
ptg004456l,412981,413296,315,EVM,mRNA,9100,815363,315,1.00
ptg004456l,1293986,1294301,315,EVM,mRNA,1291079,1510050,315,1.00
ptg004456l,1377280,1377578,298,EVM,mRNA,1291079,1510050,298,1.00
ptg004456l,3148864,3149141,277,EVM,mRNA,2903973,3178597,277,1.00
ptg004457l,892068,892374,306,EVM,mRNA,780784,1806901,306,1.00
ptg004457l,1253469,1253768,299,EVM,mRNA,780784,1806901,299,1.00
ptg004460l,589436,589741,305,EVM,mRNA,266709,1091674,305,1.00
ptg004460l,671124,671442,318,EVM,mRNA,266709,1091674,318,1.00
ptg004460l,1434222,1434525,303,EVM,mRNA,1118110,2095518,303,1.00
ptg004460l,1931006,1931304,298,EVM,mRNA,1118110,2095518,298,1.00
ptg004460l,2042014,2042297,283,EVM,mRNA,1118110,2095518,283,1.00
ptg004465l,754287,754581,294,EVM,mRNA,202214,989444,294,1.00
ptg004468l,148388,148707,319,EVM,mRNA,22,3271886,319,1.00
ptg004468l,315180,315486,306,EVM,mRNA,22,3271886,306,1.00
ptg004468l,1532535,1532836,301,EVM,mRNA,22,3271886,301,1.00
ptg004468l,1942111,1942392,281,EVM,mRNA,22,3271886,281,1.00
ptg004468l,2479601,2479895,294,EVM,mRNA,22,3271886,294,1.00
ptg004468l,2584829,2585135,306,EVM,mRNA,22,3271886,306,1.00
ptg004471l,2863220,2863515,295,EVM,mRNA,2847223,3060783,295,1.00
ptg004472l,2141801,2142118,317,EVM,mRNA,1137011,3359476,317,1.00
ptg004472l,2875500,2875787,287,EVM,mRNA,1137011,3359476,287,1.00
ptg004472l,3281162,3281476,314,EVM,mRNA,1137011,3359476,314,1.00
ptg004476l,59749,60027,278,EVM,mRNA,48600,248407,278,1.00
ptg004478l,1446713,1446984,271,EVM,mRNA,1446556,2492204,271,1.00
ptg004478l,2456184,2456483,299,EVM,mRNA,1446556,2492204,299,1.00
ptg004478l,3085837,3086129,292,EVM,mRNA,2927765,3282484,292,1.00
ptg004479l,2639734,2640014,280,EVM,mRNA,25783,2800755,280,1.00
ptg004479l,3010991,3011279,288,EVM,mRNA,2855671,3581172,288,1.00
ptg004482l,374517,374831,314,EVM,mRNA,368105,498680,314,1.00
ptg004482l,469403,469732,329,EVM,mRNA,368105,498680,329,1.00
ptg004482l,4975644,4975972,328,EVM,mRNA,4947373,5025775,328,1.00
ptg004484l,110090,110431,341,EVM,mRNA,75267,299078,341,1.00
ptg004486l,601484,601772,288,EVM,mRNA,8782,1139520,288,1.00
ptg004486l,2251059,2251392,333,EVM,mRNA,1903667,2486721,333,1.00
ptg004487l,1361866,1362165,299,EVM,mRNA,917554,2005660,299,1.00
ptg004487l,1501521,1501817,296,EVM,mRNA,917554,2005660,296,1.00
ptg004487l,1712041,1712340,299,EVM,mRNA,917554,2005660,299,1.00
ptg004488l,1176023,1176341,318,EVM,mRNA,848325,1518366,318,1.00
ptg004489l,3483131,3483422,291,EVM,mRNA,2313272,3576003,291,1.00
ptg004491l,1243732,1244048,316,EVM,mRNA,1147982,1857129,316,1.00
ptg004493l,1386072,1386388,316,EVM,mRNA,1325521,2271128,316,1.00
ptg004493l,2100891,2101181,290,EVM,mRNA,1325521,2271128,290,1.00
ptg004495l,182536,182832,296,EVM,mRNA,21835,211033,296,1.00
ptg004495l,417570,417868,298,EVM,mRNA,357643,511573,298,1.00
ptg004495l,1154142,1154434,292,EVM,mRNA,1032636,1274619,292,1.00
ptg004497l,647584,647885,301,EVM,mRNA,417956,1031288,301,1.00
ptg004499l,2448909,2449208,299,EVM,mRNA,1880407,2591540,299,1.00
ptg004500l,92106,92416,310,EVM,mRNA,3020,443128,310,1.00
ptg004500l,905230,905548,318,EVM,mRNA,663614,2307806,318,1.00
ptg004501l,1600045,1600353,308,EVM,mRNA,1253102,1653546,308,1.00
ptg004502l,1120054,1120347,293,EVM,mRNA,946169,2119653,293,1.00
ptg004502l,1146755,1147039,284,EVM,mRNA,946169,2119653,284,1.00
ptg004510l,719562,719862,300,EVM,mRNA,216,1413287,300,1.00
ptg004512l,2165196,2165502,306,EVM,mRNA,1793105,2265765,306,1.00
ptg004512l,4779209,4779537,328,EVM,mRNA,4012842,5034870,328,1.00
ptg004521l,771927,772235,308,EVM,mRNA,211189,1007227,308,1.00
ptg004521l,4790428,4790727,299,EVM,mRNA,4168398,5255632,299,1.00
ptg004522l,384081,384382,301,EVM,mRNA,110273,387063,301,1.00
ptg004523l,1116592,1116887,295,EVM,mRNA,1095119,1308571,295,1.00
ptg004523l,4985638,4985964,326,EVM,mRNA,4705394,6593159,326,1.00
ptg004523l,5516527,5516807,280,EVM,mRNA,4705394,6593159,280,1.00
ptg004523l,5605638,5605951,313,EVM,mRNA,4705394,6593159,313,1.00
ptg004527l,329218,329533,315,EVM,mRNA,257334,691116,315,1.00
ptg004527l,525769,526080,311,EVM,mRNA,257334,691116,311,1.00
ptg004528l,1311513,1311791,278,EVM,mRNA,1215074,2230871,278,1.00
ptg004530l,1159424,1159721,297,EVM,mRNA,231573,1294077,297,1.00
ptg004530l,1938387,1938705,318,EVM,mRNA,1821601,2320146,318,1.00
ptg004530l,3313503,3313779,276,EVM,mRNA,3307605,3797944,276,1.00
ptg004530l,5069849,5070170,321,EVM,mRNA,4540665,7357994,321,1.00
ptg004530l,7088479,7088799,320,EVM,mRNA,4540665,7357994,320,1.00
ptg004540l,438192,438517,325,EVM,mRNA,148876,665142,325,1.00
ptg004540l,569446,569719,273,EVM,mRNA,148876,665142,273,1.00
ptg004541l,16479,16760,281,EVM,mRNA,1171,113349,281,1.00
ptg004543l,2564337,2564617,280,EVM,mRNA,2378145,2798800,280,1.00
ptg004543l,2592299,2592614,315,EVM,mRNA,2378145,2798800,315,1.00
ptg004544l,2591951,2592262,311,EVM,mRNA,2592024,2744368,239,0.77
ptg004544l,3923580,3923859,279,EVM,mRNA,3336816,3951504,279,1.00
ptg004546l,179516,179837,321,EVM,mRNA,175013,224381,321,1.00
ptg004551l,4411538,4411844,306,EVM,mRNA,4283148,4830287,306,1.00
ptg004552l,500569,500881,312,EVM,mRNA,175016,698238,312,1.00
ptg004558l,572874,573135,261,EVM,mRNA,548153,675637,261,1.00
ptg004558l,2300227,2300531,304,EVM,mRNA,1525267,2307774,304,1.00
ptg004563l,2218703,2219037,334,EVM,mRNA,1898788,2867756,334,1.00
ptg004563l,2328593,2328904,311,EVM,mRNA,1898788,2867756,311,1.00
ptg004563l,2431791,2432090,299,EVM,mRNA,1898788,2867756,299,1.00
ptg004563l,3841390,3841698,308,EVM,mRNA,3749136,4080221,308,1.00
ptg004567l,1928223,1928535,312,EVM,mRNA,728196,2120351,312,1.00
ptg004567l,3100839,3101125,286,EVM,mRNA,2719614,4220125,286,1.00
ptg004567l,3203759,3204080,321,EVM,mRNA,2719614,4220125,321,1.00
ptg004567l,4206871,4207198,327,EVM,mRNA,2719614,4220125,327,1.00
ptg004569l,2004886,2005164,278,EVM,mRNA,1802431,2087003,278,1.00
ptg004571l,609288,609594,306,EVM,mRNA,1836,2685022,306,1.00
ptg004571l,695046,695375,329,EVM,mRNA,1836,2685022,329,1.00
ptg004571l,829960,830256,296,EVM,mRNA,1836,2685022,296,1.00
ptg004571l,903030,903320,290,EVM,mRNA,1836,2685022,290,1.00
ptg004571l,1338950,1339269,319,EVM,mRNA,1836,2685022,319,1.00
ptg004571l,1512859,1513179,320,EVM,mRNA,1836,2685022,320,1.00
ptg004571l,1931603,1931899,296,EVM,mRNA,1836,2685022,296,1.00
ptg004577l,919406,919699,293,EVM,mRNA,909259,2952857,293,1.00
ptg004577l,2901401,2901722,321,EVM,mRNA,909259,2952857,321,1.00
ptg004578l,156030,156358,328,EVM,mRNA,41407,252672,328,1.00
ptg004584l,67009,67299,290,EVM,mRNA,12854,928640,290,1.00
ptg004584l,1941651,1941963,312,EVM,mRNA,1850633,3849435,312,1.00
ptg004584l,3347183,3347502,319,EVM,mRNA,1850633,3849435,319,1.00
ptg004586l,378200,378533,333,EVM,mRNA,93177,537132,333,1.00
ptg004586l,378200,378533,333,GeneWise,mRNA,35819,605468,333,1.00
ptg004589l,543521,543836,315,EVM,mRNA,66311,604962,315,1.00
ptg004591l,628337,628632,295,EVM,mRNA,537496,636492,295,1.00
ptg004594l,236659,236983,324,EVM,mRNA,102809,2587493,324,1.00
ptg004594l,2471616,2471945,329,EVM,mRNA,102809,2587493,329,1.00
ptg004597l,154321,154641,320,EVM,mRNA,10479,1509566,320,1.00
ptg004597l,2904489,2904788,299,EVM,mRNA,2520622,4501655,299,1.00
ptg004597l,3708965,3709276,311,EVM,mRNA,2520622,4501655,311,1.00
ptg004597l,4281249,4281540,291,EVM,mRNA,2520622,4501655,291,1.00
ptg004597l,5088203,5088493,290,EVM,mRNA,4695832,5294179,290,1.00
ptg004598l,519420,519740,320,EVM,mRNA,6872,732664,320,1.00
ptg004600l,714969,715279,310,EVM,mRNA,445586,1946041,310,1.00
ptg004600l,1818346,1818661,315,EVM,mRNA,445586,1946041,315,1.00
ptg004602l,94241,94537,296,EVM,mRNA,17488,202563,296,1.00
ptg004605l,524105,524423,318,EVM,mRNA,8367,544506,318,1.00
ptg004608l,1738381,1738693,312,EVM,mRNA,1390790,2113034,312,1.00
ptg004615l,202420,202704,284,EVM,mRNA,136091,851919,284,1.00
ptg004619l,1075511,1075832,321,EVM,mRNA,1008158,1174751,321,1.00
ptg004619l,2877767,2877995,228,EVM,mRNA,2495126,4527779,228,1.00
ptg004619l,3517186,3517494,308,EVM,mRNA,2495126,4527779,308,1.00
ptg004619l,3617706,3618015,309,EVM,mRNA,2495126,4527779,309,1.00
ptg004619l,4053979,4054298,319,EVM,mRNA,2495126,4527779,319,1.00
ptg004626l,686940,687212,272,EVM,mRNA,662551,2663274,272,1.00
ptg004626l,1395190,1395510,320,EVM,mRNA,662551,2663274,320,1.00
ptg004626l,2638365,2638702,337,EVM,mRNA,662551,2663274,337,1.00
ptg004627l,166842,167141,299,EVM,mRNA,166494,316579,299,1.00
ptg004632l,1298705,1298992,287,EVM,mRNA,791945,2859767,287,1.00
ptg004632l,1486911,1487198,287,EVM,mRNA,791945,2859767,287,1.00
ptg004632l,2151480,2151765,285,EVM,mRNA,791945,2859767,285,1.00
ptg004632l,2311580,2311911,331,EVM,mRNA,791945,2859767,331,1.00
ptg004632l,2351937,2352231,294,EVM,mRNA,791945,2859767,294,1.00
ptg004634l,1070854,1071162,308,EVM,mRNA,15534,1223528,308,1.00
ptg004636l,146872,147196,324,EVM,mRNA,94717,217410,324,1.00
ptg004637l,564567,564843,276,EVM,mRNA,467704,1535718,276,1.00
ptg004637l,768197,768493,296,EVM,mRNA,467704,1535718,296,1.00
ptg004639l,864392,864703,311,EVM,mRNA,311336,1084663,311,1.00
ptg004639l,2068369,2068634,265,EVM,mRNA,1716945,2746544,265,1.00
ptg004639l,2278453,2278758,305,EVM,mRNA,1716945,2746544,305,1.00
ptg004639l,2961864,2962141,277,EVM,mRNA,2897407,3119459,277,1.00
ptg004640l,1180641,1180945,304,EVM,mRNA,1045133,1997614,304,1.00
ptg004640l,1769277,1769584,307,EVM,mRNA,1045133,1997614,307,1.00
ptg004641l,1384433,1384744,311,EVM,mRNA,1329719,3005210,311,1.00
ptg004641l,1669989,1670287,298,EVM,mRNA,1329719,3005210,298,1.00
ptg004641l,2018572,2018893,321,EVM,mRNA,1329719,3005210,321,1.00
ptg004641l,5374850,5375163,313,EVM,mRNA,4349501,5431707,313,1.00
ptg004641l,6335209,6335536,327,EVM,mRNA,5702433,8070706,327,1.00
ptg004641l,7270447,7270756,309,EVM,mRNA,5702433,8070706,309,1.00
ptg004641l,7305822,7306101,279,EVM,mRNA,5702433,8070706,279,1.00
ptg004645l,867767,868060,293,EVM,mRNA,71739,1599005,293,1.00
ptg004645l,1959069,1959390,321,EVM,mRNA,1795067,2442739,321,1.00
ptg004645l,2062795,2063112,317,EVM,mRNA,1795067,2442739,317,1.00
ptg004647l,1905460,1905768,308,EVM,mRNA,1777633,2075409,308,1.00
ptg004648l,941400,941681,281,EVM,mRNA,933118,958799,281,1.00
ptg004649l,5034711,5035027,316,EVM,mRNA,4951685,5377984,316,1.00
ptg004650l,1563241,1563535,294,EVM,mRNA,231700,1767564,294,1.00
ptg004650l,1588667,1588992,325,EVM,mRNA,231700,1767564,325,1.00
ptg004650l,2049918,2050226,308,EVM,mRNA,1988218,3132872,308,1.00
ptg004650l,3026633,3026933,300,EVM,mRNA,1988218,3132872,300,1.00
ptg004650l,3026639,3026933,294,EVM,mRNA,1988218,3132872,294,1.00
ptg004658l,1521131,1521445,314,EVM,mRNA,1498612,1649817,314,1.00
ptg004660l,218120,218406,286,EVM,mRNA,5904,297319,286,1.00
ptg004660l,522026,522336,310,EVM,mRNA,383848,913518,310,1.00
ptg004660l,840620,840917,297,EVM,mRNA,383848,913518,297,1.00
ptg004661l,588203,588469,266,EVM,mRNA,433664,820118,266,1.00
ptg004661l,1487320,1487619,299,EVM,mRNA,1463710,1846947,299,1.00
ptg004663l,3046691,3047009,318,EVM,mRNA,2981575,3786902,318,1.00
ptg004665l,147018,147323,305,EVM,mRNA,46663,167121,305,1.00
ptg004665l,798197,798478,281,EVM,mRNA,732008,1197973,281,1.00
ptg004667l,881017,881301,284,EVM,mRNA,390571,1420413,284,1.00
ptg004667l,1099143,1099431,288,EVM,mRNA,390571,1420413,288,1.00
ptg004667l,3280121,3280395,274,EVM,mRNA,3265263,4186207,274,1.00
ptg004668l,1491047,1491348,301,EVM,mRNA,225700,1971403,301,1.00
ptg004670l,1642905,1643181,276,EVM,mRNA,1633962,1674538,276,1.00
ptg004672l,442844,443157,313,EVM,mRNA,419040,548325,313,1.00
ptg004672l,1381431,1381752,321,EVM,mRNA,1253755,1460705,321,1.00
ptg004674l,291656,291974,318,EVM,mRNA,120859,790178,318,1.00
ptg004674l,395757,396059,302,EVM,mRNA,120859,790178,302,1.00
ptg004674l,2674428,2674727,299,EVM,mRNA,2335598,2723555,299,1.00
ptg004677l,464755,465045,290,EVM,mRNA,371085,508034,290,1.00
ptg004679l,437447,437763,316,EVM,mRNA,324539,1614052,316,1.00
ptg004679l,587336,587652,316,EVM,mRNA,324539,1614052,316,1.00
ptg004679l,1487361,1487651,290,EVM,mRNA,324539,1614052,290,1.00
ptg004679l,2801438,2801752,314,EVM,mRNA,2269547,4536508,314,1.00
ptg004679l,5581854,5582156,302,EVM,mRNA,4979298,5758135,302,1.00
ptg004681l,252256,252578,322,EVM,mRNA,67499,324245,322,1.00
ptg004681l,1544035,1544318,283,EVM,mRNA,1443774,2258331,283,1.00
ptg004681l,1608281,1608567,286,EVM,mRNA,1443774,2258331,286,1.00
ptg004682l,640630,640930,300,EVM,mRNA,160703,1383750,300,1.00
ptg004682l,1294650,1294948,298,EVM,mRNA,160703,1383750,298,1.00
ptg004682l,2961595,2961906,311,EVM,mRNA,2347872,4345757,311,1.00
ptg004682l,3009162,3009477,315,EVM,mRNA,2347872,4345757,315,1.00
ptg004682l,3262714,3263060,346,EVM,mRNA,2347872,4345757,346,1.00
ptg004682l,4033931,4034239,308,EVM,mRNA,2347872,4345757,308,1.00
ptg004682l,4316297,4316620,323,EVM,mRNA,2347872,4345757,323,1.00
ptg004685l,1519482,1519789,307,EVM,mRNA,82300,2781646,307,1.00
ptg004685l,2098886,2099185,299,EVM,mRNA,82300,2781646,299,1.00
ptg004685l,2664759,2665058,299,EVM,mRNA,82300,2781646,299,1.00
ptg004685l,2927827,2928117,290,EVM,mRNA,2872081,2933025,290,1.00
ptg004687l,470958,471258,300,EVM,mRNA,110323,892049,300,1.00
ptg004687l,501731,502039,308,EVM,mRNA,110323,892049,308,1.00
ptg004687l,708837,709133,296,EVM,mRNA,110323,892049,296,1.00
ptg004688l,428927,429241,314,EVM,mRNA,1972,516910,314,1.00
ptg004688l,468971,469293,322,EVM,mRNA,1972,516910,322,1.00
ptg004689l,535143,535460,317,EVM,mRNA,415948,773153,317,1.00
ptg004693l,239754,240070,316,EVM,mRNA,166488,1211402,316,1.00
ptg004694l,473070,473368,298,EVM,mRNA,395649,2338019,298,1.00
ptg004694l,486518,486813,295,EVM,mRNA,395649,2338019,295,1.00
ptg004694l,678002,678297,295,EVM,mRNA,395649,2338019,295,1.00
ptg004694l,779184,779483,299,EVM,mRNA,395649,2338019,299,1.00
ptg004694l,1065590,1065889,299,EVM,mRNA,395649,2338019,299,1.00
ptg004694l,1401097,1401396,299,EVM,mRNA,395649,2338019,299,1.00
ptg004694l,1912767,1913066,299,EVM,mRNA,395649,2338019,299,1.00
ptg004694l,2130389,2130684,295,EVM,mRNA,395649,2338019,295,1.00
ptg004695l,823532,823831,299,EVM,mRNA,534575,932148,299,1.00
ptg004696l,466508,466819,311,EVM,mRNA,165160,2005780,311,1.00
ptg004696l,1080906,1081216,310,EVM,mRNA,165160,2005780,310,1.00
ptg004696l,1203497,1203811,314,EVM,mRNA,165160,2005780,314,1.00
ptg004696l,2844344,2844655,311,EVM,mRNA,2728230,4649010,311,1.00
ptg004696l,2924395,2924705,310,EVM,mRNA,2728230,4649010,310,1.00
ptg004696l,4010894,4011177,283,EVM,mRNA,2728230,4649010,283,1.00
ptg004696l,4385566,4385896,330,EVM,mRNA,2728230,4649010,330,1.00
ptg004699l,1224398,1224697,299,EVM,mRNA,362447,2197470,299,1.00
ptg004699l,1303139,1303458,319,EVM,mRNA,362447,2197470,319,1.00
ptg004699l,1383035,1383361,326,EVM,mRNA,362447,2197470,326,1.00
ptg004705l,1013019,1013318,299,EVM,mRNA,904861,2525802,299,1.00
ptg004705l,2421712,2422029,317,EVM,mRNA,904861,2525802,317,1.00
ptg004705l,3160852,3161145,293,EVM,mRNA,3010918,3268838,293,1.00
ptg004705l,3240756,3241073,317,EVM,mRNA,3010918,3268838,317,1.00
ptg004706l,1057674,1057973,299,EVM,mRNA,891293,1163167,299,1.00
ptg004708l,275732,276019,287,EVM,mRNA,26480,2452949,287,1.00
ptg004708l,658770,659065,295,EVM,mRNA,26480,2452949,295,1.00
ptg004708l,1437596,1437917,321,EVM,mRNA,26480,2452949,321,1.00
ptg004708l,1776231,1776530,299,EVM,mRNA,26480,2452949,299,1.00
ptg004712l,458318,458635,317,EVM,mRNA,366088,516206,317,1.00
ptg004712l,2540239,2540566,327,EVM,mRNA,2530616,2833063,327,1.00
ptg004712l,2759389,2759710,321,EVM,mRNA,2530616,2833063,321,1.00
ptg004715l,673023,673326,303,EVM,mRNA,650405,711526,303,1.00
ptg004717l,125577,125896,319,EVM,mRNA,99209,966295,319,1.00
ptg004717l,231162,231455,293,EVM,mRNA,99209,966295,293,1.00
ptg004717l,2159506,2159834,328,EVM,mRNA,2015309,3802189,328,1.00
ptg004717l,2760202,2760488,286,EVM,mRNA,2015309,3802189,286,1.00
ptg004717l,3493589,3493908,319,EVM,mRNA,2015309,3802189,319,1.00
ptg004717l,4518008,4518293,285,EVM,mRNA,4209836,5012012,285,1.00
ptg004717l,7490838,7491138,300,EVM,mRNA,7292665,9327428,300,1.00
ptg004717l,8159285,8159590,305,EVM,mRNA,7292665,9327428,305,1.00
ptg004717l,8542919,8543226,307,EVM,mRNA,7292665,9327428,307,1.00
ptg004723l,1782731,1782999,268,EVM,mRNA,1734472,2438573,268,1.00
ptg004728l,1326091,1326395,304,EVM,mRNA,863414,1953053,304,1.00
ptg004728l,1520321,1520628,307,EVM,mRNA,863414,1953053,307,1.00
ptg004728l,2694231,2694542,311,EVM,mRNA,2580816,3620034,311,1.00
ptg004733l,443376,443639,263,EVM,mRNA,81659,1353440,263,1.00
ptg004733l,570807,571102,295,EVM,mRNA,81659,1353440,295,1.00
ptg004733l,1032031,1032360,329,EVM,mRNA,81659,1353440,329,1.00
ptg004733l,1133206,1133475,269,EVM,mRNA,81659,1353440,269,1.00
ptg004736l,2088683,2088995,312,EVM,mRNA,2085216,2591465,312,1.00
ptg004742l,1308725,1309034,309,EVM,mRNA,1060832,1574261,309,1.00
ptg004742l,2652014,2652348,334,EVM,mRNA,2441164,3152823,334,1.00
ptg004743l,2051503,2051799,296,EVM,mRNA,1860563,2100391,296,1.00
ptg004745l,274193,274471,278,EVM,mRNA,195179,1226891,278,1.00
ptg004751l,56489,56797,308,EVM,mRNA,2586,540169,308,1.00
ptg004752l,1145211,1145510,299,EVM,mRNA,893884,4887757,299,1.00
ptg004752l,1224661,1224984,323,EVM,mRNA,893884,4887757,323,1.00
ptg004752l,1346667,1346937,270,EVM,mRNA,893884,4887757,270,1.00
ptg004752l,2996991,2997300,309,EVM,mRNA,893884,4887757,309,1.00
ptg004752l,3976375,3976651,276,EVM,mRNA,893884,4887757,276,1.00
ptg004752l,4390436,4390719,283,EVM,mRNA,893884,4887757,283,1.00
ptg004756l,1025231,1025556,325,EVM,mRNA,770615,1155628,325,1.00
ptg004756l,1147173,1147448,275,EVM,mRNA,770615,1155628,275,1.00
ptg004756l,2408934,2409230,296,EVM,mRNA,1779539,3901465,296,1.00
ptg004757l,428676,428983,307,EVM,mRNA,290145,1412049,307,1.00
ptg004757l,468791,469098,307,EVM,mRNA,290145,1412049,307,1.00
ptg004757l,620951,621271,320,EVM,mRNA,290145,1412049,320,1.00
ptg004757l,1862766,1863085,319,EVM,mRNA,1830928,2873936,319,1.00
ptg004758l,162472,162747,275,EVM,mRNA,158971,180578,275,1.00
ptg004758l,594616,594924,308,EVM,mRNA,443284,2230188,308,1.00
ptg004758l,1882043,1882338,295,EVM,mRNA,443284,2230188,295,1.00
ptg004758l,2140179,2140443,264,EVM,mRNA,443284,2230188,264,1.00
ptg004764l,605807,606105,298,EVM,mRNA,462628,810824,298,1.00
ptg004769l,851763,852069,306,EVM,mRNA,436298,2212654,306,1.00
ptg004769l,1402591,1402891,300,EVM,mRNA,436298,2212654,300,1.00
ptg004769l,1713001,1713288,287,EVM,mRNA,436298,2212654,287,1.00
ptg004769l,1731747,1732077,330,EVM,mRNA,436298,2212654,330,1.00
ptg004772l,630431,630715,284,EVM,mRNA,151279,1507523,284,1.00
ptg004772l,2347092,2347416,324,EVM,mRNA,1894621,3077302,324,1.00
ptg004775l,1517394,1517693,299,EVM,mRNA,4116,1641830,299,1.00
ptg004778l,957649,957951,302,EVM,mRNA,952222,1118915,302,1.00
ptg004782l,1352822,1353124,302,EVM,mRNA,829043,1827923,302,1.00
ptg004782l,2147460,2147774,314,EVM,mRNA,1907023,2718857,314,1.00
ptg004782l,2408389,2408704,315,EVM,mRNA,1907023,2718857,315,1.00
ptg004782l,3206270,3206571,301,EVM,mRNA,3150261,3284162,301,1.00
ptg004782l,3926540,3926830,290,EVM,mRNA,3312120,4093720,290,1.00
ptg004783l,1610484,1610785,301,EVM,mRNA,746371,1751470,301,1.00
ptg004787l,399251,399588,337,EVM,mRNA,50930,404350,337,1.00
ptg004787l,2245058,2245350,292,EVM,mRNA,2140844,2375403,292,1.00
ptg004788l,498890,499168,278,EVM,mRNA,393807,2217492,278,1.00
ptg004788l,776476,776768,292,EVM,mRNA,393807,2217492,292,1.00
ptg004788l,1966363,1966691,328,EVM,mRNA,393807,2217492,328,1.00
ptg004790l,1258071,1258371,300,EVM,mRNA,844202,1549669,300,1.00
ptg004797l,203277,203580,303,EVM,mRNA,27883,515782,303,1.00
ptg004801l,576158,576491,333,EVM,mRNA,69723,665454,333,1.00
ptg004803l,1018737,1019042,305,EVM,mRNA,329534,1607342,305,1.00
ptg004803l,2217215,2217491,276,EVM,mRNA,2080145,3136550,276,1.00
ptg004805l,767148,767453,305,EVM,mRNA,421364,870507,305,1.00
ptg004807l,1879506,1879790,284,EVM,mRNA,1648363,2169066,284,1.00
ptg004808l,168029,168304,275,EVM,mRNA,15546,667171,275,1.00
ptg004816l,442259,442558,299,EVM,mRNA,196202,772468,299,1.00
ptg004816l,1110410,1110743,333,EVM,mRNA,968021,2093634,333,1.00
ptg004816l,1514220,1514543,323,EVM,mRNA,968021,2093634,323,1.00
ptg004816l,2942004,2942298,294,EVM,mRNA,2807800,3828588,294,1.00
ptg004816l,2956359,2956620,261,EVM,mRNA,2807800,3828588,261,1.00
ptg004816l,3402560,3402819,259,EVM,mRNA,2807800,3828588,259,1.00
ptg004816l,3563138,3563417,279,EVM,mRNA,2807800,3828588,279,1.00
ptg004819l,322594,322879,285,EVM,mRNA,300570,572128,285,1.00
ptg004822l,1066323,1066609,286,EVM,mRNA,796005,1629151,286,1.00
ptg004822l,1366448,1366756,308,EVM,mRNA,796005,1629151,308,1.00
ptg004822l,1544927,1545215,288,EVM,mRNA,796005,1629151,288,1.00
ptg004826l,1947495,1947812,317,EVM,mRNA,43174,1955840,317,1.00
ptg004826l,2312318,2312627,309,EVM,mRNA,2139115,2343654,309,1.00
ptg004827l,594367,594671,304,EVM,mRNA,573294,598197,304,1.00
ptg004829l,791666,791949,283,EVM,mRNA,322725,1979281,283,1.00
ptg004829l,1948845,1949184,339,EVM,mRNA,322725,1979281,339,1.00
ptg004829l,2261413,2261707,294,EVM,mRNA,2202646,2279663,294,1.00
ptg004834l,1362895,1363185,290,EVM,mRNA,395151,2106481,290,1.00
ptg004840l,165513,165793,280,EVM,mRNA,118543,823424,280,1.00
ptg004840l,889995,890305,310,EVM,mRNA,880974,1197882,310,1.00
ptg004841l,1353526,1353827,301,EVM,mRNA,1116701,1716670,301,1.00
ptg004841l,2228019,2228317,298,EVM,mRNA,2208965,3505003,298,1.00
ptg004841l,2456317,2456592,275,EVM,mRNA,2208965,3505003,275,1.00
ptg004841l,3383910,3384189,279,EVM,mRNA,2208965,3505003,279,1.00
ptg004841l,4526983,4527250,267,EVM,mRNA,4105168,4767702,267,1.00
ptg004845l,273171,273483,312,EVM,mRNA,210497,1087270,312,1.00
ptg004845l,569159,569470,311,EVM,mRNA,210497,1087270,311,1.00
ptg004846l,1275575,1275896,321,EVM,mRNA,1082201,1534517,321,1.00
ptg004846l,1537162,1537447,285,EVM,mRNA,1537008,1537424,262,0.92
ptg004851l,3960907,3961215,308,EVM,mRNA,3090058,4311514,308,1.00
ptg004852l,641408,641715,307,EVM,mRNA,93190,807843,307,1.00
ptg004857l,1178760,1179070,310,EVM,mRNA,6187,1507274,310,1.00
ptg004857l,1284954,1285261,307,EVM,mRNA,6187,1507274,307,1.00
ptg004857l,1293209,1293493,284,EVM,mRNA,6187,1507274,284,1.00
ptg004857l,1431048,1431323,275,EVM,mRNA,6187,1507274,275,1.00
ptg004858l,84606,84911,305,EVM,mRNA,23339,1084671,305,1.00
ptg004862l,234154,234460,306,EVM,mRNA,28843,343339,306,1.00
ptg004864l,925533,925822,289,EVM,mRNA,845150,1178900,289,1.00
ptg004870l,2226427,2226715,288,EVM,mRNA,1495471,2238898,288,1.00
ptg004871l,7022436,7022749,313,EVM,mRNA,6720025,8362028,313,1.00
ptg004871l,7350103,7350416,313,EVM,mRNA,6720025,8362028,313,1.00
ptg004871l,7431926,7432232,306,EVM,mRNA,6720025,8362028,306,1.00
ptg004872l,1310526,1310824,298,EVM,mRNA,1282425,1459753,298,1.00
ptg004878l,2864972,2865293,321,EVM,mRNA,2442787,4721055,321,1.00
ptg004878l,4486939,4487252,313,EVM,mRNA,2442787,4721055,313,1.00
ptg004878l,7895776,7896067,291,EVM,mRNA,7875484,8024267,291,1.00
ptg004880l,2078865,2079189,324,EVM,mRNA,1155879,3066040,324,1.00
ptg004881l,561447,561761,314,EVM,mRNA,296452,570931,314,1.00
ptg004881l,1017364,1017675,311,EVM,mRNA,831301,1119141,311,1.00
ptg004881l,1703230,1703529,299,EVM,mRNA,1306198,1912380,299,1.00
ptg004882l,337198,337478,280,EVM,mRNA,3427,619433,280,1.00
ptg004883l,2858108,2858393,285,EVM,mRNA,1799494,2966097,285,1.00
ptg004885l,200373,200674,301,EVM,mRNA,50535,448158,301,1.00
ptg004885l,1107707,1108021,314,EVM,mRNA,727294,1833059,314,1.00
ptg004886l,383832,384122,290,EVM,mRNA,275032,467435,290,1.00
ptg004886l,454139,454451,312,EVM,mRNA,275032,467435,312,1.00
ptg004887l,359261,359533,272,EVM,mRNA,192514,361146,272,1.00
ptg004888l,1839507,1839805,298,EVM,mRNA,1803896,1939016,298,1.00
ptg004888l,1912822,1913122,300,EVM,mRNA,1803896,1939016,300,1.00
ptg004892l,375917,376197,280,EVM,mRNA,304209,433846,280,1.00
ptg004893l,359964,360253,289,EVM,mRNA,269632,493393,289,1.00
ptg004894l,128344,128636,292,EVM,mRNA,3007,305651,292,1.00
ptg004894l,147621,147936,315,EVM,mRNA,3007,305651,315,1.00
ptg004900l,729699,730025,326,EVM,mRNA,471624,881217,326,1.00
ptg004900l,1689187,1689504,317,EVM,mRNA,1508783,2456663,317,1.00
ptg004900l,2197981,2198275,294,EVM,mRNA,1508783,2456663,294,1.00
ptg004900l,3802879,3803153,274,EVM,mRNA,3035978,4621984,274,1.00
ptg004901l,552968,553263,295,EVM,mRNA,277354,2861080,295,1.00
ptg004901l,591139,591408,269,EVM,mRNA,277354,2861080,269,1.00
ptg004901l,2489036,2489370,334,EVM,mRNA,277354,2861080,334,1.00
ptg004903l,302857,303172,315,EVM,mRNA,1739,374040,315,1.00
ptg004903l,775146,775409,263,EVM,mRNA,421760,1960989,263,1.00
ptg004903l,1579667,1579986,319,EVM,mRNA,421760,1960989,319,1.00
ptg004905l,3016066,3016377,311,EVM,mRNA,2585882,3684415,311,1.00
ptg004905l,3569091,3569366,275,EVM,mRNA,2585882,3684415,275,1.00
ptg004908l,830481,830791,310,EVM,mRNA,767480,2476199,310,1.00
ptg004908l,929088,929367,279,EVM,mRNA,767480,2476199,279,1.00
ptg004908l,1525012,1525308,296,EVM,mRNA,767480,2476199,296,1.00
ptg004908l,2361585,2361917,332,EVM,mRNA,767480,2476199,332,1.00
ptg004910l,1341467,1341728,261,EVM,mRNA,1138710,1544534,261,1.00
ptg004910l,1366319,1366591,272,EVM,mRNA,1138710,1544534,272,1.00
ptg004911l,1058106,1058369,263,EVM,mRNA,920461,1298467,263,1.00
ptg004911l,1161806,1162099,293,EVM,mRNA,920461,1298467,293,1.00
ptg004912l,177996,178275,279,EVM,mRNA,148484,181461,279,1.00
ptg004916l,426249,426545,296,EVM,mRNA,66805,595791,296,1.00
ptg004916l,497847,498147,300,EVM,mRNA,66805,595791,300,1.00
ptg004916l,558397,558693,296,EVM,mRNA,66805,595791,296,1.00
ptg004921l,904340,904678,338,EVM,mRNA,18428,1462340,338,1.00
ptg004921l,981642,981961,319,EVM,mRNA,18428,1462340,319,1.00
ptg004921l,1036011,1036327,316,EVM,mRNA,18428,1462340,316,1.00
ptg004921l,4518887,4519210,323,EVM,mRNA,4472477,4783357,323,1.00
ptg004921l,5306157,5306474,317,EVM,mRNA,5282959,5985567,317,1.00
ptg004923l,2142131,2142401,270,EVM,mRNA,2027767,2338414,270,1.00
ptg004923l,3444381,3444697,316,EVM,mRNA,2456235,3525221,316,1.00
ptg004923l,3453384,3453684,300,EVM,mRNA,2456235,3525221,300,1.00
ptg004923l,3470518,3470849,331,EVM,mRNA,2456235,3525221,331,1.00
ptg004924l,289158,289445,287,EVM,mRNA,242225,937910,287,1.00
ptg004926l,2318898,2319227,329,EVM,mRNA,2004535,2566160,329,1.00
ptg004926l,2372658,2372938,280,EVM,mRNA,2004535,2566160,280,1.00
ptg004927l,1205266,1205587,321,EVM,mRNA,262614,3165531,321,1.00
ptg004927l,1679230,1679526,296,EVM,mRNA,262614,3165531,296,1.00
ptg004927l,3646779,3647061,282,EVM,mRNA,3454145,4405156,282,1.00
ptg004927l,3706004,3706298,294,EVM,mRNA,3454145,4405156,294,1.00
ptg004927l,3796965,3797264,299,EVM,mRNA,3454145,4405156,299,1.00
ptg004927l,4005195,4005498,303,EVM,mRNA,3454145,4405156,303,1.00
ptg004929l,143234,143545,311,EVM,mRNA,74203,1758446,311,1.00
ptg004929l,578556,578830,274,EVM,mRNA,74203,1758446,274,1.00
ptg004929l,630104,630374,270,EVM,mRNA,74203,1758446,270,1.00
ptg004929l,1080389,1080687,298,EVM,mRNA,74203,1758446,298,1.00
ptg004931l,1694103,1694395,292,EVM,mRNA,70440,1735281,292,1.00
ptg004933l,795541,795837,296,EVM,mRNA,484373,1390419,296,1.00
ptg004933l,1814225,1814567,342,EVM,mRNA,1516603,3020269,342,1.00
ptg004933l,2098979,2099252,273,EVM,mRNA,1516603,3020269,273,1.00
ptg004933l,2916759,2917094,335,EVM,mRNA,1516603,3020269,335,1.00
ptg004939l,937953,938257,304,EVM,mRNA,707842,1272649,304,1.00
ptg004939l,1122664,1122986,322,EVM,mRNA,707842,1272649,322,1.00
ptg004940l,89749,90056,307,EVM,mRNA,82009,685086,307,1.00
ptg004940l,108034,108320,286,EVM,mRNA,82009,685086,286,1.00
ptg004940l,485867,486160,293,EVM,mRNA,82009,685086,293,1.00
ptg004947l,161555,161848,293,EVM,mRNA,62594,1491156,293,1.00
ptg004947l,495006,495320,314,EVM,mRNA,62594,1491156,314,1.00
ptg004947l,1903787,1904108,321,EVM,mRNA,1689766,2119241,321,1.00
ptg004948l,850208,850506,298,EVM,mRNA,501845,1493709,298,1.00
ptg004948l,1426092,1426379,287,EVM,mRNA,501845,1493709,287,1.00
ptg004950l,449645,449942,297,EVM,mRNA,7741,583856,297,1.00
ptg004950l,497492,497784,292,EVM,mRNA,7741,583856,292,1.00
ptg004950l,1322756,1323060,304,EVM,mRNA,1266386,1716257,304,1.00
ptg004950l,2426367,2426660,293,EVM,mRNA,2272674,2554047,293,1.00
ptg004955l,553192,553456,264,EVM,mRNA,460542,993893,264,1.00
ptg004955l,669699,670034,335,EVM,mRNA,460542,993893,335,1.00
ptg004955l,871195,871477,282,EVM,mRNA,460542,993893,282,1.00
ptg004955l,1441137,1441409,272,EVM,mRNA,1348772,1799501,272,1.00
ptg004955l,1544465,1544778,313,EVM,mRNA,1348772,1799501,313,1.00
ptg004955l,1758155,1758470,315,EVM,mRNA,1348772,1799501,315,1.00
ptg004956l,400957,401260,303,EVM,mRNA,196087,1175188,303,1.00
ptg004956l,1019171,1019448,277,EVM,mRNA,196087,1175188,277,1.00
ptg004958l,378490,378798,308,EVM,mRNA,135265,421174,308,1.00
ptg004962l,886147,886449,302,EVM,mRNA,455201,1032065,302,1.00
ptg004966l,1176123,1176425,302,EVM,mRNA,1157239,1311130,302,1.00
ptg004968l,2084348,2084642,294,EVM,mRNA,1264118,3142667,294,1.00
ptg004968l,2279672,2279990,318,EVM,mRNA,1264118,3142667,318,1.00
ptg004968l,3056900,3057188,288,EVM,mRNA,1264118,3142667,288,1.00
ptg004968l,4169767,4170077,310,EVM,mRNA,4164920,4227214,310,1.00
ptg004968l,4571637,4571969,332,EVM,mRNA,4465825,5100946,332,1.00
ptg004968l,5875680,5876006,326,EVM,mRNA,5471098,6487959,326,1.00
ptg004968l,6008262,6008549,287,EVM,mRNA,5471098,6487959,287,1.00
ptg004968l,8838430,8838743,313,EVM,mRNA,8308168,10192404,313,1.00
ptg004968l,11687923,11688238,315,EVM,mRNA,10598206,11688387,315,1.00
ptg004971l,2411705,2411982,277,EVM,mRNA,2294277,2692451,277,1.00
ptg004986l,479279,479559,280,EVM,mRNA,426570,988450,280,1.00
ptg004986l,486423,486703,280,EVM,mRNA,426570,988450,280,1.00
ptg004987l,145285,145589,304,EVM,mRNA,101883,421642,304,1.00
ptg004987l,1155399,1155716,317,EVM,mRNA,617184,1950553,317,1.00
ptg004990l,603912,604205,293,EVM,mRNA,178154,633426,293,1.00
ptg004990l,1300397,1300711,314,EVM,mRNA,1217164,2205515,314,1.00
ptg004990l,2205421,2205738,317,EVM,mRNA,1217164,2205515,94,0.30
ptg004991l,709568,709851,283,EVM,mRNA,180649,1546653,283,1.00
ptg004991l,1041196,1041492,296,EVM,mRNA,180649,1546653,296,1.00
ptg004994l,1120747,1121032,285,EVM,mRNA,1040267,1130215,285,1.00
ptg004995l,567150,567463,313,EVM,mRNA,191122,680456,313,1.00
ptg004995l,1273296,1273602,306,EVM,mRNA,935226,1547576,306,1.00
ptg004995l,1524756,1525046,290,EVM,mRNA,935226,1547576,290,1.00
ptg004995l,2947426,2947705,279,EVM,mRNA,2924806,3074669,279,1.00
ptg004997l,321735,322032,297,EVM,mRNA,139812,546536,297,1.00
ptg004998l,537966,538277,311,EVM,mRNA,509517,1102231,311,1.00
ptg004998l,686436,686735,299,EVM,mRNA,509517,1102231,299,1.00
ptg004999l,505169,505468,299,EVM,mRNA,447429,1180319,299,1.00
ptg004999l,677767,678066,299,EVM,mRNA,447429,1180319,299,1.00
ptg004999l,1149170,1149442,272,EVM,mRNA,447429,1180319,272,1.00
ptg005000l,527507,527818,311,EVM,mRNA,85017,2357222,311,1.00
ptg005000l,703672,703986,314,EVM,mRNA,85017,2357222,314,1.00
ptg005000l,1048639,1048963,324,EVM,mRNA,85017,2357222,324,1.00
ptg005001l,402356,402654,298,EVM,mRNA,312983,1257249,298,1.00
ptg005001l,753490,753778,288,EVM,mRNA,312983,1257249,288,1.00
ptg005001l,1020877,1021157,280,EVM,mRNA,312983,1257249,280,1.00
ptg005006l,2626787,2627088,301,EVM,mRNA,2478613,3926460,301,1.00
ptg005006l,4105351,4105642,291,EVM,mRNA,4027333,4133652,291,1.00
ptg005007l,2308031,2308330,299,EVM,mRNA,2288235,3154486,299,1.00
ptg005011l,2086754,2087052,298,EVM,mRNA,2029092,2119019,298,1.00
ptg005011l,3263399,3263709,310,EVM,mRNA,2299375,3296024,310,1.00
ptg005013l,520569,520876,307,EVM,mRNA,283538,1910864,307,1.00
ptg005013l,1574681,1574997,316,EVM,mRNA,283538,1910864,316,1.00
ptg005014l,989007,989326,319,EVM,mRNA,57140,1260671,319,1.00
ptg005018l,1080832,1081128,296,EVM,mRNA,224111,1570279,296,1.00
ptg005019l,2946433,2946734,301,EVM,mRNA,1032121,2948304,301,1.00
ptg005021l,754358,754682,324,EVM,mRNA,197410,2652157,324,1.00
ptg005021l,1669275,1669589,314,EVM,mRNA,197410,2652157,314,1.00
ptg005021l,2278439,2278733,294,EVM,mRNA,197410,2652157,294,1.00
ptg005022l,813876,814176,300,EVM,mRNA,712748,875403,300,1.00
ptg005024l,1113942,1114248,306,EVM,mRNA,294294,1115750,306,1.00
ptg005024l,1492271,1492570,299,EVM,mRNA,1417985,1533393,299,1.00
ptg005024l,3637267,3637528,261,EVM,mRNA,3504591,3653810,261,1.00
ptg005026l,3940005,3940297,292,EVM,mRNA,3502966,4630393,292,1.00
ptg005026l,3970308,3970615,307,EVM,mRNA,3502966,4630393,307,1.00
ptg005026l,4093574,4093848,274,EVM,mRNA,3502966,4630393,274,1.00
ptg005026l,4127803,4128089,286,EVM,mRNA,3502966,4630393,286,1.00
ptg005026l,5314209,5314511,302,EVM,mRNA,5188082,6169907,302,1.00
ptg005032l,1053061,1053366,305,EVM,mRNA,222771,2243787,305,1.00
ptg005034l,2863211,2863516,305,EVM,mRNA,1766501,3025021,305,1.00
ptg005035l,837665,837989,324,EVM,mRNA,134297,1088054,324,1.00
ptg005038l,168277,168561,284,EVM,mRNA,123721,3633932,284,1.00
ptg005038l,770898,771197,299,EVM,mRNA,123721,3633932,299,1.00
ptg005038l,977770,978071,301,EVM,mRNA,123721,3633932,301,1.00
ptg005038l,1945265,1945580,315,EVM,mRNA,123721,3633932,315,1.00
ptg005038l,2676298,2676593,295,EVM,mRNA,123721,3633932,295,1.00
ptg005038l,3314396,3314683,287,EVM,mRNA,123721,3633932,287,1.00
ptg005040l,885278,885575,297,EVM,mRNA,349594,1713401,297,1.00
ptg005041l,831580,831857,277,EVM,mRNA,804317,998321,277,1.00
ptg005042l,1017359,1017674,315,EVM,mRNA,868232,1387965,315,1.00
ptg005042l,1894448,1894740,292,EVM,mRNA,1894626,1912706,115,0.39
ptg005045l,141757,142069,312,EVM,mRNA,23226,192170,312,1.00
ptg005052l,561758,562068,310,EVM,mRNA,462851,2035929,310,1.00
ptg005052l,777578,777861,283,EVM,mRNA,462851,2035929,283,1.00
ptg005054l,2149563,2149889,326,EVM,mRNA,699780,3582749,326,1.00
ptg005054l,2290798,2291103,305,EVM,mRNA,699780,3582749,305,1.00
ptg005054l,3386539,3386847,308,EVM,mRNA,699780,3582749,308,1.00
ptg005055l,1724743,1725052,309,EVM,mRNA,688433,2343271,309,1.00
ptg005055l,3686207,3686532,325,EVM,mRNA,2571659,3987049,325,1.00
ptg005056l,777915,778228,313,EVM,mRNA,84367,1874138,313,1.00
ptg005056l,1479295,1479601,306,EVM,mRNA,84367,1874138,306,1.00
ptg005058l,1941649,1941949,300,EVM,mRNA,1721339,2103934,300,1.00
ptg005059l,1794826,1795134,308,EVM,mRNA,1498763,2342754,308,1.00
ptg005060l,704025,704314,289,EVM,mRNA,640398,720916,289,1.00
ptg005065l,269500,269829,329,EVM,mRNA,70115,839516,329,1.00
ptg005066l,733980,734263,283,EVM,mRNA,594051,1152836,283,1.00
ptg005066l,877173,877491,318,EVM,mRNA,594051,1152836,318,1.00
ptg005066l,3422133,3422452,319,EVM,mRNA,2575064,3467623,319,1.00
ptg005069l,3286088,3286386,298,EVM,mRNA,85436,4143763,298,1.00
ptg005069l,3910098,3910370,272,EVM,mRNA,85436,4143763,272,1.00
ptg005070l,1210176,1210475,299,EVM,mRNA,975469,1347329,299,1.00
ptg005070l,1939652,1939929,277,EVM,mRNA,1640482,2309665,277,1.00
ptg005070l,4862725,4863010,285,EVM,mRNA,4816478,4939794,285,1.00
ptg005072l,267323,267637,314,EVM,mRNA,71242,300430,314,1.00
ptg005072l,700099,700352,253,EVM,mRNA,556868,1748042,253,1.00
ptg005072l,1289543,1289816,273,EVM,mRNA,556868,1748042,273,1.00
ptg005072l,1313490,1313767,277,EVM,mRNA,556868,1748042,277,1.00
ptg005072l,2509863,2510162,299,EVM,mRNA,2038653,2653540,299,1.00
ptg005078l,629192,629505,313,EVM,mRNA,200547,1296655,313,1.00
ptg005078l,631668,631983,315,EVM,mRNA,200547,1296655,315,1.00
ptg005078l,775676,775965,289,EVM,mRNA,200547,1296655,289,1.00
ptg005078l,995962,996269,307,EVM,mRNA,200547,1296655,307,1.00
ptg005080l,1768607,1768890,283,EVM,mRNA,599566,2031801,283,1.00
ptg005080l,1937445,1937747,302,EVM,mRNA,599566,2031801,302,1.00
ptg005081l,1768972,1769247,275,EVM,mRNA,153378,1950136,275,1.00
ptg005082l,754923,755235,312,EVM,mRNA,618776,781600,312,1.00
ptg005083l,1461104,1461434,330,EVM,mRNA,1189501,1840481,330,1.00
ptg005084l,341301,341575,274,EVM,mRNA,234557,1201146,274,1.00
ptg005084l,626039,626337,298,EVM,mRNA,234557,1201146,298,1.00
ptg005086l,1473026,1473334,308,EVM,mRNA,764967,2864732,308,1.00
ptg005086l,4599444,4599771,327,EVM,mRNA,4552894,5379172,327,1.00
ptg005086l,4640818,4641118,300,EVM,mRNA,4552894,5379172,300,1.00
ptg005087l,528004,528290,286,EVM,mRNA,6265,529929,286,1.00
ptg005088l,5083912,5084210,298,EVM,mRNA,4806837,5402869,298,1.00
ptg005092l,1251297,1251614,317,EVM,mRNA,120625,1414653,317,1.00
ptg005094l,1092299,1092593,294,EVM,mRNA,47916,1363226,294,1.00
ptg005095l,623247,623552,305,EVM,mRNA,590346,1131411,305,1.00
ptg005095l,1615630,1615955,325,EVM,mRNA,1555916,2220672,325,1.00
ptg005095l,2192284,2192578,294,EVM,mRNA,1555916,2220672,294,1.00
ptg005095l,3142463,3142758,295,EVM,mRNA,2814243,3187160,295,1.00
ptg005097l,621325,621609,284,EVM,mRNA,119594,1059925,284,1.00
ptg005097l,954444,954759,315,EVM,mRNA,119594,1059925,315,1.00
ptg005097l,2472923,2473220,297,EVM,mRNA,1737717,3130951,297,1.00
ptg005100l,466332,466639,307,EVM,mRNA,34475,701966,307,1.00
ptg005100l,563877,564194,317,EVM,mRNA,34475,701966,317,1.00
ptg005100l,597106,597402,296,EVM,mRNA,34475,701966,296,1.00
ptg005105l,1133659,1133960,301,EVM,mRNA,696200,1246952,301,1.00
ptg005107l,311571,311887,316,EVM,mRNA,529,1171356,316,1.00
ptg005120l,924849,925129,280,EVM,mRNA,725078,2088398,280,1.00
ptg005121l,645550,645857,307,EVM,mRNA,551269,2352317,307,1.00
ptg005121l,1610684,1611007,323,EVM,mRNA,551269,2352317,323,1.00
ptg005121l,1768794,1769079,285,EVM,mRNA,551269,2352317,285,1.00
ptg005121l,1801044,1801347,303,EVM,mRNA,551269,2352317,303,1.00
ptg005121l,2789214,2789537,323,EVM,mRNA,2437030,2972089,323,1.00
ptg005121l,3220924,3221204,280,EVM,mRNA,3083167,4325324,280,1.00
ptg005121l,3709461,3709766,305,EVM,mRNA,3083167,4325324,305,1.00
ptg005121l,3906038,3906353,315,EVM,mRNA,3083167,4325324,315,1.00
ptg005122l,1115955,1116251,296,EVM,mRNA,386309,1159543,296,1.00
ptg005123l,101716,102024,308,EVM,mRNA,72694,331675,308,1.00
ptg005123l,222696,222988,292,EVM,mRNA,72694,331675,292,1.00
ptg005123l,770882,771193,311,EVM,mRNA,511675,2905193,311,1.00
ptg005123l,1312029,1312323,294,EVM,mRNA,511675,2905193,294,1.00
ptg005123l,1450572,1450894,322,EVM,mRNA,511675,2905193,322,1.00
ptg005123l,1910849,1911120,271,EVM,mRNA,511675,2905193,271,1.00
ptg005123l,2763700,2764016,316,EVM,mRNA,511675,2905193,316,1.00
ptg005125l,182688,183009,321,EVM,mRNA,129070,264334,321,1.00
ptg005125l,539903,540173,270,EVM,mRNA,390276,651745,270,1.00
ptg005125l,591153,591430,277,EVM,mRNA,390276,651745,277,1.00
ptg005127l,828006,828267,261,EVM,mRNA,629668,917115,261,1.00
ptg005129l,291570,291851,281,EVM,mRNA,111927,1038262,281,1.00
ptg005130l,1536370,1536651,281,EVM,mRNA,1277773,1581861,281,1.00
ptg005133l,74903,75218,315,EVM,mRNA,42772,145934,315,1.00
ptg005133l,1703051,1703363,312,EVM,mRNA,1338304,2043922,312,1.00
ptg005133l,1872801,1873091,290,EVM,mRNA,1338304,2043922,290,1.00
ptg005133l,1943213,1943483,270,EVM,mRNA,1338304,2043922,270,1.00
ptg005139l,279245,279523,278,EVM,mRNA,196610,330754,278,1.00
ptg005140l,859127,859403,276,EVM,mRNA,852447,1049558,276,1.00
ptg005140l,932398,932732,334,EVM,mRNA,852447,1049558,334,1.00
ptg005146l,1649233,1649544,311,EVM,mRNA,765664,2812475,311,1.00
ptg005146l,3284142,3284456,314,EVM,mRNA,3117708,3608613,314,1.00
ptg005146l,3513592,3513900,308,EVM,mRNA,3117708,3608613,308,1.00
ptg005147l,958922,959225,303,EVM,mRNA,933370,1336683,303,1.00
ptg005147l,1008797,1009126,329,EVM,mRNA,933370,1336683,329,1.00
ptg005150l,172088,172394,306,EVM,mRNA,30719,1265106,306,1.00
ptg005150l,236575,236873,298,EVM,mRNA,30719,1265106,298,1.00
ptg005150l,2094275,2094578,303,EVM,mRNA,1797268,2266273,303,1.00
ptg005150l,2141256,2141551,295,EVM,mRNA,1797268,2266273,295,1.00
ptg005152l,48114,48437,323,EVM,mRNA,16465,99915,323,1.00
ptg005152l,1081998,1082257,259,EVM,mRNA,981285,3424627,259,1.00
ptg005152l,1370784,1371082,298,EVM,mRNA,981285,3424627,298,1.00
ptg005152l,2439892,2440180,288,EVM,mRNA,981285,3424627,288,1.00
ptg005152l,2565611,2565888,277,EVM,mRNA,981285,3424627,277,1.00
ptg005155l,105809,106132,323,EVM,mRNA,27886,615794,323,1.00
ptg005155l,599457,599755,298,EVM,mRNA,27886,615794,298,1.00
ptg005159l,965815,966125,310,EVM,mRNA,674258,1183190,310,1.00
ptg005164l,809103,809386,283,EVM,mRNA,515140,1030471,283,1.00
ptg005165l,1131277,1131602,325,EVM,mRNA,762211,1148654,325,1.00
ptg005166l,889144,889429,285,EVM,mRNA,648725,924574,285,1.00
ptg005168l,1402931,1403234,303,EVM,mRNA,63880,1404684,303,1.00
ptg005169l,1715492,1715816,324,EVM,mRNA,386629,2090080,324,1.00
ptg005173l,2848758,2849035,277,EVM,mRNA,701356,5184848,277,1.00
ptg005173l,3519164,3519476,312,EVM,mRNA,701356,5184848,312,1.00
ptg005173l,3958285,3958598,313,EVM,mRNA,701356,5184848,313,1.00
ptg005173l,4330021,4330329,308,EVM,mRNA,701356,5184848,308,1.00
ptg005173l,6046112,6046422,310,EVM,mRNA,5470904,6675762,310,1.00
ptg005173l,6113892,6114172,280,EVM,mRNA,5470904,6675762,280,1.00
ptg005173l,7641285,7641584,299,EVM,mRNA,7454103,7840529,299,1.00
ptg005177l,1074444,1074724,280,EVM,mRNA,910568,2200174,280,1.00
ptg005177l,1542667,1542956,289,EVM,mRNA,910568,2200174,289,1.00
ptg005178l,907565,907879,314,EVM,mRNA,649337,1725284,314,1.00
ptg005180l,4151986,4152292,306,EVM,mRNA,3688693,4353635,306,1.00
ptg005180l,4195036,4195335,299,EVM,mRNA,3688693,4353635,299,1.00
ptg005189l,172792,173084,292,EVM,mRNA,1933,912061,292,1.00
ptg005194l,1353970,1354297,327,EVM,mRNA,322781,1639111,327,1.00
ptg005205l,784785,785075,290,EVM,mRNA,617123,1046190,290,1.00
ptg005207l,61999,62313,314,EVM,mRNA,47369,226578,314,1.00
ptg005211l,2320646,2320970,324,EVM,mRNA,1876899,2830605,324,1.00
ptg005220l,171728,172007,279,EVM,mRNA,275,545300,279,1.00
ptg005225l,778177,778501,324,EVM,mRNA,96293,848569,324,1.00
ptg005227l,1657307,1657622,315,EVM,mRNA,1196953,1998584,315,1.00
ptg005227l,2806771,2807069,298,EVM,mRNA,2327922,2939605,298,1.00
ptg005231l,137667,137976,309,EVM,mRNA,97173,1515547,309,1.00
ptg005231l,1905104,1905384,280,EVM,mRNA,1840120,2509111,280,1.00
ptg005232l,206745,207009,264,EVM,mRNA,42277,412240,264,1.00
ptg005235l,603169,603469,300,EVM,mRNA,488074,1070073,300,1.00
ptg005235l,2963711,2963999,288,EVM,mRNA,1435423,3224579,288,1.00
ptg005237l,833711,834023,312,EVM,mRNA,524400,842494,312,1.00
ptg005237l,1100376,1100681,305,EVM,mRNA,1098356,1104449,305,1.00
ptg005237l,2333055,2333377,322,EVM,mRNA,2314456,3426731,322,1.00
ptg005237l,2963201,2963526,325,EVM,mRNA,2314456,3426731,325,1.00
ptg005237l,3366452,3366737,285,EVM,mRNA,2314456,3426731,285,1.00
ptg005238l,366430,366746,316,EVM,mRNA,25877,1094837,316,1.00
ptg005239l,348033,348288,255,EVM,mRNA,43360,608653,255,1.00
ptg005243l,629059,629382,323,EVM,mRNA,215579,822426,323,1.00
ptg005243l,1414736,1415045,309,EVM,mRNA,1330520,2076870,309,1.00
ptg005243l,2050865,2051174,309,EVM,mRNA,1330520,2076870,309,1.00
ptg005245l,3779601,3779879,278,EVM,mRNA,3566680,4430849,278,1.00
ptg005246l,205923,206211,288,EVM,mRNA,46394,1323312,288,1.00
ptg005246l,1053935,1054231,296,EVM,mRNA,46394,1323312,296,1.00
ptg005247l,1282940,1283243,303,EVM,mRNA,994699,1352721,303,1.00
ptg005250l,2063642,2063949,307,EVM,mRNA,1665162,2596582,307,1.00
ptg005250l,2084860,2085159,299,EVM,mRNA,1665162,2596582,299,1.00
ptg005250l,2344593,2344916,323,EVM,mRNA,1665162,2596582,323,1.00
ptg005250l,2378998,2379258,260,EVM,mRNA,1665162,2596582,260,1.00
ptg005250l,2463296,2463619,323,EVM,mRNA,1665162,2596582,323,1.00
ptg005250l,2801541,2801845,304,EVM,mRNA,2715499,4024897,304,1.00
ptg005252l,1065372,1065686,314,EVM,mRNA,885735,1072900,314,1.00
ptg005255l,1751518,1751811,293,EVM,mRNA,818477,2918683,293,1.00
ptg005255l,2029284,2029578,294,EVM,mRNA,818477,2918683,294,1.00
ptg005256l,201751,202029,278,EVM,mRNA,128520,327778,278,1.00
ptg005256l,279691,280013,322,EVM,mRNA,128520,327778,322,1.00
ptg005256l,488738,489030,292,EVM,mRNA,379219,501094,292,1.00
ptg005257l,1524778,1525104,326,EVM,mRNA,1359324,1728866,326,1.00
ptg005257l,1558589,1558862,273,EVM,mRNA,1359324,1728866,273,1.00
ptg005257l,1565213,1565527,314,EVM,mRNA,1359324,1728866,314,1.00
ptg005260l,603238,603561,323,EVM,mRNA,1735,1224933,323,1.00
ptg005260l,1419810,1420121,311,EVM,mRNA,1355895,3292464,311,1.00
ptg005260l,1585362,1585689,327,EVM,mRNA,1355895,3292464,327,1.00
ptg005260l,1789022,1789353,331,EVM,mRNA,1355895,3292464,331,1.00
ptg005260l,2868475,2868774,299,EVM,mRNA,1355895,3292464,299,1.00
ptg005269l,535611,535892,281,EVM,mRNA,2356,1765869,281,1.00
ptg005269l,746698,747020,322,EVM,mRNA,2356,1765869,322,1.00
ptg005269l,831306,831594,288,EVM,mRNA,2356,1765869,288,1.00
ptg005269l,1524393,1524701,308,EVM,mRNA,2356,1765869,308,1.00
ptg005269l,1576917,1577188,271,EVM,mRNA,2356,1765869,271,1.00
ptg005272l,507084,507362,278,EVM,mRNA,227153,526246,278,1.00
ptg005273l,2005122,2005426,304,EVM,mRNA,1771541,2610756,304,1.00
ptg005274l,1357944,1358257,313,EVM,mRNA,547030,2671094,313,1.00
ptg005274l,1659325,1659602,277,EVM,mRNA,547030,2671094,277,1.00
ptg005282l,1323703,1324012,309,EVM,mRNA,966023,1792766,309,1.00
ptg005285l,1797077,1797383,306,EVM,mRNA,201570,2543022,306,1.00
ptg005287l,798887,799208,321,EVM,mRNA,201965,1486916,321,1.00
ptg005290l,292822,293116,294,EVM,mRNA,31415,2836562,294,1.00
ptg005290l,763473,763801,328,EVM,mRNA,31415,2836562,328,1.00
ptg005290l,992319,992602,283,EVM,mRNA,31415,2836562,283,1.00
ptg005299l,441832,442127,295,EVM,mRNA,439197,473849,295,1.00
ptg005299l,921312,921635,323,EVM,mRNA,526831,1142749,323,1.00
ptg005299l,4154980,4155286,306,EVM,mRNA,3364065,4978703,306,1.00
ptg005300l,810544,810847,303,EVM,mRNA,962,2743306,303,1.00
ptg005300l,1266863,1267190,327,EVM,mRNA,962,2743306,327,1.00
ptg005300l,1308138,1308433,295,EVM,mRNA,962,2743306,295,1.00
ptg005300l,2588785,2589081,296,EVM,mRNA,962,2743306,296,1.00
ptg005304l,1330680,1330996,316,EVM,mRNA,1036299,4083133,316,1.00
ptg005304l,2260857,2261171,314,EVM,mRNA,1036299,4083133,314,1.00
ptg005304l,2473047,2473326,279,EVM,mRNA,1036299,4083133,279,1.00
ptg005304l,2749040,2749363,323,EVM,mRNA,1036299,4083133,323,1.00
ptg005304l,2816336,2816617,281,EVM,mRNA,1036299,4083133,281,1.00
ptg005308l,974135,974443,308,EVM,mRNA,869693,1031565,308,1.00
ptg005308l,988814,989102,288,EVM,mRNA,869693,1031565,288,1.00
ptg005309l,202489,202787,298,EVM,mRNA,76321,593705,298,1.00
ptg005309l,2491829,2492121,292,EVM,mRNA,2369493,3750652,292,1.00
ptg005311l,1262252,1262573,321,EVM,mRNA,523364,1429921,321,1.00
ptg005314l,1575074,1575327,253,EVM,mRNA,551470,1575869,253,1.00
ptg005314l,1672201,1672495,294,EVM,mRNA,1623340,2079144,294,1.00
ptg005316l,863934,864264,330,EVM,mRNA,810873,1129284,330,1.00
ptg005316l,1106724,1107022,298,EVM,mRNA,810873,1129284,298,1.00
ptg005321l,1478283,1478595,312,EVM,mRNA,1466762,1545868,312,1.00
ptg005321l,2266075,2266395,320,EVM,mRNA,2250030,2297232,320,1.00
ptg005327l,465446,465730,284,EVM,mRNA,53823,710323,284,1.00
ptg005331l,541464,541739,275,EVM,mRNA,387620,1844126,275,1.00
ptg005331l,596101,596409,308,EVM,mRNA,387620,1844126,308,1.00
ptg005331l,1229441,1229734,293,EVM,mRNA,387620,1844126,293,1.00
ptg005331l,1489910,1490219,309,EVM,mRNA,387620,1844126,309,1.00
ptg005331l,1492133,1492456,323,EVM,mRNA,387620,1844126,323,1.00
ptg005332l,418230,418533,303,EVM,mRNA,340358,1460095,303,1.00
ptg005332l,871621,871925,304,EVM,mRNA,340358,1460095,304,1.00
ptg005332l,1078855,1079137,282,EVM,mRNA,340358,1460095,282,1.00
ptg005332l,1159398,1159676,278,EVM,mRNA,340358,1460095,278,1.00
ptg005334l,335517,335828,311,EVM,mRNA,219754,797338,311,1.00
ptg005335l,711234,711532,298,EVM,mRNA,236991,767695,298,1.00
ptg005339l,2843582,2843895,313,EVM,mRNA,1278105,4073386,313,1.00
ptg005345l,1801761,1802035,274,EVM,mRNA,1701464,2620161,274,1.00
ptg005345l,2375759,2376069,310,EVM,mRNA,1701464,2620161,310,1.00
ptg005345l,4235764,4236074,310,EVM,mRNA,4220116,4259110,310,1.00
ptg005346l,4099976,4100257,281,EVM,mRNA,3314043,4875860,281,1.00
ptg005346l,4465858,4466158,300,EVM,mRNA,3314043,4875860,300,1.00
ptg005351l,604846,605121,275,EVM,mRNA,495411,745545,275,1.00
ptg005354l,1090299,1090599,300,EVM,mRNA,630792,2362884,300,1.00
ptg005354l,1095429,1095717,288,EVM,mRNA,630792,2362884,288,1.00
ptg005354l,1359732,1360010,278,EVM,mRNA,630792,2362884,278,1.00
ptg005354l,1872148,1872436,288,EVM,mRNA,630792,2362884,288,1.00
ptg005355l,229553,229870,317,EVM,mRNA,30932,297998,317,1.00
ptg005355l,811591,811890,299,EVM,mRNA,767188,1920211,299,1.00
ptg005356l,479763,480085,322,EVM,mRNA,321769,956375,322,1.00
ptg005356l,482996,483309,313,EVM,mRNA,321769,956375,313,1.00
ptg005356l,2412314,2412639,325,EVM,mRNA,2161446,2580165,325,1.00
ptg005356l,3940713,3941032,319,EVM,mRNA,3901487,4778474,319,1.00
ptg005358l,829790,830095,305,EVM,mRNA,2872,1113202,305,1.00
ptg005358l,1029229,1029557,328,EVM,mRNA,2872,1113202,328,1.00
ptg005363l,1220345,1220624,279,EVM,mRNA,190944,1408980,279,1.00
ptg005363l,1300785,1301078,293,EVM,mRNA,190944,1408980,293,1.00
ptg005364l,99816,100119,303,EVM,mRNA,15956,874111,303,1.00
ptg005364l,622392,622671,279,EVM,mRNA,15956,874111,279,1.00
ptg005364l,627427,627738,311,EVM,mRNA,15956,874111,311,1.00
ptg005366l,611928,612211,283,EVM,mRNA,421230,1318209,283,1.00
ptg005366l,756527,756840,313,EVM,mRNA,421230,1318209,313,1.00
ptg005367l,978792,979073,281,EVM,mRNA,324579,1050073,281,1.00
ptg005371l,2715953,2716266,313,EVM,mRNA,2414275,3293894,313,1.00
ptg005371l,2943512,2943822,310,EVM,mRNA,2414275,3293894,310,1.00
ptg005371l,3134102,3134363,261,EVM,mRNA,2414275,3293894,261,1.00
ptg005372l,822649,822940,291,EVM,mRNA,772488,3109989,291,1.00
ptg005372l,2362436,2362726,290,EVM,mRNA,772488,3109989,290,1.00
ptg005372l,2400638,2400936,298,EVM,mRNA,772488,3109989,298,1.00
ptg005375l,2059067,2059359,292,EVM,mRNA,800469,2703910,292,1.00
ptg005375l,2206429,2206718,289,EVM,mRNA,800469,2703910,289,1.00
ptg005375l,2677795,2678087,292,EVM,mRNA,800469,2703910,292,1.00
ptg005377l,821701,821973,272,EVM,mRNA,250159,1172720,272,1.00
ptg005378l,275455,275757,302,EVM,mRNA,243461,307246,302,1.00
ptg005379l,703614,703922,308,EVM,mRNA,670817,852374,308,1.00
ptg005380l,571919,572200,281,EVM,mRNA,410871,934002,281,1.00
ptg005381l,1293869,1294165,296,EVM,mRNA,1216844,1343065,296,1.00
ptg005385l,1359283,1359605,322,EVM,mRNA,794976,2502143,322,1.00
ptg005385l,2245748,2246045,297,EVM,mRNA,794976,2502143,297,1.00
ptg005385l,2423478,2423796,318,EVM,mRNA,794976,2502143,318,1.00
ptg005386l,473044,473334,290,EVM,mRNA,317255,1018734,290,1.00
ptg005389l,1475228,1475520,292,EVM,mRNA,1383705,3134225,292,1.00
ptg005389l,1509916,1510210,294,EVM,mRNA,1383705,3134225,294,1.00
ptg005394l,668604,668876,272,EVM,mRNA,483268,1201939,272,1.00
ptg005394l,793756,794082,326,EVM,mRNA,483268,1201939,326,1.00
ptg005398l,276041,276343,302,EVM,mRNA,251116,442535,302,1.00
ptg005400l,2120178,2120477,299,EVM,mRNA,84142,2375844,299,1.00
ptg005402l,1330608,1330924,316,EVM,mRNA,1019142,1335285,316,1.00
ptg005403l,1362998,1363285,287,EVM,mRNA,1251731,1752340,287,1.00
ptg005404l,1099530,1099831,301,EVM,mRNA,814111,1572339,301,1.00
ptg005404l,1242043,1242323,280,EVM,mRNA,814111,1572339,280,1.00
ptg005406l,338732,339056,324,EVM,mRNA,59454,1051336,324,1.00
ptg005411l,2505435,2505707,272,EVM,mRNA,2246529,2869218,272,1.00
ptg005413l,1332159,1332460,301,EVM,mRNA,1332406,1455040,55,0.18
ptg005413l,2440474,2440747,273,EVM,mRNA,2200113,3270759,273,1.00
ptg005413l,2695235,2695535,300,EVM,mRNA,2200113,3270759,300,1.00
ptg005413l,2840747,2841033,286,EVM,mRNA,2200113,3270759,286,1.00
ptg005419l,1143412,1143704,292,EVM,mRNA,968370,1182252,292,1.00
ptg005421l,1287764,1288093,329,EVM,mRNA,761311,1377473,329,1.00
ptg005421l,2109402,2109698,296,EVM,mRNA,1925245,2955608,296,1.00
ptg005421l,4059347,4059612,265,EVM,mRNA,3055430,4104838,265,1.00
ptg005422l,418916,419203,287,EVM,mRNA,1872,604114,287,1.00
ptg005422l,1939137,1939456,319,EVM,mRNA,699086,4415783,319,1.00
ptg005422l,4181105,4181427,322,EVM,mRNA,699086,4415783,322,1.00
ptg005422l,5743597,5743908,311,EVM,mRNA,5574428,6312798,311,1.00
ptg005427l,3121976,3122271,295,EVM,mRNA,3074528,3179004,295,1.00
ptg005429l,322413,322703,290,EVM,mRNA,226667,484324,290,1.00
ptg005429l,622327,622611,284,EVM,mRNA,525104,691087,284,1.00
ptg005432l,1629018,1629314,296,EVM,mRNA,1086715,4058753,296,1.00
ptg005432l,1749381,1749678,297,EVM,mRNA,1086715,4058753,297,1.00
ptg005432l,2397398,2397674,276,EVM,mRNA,1086715,4058753,276,1.00
ptg005438l,3924122,3924402,280,EVM,mRNA,3879906,3928469,280,1.00
ptg005441l,1709471,1709770,299,EVM,mRNA,1568134,2155685,299,1.00
ptg005442l,782495,782830,335,EVM,mRNA,663156,974512,335,1.00
ptg005442l,1179418,1179720,302,EVM,mRNA,1052691,2118595,302,1.00
ptg005442l,1687046,1687350,304,EVM,mRNA,1052691,2118595,304,1.00
ptg005443l,301298,301597,299,EVM,mRNA,252066,1826113,299,1.00
ptg005443l,806319,806637,318,EVM,mRNA,252066,1826113,318,1.00
ptg005443l,1169401,1169714,313,EVM,mRNA,252066,1826113,313,1.00
ptg005443l,1777282,1777598,316,EVM,mRNA,252066,1826113,316,1.00
ptg005445l,1876557,1876835,278,EVM,mRNA,1474328,2094149,278,1.00
ptg005445l,1886569,1886857,288,EVM,mRNA,1474328,2094149,288,1.00
ptg005446l,3149263,3149551,288,EVM,mRNA,2665836,3169407,288,1.00
ptg005454l,1807268,1807590,322,EVM,mRNA,74127,2134201,322,1.00
ptg005455l,225061,225356,295,EVM,mRNA,13348,244903,295,1.00
ptg005456l,492760,493056,296,EVM,mRNA,448642,819456,296,1.00
ptg005457l,1808763,1809037,274,EVM,mRNA,1130350,1968547,274,1.00
ptg005459l,3502096,3502415,319,EVM,mRNA,3364657,3562959,319,1.00
ptg005460l,940329,940627,298,EVM,mRNA,813232,1292142,298,1.00
ptg005460l,996536,996838,302,EVM,mRNA,813232,1292142,302,1.00
ptg005461l,83743,84049,306,EVM,mRNA,48478,323867,306,1.00
ptg005461l,178654,178965,311,EVM,mRNA,48478,323867,311,1.00
ptg005462l,1211082,1211370,288,EVM,mRNA,911218,2718173,288,1.00
ptg005462l,5028900,5029224,324,EVM,mRNA,3950702,5632732,324,1.00
ptg005463l,631087,631393,306,EVM,mRNA,582924,692234,306,1.00
ptg005466l,2802215,2802502,287,EVM,mRNA,592415,5512906,287,1.00
ptg005468l,1806753,1807068,315,EVM,mRNA,1755013,1866872,315,1.00
ptg005471l,551807,552103,296,EVM,mRNA,191310,939985,296,1.00
ptg005473l,431775,432051,276,EVM,mRNA,145902,1994190,276,1.00
ptg005473l,845750,846040,290,EVM,mRNA,145902,1994190,290,1.00
ptg005476l,930191,930494,303,EVM,mRNA,644683,1306366,303,1.00
ptg005476l,3239453,3239739,286,EVM,mRNA,1693810,3760710,286,1.00
ptg005476l,3430216,3430527,311,EVM,mRNA,1693810,3760710,311,1.00
ptg005476l,3556448,3556749,301,EVM,mRNA,1693810,3760710,301,1.00
ptg005476l,3631553,3631866,313,EVM,mRNA,1693810,3760710,313,1.00
ptg005477l,3627810,3628102,292,EVM,mRNA,3577720,3648023,292,1.00
ptg005478l,2267253,2267549,296,EVM,mRNA,2243759,5165023,296,1.00
ptg005478l,4153067,4153406,339,EVM,mRNA,2243759,5165023,339,1.00
ptg005478l,4810887,4811196,309,EVM,mRNA,2243759,5165023,309,1.00
ptg005478l,4869094,4869364,270,EVM,mRNA,2243759,5165023,270,1.00
ptg005479l,554021,554310,289,EVM,mRNA,548620,570964,289,1.00
ptg005481l,294121,294439,318,EVM,mRNA,113984,437413,318,1.00
ptg005484l,2251281,2251603,322,EVM,mRNA,1872839,2326529,322,1.00
ptg005484l,2637075,2637397,322,EVM,mRNA,2534290,2878968,322,1.00
ptg005484l,4655742,4656017,275,EVM,mRNA,3582582,4795241,275,1.00
ptg005490l,539426,539734,308,EVM,mRNA,330089,702002,308,1.00
ptg005492l,512363,512683,320,EVM,mRNA,473129,625707,320,1.00
ptg005492l,579940,580266,326,EVM,mRNA,473129,625707,326,1.00
ptg005492l,2094567,2094884,317,EVM,mRNA,1824093,2731281,317,1.00
ptg005492l,2238740,2239037,297,EVM,mRNA,1824093,2731281,297,1.00
ptg005492l,2496669,2496965,296,EVM,mRNA,1824093,2731281,296,1.00
ptg005493l,2204302,2204607,305,EVM,mRNA,1928255,2563950,305,1.00
ptg005494l,398561,398853,292,EVM,mRNA,7206,455024,292,1.00
ptg005496l,198630,198920,290,EVM,mRNA,5815,554510,290,1.00
ptg005498l,705102,705382,280,EVM,mRNA,552271,889574,280,1.00
ptg005500l,378992,379268,276,EVM,mRNA,168987,1289054,276,1.00
ptg005501l,844601,844883,282,EVM,mRNA,693616,930715,282,1.00
ptg005502l,1248370,1248682,312,EVM,mRNA,2380,1420699,312,1.00
ptg005503l,1116841,1117172,331,EVM,mRNA,1000501,1124999,331,1.00
ptg005504l,671628,671944,316,EVM,mRNA,650120,1071268,316,1.00
ptg005505l,124829,125177,348,EVM,mRNA,102251,1313446,348,1.00
ptg005505l,639634,639939,305,EVM,mRNA,102251,1313446,305,1.00
ptg005506l,1203912,1204223,311,EVM,mRNA,1167286,1212418,311,1.00
ptg005508l,281337,281653,316,EVM,mRNA,14455,2196918,316,1.00
ptg005508l,411749,412025,276,EVM,mRNA,14455,2196918,276,1.00
ptg005508l,458431,458696,265,EVM,mRNA,14455,2196918,265,1.00
ptg005508l,1015585,1015889,304,EVM,mRNA,14455,2196918,304,1.00
ptg005508l,2063501,2063784,283,EVM,mRNA,14455,2196918,283,1.00
ptg005508l,3569523,3569801,278,EVM,mRNA,3367395,3955628,278,1.00
ptg005508l,5133270,5133587,317,EVM,mRNA,5057835,6000165,317,1.00
ptg005508l,5141168,5141461,293,EVM,mRNA,5057835,6000165,293,1.00
ptg005508l,5332107,5332416,309,EVM,mRNA,5057835,6000165,309,1.00
ptg005508l,5370674,5370947,273,EVM,mRNA,5057835,6000165,273,1.00
ptg005508l,5900728,5901056,328,EVM,mRNA,5057835,6000165,328,1.00
ptg005510l,884462,884723,261,EVM,mRNA,872062,1133849,261,1.00
ptg005510l,1119633,1119948,315,EVM,mRNA,872062,1133849,315,1.00
ptg005510l,1266694,1267014,320,EVM,mRNA,1255371,1823718,320,1.00
ptg005510l,1823681,1823964,283,EVM,mRNA,1255371,1823718,37,0.13
ptg005510l,2558483,2558778,295,EVM,mRNA,1960014,2594208,295,1.00
ptg005514l,369013,369309,296,EVM,mRNA,15323,404858,296,1.00
ptg005515l,4044379,4044688,309,EVM,mRNA,2925597,4051490,309,1.00
ptg005519l,1221082,1221371,289,EVM,mRNA,896096,1570537,289,1.00
ptg005521l,1671677,1671976,299,EVM,mRNA,82018,2051418,299,1.00
ptg005522l,1205214,1205522,308,EVM,mRNA,910358,3285946,308,1.00
ptg005522l,1478348,1478660,312,EVM,mRNA,910358,3285946,312,1.00
ptg005522l,2372540,2372824,284,EVM,mRNA,910358,3285946,284,1.00
ptg005529l,1996100,1996395,295,EVM,mRNA,1783696,2177555,295,1.00
ptg005529l,3857944,3858225,281,EVM,mRNA,2577544,4786292,281,1.00
ptg005529l,5291977,5292292,315,EVM,mRNA,5016167,5583983,315,1.00
ptg005529l,6252033,6252342,309,EVM,mRNA,5755454,6566522,309,1.00
ptg005529l,6339432,6339748,316,EVM,mRNA,5755454,6566522,316,1.00
ptg005529l,6750590,6750901,311,EVM,mRNA,6723335,6883103,311,1.00
ptg005529l,6764768,6765055,287,EVM,mRNA,6723335,6883103,287,1.00
ptg005529l,7134486,7134803,317,EVM,mRNA,6934599,7324972,317,1.00
ptg005530l,1000662,1000960,298,EVM,mRNA,894002,1485495,298,1.00
ptg005530l,2120533,2120831,298,EVM,mRNA,1973556,2308707,298,1.00
ptg005530l,3157050,3157337,287,EVM,mRNA,3098610,3732396,287,1.00
ptg005530l,3162707,3162997,290,EVM,mRNA,3098610,3732396,290,1.00
ptg005533l,1201698,1202012,314,EVM,mRNA,998545,1353553,314,1.00
ptg005534l,831107,831401,294,EVM,mRNA,744290,898642,294,1.00
ptg005535l,808404,808707,303,EVM,mRNA,550791,869388,303,1.00
ptg005535l,858664,858941,277,EVM,mRNA,550791,869388,277,1.00
ptg005536l,425888,426179,291,EVM,mRNA,36320,964406,291,1.00
ptg005542l,1115529,1115813,284,EVM,mRNA,826581,1677192,284,1.00
ptg005542l,1146546,1146862,316,EVM,mRNA,826581,1677192,316,1.00
ptg005542l,1282162,1282444,282,EVM,mRNA,826581,1677192,282,1.00
ptg005543l,217322,217616,294,EVM,mRNA,161187,349856,294,1.00
ptg005545l,1336722,1337010,288,EVM,mRNA,755844,2142756,288,1.00
ptg005545l,1921693,1921992,299,EVM,mRNA,755844,2142756,299,1.00
ptg005548l,1099626,1099909,283,EVM,mRNA,1026866,1317436,283,1.00
ptg005548l,1170937,1171243,306,EVM,mRNA,1026866,1317436,306,1.00
ptg005548l,1544456,1544742,286,EVM,mRNA,1504085,1628371,286,1.00
ptg005548l,2046987,2047312,325,EVM,mRNA,1998078,2176465,325,1.00
ptg005550l,306592,306868,276,EVM,mRNA,2080,491835,276,1.00
ptg005550l,1171968,1172239,271,EVM,mRNA,493218,1410285,271,1.00
ptg005550l,1363654,1363957,303,EVM,mRNA,493218,1410285,303,1.00
ptg005552l,1598587,1598890,303,EVM,mRNA,329397,2684728,303,1.00
ptg005552l,1912128,1912432,304,EVM,mRNA,329397,2684728,304,1.00
ptg005552l,2150256,2150531,275,EVM,mRNA,329397,2684728,275,1.00
ptg005554l,1250289,1250556,267,EVM,mRNA,87172,1671803,267,1.00
ptg005554l,1665324,1665596,272,EVM,mRNA,87172,1671803,272,1.00
ptg005554l,2316826,2317138,312,EVM,mRNA,2036546,5224061,312,1.00
ptg005554l,2614364,2614678,314,EVM,mRNA,2036546,5224061,314,1.00
ptg005554l,2747604,2747916,312,EVM,mRNA,2036546,5224061,312,1.00
ptg005554l,5221464,5221772,308,EVM,mRNA,2036546,5224061,308,1.00
ptg005554l,7367956,7368263,307,EVM,mRNA,6512345,8616149,307,1.00
ptg005554l,7387667,7387974,307,EVM,mRNA,6512345,8616149,307,1.00
ptg005554l,9053625,9053908,283,EVM,mRNA,8940454,10405109,283,1.00
ptg005554l,9316665,9316984,319,EVM,mRNA,8940454,10405109,319,1.00
ptg005554l,10003858,10004154,296,EVM,mRNA,8940454,10405109,296,1.00
ptg005558l,18593,18918,325,EVM,mRNA,16913,350864,325,1.00
ptg005558l,2004283,2004572,289,EVM,mRNA,1909000,2064438,289,1.00
ptg005559l,459364,459647,283,EVM,mRNA,4238,723992,283,1.00
ptg005562l,230739,231053,314,EVM,mRNA,204882,2159264,314,1.00
ptg005562l,283525,283828,303,EVM,mRNA,204882,2159264,303,1.00
ptg005562l,841063,841340,277,EVM,mRNA,204882,2159264,277,1.00
ptg005562l,1557863,1558197,334,EVM,mRNA,204882,2159264,334,1.00
ptg005562l,1847777,1848096,319,EVM,mRNA,204882,2159264,319,1.00
ptg005562l,2691870,2692174,304,EVM,mRNA,2372658,3219469,304,1.00
ptg005562l,3177359,3177624,265,EVM,mRNA,2372658,3219469,265,1.00
ptg005562l,4748453,4748778,325,EVM,mRNA,4399827,5502986,325,1.00
ptg005568l,543152,543464,312,EVM,mRNA,332772,555348,312,1.00
ptg005571l,1536363,1536644,281,EVM,mRNA,1520194,1920801,281,1.00
ptg005575l,304617,304944,327,EVM,mRNA,296373,348140,327,1.00
ptg005579l,167268,167564,296,EVM,mRNA,94592,270099,296,1.00
ptg005579l,827322,827602,280,EVM,mRNA,612326,1062645,280,1.00
ptg005579l,1040045,1040342,297,EVM,mRNA,612326,1062645,297,1.00
ptg005581l,1498527,1498864,337,EVM,mRNA,1342451,1749436,337,1.00
ptg005586l,576855,577163,308,EVM,mRNA,400399,647515,308,1.00
ptg005588l,2106064,2106363,299,EVM,mRNA,1817676,5693380,299,1.00
ptg005588l,3247725,3248036,311,EVM,mRNA,1817676,5693380,311,1.00
ptg005593l,1172980,1173284,304,EVM,mRNA,974355,1322420,304,1.00
ptg005596l,61076,61367,291,EVM,mRNA,6711,143989,291,1.00
ptg005596l,793337,793624,287,EVM,mRNA,342883,1046777,287,1.00
ptg005602l,1540418,1540737,319,EVM,mRNA,1321186,2009662,319,1.00
ptg005607l,413057,413378,321,EVM,mRNA,294317,837462,321,1.00
ptg005614l,1978476,1978771,295,EVM,mRNA,1509086,2281738,295,1.00
ptg005615l,4902445,4902754,309,EVM,mRNA,4149827,7877899,309,1.00
ptg005615l,6268189,6268506,317,EVM,mRNA,4149827,7877899,317,1.00
ptg005615l,6274191,6274499,308,EVM,mRNA,4149827,7877899,308,1.00
ptg005615l,7155300,7155588,288,EVM,mRNA,4149827,7877899,288,1.00
ptg005621l,2664061,2664329,268,EVM,mRNA,2239488,2816627,268,1.00
ptg005628l,335122,335451,329,EVM,mRNA,311887,591087,329,1.00
ptg005629l,319906,320218,312,EVM,mRNA,284933,1102075,312,1.00
ptg005630l,1347609,1347931,322,EVM,mRNA,763271,1369031,322,1.00
ptg005634l,505220,505526,306,EVM,mRNA,53697,939966,306,1.00
ptg005634l,926502,926803,301,EVM,mRNA,53697,939966,301,1.00
ptg005637l,284900,285229,329,EVM,mRNA,262555,2481482,329,1.00
ptg005637l,1339604,1339898,294,EVM,mRNA,262555,2481482,294,1.00
ptg005637l,1702211,1702519,308,EVM,mRNA,262555,2481482,308,1.00
ptg005637l,1827043,1827354,311,EVM,mRNA,262555,2481482,311,1.00
ptg005637l,2434872,2435185,313,EVM,mRNA,262555,2481482,313,1.00
ptg005637l,2475824,2476133,309,EVM,mRNA,262555,2481482,309,1.00
ptg005638l,2940361,2940657,296,EVM,mRNA,2054509,3208814,296,1.00
ptg005638l,4818705,4819034,329,EVM,mRNA,3912014,5032765,329,1.00
ptg005640l,1643089,1643389,300,EVM,mRNA,1554198,1753871,300,1.00
ptg005642l,328098,328379,281,EVM,mRNA,2587,1173814,281,1.00
ptg005642l,442618,442916,298,EVM,mRNA,2587,1173814,298,1.00
ptg005642l,450880,451178,298,EVM,mRNA,2587,1173814,298,1.00
ptg005648l,1869123,1869410,287,EVM,mRNA,1805273,1875902,287,1.00
ptg005648l,4766376,4766690,314,EVM,mRNA,4505295,5135347,314,1.00
ptg005653l,984486,984799,313,EVM,mRNA,312242,1472230,313,1.00
ptg005653l,1177725,1178051,326,EVM,mRNA,312242,1472230,326,1.00
ptg005658l,398457,398789,332,EVM,mRNA,370396,516571,332,1.00
ptg005658l,471692,472019,327,EVM,mRNA,370396,516571,327,1.00
ptg005661l,1840187,1840482,295,EVM,mRNA,1705061,2205457,295,1.00
ptg005664l,648614,648902,288,EVM,mRNA,232438,650695,288,1.00
ptg005665l,595417,595725,308,EVM,mRNA,15025,1200874,308,1.00
ptg005665l,1085898,1086210,312,EVM,mRNA,15025,1200874,312,1.00
ptg005667l,813777,814077,300,EVM,mRNA,762352,982042,300,1.00
ptg005671l,45952,46255,303,EVM,mRNA,9889,177379,303,1.00
ptg005671l,539690,540015,325,EVM,mRNA,533353,2161004,325,1.00
ptg005682l,102660,102989,329,EVM,mRNA,102669,163174,321,0.98
ptg005682l,138141,138418,277,EVM,mRNA,102669,163174,277,1.00
ptg005684l,730939,731228,289,EVM,mRNA,139879,1155150,289,1.00
ptg005684l,1023518,1023795,277,EVM,mRNA,139879,1155150,277,1.00
ptg005685l,1474349,1474629,280,EVM,mRNA,731805,2336788,280,1.00
ptg005685l,1797747,1798050,303,EVM,mRNA,731805,2336788,303,1.00
ptg005687l,1341433,1341722,289,EVM,mRNA,124122,1869239,289,1.00
ptg005696l,460792,461076,284,EVM,mRNA,304243,903947,284,1.00
ptg005696l,665785,666103,318,EVM,mRNA,304243,903947,318,1.00
ptg005700l,938426,938687,261,EVM,mRNA,1557,969698,261,1.00
ptg005701l,776539,776830,291,EVM,mRNA,367343,1033346,291,1.00
ptg005701l,1004349,1004674,325,EVM,mRNA,367343,1033346,325,1.00
ptg005702l,574808,575120,312,EVM,mRNA,87386,1028650,312,1.00
ptg005702l,1584841,1585134,293,EVM,mRNA,1403834,1910638,293,1.00
ptg005705l,54847,55165,318,EVM,mRNA,6244,98506,318,1.00
ptg005708l,41648,41987,339,EVM,mRNA,33319,133709,339,1.00
ptg005708l,44191,44478,287,EVM,mRNA,33319,133709,287,1.00
ptg005708l,1806977,1807261,284,EVM,mRNA,1756061,1980351,284,1.00
ptg005709l,814779,815088,309,EVM,mRNA,524934,1721839,309,1.00
ptg005709l,2284136,2284424,288,EVM,mRNA,2055102,3109062,288,1.00
ptg005709l,2284612,2284915,303,EVM,mRNA,2055102,3109062,303,1.00
ptg005710l,97021,97315,294,EVM,mRNA,26242,106562,294,1.00
ptg005714l,320573,320849,276,EVM,mRNA,11568,1522377,276,1.00
ptg005714l,434220,434507,287,EVM,mRNA,11568,1522377,287,1.00
ptg005714l,600889,601194,305,EVM,mRNA,11568,1522377,305,1.00
ptg005714l,644413,644705,292,EVM,mRNA,11568,1522377,292,1.00
ptg005720l,1929874,1930153,279,EVM,mRNA,1820819,2663857,279,1.00
ptg005721l,3197046,3197332,286,EVM,mRNA,2809572,3285496,286,1.00
ptg005722l,731374,731662,288,EVM,mRNA,74534,3568638,288,1.00
ptg005722l,2786620,2786936,316,EVM,mRNA,74534,3568638,316,1.00
ptg005722l,3106685,3107004,319,EVM,mRNA,74534,3568638,319,1.00
ptg005722l,3118821,3119107,286,EVM,mRNA,74534,3568638,286,1.00
ptg005722l,3162833,3163105,272,EVM,mRNA,74534,3568638,272,1.00
ptg005722l,3358716,3359012,296,EVM,mRNA,74534,3568638,296,1.00
ptg005722l,3428877,3429184,307,EVM,mRNA,74534,3568638,307,1.00
ptg005722l,3880480,3880765,285,EVM,mRNA,3683300,3975074,285,1.00
ptg005724l,1870298,1870570,272,EVM,mRNA,1249605,2035265,272,1.00
ptg005724l,2033604,2033869,265,EVM,mRNA,1249605,2035265,265,1.00
ptg005725l,1627115,1627407,292,EVM,mRNA,1023936,2099687,292,1.00
ptg005727l,658836,659117,281,EVM,mRNA,315299,964065,281,1.00
ptg005727l,1347826,1348131,305,EVM,mRNA,1217347,1553357,305,1.00
ptg005731l,1121618,1121896,278,EVM,mRNA,941686,1558005,278,1.00
ptg005731l,1224868,1225169,301,EVM,mRNA,941686,1558005,301,1.00
ptg005731l,1458279,1458582,303,EVM,mRNA,941686,1558005,303,1.00
ptg005736l,809512,809803,291,EVM,mRNA,371151,854204,291,1.00
ptg005737l,4412538,4412835,297,EVM,mRNA,3951359,6715142,297,1.00
ptg005737l,4545207,4545514,307,EVM,mRNA,3951359,6715142,307,1.00
ptg005737l,4859582,4859889,307,EVM,mRNA,3951359,6715142,307,1.00
ptg005737l,5240984,5241305,321,EVM,mRNA,3951359,6715142,321,1.00
ptg005737l,5538647,5538930,283,EVM,mRNA,3951359,6715142,283,1.00
ptg005738l,4411869,4412134,265,EVM,mRNA,4160520,4474609,265,1.00
ptg005738l,5050912,5051198,286,EVM,mRNA,5051055,5444024,144,0.50
ptg005740l,813225,813537,312,EVM,mRNA,537418,908283,312,1.00
ptg005740l,867595,867930,335,EVM,mRNA,537418,908283,335,1.00
ptg005742l,3069115,3069404,289,EVM,mRNA,2383326,4003195,289,1.00
ptg005742l,3090211,3090495,284,EVM,mRNA,2383326,4003195,284,1.00
ptg005742l,3966124,3966401,277,EVM,mRNA,2383326,4003195,277,1.00
ptg005746l,618167,618450,283,EVM,mRNA,391785,1682387,283,1.00
ptg005751l,1542347,1542641,294,EVM,mRNA,1280201,1597086,294,1.00
ptg005754l,858295,858608,313,EVM,mRNA,831674,1266809,313,1.00
ptg005757l,7804,8096,292,EVM,mRNA,1351,392947,292,1.00
ptg005757l,798561,798842,281,EVM,mRNA,645451,1217176,281,1.00
ptg005761l,3258445,3258766,321,EVM,mRNA,3194399,3429153,321,1.00
ptg005761l,3340079,3340363,284,EVM,mRNA,3194399,3429153,284,1.00
ptg005763l,475836,476130,294,EVM,mRNA,40449,622234,294,1.00
ptg005767l,574186,574498,312,EVM,mRNA,440679,748128,312,1.00
ptg005770l,418945,419242,297,EVM,mRNA,390544,1089108,297,1.00
ptg005770l,888892,889191,299,EVM,mRNA,390544,1089108,299,1.00
ptg005772l,200705,201020,315,EVM,mRNA,4242,210589,315,1.00
ptg005772l,1559709,1559990,281,EVM,mRNA,1064478,4816418,281,1.00
ptg005772l,2069108,2069412,304,EVM,mRNA,1064478,4816418,304,1.00
ptg005773l,449634,449914,280,EVM,mRNA,39836,1410330,280,1.00
ptg005773l,1213767,1214053,286,EVM,mRNA,39836,1410330,286,1.00
ptg005773l,1219107,1219393,286,EVM,mRNA,39836,1410330,286,1.00
ptg005773l,1220806,1221092,286,EVM,mRNA,39836,1410330,286,1.00
ptg005773l,1221146,1221434,288,EVM,mRNA,39836,1410330,288,1.00
ptg005773l,1227026,1227312,286,EVM,mRNA,39836,1410330,286,1.00
ptg005777l,4720014,4720337,323,EVM,mRNA,4702600,5322402,323,1.00
ptg005778l,267704,268008,304,EVM,mRNA,132684,1606723,304,1.00
ptg005778l,568643,568913,270,EVM,mRNA,132684,1606723,270,1.00
ptg005780l,1754931,1755204,273,EVM,mRNA,708689,2592727,273,1.00
ptg005780l,2858705,2859010,305,EVM,mRNA,2727563,2975880,305,1.00
ptg005782l,329946,330254,308,EVM,mRNA,54861,479835,308,1.00
ptg005782l,478254,478575,321,EVM,mRNA,54861,479835,321,1.00
ptg005784l,584222,584526,304,EVM,mRNA,186406,741412,304,1.00
ptg005784l,706507,706796,289,EVM,mRNA,186406,741412,289,1.00
ptg005790l,1699393,1699700,307,EVM,mRNA,1580374,2098021,307,1.00
ptg005790l,2317052,2317334,282,EVM,mRNA,2133980,3106190,282,1.00
ptg005790l,2883030,2883294,264,EVM,mRNA,2133980,3106190,264,1.00
ptg005791l,264900,265187,287,EVM,mRNA,22062,2313468,287,1.00
ptg005793l,97179,97471,292,EVM,mRNA,96798,249503,292,1.00
ptg005795l,767805,768130,325,EVM,mRNA,611692,972608,325,1.00
ptg005795l,856726,857035,309,EVM,mRNA,611692,972608,309,1.00
ptg005795l,1690617,1690911,294,EVM,mRNA,1675909,1724348,294,1.00
ptg005800l,1755830,1756132,302,EVM,mRNA,1609323,1758425,302,1.00
ptg005802l,1195020,1195331,311,EVM,mRNA,854497,1456924,311,1.00
ptg005802l,1282565,1282884,319,EVM,mRNA,854497,1456924,319,1.00
ptg005803l,557827,558136,309,EVM,mRNA,657,1129196,309,1.00
ptg005804l,2278322,2278653,331,EVM,mRNA,2069101,2331019,331,1.00
ptg005807l,1548857,1549166,309,EVM,mRNA,476699,1834382,309,1.00
ptg005809l,1000182,1000479,297,EVM,mRNA,15861,1005854,297,1.00
ptg005809l,1595022,1595317,295,EVM,mRNA,1125818,2424144,295,1.00
ptg005809l,1863628,1863913,285,EVM,mRNA,1125818,2424144,285,1.00
ptg005809l,2298924,2299230,306,EVM,mRNA,1125818,2424144,306,1.00
ptg005811l,366107,366399,292,EVM,mRNA,260803,707762,292,1.00
ptg005812l,480152,480457,305,EVM,mRNA,386415,934950,305,1.00
ptg005812l,1899609,1899909,300,EVM,mRNA,1517131,1900338,300,1.00
ptg005813l,1701622,1701923,301,EVM,mRNA,1537800,1735328,301,1.00
ptg005815l,899208,899520,312,EVM,mRNA,236233,961438,312,1.00
ptg005816l,1889658,1889937,279,EVM,mRNA,1808574,2101967,279,1.00
ptg005816l,2599013,2599290,277,EVM,mRNA,2243554,2645335,277,1.00
ptg005816l,3015648,3015962,314,EVM,mRNA,2811834,3135792,314,1.00
ptg005817l,514416,514721,305,EVM,mRNA,280536,3369710,305,1.00
ptg005819l,655915,656223,308,EVM,mRNA,535664,1234129,308,1.00
ptg005828l,242547,242868,321,EVM,mRNA,623,1155810,321,1.00
ptg005834l,455548,455852,304,EVM,mRNA,311233,530353,304,1.00
ptg005834l,1322236,1322526,290,EVM,mRNA,1147467,1676462,290,1.00
ptg005834l,1543335,1543651,316,EVM,mRNA,1147467,1676462,316,1.00
ptg005834l,1548057,1548380,323,EVM,mRNA,1147467,1676462,323,1.00
ptg005834l,1548828,1549110,282,EVM,mRNA,1147467,1676462,282,1.00
ptg005834l,2957770,2958088,318,EVM,mRNA,2488188,3691152,318,1.00
ptg005834l,3632837,3633156,319,EVM,mRNA,2488188,3691152,319,1.00
ptg005836l,578053,578359,306,EVM,mRNA,538785,671536,306,1.00
ptg005836l,891157,891461,304,EVM,mRNA,827539,1115052,304,1.00
ptg005837l,334071,334363,292,EVM,mRNA,181660,1718732,292,1.00
ptg005837l,610897,611176,279,EVM,mRNA,181660,1718732,279,1.00
ptg005838l,1838563,1838861,298,EVM,mRNA,886442,1849497,298,1.00
ptg005838l,2678686,2678993,307,EVM,mRNA,1993131,2795700,307,1.00
ptg005839l,876137,876465,328,EVM,mRNA,871294,1029231,328,1.00
ptg005842l,1648172,1648483,311,EVM,mRNA,1630012,1763179,311,1.00
ptg005847l,870657,870934,277,EVM,mRNA,822769,947339,277,1.00
ptg005847l,1465699,1465987,288,EVM,mRNA,1464924,1510727,288,1.00
ptg005851l,939962,940282,320,EVM,mRNA,729364,3850328,320,1.00
ptg005851l,1025528,1025846,318,EVM,mRNA,729364,3850328,318,1.00
ptg005851l,1352666,1352987,321,EVM,mRNA,729364,3850328,321,1.00
ptg005851l,1354473,1354760,287,EVM,mRNA,729364,3850328,287,1.00
ptg005851l,1809754,1810054,300,EVM,mRNA,729364,3850328,300,1.00
ptg005851l,1896370,1896659,289,EVM,mRNA,729364,3850328,289,1.00
ptg005851l,2043122,2043401,279,EVM,mRNA,729364,3850328,279,1.00
ptg005851l,2613429,2613716,287,EVM,mRNA,729364,3850328,287,1.00
ptg005854l,1536159,1536485,326,EVM,mRNA,1451356,1582851,326,1.00
ptg005855l,1879634,1879933,299,EVM,mRNA,1795221,1891095,299,1.00
ptg005856l,429583,429898,315,EVM,mRNA,112939,1088433,315,1.00
ptg005856l,877502,877817,315,EVM,mRNA,112939,1088433,315,1.00
ptg005858l,891768,892058,290,EVM,mRNA,808996,984175,290,1.00
ptg005858l,973364,973640,276,EVM,mRNA,808996,984175,276,1.00
ptg005867l,532109,532441,332,EVM,mRNA,131801,581321,332,1.00
ptg005868l,927159,927469,310,EVM,mRNA,888691,1821318,310,1.00
ptg005874l,1471554,1471830,276,EVM,mRNA,1425407,1530174,276,1.00
ptg005877l,403727,404017,290,EVM,mRNA,143658,617428,290,1.00
ptg005880l,1385380,1385675,295,EVM,mRNA,936218,1507797,295,1.00
ptg005881l,133145,133436,291,EVM,mRNA,4663,167511,291,1.00
ptg005881l,293811,294127,316,EVM,mRNA,167711,511656,316,1.00
ptg005881l,1494216,1494514,298,EVM,mRNA,936493,2339716,298,1.00
ptg005881l,1830879,1831182,303,EVM,mRNA,936493,2339716,303,1.00
ptg005894l,629354,629648,294,EVM,mRNA,629384,1392104,265,0.90
ptg005897l,182592,182870,278,EVM,mRNA,78890,226941,278,1.00
ptg005901l,371494,371763,269,EVM,mRNA,184020,1228563,269,1.00
ptg005902l,610042,610374,332,EVM,mRNA,472792,615865,332,1.00
ptg005903l,287337,287629,292,EVM,mRNA,281464,534489,292,1.00
ptg005903l,877316,877647,331,EVM,mRNA,741751,1024744,331,1.00
ptg005903l,1890258,1890547,289,EVM,mRNA,1288729,3063192,289,1.00
ptg005904l,3396234,3396521,287,EVM,mRNA,3394800,3409024,287,1.00
ptg005907l,1888035,1888305,270,EVM,mRNA,1851115,1904559,270,1.00
ptg005907l,1898410,1898679,269,EVM,mRNA,1851115,1904559,269,1.00
ptg005908l,204368,204693,325,EVM,mRNA,139784,284864,325,1.00
ptg005908l,3197440,3197752,312,EVM,mRNA,1751421,3667799,312,1.00
ptg005908l,3214280,3214562,282,EVM,mRNA,1751421,3667799,282,1.00
ptg005909l,825021,825321,300,EVM,mRNA,101334,840448,300,1.00
ptg005909l,1162140,1162421,281,EVM,mRNA,1159552,1849786,281,1.00
ptg005911l,1438124,1438438,314,EVM,mRNA,61693,1488186,314,1.00
ptg005914l,158184,158521,337,EVM,mRNA,21825,2273662,337,1.00
ptg005914l,591490,591768,278,EVM,mRNA,21825,2273662,278,1.00
ptg005914l,1242605,1242902,297,EVM,mRNA,21825,2273662,297,1.00
ptg005914l,1269524,1269854,330,EVM,mRNA,21825,2273662,330,1.00
ptg005917l,566731,567042,311,EVM,mRNA,144100,711460,311,1.00
ptg005920l,1748529,1748852,323,EVM,mRNA,1747924,2076956,323,1.00
ptg005929l,2581601,2581894,293,EVM,mRNA,1696609,3795792,293,1.00
ptg005929l,3051947,3052236,289,EVM,mRNA,1696609,3795792,289,1.00
ptg005929l,3133849,3134168,319,EVM,mRNA,1696609,3795792,319,1.00
ptg005929l,3390440,3390763,323,EVM,mRNA,1696609,3795792,323,1.00
ptg005929l,3555764,3556046,282,EVM,mRNA,1696609,3795792,282,1.00
ptg005938l,774097,774395,298,EVM,mRNA,473903,1319454,298,1.00
ptg005939l,1391273,1391571,298,EVM,mRNA,1223902,1788782,298,1.00
ptg005939l,1664286,1664585,299,EVM,mRNA,1223902,1788782,299,1.00
ptg005944l,2077172,2077456,284,EVM,mRNA,438661,2506488,284,1.00
ptg005946l,739997,740323,326,EVM,mRNA,625846,1794950,326,1.00
ptg005946l,3868865,3869124,259,EVM,mRNA,3519497,4896519,259,1.00
ptg005946l,4072480,4072773,293,EVM,mRNA,3519497,4896519,293,1.00
ptg005946l,4697425,4697736,311,EVM,mRNA,3519497,4896519,311,1.00
ptg005948l,1111081,1111374,293,EVM,mRNA,3619,1283133,293,1.00
ptg005954l,774130,774408,278,EVM,mRNA,599641,1296566,278,1.00
ptg005954l,2452713,2453008,295,EVM,mRNA,1558774,2849276,295,1.00
ptg005954l,2453022,2453316,294,EVM,mRNA,1558774,2849276,294,1.00
ptg005954l,4002452,4002764,312,EVM,mRNA,3497609,4237157,312,1.00
ptg005960l,3004701,3004982,281,EVM,mRNA,2091362,3473129,281,1.00
ptg005960l,3438764,3439037,273,EVM,mRNA,2091362,3473129,273,1.00
ptg005964l,961869,962183,314,EVM,mRNA,780401,1033199,314,1.00
ptg005966l,1779519,1779765,246,EVM,mRNA,1245018,2592388,246,1.00
ptg005966l,2258837,2259127,290,EVM,mRNA,1245018,2592388,290,1.00
ptg005966l,2431313,2431631,318,EVM,mRNA,1245018,2592388,318,1.00
ptg005967l,267435,267732,297,EVM,mRNA,23393,285263,297,1.00
ptg005968l,1904105,1904414,309,EVM,mRNA,570635,2243509,309,1.00
ptg005973l,2920304,2920593,289,EVM,mRNA,2907061,3030038,289,1.00
ptg005977l,857330,857615,285,EVM,mRNA,802842,927974,285,1.00
ptg005978l,932773,933091,318,EVM,mRNA,883275,1055931,318,1.00
ptg005978l,3614864,3615168,304,EVM,mRNA,3531477,4016547,304,1.00
ptg005979l,658728,659025,297,EVM,mRNA,613528,1582446,297,1.00
ptg005979l,1117007,1117279,272,EVM,mRNA,613528,1582446,272,1.00
ptg005979l,1200436,1200739,303,EVM,mRNA,613528,1582446,303,1.00
ptg005979l,2185368,2185670,302,EVM,mRNA,1710129,2341092,302,1.00
ptg005979l,2308118,2308421,303,EVM,mRNA,1710129,2341092,303,1.00
ptg005979l,3933084,3933400,316,EVM,mRNA,3469095,4450277,316,1.00
ptg005984l,1265352,1265676,324,EVM,mRNA,1039859,1268942,324,1.00
ptg005986l,252927,253253,326,EVM,mRNA,232733,499293,326,1.00
ptg005990l,772850,773136,286,EVM,mRNA,627491,1923658,286,1.00
ptg005990l,919678,919978,300,EVM,mRNA,627491,1923658,300,1.00
ptg005990l,950650,950949,299,EVM,mRNA,627491,1923658,299,1.00
ptg005990l,1255575,1255879,304,EVM,mRNA,627491,1923658,304,1.00
ptg005990l,1522334,1522633,299,EVM,mRNA,627491,1923658,299,1.00
ptg005990l,1594790,1595070,280,EVM,mRNA,627491,1923658,280,1.00
ptg005994l,1805052,1805367,315,EVM,mRNA,1747562,2128981,315,1.00
ptg005997l,461284,461570,286,EVM,mRNA,397656,530581,286,1.00
ptg006003l,745430,745736,306,EVM,mRNA,267361,858723,306,1.00
ptg006004l,193318,193633,315,EVM,mRNA,24489,299937,315,1.00
ptg006013l,981687,982013,326,EVM,mRNA,84055,1403699,326,1.00
ptg006013l,1185609,1185922,313,EVM,mRNA,84055,1403699,313,1.00
ptg006015l,1606166,1606476,310,EVM,mRNA,1296318,2651494,310,1.00
ptg006015l,2166074,2166340,266,EVM,mRNA,1296318,2651494,266,1.00
ptg006020l,464907,465170,263,EVM,mRNA,367113,1309131,263,1.00
ptg006020l,582798,583111,313,EVM,mRNA,367113,1309131,313,1.00
ptg006020l,949178,949475,297,EVM,mRNA,367113,1309131,297,1.00
ptg006022l,2572109,2572392,283,EVM,mRNA,790517,3013954,283,1.00
ptg006022l,2882497,2882808,311,EVM,mRNA,790517,3013954,311,1.00
ptg006026l,530153,530422,269,EVM,mRNA,21561,839271,269,1.00
ptg006026l,785399,785655,256,EVM,mRNA,21561,839271,256,1.00
ptg006033l,144248,144523,275,EVM,mRNA,132858,193205,275,1.00
ptg006036l,830277,830578,301,EVM,mRNA,377239,1227575,301,1.00
ptg006036l,1197469,1197597,128,EVM,mRNA,377239,1227575,128,1.00
ptg006039l,1422831,1423142,311,EVM,mRNA,1373465,1495230,311,1.00
ptg006043l,492319,492550,231,EVM,mRNA,428636,1763937,231,1.00
ptg006043l,603823,604123,300,EVM,mRNA,428636,1763937,300,1.00
ptg006043l,1188037,1188336,299,EVM,mRNA,428636,1763937,299,1.00
ptg006043l,1545722,1546034,312,EVM,mRNA,428636,1763937,312,1.00
ptg006045l,1315383,1315698,315,EVM,mRNA,1259733,1438785,315,1.00
ptg006048l,2141184,2141507,323,EVM,mRNA,1216828,2545881,323,1.00
ptg006058l,544037,544327,290,EVM,mRNA,518961,975060,290,1.00
ptg006058l,578296,578594,298,EVM,mRNA,518961,975060,298,1.00
ptg006058l,940844,941156,312,EVM,mRNA,518961,975060,312,1.00
ptg006065l,940452,940771,319,EVM,mRNA,380437,1260250,319,1.00
ptg006065l,1229793,1230083,290,EVM,mRNA,380437,1260250,290,1.00
ptg006069l,239678,239987,309,EVM,mRNA,45725,1073419,309,1.00
ptg006069l,825019,825330,311,EVM,mRNA,45725,1073419,311,1.00
ptg006069l,888748,889048,300,EVM,mRNA,45725,1073419,300,1.00
ptg006070l,193669,193997,328,EVM,mRNA,117600,345598,328,1.00
ptg006075l,450661,450941,280,EVM,mRNA,423346,3908196,280,1.00
ptg006075l,2521615,2521915,300,EVM,mRNA,423346,3908196,300,1.00
ptg006077l,540522,540848,326,EVM,mRNA,514232,656848,326,1.00
ptg006078l,3541728,3542016,288,EVM,mRNA,3422780,3647408,288,1.00
ptg006078l,4320599,4320875,276,EVM,mRNA,3811644,4396015,276,1.00
ptg006078l,5178235,5178522,287,EVM,mRNA,4886227,5230199,287,1.00
ptg006079l,591086,591334,248,EVM,mRNA,380017,603990,248,1.00
ptg006081l,1859892,1860213,321,EVM,mRNA,85049,2499706,321,1.00
ptg006081l,2139657,2139957,300,EVM,mRNA,85049,2499706,300,1.00
ptg006087l,1216013,1216300,287,EVM,mRNA,980470,1533087,287,1.00
ptg006090l,3357564,3357860,296,EVM,mRNA,3295712,3395487,296,1.00
ptg006104l,200940,201230,290,EVM,mRNA,18411,885212,290,1.00
ptg006104l,2072144,2072449,305,EVM,mRNA,1904838,3666743,305,1.00
ptg006104l,3292446,3292726,280,EVM,mRNA,1904838,3666743,280,1.00
ptg006104l,3364101,3364382,281,EVM,mRNA,1904838,3666743,281,1.00
ptg006104l,3755938,3756229,291,EVM,mRNA,3725347,3946020,291,1.00
ptg006104l,3813017,3813325,308,EVM,mRNA,3725347,3946020,308,1.00
ptg006107l,528517,528853,336,EVM,mRNA,515775,1788817,336,1.00
ptg006107l,1208163,1208455,292,EVM,mRNA,515775,1788817,292,1.00
ptg006108l,424005,424306,301,EVM,mRNA,312709,425935,301,1.00
ptg006108l,2359614,2359885,271,EVM,mRNA,2348859,2589384,271,1.00
ptg006110l,1143241,1143545,304,EVM,mRNA,946661,1557892,304,1.00
ptg006110l,1269565,1269876,311,EVM,mRNA,946661,1557892,311,1.00
ptg006110l,2450193,2450503,310,EVM,mRNA,2205748,4934368,310,1.00
ptg006110l,2512885,2513208,323,EVM,mRNA,2205748,4934368,323,1.00
ptg006110l,2746699,2747011,312,EVM,mRNA,2205748,4934368,312,1.00
ptg006110l,2908678,2908971,293,EVM,mRNA,2205748,4934368,293,1.00
ptg006110l,3909777,3910061,284,EVM,mRNA,2205748,4934368,284,1.00
ptg006111l,262456,262744,288,EVM,mRNA,151164,416642,288,1.00
ptg006121l,127368,127645,277,EVM,mRNA,24918,230098,277,1.00
ptg006121l,920402,920701,299,EVM,mRNA,655903,1021553,299,1.00
ptg006124l,611056,611361,305,EVM,mRNA,3369,1008896,305,1.00
ptg006124l,682409,682669,260,EVM,mRNA,3369,1008896,260,1.00
ptg006124l,1713180,1713507,327,EVM,mRNA,1684733,2096948,327,1.00
ptg006126l,585137,585418,281,EVM,mRNA,577349,1006998,281,1.00
ptg006126l,636164,636449,285,EVM,mRNA,577349,1006998,285,1.00
ptg006126l,817957,818270,313,EVM,mRNA,577349,1006998,313,1.00
ptg006132l,905230,905523,293,EVM,mRNA,719404,1315048,293,1.00
ptg006134l,25485,25761,276,EVM,mRNA,2003,1633810,276,1.00
ptg006134l,52556,52834,278,EVM,mRNA,2003,1633810,278,1.00
ptg006134l,181197,181522,325,EVM,mRNA,2003,1633810,325,1.00
ptg006134l,1243965,1244253,288,EVM,mRNA,2003,1633810,288,1.00
ptg006145l,410219,410528,309,EVM,mRNA,301181,419170,309,1.00
ptg006147l,889673,889982,309,EVM,mRNA,775771,924352,309,1.00
ptg006148l,8135,8414,279,EVM,mRNA,8021,240594,279,1.00
ptg006150l,369070,369371,301,EVM,mRNA,5209,840096,301,1.00
ptg006150l,554677,554990,313,EVM,mRNA,5209,840096,313,1.00
ptg006150l,766869,767181,312,EVM,mRNA,5209,840096,312,1.00
ptg006153l,238578,238854,276,EVM,mRNA,93867,3768532,276,1.00
ptg006153l,1943577,1943891,314,EVM,mRNA,93867,3768532,314,1.00
ptg006153l,2716637,2716915,278,EVM,mRNA,93867,3768532,278,1.00
ptg006153l,2769008,2769318,310,EVM,mRNA,93867,3768532,310,1.00
ptg006153l,3049815,3050105,290,EVM,mRNA,93867,3768532,290,1.00
ptg006153l,3096857,3097133,276,EVM,mRNA,93867,3768532,276,1.00
ptg006153l,3332366,3332658,292,EVM,mRNA,93867,3768532,292,1.00
ptg006153l,3509239,3509573,334,EVM,mRNA,93867,3768532,334,1.00
ptg006156l,930636,930942,306,EVM,mRNA,169034,2043887,306,1.00
ptg006156l,1996417,1996722,305,EVM,mRNA,169034,2043887,305,1.00
ptg006156l,2385185,2385460,275,EVM,mRNA,2383055,2606102,275,1.00
ptg006159l,2113617,2113944,327,EVM,mRNA,1927340,2530150,327,1.00
ptg006159l,2131210,2131487,277,EVM,mRNA,1927340,2530150,277,1.00
ptg006166l,101753,102030,277,EVM,mRNA,57129,267920,277,1.00
ptg006167l,764009,764281,272,EVM,mRNA,334197,2178012,272,1.00
ptg006167l,1232534,1232849,315,EVM,mRNA,334197,2178012,315,1.00
ptg006167l,1361315,1361604,289,EVM,mRNA,334197,2178012,289,1.00
ptg006167l,1767305,1767627,322,EVM,mRNA,334197,2178012,322,1.00
ptg006173l,199342,199639,297,EVM,mRNA,178703,226675,297,1.00
ptg006176l,380195,380482,287,EVM,mRNA,37611,434573,287,1.00
ptg006176l,1269305,1269611,306,EVM,mRNA,596368,2046859,306,1.00
ptg006183l,2366848,2367126,278,EVM,mRNA,2061126,2444314,278,1.00
ptg006190l,1598526,1598838,312,EVM,mRNA,1324504,1792321,312,1.00
ptg006191l,725175,725468,293,EVM,mRNA,585967,1492435,293,1.00
ptg006193l,247412,247705,293,EVM,mRNA,57841,374310,293,1.00
ptg006193l,4499751,4500016,265,EVM,mRNA,3989250,4776476,265,1.00
ptg006197l,1694855,1695168,313,EVM,mRNA,1673657,3233033,313,1.00
ptg006197l,1757949,1758253,304,EVM,mRNA,1673657,3233033,304,1.00
ptg006197l,1800893,1801220,327,EVM,mRNA,1673657,3233033,327,1.00
ptg006197l,1985064,1985376,312,EVM,mRNA,1673657,3233033,312,1.00
ptg006197l,2371345,2371665,320,EVM,mRNA,1673657,3233033,320,1.00
ptg006197l,2583505,2583805,300,EVM,mRNA,1673657,3233033,300,1.00
ptg006200l,1562718,1563032,314,EVM,mRNA,1340721,1964412,314,1.00
ptg006200l,1914481,1914798,317,EVM,mRNA,1340721,1964412,317,1.00
ptg006207l,30878,31196,318,EVM,mRNA,945,407861,318,1.00
ptg006213l,594623,594920,297,EVM,mRNA,25958,973706,297,1.00
ptg006213l,1600910,1601193,283,EVM,mRNA,1158804,2799857,283,1.00
ptg006213l,2261465,2261738,273,EVM,mRNA,1158804,2799857,273,1.00
ptg006213l,2799068,2799367,299,EVM,mRNA,1158804,2799857,299,1.00
ptg006215l,373489,373800,311,EVM,mRNA,159065,704156,311,1.00
ptg006215l,2485790,2486103,313,EVM,mRNA,2203142,3774079,313,1.00
ptg006215l,2873917,2874241,324,EVM,mRNA,2203142,3774079,324,1.00
ptg006217l,1620453,1620767,314,EVM,mRNA,1100396,3603682,314,1.00
ptg006217l,2540652,2540932,280,EVM,mRNA,1100396,3603682,280,1.00
ptg006219l,1643314,1643593,279,EVM,mRNA,1383338,1803240,279,1.00
ptg006219l,3498891,3499198,307,EVM,mRNA,2801916,4296501,307,1.00
ptg006219l,3830953,3831274,321,EVM,mRNA,2801916,4296501,321,1.00
ptg006223l,1726828,1727125,297,EVM,mRNA,5125,2318812,297,1.00
ptg006223l,4491758,4492017,259,EVM,mRNA,4270938,4500412,259,1.00
ptg006224l,772905,773182,277,EVM,mRNA,751902,1006275,277,1.00
ptg006224l,977534,977833,299,EVM,mRNA,751902,1006275,299,1.00
ptg006224l,1826942,1827241,299,EVM,mRNA,1138114,2407952,299,1.00
ptg006224l,1965062,1965361,299,EVM,mRNA,1138114,2407952,299,1.00
ptg006224l,2009930,2010229,299,EVM,mRNA,1138114,2407952,299,1.00
ptg006224l,3493164,3493459,295,EVM,mRNA,3253552,5827610,295,1.00
ptg006224l,3717559,3717875,316,EVM,mRNA,3253552,5827610,316,1.00
ptg006224l,4879242,4879522,280,EVM,mRNA,3253552,5827610,280,1.00
ptg006227l,996491,996807,316,EVM,mRNA,865675,1006908,316,1.00
ptg006228l,1560882,1561194,312,EVM,mRNA,1556068,2755037,312,1.00
ptg006233l,3383096,3383431,335,EVM,mRNA,2977978,3967451,335,1.00
ptg006233l,3922715,3923012,297,EVM,mRNA,2977978,3967451,297,1.00
ptg006235l,511802,512071,269,EVM,mRNA,87103,744970,269,1.00
ptg006239l,2283044,2283356,312,EVM,mRNA,1863049,2471123,312,1.00
ptg006240l,786573,786884,311,EVM,mRNA,563025,927959,311,1.00
ptg006240l,852634,852913,279,EVM,mRNA,563025,927959,279,1.00
ptg006253l,1697477,1697789,312,EVM,mRNA,1624362,1890117,312,1.00
ptg006255l,1918442,1918758,316,EVM,mRNA,1514555,1985170,316,1.00
ptg006256l,620608,620905,297,EVM,mRNA,13658,1665169,297,1.00
ptg006260l,996327,996661,334,EVM,mRNA,536894,996931,334,1.00
ptg006260l,1252530,1252830,300,EVM,mRNA,1173295,1441490,300,1.00
ptg006261l,451817,452145,328,EVM,mRNA,270309,463885,328,1.00
ptg006272l,506982,507285,303,EVM,mRNA,93697,608441,303,1.00
ptg006272l,1187442,1187717,275,EVM,mRNA,1113563,1395552,275,1.00
ptg006278l,150093,150415,322,EVM,mRNA,108402,422402,322,1.00
ptg006278l,416851,417130,279,EVM,mRNA,108402,422402,279,1.00
ptg006281l,348931,349242,311,EVM,mRNA,32948,556545,311,1.00
ptg006281l,385185,385500,315,EVM,mRNA,32948,556545,315,1.00
ptg006284l,82195,82491,296,EVM,mRNA,68618,855259,296,1.00
ptg006287l,582611,582895,284,EVM,mRNA,233459,750811,284,1.00
ptg006289l,4141499,4141789,290,EVM,mRNA,3919312,6519255,290,1.00
ptg006289l,4871155,4871464,309,EVM,mRNA,3919312,6519255,309,1.00
ptg006291l,486604,486875,271,EVM,mRNA,358249,599227,271,1.00
ptg006293l,171400,171683,283,EVM,mRNA,14804,174273,283,1.00
ptg006296l,1193521,1193801,280,GeneWise,mRNA,1097254,1212039,280,1.00
ptg006296l,1193521,1193801,280,GeneWise,mRNA,1150187,1765843,280,1.00
ptg006296l,1671195,1671490,295,GeneWise,mRNA,1150187,1765843,295,1.00
ptg006297l,1604831,1605162,331,EVM,mRNA,1019143,1737611,331,1.00
ptg006298l,1263097,1263367,270,EVM,mRNA,901843,2309116,270,1.00
ptg006298l,5223758,5224039,281,EVM,mRNA,5154739,5904391,281,1.00
ptg006299l,642708,643001,293,EVM,mRNA,599548,790301,293,1.00
ptg006300l,979588,979886,298,EVM,mRNA,791938,1204196,298,1.00
ptg006301l,1482485,1482800,315,EVM,mRNA,127796,1784576,315,1.00
ptg006305l,808489,808791,302,EVM,mRNA,109478,888914,302,1.00
ptg006309l,1021526,1021818,292,EVM,mRNA,1012538,1139196,292,1.00
ptg006310l,2415667,2415954,287,EVM,mRNA,2096277,2873663,287,1.00
ptg006310l,2415667,2415954,287,GeMoMa,mRNA,1495838,2708178,287,1.00
ptg006314l,2722488,2722783,295,EVM,mRNA,2528332,3062453,295,1.00
ptg006314l,2839560,2839855,295,EVM,mRNA,2528332,3062453,295,1.00
ptg006314l,9137924,9138244,320,EVM,mRNA,8865989,9447155,320,1.00
ptg006314l,11843225,11843529,304,EVM,mRNA,11508130,11999618,304,1.00
ptg006315l,1408708,1408986,278,EVM,mRNA,1340172,2586125,278,1.00
ptg006315l,1858873,1859191,318,EVM,mRNA,1340172,2586125,318,1.00
ptg006316l,1039399,1039701,302,EVM,mRNA,514742,1217510,302,1.00
ptg006320l,58740,59021,281,EVM,mRNA,2565,773239,281,1.00
ptg006320l,1129089,1129408,319,EVM,mRNA,1041406,1661398,319,1.00
ptg006325l,199330,199631,301,EVM,mRNA,23950,438123,301,1.00
ptg006325l,389256,389564,308,EVM,mRNA,23950,438123,308,1.00
ptg006325l,1438531,1438799,268,EVM,mRNA,1224078,1759998,268,1.00
ptg006327l,804869,805169,300,EVM,mRNA,620539,921637,300,1.00
ptg006327l,1408584,1408896,312,EVM,mRNA,1406174,2779694,312,1.00
ptg006327l,2081493,2081804,311,EVM,mRNA,1406174,2779694,311,1.00
ptg006330l,639414,639705,291,EVM,mRNA,407052,671565,291,1.00
ptg006330l,2709558,2709841,283,EVM,mRNA,2408935,3083945,283,1.00
ptg006330l,3385142,3385417,275,EVM,mRNA,3263468,3455839,275,1.00
ptg006330l,3440627,3440936,309,EVM,mRNA,3263468,3455839,309,1.00
ptg006331l,2078052,2078367,315,EVM,mRNA,2013755,2572884,315,1.00
ptg006331l,2256570,2256872,302,EVM,mRNA,2013755,2572884,302,1.00
ptg006331l,2277591,2277872,281,EVM,mRNA,2013755,2572884,281,1.00
ptg006331l,2478230,2478510,280,EVM,mRNA,2013755,2572884,280,1.00
ptg006332l,768666,768960,294,EVM,mRNA,446265,958572,294,1.00
ptg006335l,3485296,3485601,305,EVM,mRNA,3381950,3516870,305,1.00
ptg006338l,1253947,1254231,284,EVM,mRNA,1057025,1398633,284,1.00
ptg006339l,3633336,3633610,274,EVM,mRNA,3142215,4645942,274,1.00
ptg006340l,40070,40361,291,EVM,mRNA,21860,68635,291,1.00
ptg006352l,621469,621768,299,EVM,mRNA,557385,1027469,299,1.00
ptg006354l,1230549,1230839,290,EVM,mRNA,900466,1236253,290,1.00
ptg006355l,692543,692852,309,EVM,mRNA,143053,964075,309,1.00
ptg006356l,1384477,1384778,301,EVM,mRNA,892067,2786827,301,1.00
ptg006356l,1443316,1443593,277,EVM,mRNA,892067,2786827,277,1.00
ptg006356l,1469542,1469846,304,EVM,mRNA,892067,2786827,304,1.00
ptg006356l,2447536,2447804,268,EVM,mRNA,892067,2786827,268,1.00
ptg006361l,1918394,1918681,287,EVM,mRNA,1884388,2046092,287,1.00
ptg006361l,1922573,1922885,312,EVM,mRNA,1884388,2046092,312,1.00
ptg006362l,2220170,2220467,297,EVM,mRNA,2137086,2977001,297,1.00
ptg006363l,768671,768953,282,EVM,mRNA,655574,907527,282,1.00
ptg006363l,890016,890318,302,EVM,mRNA,655574,907527,302,1.00
ptg006365l,12404,12721,317,EVM,mRNA,600,892075,317,1.00
ptg006365l,547687,548012,325,EVM,mRNA,600,892075,325,1.00
ptg006365l,730180,730462,282,EVM,mRNA,600,892075,282,1.00
ptg006365l,2694392,2694680,288,EVM,mRNA,2193609,3368665,288,1.00
ptg006366l,246851,247172,321,EVM,mRNA,43336,747648,321,1.00
ptg006366l,558984,559259,275,EVM,mRNA,43336,747648,275,1.00
ptg006369l,885986,886325,339,EVM,mRNA,772127,1461756,339,1.00
ptg006369l,1346664,1346979,315,EVM,mRNA,772127,1461756,315,1.00
ptg006369l,1435365,1435680,315,EVM,mRNA,772127,1461756,315,1.00
ptg006371l,54717,55054,337,EVM,mRNA,18514,1166163,337,1.00
ptg006371l,678548,678857,309,EVM,mRNA,18514,1166163,309,1.00
ptg006371l,1066981,1067284,303,EVM,mRNA,18514,1166163,303,1.00
ptg006371l,3627172,3627457,285,EVM,mRNA,3545389,3731149,285,1.00
ptg006372l,1423778,1424054,276,EVM,mRNA,1261986,6258827,276,1.00
ptg006372l,1465847,1466140,293,EVM,mRNA,1261986,6258827,293,1.00
ptg006372l,3569281,3569601,320,EVM,mRNA,1261986,6258827,320,1.00
ptg006372l,4167267,4167578,311,EVM,mRNA,1261986,6258827,311,1.00
ptg006372l,4319878,4320194,316,EVM,mRNA,1261986,6258827,316,1.00
ptg006372l,6490698,6490992,294,EVM,mRNA,6445537,6510787,294,1.00
ptg006378l,1520410,1520684,274,EVM,mRNA,1440187,1760546,274,1.00
ptg006380l,2608136,2608406,270,EVM,mRNA,2509637,5004074,270,1.00
ptg006380l,2761560,2761843,283,EVM,mRNA,2509637,5004074,283,1.00
ptg006380l,4661020,4661300,280,EVM,mRNA,2509637,5004074,280,1.00
ptg006380l,6524646,6524931,285,EVM,mRNA,5296823,6525454,285,1.00
ptg006380l,9241127,9241397,270,EVM,mRNA,8569013,9776501,270,1.00
ptg006383l,578119,578408,289,EVM,mRNA,571,719216,289,1.00
ptg006383l,597672,597939,267,EVM,mRNA,571,719216,267,1.00
ptg006383l,1207705,1208022,317,EVM,mRNA,1017862,2192559,317,1.00
ptg006383l,1629077,1629365,288,EVM,mRNA,1017862,2192559,288,1.00
ptg006383l,1787323,1787635,312,EVM,mRNA,1017862,2192559,312,1.00
ptg006383l,1983386,1983681,295,EVM,mRNA,1017862,2192559,295,1.00
ptg006383l,3989692,3990020,328,EVM,mRNA,3907575,4142538,328,1.00
ptg006384l,343753,344048,295,EVM,mRNA,185782,642082,295,1.00
ptg006384l,501787,502070,283,EVM,mRNA,185782,642082,283,1.00
ptg006384l,636110,636402,292,EVM,mRNA,185782,642082,292,1.00
ptg006384l,730821,731135,314,EVM,mRNA,684248,1137352,314,1.00
ptg006384l,1639366,1639681,315,EVM,mRNA,1582777,1666696,315,1.00
ptg006387l,578655,578988,333,EVM,mRNA,287593,761705,333,1.00
ptg006390l,759496,759802,306,EVM,mRNA,1881,782600,306,1.00
ptg006391l,502866,503179,313,EVM,mRNA,328922,705847,313,1.00
ptg006392l,1212587,1212889,302,EVM,mRNA,1012657,1504817,302,1.00
ptg006392l,1484190,1484513,323,EVM,mRNA,1012657,1504817,323,1.00
ptg006399l,338686,339004,318,EVM,mRNA,302392,1368806,318,1.00
ptg006399l,2403879,2404209,330,EVM,mRNA,2091742,2447497,330,1.00
ptg006401l,458556,458855,299,EVM,mRNA,14206,599803,299,1.00
ptg006402l,616806,617090,284,EVM,mRNA,600860,636104,284,1.00
ptg006405l,372125,372443,318,EVM,mRNA,37884,483740,318,1.00
ptg006408l,1636429,1636728,299,EVM,mRNA,1423206,2159079,299,1.00
ptg006408l,1875284,1875568,284,EVM,mRNA,1423206,2159079,284,1.00
ptg006408l,1881532,1881830,298,EVM,mRNA,1423206,2159079,298,1.00
ptg006409l,227356,227670,314,EVM,mRNA,10590,1248650,314,1.00
ptg006409l,566576,566849,273,EVM,mRNA,10590,1248650,273,1.00
ptg006413l,1814116,1814402,286,EVM,mRNA,1804397,1964793,286,1.00
ptg006413l,2280084,2280356,272,EVM,mRNA,2208098,2315949,272,1.00
ptg006418l,332866,333151,285,EVM,mRNA,297297,364646,285,1.00
ptg006418l,1968225,1968513,288,EVM,mRNA,1510728,2431783,288,1.00
ptg006420l,380473,380751,278,EVM,mRNA,311696,817397,278,1.00
ptg006422l,1399803,1400097,294,EVM,mRNA,744250,2638912,294,1.00
ptg006422l,1468233,1468542,309,EVM,mRNA,744250,2638912,309,1.00
ptg006423l,600532,600859,327,EVM,mRNA,197453,770028,327,1.00
ptg006423l,690914,691226,312,EVM,mRNA,197453,770028,312,1.00
ptg006426l,2922035,2922362,327,EVM,mRNA,2761817,5484765,327,1.00
ptg006426l,3329681,3329980,299,EVM,mRNA,2761817,5484765,299,1.00
ptg006426l,5029243,5029536,293,EVM,mRNA,2761817,5484765,293,1.00
ptg006427l,860400,860701,301,EVM,mRNA,251648,1452252,301,1.00
ptg006427l,1123148,1123445,297,EVM,mRNA,251648,1452252,297,1.00
ptg006427l,2216622,2216938,316,EVM,mRNA,2098875,2672149,316,1.00
ptg006427l,3169426,3169705,279,EVM,mRNA,2846647,3502805,279,1.00
ptg006434l,163573,163879,306,EVM,mRNA,86686,173756,306,1.00
ptg006436l,518994,519325,331,EVM,mRNA,216035,676807,331,1.00
ptg006439l,3566585,3566886,301,EVM,mRNA,3057649,5729894,301,1.00
ptg006439l,4401732,4402025,293,EVM,mRNA,3057649,5729894,293,1.00
ptg006439l,4473494,4473826,332,EVM,mRNA,3057649,5729894,332,1.00
ptg006441l,1478260,1478580,320,EVM,mRNA,258823,1528207,320,1.00
ptg006442l,810357,810625,268,EVM,mRNA,499451,1039357,268,1.00
ptg006444l,597291,597619,328,EVM,mRNA,79793,1259817,328,1.00
ptg006444l,1187871,1188190,319,EVM,mRNA,79793,1259817,319,1.00
ptg006454l,4037526,4037806,280,EVM,mRNA,3834417,6562880,280,1.00
ptg006454l,4229233,4229521,288,EVM,mRNA,3834417,6562880,288,1.00
ptg006461l,1365965,1366282,317,EVM,mRNA,1165500,2055165,317,1.00
ptg006461l,1909480,1909786,306,EVM,mRNA,1165500,2055165,306,1.00
ptg006461l,3229985,3230297,312,EVM,mRNA,2055424,4435222,312,1.00
ptg006466l,117709,118020,311,EVM,mRNA,110965,332175,311,1.00
ptg006466l,805503,805814,311,EVM,mRNA,497127,1182310,311,1.00
ptg006466l,1223364,1223644,280,EVM,mRNA,1223273,1631007,280,1.00
ptg006466l,1259601,1259929,328,EVM,mRNA,1223273,1631007,328,1.00
ptg006467l,268164,268431,267,EVM,mRNA,228537,1924444,267,1.00
ptg006467l,345195,345498,303,EVM,mRNA,228537,1924444,303,1.00
ptg006468l,683908,684241,333,EVM,mRNA,397852,1112700,333,1.00
ptg006468l,1062318,1062623,305,EVM,mRNA,397852,1112700,305,1.00
ptg006468l,3235511,3235804,293,EVM,mRNA,3217733,3492419,293,1.00
ptg006471l,1320171,1320475,304,EVM,mRNA,1236760,1455580,304,1.00
ptg006473l,1014848,1015150,302,EVM,mRNA,994878,1552870,302,1.00
ptg006473l,1183012,1183333,321,EVM,mRNA,994878,1552870,321,1.00
ptg006473l,1518910,1519177,267,EVM,mRNA,994878,1552870,267,1.00
ptg006478l,1449560,1449879,319,EVM,mRNA,1352193,1598084,319,1.00
ptg006478l,1596595,1596911,316,EVM,mRNA,1352193,1598084,316,1.00
ptg006480l,718639,718920,281,EVM,mRNA,714580,894176,281,1.00
ptg006482l,2462825,2463115,290,EVM,mRNA,1885159,2498992,290,1.00
ptg006486l,752486,752774,288,EVM,mRNA,592785,860566,288,1.00
ptg006486l,765537,765818,281,EVM,mRNA,592785,860566,281,1.00
ptg006486l,1417940,1418258,318,EVM,mRNA,861623,1608776,318,1.00
ptg006486l,1978657,1978983,326,EVM,mRNA,1904943,2139725,326,1.00
ptg006489l,510314,510613,299,EVM,mRNA,63950,654029,299,1.00
ptg006492l,698442,698736,294,EVM,mRNA,688798,2356695,294,1.00
ptg006492l,1919327,1919613,286,EVM,mRNA,688798,2356695,286,1.00
ptg006492l,2229954,2230238,284,EVM,mRNA,688798,2356695,284,1.00
ptg006492l,2804433,2804758,325,EVM,mRNA,2799050,3005988,325,1.00
ptg006493l,174118,174398,280,EVM,mRNA,12858,476706,280,1.00
ptg006495l,1709676,1709994,318,EVM,mRNA,1608546,1858154,318,1.00
ptg006495l,1853650,1853934,284,EVM,mRNA,1608546,1858154,284,1.00
ptg006496l,886492,886801,309,EVM,mRNA,1408,1961111,309,1.00
ptg006496l,910463,910746,283,EVM,mRNA,1408,1961111,283,1.00
ptg006496l,1069194,1069503,309,EVM,mRNA,1408,1961111,309,1.00
ptg006496l,1386794,1387090,296,EVM,mRNA,1408,1961111,296,1.00
ptg006496l,1557825,1558138,313,EVM,mRNA,1408,1961111,313,1.00
ptg006500l,522690,522963,273,EVM,mRNA,456980,799222,273,1.00
ptg006500l,526541,526851,310,EVM,mRNA,456980,799222,310,1.00
ptg006500l,688338,688622,284,EVM,mRNA,456980,799222,284,1.00
ptg006500l,1443259,1443582,323,EVM,mRNA,1172500,2247431,323,1.00
ptg006511l,2413068,2413367,299,EVM,mRNA,1945186,4045033,299,1.00
ptg006511l,2621054,2621355,301,EVM,mRNA,1945186,4045033,301,1.00
ptg006511l,2734678,2734993,315,EVM,mRNA,1945186,4045033,315,1.00
ptg006511l,3665799,3666097,298,EVM,mRNA,1945186,4045033,298,1.00
ptg006511l,3992586,3992864,278,EVM,mRNA,1945186,4045033,278,1.00
ptg006514l,1422214,1422516,302,EVM,mRNA,1029964,2015995,302,1.00
ptg006515l,846868,847171,303,EVM,mRNA,671075,990205,303,1.00
ptg006516l,5212013,5212319,306,EVM,mRNA,5149053,5214571,306,1.00
ptg006522l,1574910,1575219,309,EVM,mRNA,1465499,1669529,309,1.00
ptg006522l,4764925,4765247,322,EVM,mRNA,4505665,5107226,322,1.00
ptg006522l,4898239,4898523,284,EVM,mRNA,4505665,5107226,284,1.00
ptg006524l,1925012,1925326,314,EVM,mRNA,1900773,2631063,314,1.00
ptg006525l,820429,820714,285,EVM,mRNA,603066,823702,285,1.00
ptg006534l,385954,386253,299,EVM,mRNA,364839,605592,299,1.00
ptg006536l,896125,896424,299,EVM,mRNA,343519,1096889,299,1.00
ptg006536l,984520,984835,315,EVM,mRNA,343519,1096889,315,1.00
ptg006537l,1235066,1235360,294,EVM,mRNA,762735,1512527,294,1.00
ptg006537l,3458303,3458587,284,EVM,mRNA,3143040,4586264,284,1.00
ptg006537l,3681072,3681371,299,EVM,mRNA,3143040,4586264,299,1.00
ptg006537l,3957860,3958189,329,EVM,mRNA,3143040,4586264,329,1.00
ptg006537l,4186194,4186515,321,EVM,mRNA,3143040,4586264,321,1.00
ptg006537l,4189152,4189472,320,EVM,mRNA,3143040,4586264,320,1.00
ptg006537l,5888649,5888930,281,EVM,mRNA,5408634,7668532,281,1.00
ptg006537l,5906642,5906938,296,EVM,mRNA,5408634,7668532,296,1.00
ptg006537l,5972141,5972427,286,EVM,mRNA,5408634,7668532,286,1.00
ptg006537l,6143018,6143281,263,EVM,mRNA,5408634,7668532,263,1.00
ptg006537l,7119622,7119924,302,EVM,mRNA,5408634,7668532,302,1.00
ptg006537l,7292519,7292848,329,EVM,mRNA,5408634,7668532,329,1.00
ptg006537l,7400453,7400748,295,EVM,mRNA,5408634,7668532,295,1.00
ptg006541l,469456,469737,281,EVM,mRNA,459755,622501,281,1.00
ptg006545l,1552705,1553017,312,EVM,mRNA,1355021,2037618,312,1.00
ptg006546l,457358,457674,316,EVM,mRNA,370096,619688,316,1.00
ptg006548l,760441,760764,323,EVM,mRNA,594168,837619,323,1.00
ptg006548l,1165816,1166116,300,EVM,mRNA,1030751,1205814,300,1.00
ptg006548l,1329637,1329960,323,EVM,mRNA,1307413,1824394,323,1.00
ptg006548l,1477514,1477822,308,EVM,mRNA,1307413,1824394,308,1.00
ptg006548l,1691327,1691585,258,EVM,mRNA,1307413,1824394,258,1.00
ptg006551l,191663,191987,324,EVM,mRNA,2611,307300,324,1.00
ptg006551l,1139804,1140123,319,EVM,mRNA,997420,1632074,319,1.00
ptg006551l,1993760,1994050,290,EVM,mRNA,1773231,2119991,290,1.00
ptg006551l,2814470,2814785,315,EVM,mRNA,2779852,2894574,315,1.00
ptg006551l,2843107,2843385,278,EVM,mRNA,2779852,2894574,278,1.00
ptg006551l,3194970,3195258,288,EVM,mRNA,2905254,4126131,288,1.00
ptg006551l,3276368,3276684,316,EVM,mRNA,2905254,4126131,316,1.00
ptg006551l,4011278,4011560,282,EVM,mRNA,2905254,4126131,282,1.00
ptg006555l,1736063,1736342,279,EVM,mRNA,1715246,3396858,279,1.00
ptg006565l,1742514,1742824,310,EVM,mRNA,1668302,1890137,310,1.00
ptg006566l,944880,945160,280,EVM,mRNA,941696,1225801,280,1.00
ptg006566l,1128838,1129146,308,EVM,mRNA,941696,1225801,308,1.00
ptg006569l,1752601,1752902,301,EVM,mRNA,1654377,1808280,301,1.00
ptg006569l,1873985,1874270,285,EVM,mRNA,1855446,2930172,285,1.00
ptg006569l,1873985,1874270,285,GeneWise,mRNA,1855449,2939956,285,1.00
ptg006569l,2669646,2669944,298,EVM,mRNA,1855446,2930172,298,1.00
ptg006569l,2669646,2669944,298,GeneWise,mRNA,1855449,2939956,298,1.00
ptg006570l,240312,240625,313,EVM,mRNA,68821,324347,313,1.00
ptg006572l,455542,455871,329,EVM,mRNA,193246,521816,329,1.00
ptg006572l,509455,509757,302,EVM,mRNA,193246,521816,302,1.00
ptg006582l,1252392,1252687,295,EVM,mRNA,721531,1772778,295,1.00
ptg006582l,1361870,1362164,294,EVM,mRNA,721531,1772778,294,1.00
ptg006582l,2396039,2396306,267,EVM,mRNA,1829938,2604011,267,1.00
ptg006582l,2445429,2445772,343,EVM,mRNA,1829938,2604011,343,1.00
ptg006583l,636757,637074,317,EVM,mRNA,425299,3346532,317,1.00
ptg006583l,735999,736247,248,EVM,mRNA,425299,3346532,248,1.00
ptg006583l,1959325,1959628,303,EVM,mRNA,425299,3346532,303,1.00
ptg006583l,1984912,1985210,298,EVM,mRNA,425299,3346532,298,1.00
ptg006583l,2171501,2171824,323,EVM,mRNA,425299,3346532,323,1.00
ptg006583l,2991765,2992093,328,EVM,mRNA,425299,3346532,328,1.00
ptg006584l,626227,626518,291,EVM,mRNA,459772,1408001,291,1.00
ptg006584l,998289,998589,300,EVM,mRNA,459772,1408001,300,1.00
ptg006584l,1307866,1308192,326,EVM,mRNA,459772,1408001,326,1.00
ptg006585l,168873,169185,312,EVM,mRNA,3749,239872,312,1.00
ptg006588l,170904,171236,332,EVM,mRNA,66579,413941,332,1.00
ptg006588l,2797645,2797928,283,EVM,mRNA,2308551,2887482,283,1.00
ptg006589l,1517589,1517891,302,EVM,mRNA,1262616,2454457,302,1.00
ptg006589l,2415048,2415372,324,EVM,mRNA,1262616,2454457,324,1.00
ptg006590l,1555330,1555656,326,EVM,mRNA,1544747,2419240,326,1.00
ptg006590l,1953996,1954316,320,EVM,mRNA,1544747,2419240,320,1.00
ptg006590l,2289137,2289400,263,EVM,mRNA,1544747,2419240,263,1.00
ptg006591l,172522,172830,308,EVM,mRNA,114524,307247,308,1.00
ptg006592l,520019,520342,323,EVM,mRNA,258322,2232577,323,1.00
ptg006592l,1191318,1191617,299,EVM,mRNA,258322,2232577,299,1.00
ptg006592l,1702034,1702360,326,EVM,mRNA,258322,2232577,326,1.00
ptg006593l,111007,111324,317,EVM,mRNA,18812,130295,317,1.00
ptg006594l,713895,714175,280,EVM,mRNA,101474,1299174,280,1.00
ptg006594l,721047,721327,280,EVM,mRNA,101474,1299174,280,1.00
ptg006595l,1149275,1149586,311,EVM,mRNA,6314,1212700,311,1.00
ptg006597l,1713826,1714145,319,EVM,mRNA,1581575,1716508,319,1.00
ptg006599l,467544,467861,317,EVM,mRNA,302442,490095,317,1.00
ptg006607l,411916,412233,317,EVM,mRNA,355710,4294911,317,1.00
ptg006607l,758193,758462,269,EVM,mRNA,355710,4294911,269,1.00
ptg006607l,762676,762958,282,EVM,mRNA,355710,4294911,282,1.00
ptg006607l,1068118,1068407,289,EVM,mRNA,355710,4294911,289,1.00
ptg006607l,1527407,1527683,276,EVM,mRNA,355710,4294911,276,1.00
ptg006607l,2616713,2617029,316,EVM,mRNA,355710,4294911,316,1.00
ptg006607l,2751199,2751499,300,EVM,mRNA,355710,4294911,300,1.00
ptg006607l,2845391,2845674,283,EVM,mRNA,355710,4294911,283,1.00
ptg006607l,3053543,3053827,284,EVM,mRNA,355710,4294911,284,1.00
ptg006607l,3452309,3452639,330,EVM,mRNA,355710,4294911,330,1.00
ptg006607l,4047856,4048159,303,EVM,mRNA,355710,4294911,303,1.00
ptg006609l,942867,943157,290,EVM,mRNA,276471,1603815,290,1.00
ptg006609l,1007358,1007685,327,EVM,mRNA,276471,1603815,327,1.00
ptg006609l,1396371,1396680,309,EVM,mRNA,276471,1603815,309,1.00
ptg006609l,2348656,2348949,293,EVM,mRNA,1768897,2364661,293,1.00
ptg006609l,2945554,2945795,241,EVM,mRNA,2558193,2958098,241,1.00
ptg006609l,2955889,2956199,310,EVM,mRNA,2558193,2958098,310,1.00
ptg006613l,421515,421846,331,EVM,mRNA,262827,1644524,331,1.00
ptg006613l,1959624,1959909,285,EVM,mRNA,1850895,1999499,285,1.00
ptg006614l,529475,529764,289,EVM,mRNA,158691,873887,289,1.00
ptg006614l,598934,599253,319,EVM,mRNA,158691,873887,319,1.00
ptg006614l,769096,769423,327,EVM,mRNA,158691,873887,327,1.00
ptg006615l,1728800,1729089,289,EVM,mRNA,1250902,1736363,289,1.00
ptg006619l,1594716,1595023,307,EVM,mRNA,1490308,1767335,307,1.00
ptg006619l,1719801,1720116,315,EVM,mRNA,1490308,1767335,315,1.00
ptg006619l,2050187,2050518,331,EVM,mRNA,1963271,2088059,331,1.00
ptg006620l,1833330,1833627,297,EVM,mRNA,291906,4773329,297,1.00
ptg006620l,2005821,2006124,303,EVM,mRNA,291906,4773329,303,1.00
ptg006620l,2199851,2200129,278,EVM,mRNA,291906,4773329,278,1.00
ptg006623l,2064294,2064606,312,EVM,mRNA,1646824,2097946,312,1.00
ptg006623l,2393193,2393499,306,EVM,mRNA,2251643,3083995,306,1.00
ptg006623l,2637546,2637865,319,EVM,mRNA,2251643,3083995,319,1.00
ptg006624l,163804,164091,287,EVM,mRNA,1124,351030,287,1.00
ptg006630l,1021643,1021950,307,EVM,mRNA,822827,1623276,307,1.00
ptg006630l,1089191,1089527,336,EVM,mRNA,822827,1623276,336,1.00
ptg006633l,4467292,4467607,315,EVM,mRNA,4190136,4655945,315,1.00
ptg006637l,1766993,1767301,308,EVM,mRNA,530227,2444140,308,1.00
ptg006637l,2336989,2337263,274,EVM,mRNA,530227,2444140,274,1.00
ptg006639l,2714584,2714877,293,EVM,mRNA,212166,3349258,293,1.00
ptg006639l,3620236,3620529,293,EVM,mRNA,3530686,3780119,293,1.00
ptg006642l,782297,782599,302,EVM,mRNA,29859,1289882,302,1.00
ptg006642l,1288500,1288817,317,EVM,mRNA,29859,1289882,317,1.00
ptg006651l,258774,259091,317,EVM,mRNA,205600,291703,317,1.00
ptg006654l,237304,237613,309,EVM,mRNA,113124,284821,309,1.00
ptg006657l,763063,763383,320,EVM,mRNA,622556,2013818,320,1.00
ptg006657l,1050899,1051181,282,EVM,mRNA,622556,2013818,282,1.00
ptg006660l,546812,547111,299,EVM,mRNA,449538,791206,299,1.00
ptg006660l,3989575,3989894,319,EVM,mRNA,3224976,5084944,319,1.00
ptg006660l,4557507,4557827,320,EVM,mRNA,3224976,5084944,320,1.00
ptg006669l,380837,381125,288,EVM,mRNA,367846,1754709,288,1.00
ptg006669l,437454,437759,305,EVM,mRNA,367846,1754709,305,1.00
ptg006669l,494164,494484,320,EVM,mRNA,367846,1754709,320,1.00
ptg006669l,601880,602203,323,EVM,mRNA,367846,1754709,323,1.00
ptg006669l,1983032,1983349,317,EVM,mRNA,1898492,2386071,317,1.00
ptg006669l,2256912,2257194,282,EVM,mRNA,1898492,2386071,282,1.00
ptg006669l,2308103,2308398,295,EVM,mRNA,1898492,2386071,295,1.00
ptg006671l,919771,920085,314,EVM,mRNA,300114,1128980,314,1.00
ptg006675l,331109,331381,272,EVM,mRNA,294002,412375,272,1.00
ptg006675l,739933,740254,321,EVM,mRNA,722052,885165,321,1.00
ptg006678l,462872,463210,338,EVM,mRNA,313469,716173,338,1.00
ptg006678l,1053432,1053721,289,EVM,mRNA,941281,1072788,289,1.00
ptg006678l,1082166,1082466,300,EVM,mRNA,1081856,1136816,300,1.00
ptg006680l,1129355,1129656,301,EVM,mRNA,991465,3013788,301,1.00
ptg006680l,3112971,3113262,291,EVM,mRNA,3075567,3155134,291,1.00
ptg006683l,111844,112163,319,EVM,mRNA,89665,669036,319,1.00
ptg006687l,545362,545658,296,EVM,mRNA,2794,831506,296,1.00
ptg006695l,957325,957617,292,EVM,mRNA,14958,1018036,292,1.00
ptg006698l,953225,953532,307,EVM,mRNA,65308,1027440,307,1.00
ptg006699l,239766,240065,299,EVM,mRNA,12281,772147,299,1.00
ptg006699l,3489793,3490101,308,EVM,mRNA,3455296,4527806,308,1.00
ptg006699l,3904565,3904844,279,EVM,mRNA,3455296,4527806,279,1.00
ptg006703l,229237,229550,313,EVM,mRNA,74042,521111,313,1.00
ptg006703l,510018,510321,303,EVM,mRNA,74042,521111,303,1.00
ptg006703l,2273090,2273357,267,EVM,mRNA,2219121,2360506,267,1.00
ptg006704l,2253993,2254250,257,EVM,mRNA,2082422,2275427,257,1.00
ptg006707l,300198,300495,297,EVM,mRNA,220361,400016,297,1.00
ptg006707l,2017600,2017840,240,EVM,mRNA,1367110,2018629,240,1.00
ptg006709l,453871,454167,296,EVM,mRNA,352758,468867,296,1.00
ptg006709l,1658054,1658352,298,EVM,mRNA,1392596,2166712,298,1.00
ptg006709l,2074503,2074821,318,EVM,mRNA,1392596,2166712,318,1.00
ptg006709l,2360422,2360710,288,EVM,mRNA,2276944,2442611,288,1.00
ptg006711l,1647963,1648247,284,EVM,mRNA,895929,1769588,284,1.00
ptg006711l,2360393,2360673,280,EVM,mRNA,2000376,3544615,280,1.00
ptg006711l,3212389,3212691,302,EVM,mRNA,2000376,3544615,302,1.00
ptg006711l,4123088,4123372,284,EVM,mRNA,4065289,5024156,284,1.00
ptg006711l,4348723,4349004,281,EVM,mRNA,4065289,5024156,281,1.00
ptg006712l,4213285,4213585,300,EVM,mRNA,4148369,5257023,300,1.00
ptg006716l,828771,829067,296,EVM,mRNA,195218,1435889,296,1.00
ptg006716l,2538421,2538672,251,EVM,mRNA,2302450,3039266,251,1.00
ptg006716l,3871412,3871718,306,EVM,mRNA,3751531,4235734,306,1.00
ptg006716l,3930126,3930456,330,EVM,mRNA,3751531,4235734,330,1.00
ptg006716l,4070760,4071004,244,EVM,mRNA,3751531,4235734,244,1.00
ptg006719l,530189,530460,271,EVM,mRNA,412541,812968,271,1.00
ptg006720l,744996,745284,288,EVM,mRNA,31697,852041,288,1.00
ptg006721l,725758,726058,300,EVM,mRNA,40183,964263,300,1.00
ptg006721l,898396,898710,314,EVM,mRNA,40183,964263,314,1.00
ptg006723l,736166,736466,300,EVM,mRNA,173396,2125533,300,1.00
ptg006725l,440953,441266,313,EVM,mRNA,184585,564272,313,1.00
ptg006727l,1308044,1308304,260,EVM,mRNA,930730,2057169,260,1.00
ptg006727l,1510933,1511213,280,EVM,mRNA,930730,2057169,280,1.00
ptg006728l,880826,881151,325,EVM,mRNA,47483,1306360,325,1.00
ptg006734l,839948,840250,302,EVM,mRNA,211278,895534,302,1.00
ptg006737l,457952,458278,326,EVM,mRNA,61379,871252,326,1.00
ptg006737l,759097,759404,307,EVM,mRNA,61379,871252,307,1.00
ptg006737l,2047019,2047330,311,EVM,mRNA,1362654,3589387,311,1.00
ptg006737l,3298074,3298366,292,EVM,mRNA,1362654,3589387,292,1.00
ptg006738l,839405,839697,292,EVM,mRNA,386003,1152588,292,1.00
ptg006742l,3899260,3899566,306,EVM,mRNA,3874265,4188721,306,1.00
ptg006744l,334173,334491,318,EVM,mRNA,39677,817871,318,1.00
ptg006747l,1862002,1862324,322,EVM,mRNA,1708123,2230537,322,1.00
ptg006752l,753640,753910,270,EVM,mRNA,71627,815890,270,1.00
ptg006752l,1091967,1092249,282,EVM,mRNA,868414,1218503,282,1.00
ptg006755l,1066553,1066838,285,EVM,mRNA,141212,1070487,285,1.00
ptg006755l,3463500,3463783,283,EVM,mRNA,3404763,4377645,283,1.00
ptg006758l,690160,690469,309,EVM,mRNA,115926,1932322,309,1.00
ptg006758l,1735286,1735577,291,EVM,mRNA,115926,1932322,291,1.00
ptg006760l,11599,11873,274,EVM,mRNA,7761,1358339,274,1.00
ptg006760l,454939,455246,307,EVM,mRNA,7761,1358339,307,1.00
ptg006760l,620764,621076,312,EVM,mRNA,7761,1358339,312,1.00
ptg006767l,865071,865378,307,EVM,mRNA,156007,3216571,307,1.00
ptg006767l,2618572,2618867,295,EVM,mRNA,156007,3216571,295,1.00
ptg006770l,570649,570978,329,EVM,mRNA,540638,708271,329,1.00
ptg006770l,1090760,1091067,307,EVM,mRNA,953548,1234667,307,1.00
ptg006770l,1229329,1229584,255,EVM,mRNA,953548,1234667,255,1.00
ptg006771l,2818902,2819212,310,EVM,mRNA,1816599,3014903,310,1.00
ptg006775l,451273,451589,316,EVM,mRNA,250,483875,316,1.00
ptg006781l,818041,818340,299,EVM,mRNA,223621,1233200,299,1.00
ptg006787l,579003,579320,317,EVM,mRNA,27020,1244397,317,1.00
ptg006787l,770261,770569,308,EVM,mRNA,27020,1244397,308,1.00
ptg006788l,100709,100990,281,EVM,mRNA,2895,339498,281,1.00
ptg006788l,179824,180095,271,EVM,mRNA,2895,339498,271,1.00
ptg006788l,927750,928009,259,EVM,mRNA,841937,1029635,259,1.00
ptg006788l,3949802,3950120,318,EVM,mRNA,3596992,4482402,318,1.00
ptg006788l,4046683,4046957,274,EVM,mRNA,3596992,4482402,274,1.00
ptg006788l,6018268,6018563,295,EVM,mRNA,5706297,6436589,295,1.00
ptg006789l,659493,659814,321,EVM,mRNA,576759,1207398,321,1.00
ptg006796l,56492,56785,293,EVM,mRNA,48078,2122478,293,1.00
ptg006796l,210340,210637,297,EVM,mRNA,48078,2122478,297,1.00
ptg006796l,1038059,1038355,296,EVM,mRNA,48078,2122478,296,1.00
ptg006796l,1582681,1582967,286,EVM,mRNA,48078,2122478,286,1.00
ptg006797l,743660,743928,268,EVM,mRNA,710596,1375123,268,1.00
ptg006797l,763570,763894,324,EVM,mRNA,710596,1375123,324,1.00
ptg006797l,1221126,1221440,314,EVM,mRNA,710596,1375123,314,1.00
ptg006797l,1283890,1284168,278,EVM,mRNA,710596,1375123,278,1.00
ptg006800l,800008,800294,286,EVM,mRNA,15206,2196871,286,1.00
ptg006800l,1163158,1163495,337,EVM,mRNA,15206,2196871,337,1.00
ptg006803l,324139,324454,315,EVM,mRNA,2069,325293,315,1.00
ptg006803l,1548647,1548975,328,EVM,mRNA,846082,1555366,328,1.00
ptg006804l,400238,400534,296,EVM,mRNA,80798,611541,296,1.00
ptg006804l,1245624,1245909,285,EVM,mRNA,1226258,1565251,285,1.00
ptg006805l,190188,190461,273,EVM,mRNA,2808,907293,273,1.00
ptg006805l,831547,831832,285,EVM,mRNA,2808,907293,285,1.00
ptg006805l,873001,873273,272,EVM,mRNA,2808,907293,272,1.00
ptg006809l,962379,962679,300,EVM,mRNA,880962,1005548,300,1.00
ptg006811l,632386,632685,299,EVM,mRNA,115559,1153205,299,1.00
ptg006812l,744719,745017,298,EVM,mRNA,315840,988607,298,1.00
ptg006812l,1282115,1282448,333,EVM,mRNA,1042710,1896142,333,1.00
ptg006814l,1915979,1916276,297,EVM,mRNA,1893685,1997073,297,1.00
ptg006816l,430155,430468,313,EVM,mRNA,70256,636637,313,1.00
ptg006821l,1986207,1986526,319,EVM,mRNA,1643604,2290064,319,1.00
ptg006822l,2635215,2635488,273,EVM,mRNA,2484779,2662526,273,1.00
ptg006822l,2930938,2931242,304,EVM,mRNA,2803441,5269000,304,1.00
ptg006825l,2271898,2272222,324,EVM,mRNA,967967,3091244,324,1.00
ptg006825l,6129654,6129987,333,EVM,mRNA,6009537,6894347,333,1.00
ptg006826l,914727,915017,290,EVM,mRNA,545874,1939558,290,1.00
ptg006826l,972377,972674,297,EVM,mRNA,545874,1939558,297,1.00
ptg006826l,1101251,1101562,311,EVM,mRNA,545874,1939558,311,1.00
ptg006826l,1109496,1109810,314,EVM,mRNA,545874,1939558,314,1.00
ptg006826l,1308026,1308352,326,EVM,mRNA,545874,1939558,326,1.00
ptg006826l,1609207,1609519,312,EVM,mRNA,545874,1939558,312,1.00
ptg006826l,1758398,1758720,322,EVM,mRNA,545874,1939558,322,1.00
ptg006829l,670946,671240,294,EVM,mRNA,309166,969226,294,1.00
ptg006838l,161284,161597,313,EVM,mRNA,1405,905667,313,1.00
ptg006841l,761858,762177,319,EVM,mRNA,231519,764515,319,1.00
ptg006842l,779753,780039,286,EVM,mRNA,432705,938701,286,1.00
ptg006842l,801215,801485,270,EVM,mRNA,432705,938701,270,1.00
ptg006843l,182839,183159,320,EVM,mRNA,30836,1943078,320,1.00
ptg006843l,806515,806819,304,EVM,mRNA,30836,1943078,304,1.00
ptg006845l,19786,20083,297,EVM,mRNA,7097,124575,297,1.00
ptg006845l,487961,488268,307,EVM,mRNA,194397,503899,307,1.00
ptg006846l,340404,340685,281,EVM,mRNA,17782,619984,281,1.00
ptg006846l,347571,347852,281,EVM,mRNA,17782,619984,281,1.00
ptg006854l,603479,603774,295,EVM,mRNA,342643,895467,295,1.00
ptg006854l,695574,695850,276,EVM,mRNA,342643,895467,276,1.00
ptg006854l,772551,772820,269,EVM,mRNA,342643,895467,269,1.00
ptg006858l,1780598,1780912,314,EVM,mRNA,547778,2367257,314,1.00
ptg006859l,302507,302778,271,EVM,mRNA,968,860771,271,1.00
ptg006860l,95221,95500,279,EVM,mRNA,81718,274967,279,1.00
ptg006860l,110372,110668,296,EVM,mRNA,81718,274967,296,1.00
ptg006860l,172204,172514,310,EVM,mRNA,81718,274967,310,1.00
ptg006867l,84788,85071,283,EVM,mRNA,81020,536862,283,1.00
ptg006868l,1447876,1448211,335,EVM,mRNA,1373803,1476662,335,1.00
ptg006869l,419019,419316,297,EVM,mRNA,218181,431989,297,1.00
ptg006870l,732130,732453,323,EVM,mRNA,712718,1080423,323,1.00
ptg006870l,735730,736038,308,EVM,mRNA,712718,1080423,308,1.00
ptg006870l,1881223,1881545,322,EVM,mRNA,1328641,2489125,322,1.00
ptg006870l,2216692,2217004,312,EVM,mRNA,1328641,2489125,312,1.00
ptg006870l,2326886,2327171,285,EVM,mRNA,1328641,2489125,285,1.00
ptg006870l,3081700,3081983,283,EVM,mRNA,2727010,4368455,283,1.00
ptg006873l,2556147,2556432,285,EVM,mRNA,2438992,3612732,285,1.00
ptg006873l,3023117,3023393,276,EVM,mRNA,2438992,3612732,276,1.00
ptg006873l,4550822,4551121,299,EVM,mRNA,3962094,4574018,299,1.00
ptg006879l,308818,309096,278,EVM,mRNA,164033,1145329,278,1.00
ptg006879l,464232,464529,297,EVM,mRNA,164033,1145329,297,1.00
ptg006881l,713688,714004,316,EVM,mRNA,178588,1308624,316,1.00
ptg006885l,574420,574735,315,EVM,mRNA,537325,647556,315,1.00
ptg006887l,541788,542092,304,EVM,mRNA,494338,703003,304,1.00
ptg006888l,632792,633119,327,EVM,mRNA,446430,2270157,327,1.00
ptg006888l,836932,837238,306,EVM,mRNA,446430,2270157,306,1.00
ptg006888l,1059536,1059844,308,EVM,mRNA,446430,2270157,308,1.00
ptg006888l,1243540,1243825,285,EVM,mRNA,446430,2270157,285,1.00
ptg006889l,1999850,2000146,296,EVM,mRNA,1825957,2792930,296,1.00
ptg006890l,455137,455442,305,EVM,mRNA,423823,501757,305,1.00
ptg006898l,440386,440698,312,EVM,mRNA,171365,1791088,312,1.00
ptg006898l,687272,687561,289,EVM,mRNA,171365,1791088,289,1.00
ptg006900l,2812896,2813197,301,EVM,mRNA,2792165,2816158,301,1.00
ptg006900l,5077611,5077926,315,EVM,mRNA,2953459,6035577,315,1.00
ptg006900l,5449639,5449930,291,EVM,mRNA,2953459,6035577,291,1.00
ptg006900l,6005855,6006142,287,EVM,mRNA,2953459,6035577,287,1.00
ptg006900l,9426358,9426679,321,EVM,mRNA,8122602,9760103,321,1.00
ptg006900l,10265264,10265563,299,EVM,mRNA,10050557,13100316,299,1.00
ptg006900l,10814337,10814664,327,EVM,mRNA,10050557,13100316,327,1.00
ptg006900l,11411271,11411569,298,EVM,mRNA,10050557,13100316,298,1.00
ptg006900l,13798775,13799055,280,EVM,mRNA,13718292,16731816,280,1.00
ptg006900l,15256439,15256762,323,EVM,mRNA,13718292,16731816,323,1.00
ptg006900l,15346441,15346740,299,EVM,mRNA,13718292,16731816,299,1.00
ptg006900l,15656862,15657166,304,EVM,mRNA,13718292,16731816,304,1.00
ptg006900l,16493050,16493329,279,EVM,mRNA,13718292,16731816,279,1.00
ptg006900l,16523839,16524134,295,EVM,mRNA,13718292,16731816,295,1.00
ptg006904l,30557,30863,306,EVM,mRNA,28950,231915,306,1.00
ptg006906l,1362073,1362359,286,EVM,mRNA,1192188,1559728,286,1.00
ptg006908l,794697,795017,320,EVM,mRNA,714613,1823745,320,1.00
ptg006908l,1810128,1810442,314,EVM,mRNA,714613,1823745,314,1.00
ptg006909l,1609936,1610222,286,EVM,mRNA,1560415,1702421,286,1.00
ptg006911l,107240,107577,337,EVM,mRNA,70002,280577,337,1.00
ptg006912l,315777,316047,270,EVM,mRNA,174219,867460,270,1.00
ptg006914l,679110,679414,304,EVM,mRNA,238982,983965,304,1.00
ptg006915l,421605,421891,286,EVM,mRNA,421210,1594137,286,1.00
ptg006915l,1152747,1153068,321,EVM,mRNA,421210,1594137,321,1.00
ptg006917l,896524,896841,317,EVM,mRNA,301806,1155628,317,1.00
ptg006917l,1015732,1016011,279,EVM,mRNA,301806,1155628,279,1.00
ptg006921l,1733290,1733622,332,EVM,mRNA,1577803,1988558,332,1.00
ptg006922l,681517,681803,286,EVM,mRNA,535573,2917464,286,1.00
ptg006922l,1696082,1696391,309,EVM,mRNA,535573,2917464,309,1.00
ptg006922l,1960998,1961307,309,EVM,mRNA,535573,2917464,309,1.00
ptg006922l,2293167,2293478,311,EVM,mRNA,535573,2917464,311,1.00
ptg006927l,107184,107491,307,EVM,mRNA,67994,468294,307,1.00
ptg006928l,1780520,1780795,275,EVM,mRNA,1686824,2011706,275,1.00
ptg006928l,1814775,1815072,297,EVM,mRNA,1686824,2011706,297,1.00
ptg006933l,1015865,1016176,311,EVM,mRNA,794896,1924931,311,1.00
ptg006933l,2614987,2615295,308,EVM,mRNA,2285987,3183008,308,1.00
ptg006933l,2974322,2974641,319,EVM,mRNA,2285987,3183008,319,1.00
ptg006933l,3732500,3732815,315,EVM,mRNA,3494417,3734820,315,1.00
ptg006937l,863138,863421,283,EVM,mRNA,56494,1420849,283,1.00
ptg006937l,1009513,1009823,310,EVM,mRNA,56494,1420849,310,1.00
ptg006937l,1324791,1325090,299,EVM,mRNA,56494,1420849,299,1.00
ptg006939l,1726009,1726336,327,EVM,mRNA,1495891,2315858,327,1.00
ptg006939l,2054510,2054788,278,EVM,mRNA,1495891,2315858,278,1.00
ptg006942l,722820,723100,280,EVM,mRNA,616252,821634,280,1.00
ptg006944l,173496,173795,299,EVM,mRNA,33382,477302,299,1.00
ptg006944l,348270,348579,309,EVM,mRNA,33382,477302,309,1.00
ptg006944l,1005630,1005912,282,EVM,mRNA,853564,1451081,282,1.00
ptg006944l,1433797,1434118,321,EVM,mRNA,853564,1451081,321,1.00
ptg006944l,1860090,1860407,317,EVM,mRNA,1637264,3956272,317,1.00
ptg006944l,5100656,5100951,295,EVM,mRNA,4892299,5592082,295,1.00
ptg006944l,5273928,5274197,269,EVM,mRNA,4892299,5592082,269,1.00
ptg006945l,578273,578572,299,EVM,mRNA,469680,872274,299,1.00
ptg006945l,1331619,1331935,316,EVM,mRNA,1109980,1359030,316,1.00
ptg006948l,302104,302402,298,EVM,mRNA,294539,1463998,298,1.00
ptg006948l,899479,899783,304,EVM,mRNA,294539,1463998,304,1.00
ptg006950l,1645351,1645616,265,EVM,mRNA,1600591,1705548,265,1.00
ptg006952l,755832,756105,273,EVM,mRNA,459260,3565629,273,1.00
ptg006952l,874073,874383,310,EVM,mRNA,459260,3565629,310,1.00
ptg006952l,1462442,1462768,326,EVM,mRNA,459260,3565629,326,1.00
ptg006952l,2074441,2074709,268,EVM,mRNA,459260,3565629,268,1.00
ptg006952l,2158191,2158506,315,EVM,mRNA,459260,3565629,315,1.00
ptg006952l,3534486,3534758,272,EVM,mRNA,459260,3565629,272,1.00
ptg006955l,1236036,1236348,312,EVM,mRNA,1028424,1564165,312,1.00
ptg006960l,561693,561978,285,EVM,mRNA,331899,995111,285,1.00
ptg006964l,561844,562154,310,EVM,mRNA,16242,996727,310,1.00
ptg006964l,976206,976533,327,EVM,mRNA,16242,996727,327,1.00
ptg006965l,2063962,2064280,318,EVM,mRNA,2034126,2118576,318,1.00
ptg006970l,732545,732823,278,EVM,mRNA,595318,743683,278,1.00
ptg006974l,875936,876245,309,EVM,mRNA,709439,1109978,309,1.00
ptg006979l,507997,508319,322,EVM,mRNA,460284,576990,322,1.00
ptg006981l,539612,539931,319,EVM,mRNA,173606,569996,319,1.00
ptg006983l,80542,80858,316,EVM,mRNA,48423,143527,316,1.00
ptg006992l,705817,706137,320,EVM,mRNA,66075,756287,320,1.00
ptg006993l,1750042,1750350,308,EVM,mRNA,1707840,2009208,308,1.00
ptg006993l,1822779,1823067,288,EVM,mRNA,1707840,2009208,288,1.00
ptg007004l,50498,50790,292,EVM,mRNA,502,503953,292,1.00
ptg007004l,978560,978883,323,EVM,mRNA,627999,1107960,323,1.00
ptg007014l,1600103,1600415,312,EVM,mRNA,1286932,1623770,312,1.00
ptg007017l,1748011,1748306,295,EVM,mRNA,1584928,1868564,295,1.00
ptg007017l,3942478,3942754,276,EVM,mRNA,3268313,4542025,276,1.00
ptg007017l,6853949,6854245,296,EVM,mRNA,6794111,6964049,296,1.00
ptg007020l,433930,434229,299,EVM,mRNA,259877,3963614,299,1.00
ptg007020l,713932,714244,312,EVM,mRNA,259877,3963614,312,1.00
ptg007020l,768590,768906,316,EVM,mRNA,259877,3963614,316,1.00
ptg007020l,2406412,2406711,299,EVM,mRNA,259877,3963614,299,1.00
ptg007020l,2791046,2791331,285,EVM,mRNA,259877,3963614,285,1.00
ptg007020l,3099344,3099670,326,EVM,mRNA,259877,3963614,326,1.00
ptg007021l,384192,384462,270,EVM,mRNA,303553,408638,270,1.00
ptg007021l,4049968,4050282,314,EVM,mRNA,3828521,5838566,314,1.00
ptg007021l,4299297,4299580,283,EVM,mRNA,3828521,5838566,283,1.00
ptg007021l,4849202,4849501,299,EVM,mRNA,3828521,5838566,299,1.00
ptg007021l,6658332,6658674,342,EVM,mRNA,6272611,7179832,342,1.00
ptg007024l,1169091,1169398,307,EVM,mRNA,25838,2817322,307,1.00
ptg007024l,1333767,1334060,293,EVM,mRNA,25838,2817322,293,1.00
ptg007024l,1348148,1348445,297,EVM,mRNA,25838,2817322,297,1.00
ptg007024l,2335064,2335355,291,EVM,mRNA,25838,2817322,291,1.00
ptg007024l,2392882,2393174,292,EVM,mRNA,25838,2817322,292,1.00
ptg007024l,2596495,2596805,310,EVM,mRNA,25838,2817322,310,1.00
ptg007027l,725348,725691,343,EVM,mRNA,723351,1474384,343,1.00
ptg007030l,878403,878721,318,EVM,mRNA,761062,1061638,318,1.00
ptg007036l,698003,698261,258,EVM,mRNA,18632,1459584,258,1.00
ptg007036l,956225,956534,309,EVM,mRNA,18632,1459584,309,1.00
ptg007036l,1148124,1148437,313,EVM,mRNA,18632,1459584,313,1.00
ptg007036l,1681528,1681814,286,EVM,mRNA,1664651,1877902,286,1.00
ptg007037l,1758162,1758487,325,EVM,mRNA,597957,2811367,325,1.00
ptg007044l,2471769,2472075,306,EVM,mRNA,1863504,2477948,306,1.00
ptg007045l,383873,384177,304,EVM,mRNA,206214,759758,304,1.00
ptg007047l,319543,319837,294,EVM,mRNA,1274,442360,294,1.00
ptg007053l,3335108,3335395,287,EVM,mRNA,3195766,3788705,287,1.00
ptg007056l,732469,732751,282,EVM,mRNA,538526,806258,282,1.00
ptg007060l,1569540,1569797,257,EVM,mRNA,1388825,1570097,257,1.00
ptg007060l,2082723,2083032,309,EVM,mRNA,1974821,2576081,309,1.00
ptg007060l,2229009,2229320,311,EVM,mRNA,1974821,2576081,311,1.00
ptg007060l,2564561,2564894,333,EVM,mRNA,1974821,2576081,333,1.00
ptg007061l,192462,192754,292,EVM,mRNA,56919,1557942,292,1.00
ptg007063l,1786907,1787210,303,EVM,mRNA,1742046,2008426,303,1.00
ptg007063l,1807826,1808127,301,EVM,mRNA,1742046,2008426,301,1.00
ptg007065l,1483023,1483307,284,EVM,mRNA,1033990,2896894,284,1.00
ptg007078l,1141217,1141493,276,EVM,mRNA,851913,1541779,276,1.00
ptg007078l,1368859,1369148,289,EVM,mRNA,851913,1541779,289,1.00
ptg007078l,2983798,2984096,298,EVM,mRNA,1772959,3233888,298,1.00
ptg007082l,597000,597317,317,EVM,mRNA,62162,1204280,317,1.00
ptg007083l,66777,67054,277,EVM,mRNA,32981,209865,277,1.00
ptg007084l,1087212,1087507,295,EVM,mRNA,971771,1148967,295,1.00
ptg007086l,655268,655556,288,EVM,mRNA,358823,1367569,288,1.00
ptg007086l,967370,967678,308,EVM,mRNA,358823,1367569,308,1.00
ptg007086l,1217642,1217935,293,EVM,mRNA,358823,1367569,293,1.00
ptg007086l,2962148,2962450,302,EVM,mRNA,2770091,3496576,302,1.00
ptg007086l,3246015,3246350,335,EVM,mRNA,2770091,3496576,335,1.00
ptg007086l,3688355,3688648,293,EVM,mRNA,3531959,3820060,293,1.00
ptg007086l,6318129,6318421,292,EVM,mRNA,6121931,6490065,292,1.00
ptg007087l,106953,107245,292,EVM,mRNA,36070,734592,292,1.00
ptg007088l,519326,519640,314,EVM,mRNA,492630,959223,314,1.00
ptg007088l,2432643,2432905,262,EVM,mRNA,2221706,3088801,262,1.00
ptg007094l,135725,136055,330,EVM,mRNA,14511,806805,330,1.00
ptg007097l,153352,153652,300,EVM,mRNA,117229,746383,300,1.00
ptg007097l,438899,439222,323,EVM,mRNA,117229,746383,323,1.00
ptg007097l,1884886,1885191,305,EVM,mRNA,1419176,1919574,305,1.00
ptg007099l,1090962,1091282,320,EVM,mRNA,458450,4532142,320,1.00
ptg007099l,1627660,1627981,321,EVM,mRNA,458450,4532142,321,1.00
ptg007099l,2163657,2163957,300,EVM,mRNA,458450,4532142,300,1.00
ptg007099l,2315628,2315903,275,EVM,mRNA,458450,4532142,275,1.00
ptg007099l,2387351,2387676,325,EVM,mRNA,458450,4532142,325,1.00
ptg007099l,2387815,2388146,331,EVM,mRNA,458450,4532142,331,1.00
ptg007099l,2561775,2562044,269,EVM,mRNA,458450,4532142,269,1.00
ptg007099l,2765864,2766157,293,EVM,mRNA,458450,4532142,293,1.00
ptg007099l,2815632,2815915,283,EVM,mRNA,458450,4532142,283,1.00
ptg007099l,3201636,3201919,283,EVM,mRNA,458450,4532142,283,1.00
ptg007101l,838197,838522,325,EVM,mRNA,110789,1148740,325,1.00
ptg007101l,957921,958220,299,EVM,mRNA,110789,1148740,299,1.00
ptg007101l,1245322,1245644,322,EVM,mRNA,1245547,2828538,98,0.30
ptg007101l,2510854,2511145,291,EVM,mRNA,1245547,2828538,291,1.00
ptg007103l,563724,564046,322,EVM,mRNA,543925,1086166,322,1.00
ptg007107l,216932,217227,295,EVM,mRNA,203900,1490725,295,1.00
ptg007112l,417978,418281,303,EVM,mRNA,14491,1097930,303,1.00
ptg007123l,16800,17116,316,EVM,mRNA,8136,302054,316,1.00
ptg007123l,102773,103070,297,EVM,mRNA,8136,302054,297,1.00
ptg007125l,429082,429373,291,EVM,mRNA,103246,889037,291,1.00
ptg007131l,2420691,2421020,329,EVM,mRNA,2365064,2471280,329,1.00
ptg007131l,3134088,3134372,284,EVM,mRNA,2954434,3501329,284,1.00
ptg007135l,228026,228322,296,EVM,mRNA,206290,417686,296,1.00
ptg007138l,1045834,1046154,320,EVM,mRNA,970766,1332253,320,1.00
ptg007140l,486363,486671,308,EVM,mRNA,235747,705792,308,1.00
ptg007143l,84475,84760,285,EVM,mRNA,70080,249897,285,1.00
ptg007143l,721095,721379,284,EVM,mRNA,455382,798130,284,1.00
ptg007143l,2091944,2092246,302,EVM,mRNA,2067150,2364148,302,1.00
ptg007143l,2558176,2558460,284,EVM,mRNA,2539720,2937601,284,1.00
ptg007143l,4954569,4954878,309,EVM,mRNA,4721229,6421696,309,1.00
ptg007143l,5209982,5210258,276,EVM,mRNA,4721229,6421696,276,1.00
ptg007143l,5713192,5713504,312,EVM,mRNA,4721229,6421696,312,1.00
ptg007144l,738644,738971,327,EVM,mRNA,155250,747925,327,1.00
ptg007147l,356047,356335,288,EVM,mRNA,333038,1413722,288,1.00
ptg007148l,1942421,1942720,299,EVM,mRNA,1894461,2189370,299,1.00
ptg007148l,2022144,2022444,300,EVM,mRNA,1894461,2189370,300,1.00
ptg007148l,2595567,2595895,328,EVM,mRNA,2429652,3371324,328,1.00
ptg007152l,518780,519080,300,EVM,mRNA,429229,1821574,300,1.00
ptg007154l,372003,372305,302,EVM,mRNA,265213,922345,302,1.00
ptg007162l,2959576,2959852,276,EVM,mRNA,2869949,2984451,276,1.00
ptg007162l,2979097,2979381,284,EVM,mRNA,2869949,2984451,284,1.00
ptg007163l,194066,194377,311,EVM,mRNA,176498,196146,311,1.00
ptg007166l,2426232,2426530,298,EVM,mRNA,2370470,2821146,298,1.00
ptg007166l,2528064,2528354,290,EVM,mRNA,2370470,2821146,290,1.00
ptg007169l,475169,475479,310,EVM,mRNA,61368,846722,310,1.00
ptg007171l,2623079,2623359,280,EVM,mRNA,2299489,3372710,280,1.00
ptg007171l,2689579,2689897,318,EVM,mRNA,2299489,3372710,318,1.00
ptg007172l,75613,75920,307,EVM,mRNA,418,91227,307,1.00
ptg007176l,266027,266331,304,EVM,mRNA,123216,293046,304,1.00
ptg007179l,1027895,1028221,326,EVM,mRNA,525689,3401900,326,1.00
ptg007180l,299232,299543,311,EVM,mRNA,272799,503030,311,1.00
ptg007180l,313303,313617,314,EVM,mRNA,272799,503030,314,1.00
ptg007180l,485915,486238,323,EVM,mRNA,272799,503030,323,1.00
ptg007181l,186964,187260,296,EVM,mRNA,35,903095,296,1.00
ptg007181l,513719,514021,302,EVM,mRNA,35,903095,302,1.00
ptg007182l,49440,49768,328,EVM,mRNA,15030,375017,328,1.00
ptg007188l,1594385,1594692,307,EVM,mRNA,558696,2212755,307,1.00
ptg007190l,1246796,1247116,320,EVM,mRNA,661330,1503846,320,1.00
ptg007190l,1372790,1373094,304,EVM,mRNA,661330,1503846,304,1.00
ptg007190l,1995684,1995966,282,EVM,mRNA,1698936,2277302,282,1.00
ptg007190l,2149689,2149977,288,EVM,mRNA,1698936,2277302,288,1.00
ptg007192l,2820185,2820489,304,EVM,mRNA,2530475,3097116,304,1.00
ptg007192l,2880470,2880803,333,EVM,mRNA,2530475,3097116,333,1.00
ptg007192l,2904079,2904353,274,EVM,mRNA,2530475,3097116,274,1.00
ptg007198l,1472937,1473077,140,EVM,mRNA,492856,2902987,140,1.00
ptg007198l,2123026,2123323,297,EVM,mRNA,492856,2902987,297,1.00
ptg007207l,289704,290007,303,EVM,mRNA,224,903365,303,1.00
ptg007207l,563722,564018,296,EVM,mRNA,224,903365,296,1.00
ptg007207l,745153,745455,302,EVM,mRNA,224,903365,302,1.00
ptg007210l,172804,173090,286,EVM,mRNA,116801,688326,286,1.00
ptg007210l,461687,462016,329,EVM,mRNA,116801,688326,329,1.00
ptg007212l,766597,766922,325,EVM,mRNA,341286,1564489,325,1.00
ptg007212l,967531,967857,326,EVM,mRNA,341286,1564489,326,1.00
ptg007212l,1100120,1100397,277,EVM,mRNA,341286,1564489,277,1.00
ptg007212l,1452694,1452975,281,EVM,mRNA,341286,1564489,281,1.00
ptg007214l,1643421,1643747,326,EVM,mRNA,775096,1840048,326,1.00
ptg007218l,1002989,1003306,317,EVM,mRNA,61783,3536657,317,1.00
ptg007218l,2599525,2599829,304,EVM,mRNA,61783,3536657,304,1.00
ptg007218l,2614298,2614602,304,EVM,mRNA,61783,3536657,304,1.00
ptg007218l,2819406,2819716,310,EVM,mRNA,61783,3536657,310,1.00
ptg007218l,2953936,2954240,304,EVM,mRNA,61783,3536657,304,1.00
ptg007218l,3746705,3747017,312,EVM,mRNA,3714455,3850100,312,1.00
ptg007222l,538353,538645,292,EVM,mRNA,46744,793634,292,1.00
ptg007228l,2412986,2413289,303,EVM,mRNA,1787568,3506757,303,1.00
ptg007228l,3037203,3037518,315,EVM,mRNA,1787568,3506757,315,1.00
ptg007228l,3153708,3154028,320,EVM,mRNA,1787568,3506757,320,1.00
ptg007229l,837724,838059,335,EVM,mRNA,524966,1335929,335,1.00
ptg007229l,993659,993977,318,EVM,mRNA,524966,1335929,318,1.00
ptg007229l,2763708,2763997,289,EVM,mRNA,1794824,3098413,289,1.00
ptg007230l,234071,234370,299,EVM,mRNA,206681,1409321,299,1.00
ptg007230l,761473,761780,307,EVM,mRNA,206681,1409321,307,1.00
ptg007230l,1166542,1166873,331,EVM,mRNA,206681,1409321,331,1.00
ptg007236l,721110,721438,328,EVM,mRNA,710582,786326,328,1.00
ptg007238l,745068,745388,320,EVM,mRNA,744910,784610,320,1.00
ptg007241l,1175600,1175899,299,EVM,mRNA,702762,1210564,299,1.00
ptg007243l,326954,327277,323,EVM,mRNA,164707,416047,323,1.00
ptg007243l,408976,409273,297,EVM,mRNA,164707,416047,297,1.00
ptg007243l,667533,667833,300,EVM,mRNA,520108,1104703,300,1.00
ptg007244l,959387,959699,312,EVM,mRNA,777680,1540631,312,1.00
ptg007244l,1538710,1539021,311,EVM,mRNA,777680,1540631,311,1.00
ptg007244l,1820810,1821126,316,EVM,mRNA,1790302,1903565,316,1.00
ptg007250l,1121315,1121604,289,EVM,mRNA,67007,1903025,289,1.00
ptg007250l,1687611,1687927,316,EVM,mRNA,67007,1903025,316,1.00
ptg007251l,324918,325184,266,EVM,mRNA,76307,417890,266,1.00
ptg007252l,756297,756589,292,EVM,mRNA,741059,767633,292,1.00
ptg007253l,393466,393763,297,EVM,mRNA,259682,808900,297,1.00
ptg007265l,58246,58551,305,EVM,mRNA,45848,917761,305,1.00
ptg007267l,916239,916548,309,EVM,mRNA,532,1092559,309,1.00
ptg007269l,623778,624101,323,EVM,mRNA,173,884710,323,1.00
ptg007273l,450731,451039,308,EVM,mRNA,449040,1378105,308,1.00
ptg007273l,1274670,1274932,262,EVM,mRNA,449040,1378105,262,1.00
ptg007276l,210676,211012,336,EVM,mRNA,72920,1673094,336,1.00
ptg007276l,295493,295809,316,EVM,mRNA,72920,1673094,316,1.00
ptg007276l,543183,543463,280,EVM,mRNA,72920,1673094,280,1.00
ptg007276l,826282,826606,324,EVM,mRNA,72920,1673094,324,1.00
ptg007276l,1667307,1667579,272,EVM,mRNA,72920,1673094,272,1.00
ptg007276l,2730580,2730915,335,EVM,mRNA,2680286,4322517,335,1.00
ptg007276l,3365945,3366221,276,EVM,mRNA,2680286,4322517,276,1.00
ptg007276l,4212699,4212974,275,EVM,mRNA,2680286,4322517,275,1.00
ptg007276l,4280877,4281175,298,EVM,mRNA,2680286,4322517,298,1.00
ptg007277l,939257,939563,306,EVM,mRNA,776772,1180826,306,1.00
ptg007277l,1024400,1024695,295,EVM,mRNA,776772,1180826,295,1.00
ptg007277l,1438672,1438951,279,EVM,mRNA,1312730,1661238,279,1.00
ptg007283l,775567,775868,301,EVM,mRNA,237912,1116048,301,1.00
ptg007283l,1041619,1041955,336,EVM,mRNA,237912,1116048,336,1.00
ptg007287l,1429427,1429712,285,EVM,mRNA,1168741,1462249,285,1.00
ptg007288l,1207695,1208010,315,EVM,mRNA,5380,1340378,315,1.00
ptg007289l,2133081,2133384,303,EVM,mRNA,1931796,2970641,303,1.00
ptg007289l,2880441,2880725,284,EVM,mRNA,1931796,2970641,284,1.00
ptg007291l,1261627,1261936,309,EVM,mRNA,985095,1339542,309,1.00
ptg007293l,1936108,1936379,271,EVM,mRNA,1920849,1995625,271,1.00
ptg007295l,1254822,1255126,304,EVM,mRNA,868708,1391776,304,1.00
ptg007295l,3351917,3352218,301,EVM,mRNA,3348003,4170855,301,1.00
ptg007295l,3879899,3880192,293,EVM,mRNA,3348003,4170855,293,1.00
ptg007301l,573652,573957,305,EVM,mRNA,530379,3684962,305,1.00
ptg007301l,3339506,3339788,282,EVM,mRNA,530379,3684962,282,1.00
ptg007301l,3555908,3556220,312,EVM,mRNA,530379,3684962,312,1.00
ptg007302l,1286680,1286992,312,EVM,mRNA,735578,2537950,312,1.00
ptg007302l,1563688,1563985,297,EVM,mRNA,735578,2537950,297,1.00
ptg007304l,168713,169023,310,EVM,mRNA,70049,358405,310,1.00
ptg007308l,2485619,2485930,311,EVM,mRNA,309546,3139975,311,1.00
ptg007309l,598618,598930,312,EVM,mRNA,109364,1536727,312,1.00
ptg007309l,1386985,1387285,300,EVM,mRNA,109364,1536727,300,1.00
ptg007310l,1100374,1100667,293,EVM,mRNA,1100100,1234832,293,1.00
ptg007314l,331393,331709,316,EVM,mRNA,87464,742335,316,1.00
ptg007314l,425839,426133,294,EVM,mRNA,87464,742335,294,1.00
ptg007316l,3462701,3463037,336,EVM,mRNA,1268660,3493616,336,1.00
ptg007317l,362396,362694,298,EVM,mRNA,361848,458103,298,1.00
ptg007319l,518435,518732,297,EVM,mRNA,325817,742472,297,1.00
ptg007325l,741311,741589,278,EVM,mRNA,502480,1315596,278,1.00
ptg007325l,749399,749687,288,EVM,mRNA,502480,1315596,288,1.00
ptg007331l,106740,107020,280,EVM,mRNA,15340,790602,280,1.00
ptg007331l,706868,707148,280,EVM,mRNA,15340,790602,280,1.00
ptg007332l,617856,618124,268,EVM,mRNA,257506,2718371,268,1.00
ptg007332l,1535496,1535757,261,EVM,mRNA,257506,2718371,261,1.00
ptg007334l,401718,402014,296,EVM,mRNA,173392,1654833,296,1.00
ptg007334l,1061586,1061911,325,EVM,mRNA,173392,1654833,325,1.00
ptg007337l,178025,178318,293,EVM,mRNA,834,1881121,293,1.00
ptg007337l,706551,706887,336,EVM,mRNA,834,1881121,336,1.00
ptg007339l,287657,287950,293,EVM,mRNA,84575,289091,293,1.00
ptg007342l,2447410,2447709,299,EVM,mRNA,1665032,3625154,299,1.00
ptg007342l,2527560,2527859,299,EVM,mRNA,1665032,3625154,299,1.00
ptg007342l,2704999,2705294,295,EVM,mRNA,1665032,3625154,295,1.00
ptg007342l,2827712,2828011,299,EVM,mRNA,1665032,3625154,299,1.00
ptg007342l,3425252,3425552,300,EVM,mRNA,1665032,3625154,300,1.00
ptg007343l,1000651,1000958,307,EVM,mRNA,684315,1008489,307,1.00
ptg007344l,1431883,1432186,303,EVM,mRNA,1335375,1453642,303,1.00
ptg007345l,346332,346631,299,EVM,mRNA,69039,1054283,299,1.00
ptg007345l,676591,676890,299,EVM,mRNA,69039,1054283,299,1.00
ptg007349l,665874,666154,280,EVM,mRNA,347959,2515571,280,1.00
ptg007349l,839937,840248,311,EVM,mRNA,347959,2515571,311,1.00
ptg007349l,1839972,1840294,322,EVM,mRNA,347959,2515571,322,1.00
ptg007349l,2126827,2127130,303,EVM,mRNA,347959,2515571,303,1.00
ptg007355l,2079996,2080306,310,EVM,mRNA,887809,2696542,310,1.00
ptg007356l,308522,308821,299,EVM,mRNA,60005,689234,299,1.00
ptg007356l,368537,368865,328,EVM,mRNA,60005,689234,328,1.00
ptg007356l,1278644,1278960,316,EVM,mRNA,1249030,2090568,316,1.00
ptg007356l,2576284,2576598,314,EVM,mRNA,2435953,3289649,314,1.00
ptg007356l,2704369,2704680,311,EVM,mRNA,2435953,3289649,311,1.00
ptg007356l,3086698,3087018,320,EVM,mRNA,2435953,3289649,320,1.00
ptg007357l,598160,598447,287,EVM,mRNA,181268,730934,287,1.00
ptg007357l,1457644,1457975,331,EVM,mRNA,1457671,2231238,305,0.92
ptg007359l,611397,611719,322,EVM,mRNA,536620,827921,322,1.00
ptg007359l,803721,804010,289,EVM,mRNA,536620,827921,289,1.00
ptg007359l,1392697,1393012,315,EVM,mRNA,1137254,1570490,315,1.00
ptg007360l,182771,183045,274,EVM,mRNA,42749,895667,274,1.00
ptg007360l,572770,573097,327,EVM,mRNA,42749,895667,327,1.00
ptg007360l,1151313,1151588,275,EVM,mRNA,996424,1343385,275,1.00
ptg007361l,350388,350699,311,EVM,mRNA,40552,2098628,311,1.00
ptg007369l,847756,848085,329,EVM,mRNA,750420,1889040,329,1.00
ptg007370l,426822,427128,306,EVM,mRNA,426905,427576,224,0.73
ptg007374l,1482274,1482574,300,EVM,mRNA,1461062,2443023,300,1.00
ptg007374l,1663159,1663459,300,EVM,mRNA,1461062,2443023,300,1.00
ptg007374l,1817855,1818154,299,EVM,mRNA,1461062,2443023,299,1.00
ptg007374l,1942788,1943107,319,EVM,mRNA,1461062,2443023,319,1.00
ptg007374l,1951857,1952145,288,EVM,mRNA,1461062,2443023,288,1.00
ptg007374l,2168087,2168407,320,EVM,mRNA,1461062,2443023,320,1.00
ptg007374l,2432236,2432522,286,EVM,mRNA,1461062,2443023,286,1.00
ptg007374l,2437899,2438179,280,EVM,mRNA,1461062,2443023,280,1.00
ptg007375l,3578174,3578461,287,EVM,mRNA,3338749,5491145,287,1.00
ptg007375l,3934951,3935253,302,EVM,mRNA,3338749,5491145,302,1.00
ptg007375l,4541336,4541670,334,EVM,mRNA,3338749,5491145,334,1.00
ptg007375l,4617616,4617949,333,EVM,mRNA,3338749,5491145,333,1.00
ptg007375l,5134051,5134339,288,EVM,mRNA,3338749,5491145,288,1.00
ptg007375l,5210548,5210861,313,EVM,mRNA,3338749,5491145,313,1.00
ptg007375l,5234162,5234438,276,EVM,mRNA,3338749,5491145,276,1.00
ptg007375l,6921970,6922240,270,EVM,mRNA,6543867,7549624,270,1.00
ptg007375l,7351180,7351490,310,EVM,mRNA,6543867,7549624,310,1.00
ptg007376l,2258791,2259047,256,EVM,mRNA,2238396,3854956,256,1.00
ptg007376l,3049684,3049986,302,EVM,mRNA,2238396,3854956,302,1.00
ptg007378l,330411,330731,320,EVM,mRNA,130332,1548956,320,1.00
ptg007383l,1657195,1657521,326,EVM,mRNA,1540036,1803475,326,1.00
ptg007384l,356794,357087,293,EVM,mRNA,87051,1019755,293,1.00
ptg007385l,1265829,1266118,289,EVM,mRNA,1172773,1342083,289,1.00
ptg007390l,970029,970316,287,EVM,mRNA,689125,1126479,287,1.00
ptg007390l,1029654,1029936,282,EVM,mRNA,689125,1126479,282,1.00
ptg007390l,1036942,1037218,276,EVM,mRNA,689125,1126479,276,1.00
ptg007390l,2062339,2062636,297,EVM,mRNA,2008866,2090981,297,1.00
ptg007392l,23021,23298,277,EVM,mRNA,601,721122,277,1.00
ptg007395l,525607,525890,283,EVM,mRNA,184381,1759834,283,1.00
ptg007395l,1176758,1177059,301,EVM,mRNA,184381,1759834,301,1.00
ptg007396l,2016509,2016815,306,EVM,mRNA,1458768,2553954,306,1.00
ptg007397l,3700137,3700450,313,EVM,mRNA,3020635,4991737,313,1.00
ptg007397l,4184905,4185187,282,EVM,mRNA,3020635,4991737,282,1.00
ptg007397l,4193296,4193604,308,EVM,mRNA,3020635,4991737,308,1.00
ptg007397l,4489128,4489434,306,EVM,mRNA,3020635,4991737,306,1.00
ptg007403l,211405,211688,283,EVM,mRNA,376,772637,283,1.00
ptg007403l,385974,386257,283,EVM,mRNA,376,772637,283,1.00
ptg007404l,758162,758465,303,EVM,mRNA,109133,892133,303,1.00
ptg007406l,777484,777786,302,EVM,mRNA,374831,1265331,302,1.00
ptg007406l,1202004,1202309,305,EVM,mRNA,374831,1265331,305,1.00
ptg007410l,532665,532985,320,EVM,mRNA,97260,1116850,320,1.00
ptg007410l,3111022,3111336,314,EVM,mRNA,2906193,3119383,314,1.00
ptg007410l,3114858,3115165,307,EVM,mRNA,2906193,3119383,307,1.00
ptg007413l,260135,260412,277,EVM,mRNA,218714,942665,277,1.00
ptg007420l,1161765,1162054,289,EVM,mRNA,959226,1413931,289,1.00
ptg007421l,1691455,1691726,271,EVM,mRNA,666838,2316646,271,1.00
ptg007421l,4575387,4575711,324,EVM,mRNA,4128711,4940932,324,1.00
ptg007422l,398375,398710,335,EVM,mRNA,94470,700464,335,1.00
ptg007424l,634314,634623,309,EVM,mRNA,50,1028641,309,1.00
ptg007436l,2341028,2341336,308,EVM,mRNA,2229246,2499606,308,1.00
ptg007439l,2588167,2588462,295,EVM,mRNA,1001537,3912497,295,1.00
ptg007439l,2962848,2963144,296,EVM,mRNA,1001537,3912497,296,1.00
ptg007439l,4886908,4887198,290,EVM,mRNA,4308874,7143874,290,1.00
ptg007439l,5122433,5122701,268,EVM,mRNA,4308874,7143874,268,1.00
ptg007439l,5741909,5742182,273,EVM,mRNA,4308874,7143874,273,1.00
ptg007439l,6028129,6028409,280,EVM,mRNA,4308874,7143874,280,1.00
ptg007441l,829181,829483,302,EVM,mRNA,22649,904957,302,1.00
ptg007455l,2220528,2220815,287,EVM,mRNA,2179627,2329044,287,1.00
ptg007456l,657842,658131,289,EVM,mRNA,24349,2404354,289,1.00
ptg007456l,1025245,1025553,308,EVM,mRNA,24349,2404354,308,1.00
ptg007456l,1267993,1268298,305,EVM,mRNA,24349,2404354,305,1.00
ptg007456l,2159361,2159672,311,EVM,mRNA,24349,2404354,311,1.00
ptg007459l,3305512,3305826,314,EVM,mRNA,3116383,4603616,314,1.00
ptg007459l,3363522,3363830,308,EVM,mRNA,3116383,4603616,308,1.00
ptg007461l,2597534,2597825,291,EVM,mRNA,2383674,3296677,291,1.00
ptg007461l,3183480,3183823,343,EVM,mRNA,2383674,3296677,343,1.00
ptg007464l,212597,212879,282,EVM,mRNA,72522,324266,282,1.00
ptg007465l,812514,812783,269,EVM,mRNA,524316,1274897,269,1.00
ptg007465l,824119,824423,304,EVM,mRNA,524316,1274897,304,1.00
ptg007465l,1051133,1051422,289,EVM,mRNA,524316,1274897,289,1.00
ptg007465l,1218674,1218986,312,EVM,mRNA,524316,1274897,312,1.00
ptg007469l,492362,492678,316,EVM,mRNA,142552,1100179,316,1.00
ptg007471l,572187,572496,309,EVM,mRNA,444657,1322750,309,1.00
ptg007472l,4495452,4495758,306,EVM,mRNA,1976426,5132636,306,1.00
ptg007472l,7480008,7480332,324,EVM,mRNA,7348251,7875457,324,1.00
ptg007472l,7676777,7677103,326,EVM,mRNA,7348251,7875457,326,1.00
ptg007473l,572858,573156,298,EVM,mRNA,137651,1214477,298,1.00
ptg007473l,586435,586734,299,EVM,mRNA,137651,1214477,299,1.00
ptg007473l,605316,605606,290,EVM,mRNA,137651,1214477,290,1.00
ptg007473l,985901,986200,299,EVM,mRNA,137651,1214477,299,1.00
ptg007473l,2355302,2355578,276,EVM,mRNA,2058381,2883130,276,1.00
ptg007473l,4806814,4807113,299,EVM,mRNA,3252659,5112004,299,1.00
ptg007474l,1098287,1098591,304,EVM,mRNA,426679,1690838,304,1.00
ptg007474l,1237899,1238198,299,EVM,mRNA,426679,1690838,299,1.00
ptg007474l,1394659,1394956,297,EVM,mRNA,426679,1690838,297,1.00
ptg007474l,1590590,1590900,310,EVM,mRNA,426679,1690838,310,1.00
ptg007474l,1601009,1601315,306,EVM,mRNA,426679,1690838,306,1.00
ptg007483l,1009445,1009759,314,EVM,mRNA,337654,1475691,314,1.00
ptg007488l,417229,417530,301,EVM,mRNA,329038,2888122,301,1.00
ptg007491l,255609,255897,288,EVM,mRNA,254504,270436,288,1.00
ptg007493l,423776,424089,313,EVM,mRNA,363773,482768,313,1.00
ptg007493l,731065,731362,297,EVM,mRNA,657192,917123,297,1.00
ptg007493l,899667,899980,313,EVM,mRNA,657192,917123,313,1.00
ptg007493l,1695187,1695490,303,EVM,mRNA,1590015,2424998,303,1.00
ptg007497l,504499,504803,304,EVM,mRNA,289075,719932,304,1.00
ptg007497l,1121022,1121302,280,EVM,mRNA,1035370,2674366,280,1.00
ptg007497l,1331406,1331730,324,EVM,mRNA,1035370,2674366,324,1.00
ptg007497l,1373162,1373445,283,EVM,mRNA,1035370,2674366,283,1.00
ptg007501l,1212185,1212483,298,EVM,mRNA,840637,1458592,298,1.00
ptg007501l,1216744,1217039,295,EVM,mRNA,840637,1458592,295,1.00
ptg007502l,441917,442226,309,EVM,mRNA,2941,2329266,309,1.00
ptg007502l,832506,832800,294,EVM,mRNA,2941,2329266,294,1.00
ptg007502l,969516,969798,282,EVM,mRNA,2941,2329266,282,1.00
ptg007502l,1241625,1241913,288,EVM,mRNA,2941,2329266,288,1.00
ptg007503l,773113,773426,313,EVM,mRNA,559539,897755,313,1.00
ptg007504l,757510,757791,281,EVM,mRNA,727089,1105143,281,1.00
ptg007504l,2033242,2033533,291,EVM,mRNA,1856366,2092706,291,1.00
ptg007506l,143376,143668,292,EVM,mRNA,81312,147854,292,1.00
ptg007506l,852581,852841,260,EVM,mRNA,776873,1143714,260,1.00
ptg007506l,1063402,1063729,327,EVM,mRNA,776873,1143714,327,1.00
ptg007509l,2130479,2130738,259,EVM,mRNA,1352796,2518118,259,1.00
ptg007515l,247764,248090,326,EVM,mRNA,14094,1692572,326,1.00
ptg007515l,494259,494575,316,EVM,mRNA,14094,1692572,316,1.00
ptg007515l,1007988,1008278,290,EVM,mRNA,14094,1692572,290,1.00
ptg007515l,1138323,1138614,291,EVM,mRNA,14094,1692572,291,1.00
ptg007515l,1529235,1529548,313,EVM,mRNA,14094,1692572,313,1.00
ptg007516l,341903,342214,311,EVM,mRNA,183883,3013695,311,1.00
ptg007516l,831917,832240,323,EVM,mRNA,183883,3013695,323,1.00
ptg007516l,1268551,1268865,314,EVM,mRNA,183883,3013695,314,1.00
ptg007516l,1354322,1354585,263,EVM,mRNA,183883,3013695,263,1.00
ptg007516l,2017461,2017790,329,EVM,mRNA,183883,3013695,329,1.00
ptg007516l,2935630,2935942,312,EVM,mRNA,183883,3013695,312,1.00
ptg007517l,507722,508029,307,EVM,mRNA,474968,596556,307,1.00
ptg007525l,41573,41853,280,EVM,mRNA,18111,232607,280,1.00
ptg007525l,206162,206439,277,EVM,mRNA,18111,232607,277,1.00
ptg007533l,342723,342998,275,EVM,mRNA,342908,856040,91,0.33
ptg007534l,167098,167424,326,EVM,mRNA,107171,196391,326,1.00
ptg007535l,1166249,1166529,280,EVM,mRNA,1120299,1402955,280,1.00
ptg007535l,1288179,1288461,282,EVM,mRNA,1120299,1402955,282,1.00
ptg007538l,1249597,1249908,311,EVM,mRNA,1248529,1444829,311,1.00
ptg007540l,494389,494677,288,EVM,mRNA,1077,623307,288,1.00
ptg007541l,249443,249746,303,EVM,mRNA,138890,680872,303,1.00
ptg007542l,343901,344209,308,EVM,mRNA,150021,606974,308,1.00
ptg007542l,449910,450219,309,EVM,mRNA,150021,606974,309,1.00
ptg007543l,3232692,3233005,313,EVM,mRNA,2960325,3447377,313,1.00
ptg007545l,3652946,3653293,347,EVM,mRNA,3568680,3724491,347,1.00
ptg007545l,3724426,3724703,277,EVM,mRNA,3568680,3724491,65,0.23
ptg007545l,4014031,4014306,275,EVM,mRNA,3766964,4777817,275,1.00
ptg007545l,6373868,6374155,287,EVM,mRNA,6309404,6925462,287,1.00
ptg007545l,6735277,6735567,290,EVM,mRNA,6309404,6925462,290,1.00
ptg007545l,6802822,6803115,293,EVM,mRNA,6309404,6925462,293,1.00
ptg007547l,1940952,1941246,294,EVM,mRNA,1751774,2946183,294,1.00
ptg007547l,2307666,2307955,289,EVM,mRNA,1751774,2946183,289,1.00
ptg007547l,2660617,2660904,287,EVM,mRNA,1751774,2946183,287,1.00
ptg007547l,3386263,3386533,270,EVM,mRNA,3215595,3447113,270,1.00
ptg007553l,690367,690673,306,EVM,mRNA,58925,690534,167,0.55
ptg007557l,2134051,2134335,284,EVM,mRNA,1908383,3476245,284,1.00
ptg007558l,2567266,2567582,316,EVM,mRNA,2347333,2658252,316,1.00
ptg007561l,483171,483496,325,EVM,mRNA,321366,592012,325,1.00
ptg007563l,5162883,5163200,317,EVM,mRNA,4830263,5352181,317,1.00
ptg007565l,287402,287696,294,EVM,mRNA,228169,667044,294,1.00
ptg007565l,2204722,2205028,306,EVM,mRNA,1974468,2282356,306,1.00
ptg007566l,2310150,2310470,320,EVM,mRNA,1489258,2431716,320,1.00
ptg007567l,522885,523200,315,EVM,mRNA,488050,614902,315,1.00
ptg007569l,407955,408240,285,EVM,mRNA,3,686760,285,1.00
ptg007569l,657264,657528,264,EVM,mRNA,3,686760,264,1.00
ptg007570l,739655,739950,295,EVM,mRNA,38691,1250535,295,1.00
ptg007570l,1237360,1237666,306,EVM,mRNA,38691,1250535,306,1.00
ptg007576l,439759,440024,265,EVM,mRNA,344692,2193236,265,1.00
ptg007576l,1272231,1272518,287,EVM,mRNA,344692,2193236,287,1.00
ptg007576l,1600142,1600422,280,EVM,mRNA,344692,2193236,280,1.00
ptg007577l,1726485,1726807,322,EVM,mRNA,2663,2138434,322,1.00
ptg007578l,122647,122959,312,EVM,mRNA,38297,725908,312,1.00
ptg007583l,757310,757627,317,EVM,mRNA,637611,2093392,317,1.00
ptg007586l,1803321,1803616,295,EVM,mRNA,1553770,1926435,295,1.00
ptg007586l,1854478,1854793,315,EVM,mRNA,1553770,1926435,315,1.00
ptg007605l,893697,894015,318,EVM,mRNA,727378,945809,318,1.00
ptg007608l,292566,292859,293,EVM,mRNA,288577,320734,293,1.00
ptg007608l,594572,594862,290,EVM,mRNA,364346,694713,290,1.00
ptg007608l,965106,965368,262,EVM,mRNA,741201,1056774,262,1.00
ptg007613l,403837,404149,312,EVM,mRNA,161876,516724,312,1.00
ptg007613l,3289073,3289385,312,EVM,mRNA,2821129,3925979,312,1.00
ptg007613l,3323923,3324230,307,EVM,mRNA,2821129,3925979,307,1.00
ptg007613l,4671408,4671706,298,EVM,mRNA,4656432,4791702,298,1.00
ptg007613l,4744212,4744474,262,EVM,mRNA,4656432,4791702,262,1.00
ptg007617l,396988,397275,287,EVM,mRNA,183120,1943017,287,1.00
ptg007617l,716720,717014,294,EVM,mRNA,183120,1943017,294,1.00
ptg007617l,1028668,1028967,299,EVM,mRNA,183120,1943017,299,1.00
ptg007617l,2503821,2504136,315,EVM,mRNA,2441563,2620320,315,1.00
ptg007618l,807057,807344,287,EVM,mRNA,206832,1415165,287,1.00
ptg007618l,1161323,1161618,295,EVM,mRNA,206832,1415165,295,1.00
ptg007618l,1657209,1657487,278,EVM,mRNA,1493634,2205832,278,1.00
ptg007623l,1386423,1386717,294,EVM,mRNA,1326653,2713605,294,1.00
ptg007623l,1590638,1590923,285,EVM,mRNA,1326653,2713605,285,1.00
ptg007623l,3525445,3525745,300,EVM,mRNA,3372375,3856118,300,1.00
ptg007623l,5396184,5396503,319,EVM,mRNA,4083233,5666174,319,1.00
ptg007624l,1026754,1027036,282,EVM,mRNA,855180,1128807,282,1.00
ptg007624l,1578335,1578620,285,EVM,mRNA,1156233,2014077,285,1.00
ptg007624l,1579094,1579375,281,EVM,mRNA,1156233,2014077,281,1.00
ptg007624l,2004614,2004923,309,EVM,mRNA,1156233,2014077,309,1.00
ptg007625l,310122,310411,289,EVM,mRNA,208665,364978,289,1.00
ptg007626l,139549,139842,293,EVM,mRNA,55457,266936,293,1.00
ptg007633l,263633,263921,288,EVM,mRNA,15632,374634,288,1.00
ptg007635l,835419,835698,279,EVM,mRNA,76378,1095640,279,1.00
ptg007635l,1552895,1553217,322,EVM,mRNA,1547356,1798952,322,1.00
ptg007635l,2122206,2122513,307,EVM,mRNA,1996039,2169151,307,1.00
ptg007636l,393015,393322,307,EVM,mRNA,322128,564198,307,1.00
ptg007636l,442336,442657,321,EVM,mRNA,322128,564198,321,1.00
ptg007636l,473621,473934,313,EVM,mRNA,322128,564198,313,1.00
ptg007636l,916325,916649,324,EVM,mRNA,777337,923821,324,1.00
ptg007644l,71079,71377,298,EVM,mRNA,6557,200371,298,1.00
ptg007644l,1110604,1110864,260,EVM,mRNA,1106641,1134036,260,1.00
ptg007644l,1478451,1478760,309,EVM,mRNA,1466099,1628366,309,1.00
ptg007649l,929016,929302,286,EVM,mRNA,579984,964590,286,1.00
ptg007650l,1313752,1314024,272,EVM,mRNA,866083,1391202,272,1.00
ptg007650l,1324598,1324897,299,EVM,mRNA,866083,1391202,299,1.00
ptg007652l,1280593,1280902,309,EVM,mRNA,652684,1357856,309,1.00
ptg007662l,62051,62360,309,EVM,mRNA,45259,387682,309,1.00
ptg007664l,2745927,2746228,301,EVM,mRNA,2158266,3066176,301,1.00
ptg007664l,2774344,2774652,308,EVM,mRNA,2158266,3066176,308,1.00
ptg007668l,1695607,1695894,287,EVM,mRNA,854230,3770148,287,1.00
ptg007668l,2728889,2729202,313,EVM,mRNA,854230,3770148,313,1.00
ptg007677l,508099,508424,325,EVM,mRNA,96096,910695,325,1.00
ptg007678l,1609410,1609692,282,EVM,mRNA,1590198,2297864,282,1.00
ptg007678l,4210451,4210725,274,EVM,mRNA,2541791,4895695,274,1.00
ptg007678l,4287785,4288116,331,EVM,mRNA,2541791,4895695,331,1.00
ptg007687l,2277554,2277853,299,EVM,mRNA,1928463,2457585,299,1.00
ptg007698l,1332660,1332974,314,EVM,mRNA,311322,2005386,314,1.00
ptg007701l,607931,608223,292,EVM,mRNA,21735,1165345,292,1.00
ptg007711l,1117873,1118196,323,EVM,mRNA,840222,1135651,323,1.00
ptg007718l,2907231,2907537,306,EVM,mRNA,2877761,3171958,306,1.00
ptg007719l,533562,533883,321,EVM,mRNA,12948,709558,321,1.00
ptg007720l,1331249,1331555,306,EVM,mRNA,806458,1487795,306,1.00
ptg007720l,1467663,1467973,310,EVM,mRNA,806458,1487795,310,1.00
ptg007721l,792909,793216,307,EVM,mRNA,581466,1157868,307,1.00
ptg007726l,422546,422864,318,EVM,mRNA,299424,1031643,318,1.00
ptg007729l,1641440,1641754,314,EVM,mRNA,40434,2072225,314,1.00
ptg007729l,3975201,3975520,319,EVM,mRNA,3539133,4002966,319,1.00
ptg007729l,3982677,3982974,297,EVM,mRNA,3539133,4002966,297,1.00
ptg007730l,1036478,1036794,316,EVM,mRNA,18588,1162521,316,1.00
ptg007732l,695095,695404,309,EVM,mRNA,136328,2583463,309,1.00
ptg007732l,2001172,2001440,268,EVM,mRNA,136328,2583463,268,1.00
ptg007732l,3385618,3385942,324,EVM,mRNA,3256338,3556262,324,1.00
ptg007736l,256181,256480,299,EVM,mRNA,233084,410743,299,1.00
ptg007739l,1049719,1050017,298,EVM,mRNA,1036964,1475799,298,1.00
ptg007739l,1259283,1259587,304,EVM,mRNA,1036964,1475799,304,1.00
ptg007740l,1024359,1024652,293,EVM,mRNA,746517,2353362,293,1.00
ptg007757l,445268,445580,312,EVM,mRNA,163488,1381952,312,1.00
ptg007758l,558495,558814,319,EVM,mRNA,463003,1323660,319,1.00
ptg007763l,252585,252903,318,EVM,mRNA,23719,3084891,318,1.00
ptg007763l,2086847,2087148,301,EVM,mRNA,23719,3084891,301,1.00
ptg007763l,5918229,5918558,329,EVM,mRNA,4960508,7949377,329,1.00
ptg007763l,6433321,6433631,310,EVM,mRNA,4960508,7949377,310,1.00
ptg007763l,7387852,7388158,306,EVM,mRNA,4960508,7949377,306,1.00
ptg007767l,1927199,1927493,294,EVM,mRNA,1798948,2365012,294,1.00
ptg007768l,1372667,1372945,278,EVM,mRNA,1298621,1399360,278,1.00
ptg007768l,3093987,3094284,297,EVM,mRNA,2741745,3180325,297,1.00
ptg007770l,1437264,1437540,276,EVM,mRNA,1252636,1445652,276,1.00
ptg007770l,1977541,1977837,296,EVM,mRNA,1740734,2738373,296,1.00
ptg007773l,1351175,1351487,312,EVM,mRNA,1070248,1663415,312,1.00
ptg007774l,1181012,1181284,272,EVM,mRNA,866773,2023752,272,1.00
ptg007778l,92698,92985,287,EVM,mRNA,50724,188170,287,1.00
ptg007781l,1211184,1211474,290,EVM,mRNA,299391,1316757,290,1.00
ptg007784l,226811,227107,296,EVM,mRNA,76423,442529,296,1.00
ptg007784l,233728,234028,300,EVM,mRNA,76423,442529,300,1.00
ptg007784l,2511339,2511636,297,EVM,mRNA,1689384,3772754,297,1.00
ptg007784l,5560992,5561312,320,EVM,mRNA,5241431,5816574,320,1.00
ptg007784l,5736100,5736429,329,EVM,mRNA,5241431,5816574,329,1.00
ptg007784l,5739386,5739715,329,EVM,mRNA,5241431,5816574,329,1.00
ptg007785l,736075,736380,305,EVM,mRNA,3808,1173131,305,1.00
ptg007785l,830322,830583,261,EVM,mRNA,3808,1173131,261,1.00
ptg007787l,1265232,1265529,297,EVM,mRNA,916163,1460361,297,1.00
ptg007787l,1595849,1596173,324,EVM,mRNA,1592738,1774908,324,1.00
ptg007790l,450410,450705,295,EVM,mRNA,49559,600535,295,1.00
ptg007790l,1994950,1995239,289,EVM,mRNA,1724523,1995614,289,1.00
ptg007798l,1421997,1422306,309,EVM,mRNA,90868,1931626,309,1.00
ptg007800l,78911,79230,319,EVM,mRNA,1753,618425,319,1.00
ptg007800l,333215,333504,289,EVM,mRNA,1753,618425,289,1.00
ptg007807l,954132,954436,304,EVM,mRNA,229335,1763594,304,1.00
ptg007807l,2604691,2604986,295,EVM,mRNA,2474020,3468293,295,1.00
ptg007807l,2999165,2999468,303,EVM,mRNA,2474020,3468293,303,1.00
ptg007808l,426962,427257,295,EVM,mRNA,36321,1265636,295,1.00
ptg007808l,674598,674917,319,EVM,mRNA,36321,1265636,319,1.00
ptg007810l,1285340,1285638,298,EVM,mRNA,725484,1893788,298,1.00
ptg007810l,1656055,1656369,314,EVM,mRNA,725484,1893788,314,1.00
ptg007820l,270294,270585,291,EVM,mRNA,7691,409939,291,1.00
ptg007821l,1662078,1662393,315,EVM,mRNA,363296,2258356,315,1.00
ptg007821l,2159714,2159986,272,EVM,mRNA,363296,2258356,272,1.00
ptg007824l,2571449,2571727,278,EVM,mRNA,2379346,3164219,278,1.00
ptg007824l,3024527,3024840,313,EVM,mRNA,2379346,3164219,313,1.00
ptg007826l,773493,773802,309,EVM,mRNA,690798,1939002,309,1.00
ptg007826l,2665434,2665733,299,EVM,mRNA,2592665,3394465,299,1.00
ptg007826l,2783696,2783989,293,EVM,mRNA,2592665,3394465,293,1.00
ptg007826l,2911483,2911789,306,EVM,mRNA,2592665,3394465,306,1.00
ptg007826l,2924009,2924331,322,EVM,mRNA,2592665,3394465,322,1.00
ptg007827l,686850,687141,291,EVM,mRNA,207375,922918,291,1.00
ptg007827l,1971616,1971885,269,EVM,mRNA,1828634,2288152,269,1.00
ptg007828l,687673,687983,310,EVM,mRNA,327178,1359123,310,1.00
ptg007828l,2662986,2663291,305,EVM,mRNA,2268395,3432940,305,1.00
ptg007828l,3311141,3311464,323,EVM,mRNA,2268395,3432940,323,1.00
ptg007831l,378949,379259,310,EVM,mRNA,214811,522544,310,1.00
ptg007831l,439251,439535,284,EVM,mRNA,214811,522544,284,1.00
ptg007840l,3570058,3570357,299,EVM,mRNA,3462245,3891725,299,1.00
ptg007840l,3878965,3879277,312,EVM,mRNA,3462245,3891725,312,1.00
ptg007840l,4376045,4376305,260,EVM,mRNA,4030092,4477905,260,1.00
ptg007843l,89383,89705,322,EVM,mRNA,19052,157471,322,1.00
ptg007844l,95014,95319,305,EVM,mRNA,87663,1286272,305,1.00
ptg007844l,1522305,1522582,277,EVM,mRNA,1477810,1847594,277,1.00
ptg007850l,2695449,2695764,315,EVM,mRNA,2650213,3651212,315,1.00
ptg007850l,3304942,3305271,329,EVM,mRNA,2650213,3651212,329,1.00
ptg007852l,2045465,2045767,302,EVM,mRNA,1265685,2863780,302,1.00
ptg007852l,3723014,3723323,309,EVM,mRNA,3626962,3730646,309,1.00
ptg007856l,331628,331935,307,EVM,mRNA,46617,1006430,307,1.00
ptg007856l,1193226,1193530,304,EVM,mRNA,1029703,3970477,304,1.00
ptg007856l,1654455,1654772,317,EVM,mRNA,1029703,3970477,317,1.00
ptg007856l,3824665,3824979,314,EVM,mRNA,1029703,3970477,314,1.00
ptg007861l,919928,920205,277,EVM,mRNA,84619,952668,277,1.00
ptg007862l,483701,484035,334,EVM,mRNA,366418,642154,334,1.00
ptg007865l,275805,276122,317,EVM,mRNA,69225,2726822,317,1.00
ptg007865l,352804,353136,332,EVM,mRNA,69225,2726822,332,1.00
ptg007865l,1488345,1488645,300,EVM,mRNA,69225,2726822,300,1.00
ptg007865l,2627185,2627513,328,EVM,mRNA,69225,2726822,328,1.00
ptg007869l,805809,806076,267,EVM,mRNA,758166,1425566,267,1.00
ptg007869l,820020,820309,289,EVM,mRNA,758166,1425566,289,1.00
ptg007869l,1317531,1317827,296,EVM,mRNA,758166,1425566,296,1.00
ptg007870l,463878,464167,289,EVM,mRNA,233545,664864,289,1.00
ptg007884l,1022583,1022865,282,EVM,mRNA,42396,1467890,282,1.00
ptg007898l,1579807,1580131,324,EVM,mRNA,1227781,2627376,324,1.00
ptg007898l,2410018,2410276,258,EVM,mRNA,1227781,2627376,258,1.00
ptg007898l,3482298,3482596,298,EVM,mRNA,2850167,4931623,298,1.00
ptg007898l,4806955,4807258,303,EVM,mRNA,2850167,4931623,303,1.00
ptg007902l,270690,270984,294,EVM,mRNA,199807,371475,294,1.00
ptg007903l,868589,868891,302,EVM,mRNA,579247,957367,302,1.00
ptg007903l,868595,868893,298,EVM,mRNA,579247,957367,298,1.00
ptg007903l,2499214,2499502,288,EVM,mRNA,2427956,2968682,288,1.00
ptg007906l,1099896,1100188,292,EVM,mRNA,522375,1642423,292,1.00
ptg007906l,1438913,1439212,299,EVM,mRNA,522375,1642423,299,1.00
ptg007906l,1614338,1614635,297,EVM,mRNA,522375,1642423,297,1.00
ptg007906l,1860588,1860878,290,EVM,mRNA,1822001,1891373,290,1.00
ptg007909l,249452,249720,268,EVM,mRNA,17089,295159,268,1.00
ptg007910l,287089,287388,299,EVM,mRNA,201644,1043425,299,1.00
ptg007910l,860334,860635,301,EVM,mRNA,201644,1043425,301,1.00
ptg007910l,929476,929782,306,EVM,mRNA,201644,1043425,306,1.00
ptg007910l,972276,972577,301,EVM,mRNA,201644,1043425,301,1.00
ptg007921l,509464,509742,278,EVM,mRNA,465283,522043,278,1.00
ptg007923l,880911,881204,293,EVM,mRNA,710837,961801,293,1.00
ptg007923l,2801828,2802123,295,EVM,mRNA,2770323,2878163,295,1.00
ptg007924l,45135,45433,298,EVM,mRNA,39870,1112984,298,1.00
ptg007924l,365439,365708,269,EVM,mRNA,39870,1112984,269,1.00
ptg007924l,480453,480733,280,EVM,mRNA,39870,1112984,280,1.00
ptg007924l,487630,487926,296,EVM,mRNA,39870,1112984,296,1.00
ptg007924l,531893,532214,321,EVM,mRNA,39870,1112984,321,1.00
ptg007925l,573678,573964,286,EVM,mRNA,212209,788993,286,1.00
ptg007925l,1560530,1560840,310,EVM,mRNA,893827,1682716,310,1.00
ptg007925l,2593414,2593740,326,EVM,mRNA,2587420,2998575,326,1.00
ptg007925l,3903147,3903410,263,EVM,mRNA,3900953,3954247,263,1.00
ptg007930l,2238114,2238406,292,EVM,mRNA,1795262,3107027,292,1.00
ptg007932l,490052,490370,318,EVM,mRNA,346481,672601,318,1.00
ptg007932l,595703,596019,316,EVM,mRNA,346481,672601,316,1.00
ptg007940l,267326,267640,314,EVM,mRNA,124428,1378590,314,1.00
ptg007940l,940896,941175,279,EVM,mRNA,124428,1378590,279,1.00
ptg007940l,3464783,3465060,277,EVM,mRNA,1789078,3585284,277,1.00
ptg007942l,1709975,1710253,278,EVM,mRNA,1248015,2277530,278,1.00
ptg007945l,1601086,1601359,273,EVM,mRNA,608776,2839786,273,1.00
ptg007945l,2426342,2426644,302,EVM,mRNA,608776,2839786,302,1.00
ptg007948l,535855,536136,281,EVM,mRNA,197394,1078987,281,1.00
ptg007948l,996578,996892,314,EVM,mRNA,197394,1078987,314,1.00
ptg007953l,2058906,2059222,316,EVM,mRNA,885981,3254205,316,1.00
ptg007953l,2218443,2218734,291,EVM,mRNA,885981,3254205,291,1.00
ptg007953l,2360342,2360643,301,EVM,mRNA,885981,3254205,301,1.00
ptg007953l,2582725,2583034,309,EVM,mRNA,885981,3254205,309,1.00
ptg007956l,4510305,4510601,296,EVM,mRNA,3801195,4690085,296,1.00
ptg007956l,5535930,5536232,302,EVM,mRNA,5348977,5618130,302,1.00
ptg007963l,1729602,1729903,301,EVM,mRNA,1687464,1914261,301,1.00
ptg007963l,1740729,1741042,313,EVM,mRNA,1687464,1914261,313,1.00
ptg007966l,708054,708343,289,EVM,mRNA,190624,2847384,289,1.00
ptg007966l,720966,721279,313,EVM,mRNA,190624,2847384,313,1.00
ptg007966l,2144303,2144616,313,EVM,mRNA,190624,2847384,313,1.00
ptg007966l,2178167,2178478,311,EVM,mRNA,190624,2847384,311,1.00
ptg007969l,628545,628843,298,EVM,mRNA,223326,2566356,298,1.00
ptg007969l,1703451,1703742,291,EVM,mRNA,223326,2566356,291,1.00
ptg007979l,1314427,1314749,322,EVM,mRNA,1113004,1359613,322,1.00
ptg007981l,179981,180280,299,EVM,mRNA,59809,2685789,299,1.00
ptg007981l,740886,741185,299,EVM,mRNA,59809,2685789,299,1.00
ptg007981l,1308070,1308368,298,EVM,mRNA,59809,2685789,298,1.00
ptg007982l,749658,749972,314,EVM,mRNA,448994,1956968,314,1.00
ptg007984l,2531153,2531482,329,EVM,mRNA,2392518,2983876,329,1.00
ptg007989l,2028615,2028913,298,EVM,mRNA,1967212,2915019,298,1.00
ptg007989l,2778262,2778576,314,EVM,mRNA,1967212,2915019,314,1.00
ptg007989l,2870407,2870711,304,EVM,mRNA,1967212,2915019,304,1.00
ptg007990l,864867,865183,316,EVM,mRNA,857623,919177,316,1.00
ptg007991l,563671,563952,281,EVM,mRNA,481040,999780,281,1.00
ptg007991l,970007,970302,295,EVM,mRNA,481040,999780,295,1.00
ptg007993l,1343115,1343394,279,EVM,mRNA,295164,2176426,279,1.00
ptg007993l,2799936,2800244,308,EVM,mRNA,2317972,3061073,308,1.00
ptg008002l,308437,308739,302,EVM,mRNA,197082,470688,302,1.00
ptg008006l,1461260,1461576,316,EVM,mRNA,622586,1747960,316,1.00
ptg008008l,7810,8117,307,EVM,mRNA,240,26340,307,1.00
ptg008009l,2240755,2241070,315,EVM,mRNA,2095780,2621912,315,1.00
ptg008010l,2187963,2188249,286,EVM,mRNA,221180,2626976,286,1.00
ptg008010l,2283505,2283825,320,EVM,mRNA,221180,2626976,320,1.00
ptg008016l,1243832,1244143,311,EVM,mRNA,1088092,1329903,311,1.00
ptg008023l,1098982,1099304,322,EVM,mRNA,930455,1514793,322,1.00
ptg008024l,213321,213587,266,EVM,mRNA,186166,569739,266,1.00
ptg008026l,701988,702301,313,EVM,mRNA,589112,1309798,313,1.00
ptg008026l,1233835,1234151,316,EVM,mRNA,589112,1309798,316,1.00
ptg008027l,624874,625138,264,EVM,mRNA,576541,1077735,264,1.00
ptg008030l,510217,510534,317,EVM,mRNA,266340,1994052,317,1.00
ptg008030l,851198,851502,304,EVM,mRNA,266340,1994052,304,1.00
ptg008031l,1059137,1059432,295,EVM,mRNA,847979,2258487,295,1.00
ptg008031l,1549679,1549978,299,EVM,mRNA,847979,2258487,299,1.00
ptg008032l,1249961,1250263,302,EVM,mRNA,1139578,2500375,302,1.00
ptg008032l,3061215,3061533,318,EVM,mRNA,2888253,3537027,318,1.00
ptg008032l,3751169,3751422,253,EVM,mRNA,3688529,3782666,253,1.00
ptg008036l,346962,347254,292,EVM,mRNA,287896,456439,292,1.00
ptg008036l,363630,363926,296,EVM,mRNA,287896,456439,296,1.00
ptg008038l,268155,268462,307,EVM,mRNA,5,444008,307,1.00
ptg008038l,573639,573928,289,EVM,mRNA,532874,756462,289,1.00
ptg008038l,1306291,1306579,288,EVM,mRNA,930838,1532462,288,1.00
ptg008038l,1323539,1323823,284,EVM,mRNA,930838,1532462,284,1.00
ptg008038l,1456665,1456950,285,EVM,mRNA,930838,1532462,285,1.00
ptg008038l,1520924,1521237,313,EVM,mRNA,930838,1532462,313,1.00
ptg008043l,676264,676555,291,EVM,mRNA,366547,946745,291,1.00
ptg008043l,1225671,1225972,301,EVM,mRNA,1099153,1723414,301,1.00
ptg008043l,4264384,4264679,295,EVM,mRNA,4054240,4768048,295,1.00
ptg008043l,4379660,4379949,289,EVM,mRNA,4054240,4768048,289,1.00
ptg008044l,432998,433289,291,EVM,mRNA,3060,1412864,291,1.00
ptg008044l,1058986,1059273,287,EVM,mRNA,3060,1412864,287,1.00
ptg008044l,1146493,1146807,314,EVM,mRNA,3060,1412864,314,1.00
ptg008044l,1258009,1258290,281,EVM,mRNA,3060,1412864,281,1.00
ptg008048l,2411545,2411828,283,EVM,mRNA,1556658,2780061,283,1.00
ptg008051l,95692,95981,289,EVM,mRNA,32523,878988,289,1.00
ptg008051l,323936,324201,265,EVM,mRNA,32523,878988,265,1.00
ptg008053l,186974,187264,290,EVM,mRNA,7648,794029,290,1.00
ptg008053l,539090,539373,283,EVM,mRNA,7648,794029,283,1.00
ptg008053l,1468416,1468719,303,EVM,mRNA,1407669,1842557,303,1.00
ptg008063l,3915789,3916109,320,EVM,mRNA,2444166,4415934,320,1.00
ptg008066l,546581,546890,309,EVM,mRNA,389537,1292826,309,1.00
ptg008067l,304701,305032,331,EVM,mRNA,43354,378546,331,1.00
ptg008067l,1655194,1655506,312,EVM,mRNA,1562451,1916832,312,1.00
ptg008067l,1915368,1915692,324,EVM,mRNA,1562451,1916832,324,1.00
ptg008075l,781650,781942,292,EVM,mRNA,649644,1012391,292,1.00
ptg008075l,1542304,1542630,326,EVM,mRNA,1429413,2211583,326,1.00
ptg008076l,627744,628059,315,EVM,mRNA,386634,1296276,315,1.00
ptg008076l,1928128,1928447,319,EVM,mRNA,1844454,1960482,319,1.00
ptg008079l,508143,508422,279,EVM,mRNA,167581,1314770,279,1.00
ptg008084l,1604015,1604329,314,EVM,mRNA,1501602,1880082,314,1.00
ptg008088l,895745,896031,286,EVM,mRNA,771220,1092401,286,1.00
ptg008088l,2227109,2227364,255,EVM,mRNA,1998981,2288503,255,1.00
ptg008089l,305898,306167,269,EVM,mRNA,249486,621893,269,1.00
ptg008089l,357570,357856,286,EVM,mRNA,249486,621893,286,1.00
ptg008089l,489096,489375,279,EVM,mRNA,249486,621893,279,1.00
ptg008090l,1041307,1041603,296,EVM,mRNA,974628,1379202,296,1.00
ptg008090l,3688851,3689187,336,EVM,mRNA,2646803,4139411,336,1.00
ptg008090l,4063277,4063590,313,EVM,mRNA,2646803,4139411,313,1.00
ptg008093l,420329,420602,273,EVM,mRNA,18070,1153990,273,1.00
ptg008093l,746649,746939,290,EVM,mRNA,18070,1153990,290,1.00
ptg008093l,761049,761377,328,EVM,mRNA,18070,1153990,328,1.00
ptg008096l,1199144,1199441,297,EVM,mRNA,592668,1549867,297,1.00
ptg008096l,1902850,1903170,320,EVM,mRNA,1883646,1984359,320,1.00
ptg008099l,420362,420713,351,EVM,mRNA,300853,441160,351,1.00
ptg008100l,754262,754578,316,EVM,mRNA,574814,863865,316,1.00
ptg008102l,1348877,1349169,292,EVM,mRNA,1118427,1505639,292,1.00
ptg008102l,3319472,3319782,310,EVM,mRNA,3249490,3471507,310,1.00
ptg008107l,1014110,1014434,324,EVM,mRNA,842514,1239010,324,1.00
ptg008107l,1551089,1551378,289,EVM,mRNA,1480274,1854077,289,1.00
ptg008112l,358925,359225,300,EVM,mRNA,17786,2255957,300,1.00
ptg008112l,798977,799263,286,EVM,mRNA,17786,2255957,286,1.00
ptg008112l,2118165,2118450,285,EVM,mRNA,17786,2255957,285,1.00
ptg008112l,3206678,3206959,281,EVM,mRNA,2484279,5327098,281,1.00
ptg008112l,3860175,3860478,303,EVM,mRNA,2484279,5327098,303,1.00
ptg008112l,3933321,3933576,255,EVM,mRNA,2484279,5327098,255,1.00
ptg008113l,943453,943732,279,EVM,mRNA,320632,1966612,279,1.00
ptg008113l,1148188,1148506,318,EVM,mRNA,320632,1966612,318,1.00
ptg008113l,1341595,1341918,323,EVM,mRNA,320632,1966612,323,1.00
ptg008113l,1743600,1743887,287,EVM,mRNA,320632,1966612,287,1.00
ptg008113l,1810642,1810973,331,EVM,mRNA,320632,1966612,331,1.00
ptg008114l,1314114,1314386,272,EVM,mRNA,1176364,1632225,272,1.00
ptg008116l,2595455,2595748,293,EVM,mRNA,2502204,2873246,293,1.00
ptg008119l,560980,561256,276,EVM,mRNA,230300,899925,276,1.00
ptg008119l,593851,594169,318,EVM,mRNA,230300,899925,318,1.00
ptg008120l,2248758,2249080,322,EVM,mRNA,2241653,2267120,322,1.00
ptg008121l,1687755,1688050,295,EVM,mRNA,1650924,3044557,295,1.00
ptg008121l,2917117,2917397,280,EVM,mRNA,1650924,3044557,280,1.00
ptg008122l,67164,67490,326,EVM,mRNA,8900,1466671,326,1.00
ptg008122l,245424,245736,312,EVM,mRNA,8900,1466671,312,1.00
ptg008122l,258458,258724,266,EVM,mRNA,8900,1466671,266,1.00
ptg008122l,279631,279920,289,EVM,mRNA,8900,1466671,289,1.00
ptg008122l,3327475,3327773,298,EVM,mRNA,2757396,3347928,298,1.00
ptg008122l,3782731,3783041,310,EVM,mRNA,3596755,3945006,310,1.00
ptg008127l,483541,483849,308,EVM,mRNA,352193,1215431,308,1.00
ptg008132l,2401857,2402138,281,EVM,mRNA,2394989,2592983,281,1.00
ptg008133l,695865,696193,328,EVM,mRNA,677915,951414,328,1.00
ptg008137l,3832496,3832807,311,EVM,mRNA,2929763,4224650,311,1.00
ptg008142l,2451573,2451903,330,EVM,mRNA,1644477,2453569,330,1.00
ptg008143l,1106570,1106833,263,EVM,mRNA,1096628,1116800,263,1.00
ptg008144l,521809,522158,349,EVM,mRNA,158440,1535157,349,1.00
ptg008144l,634584,634883,299,EVM,mRNA,158440,1535157,299,1.00
ptg008147l,1291812,1292134,322,EVM,mRNA,1216534,1365683,322,1.00
ptg008150l,236047,236330,283,EVM,mRNA,24459,672099,283,1.00
ptg008151l,250653,250936,283,EVM,mRNA,9413,371807,283,1.00
ptg008151l,819860,820124,264,EVM,mRNA,464112,844519,264,1.00
ptg008153l,1215411,1215691,280,EVM,mRNA,1079529,1316477,280,1.00
ptg008153l,1340490,1340788,298,EVM,mRNA,1340372,1399162,298,1.00
ptg008165l,199078,199398,320,EVM,mRNA,142364,270920,320,1.00
ptg008166l,290531,290792,261,EVM,mRNA,264538,977678,261,1.00
ptg008166l,680267,680564,297,EVM,mRNA,264538,977678,297,1.00
ptg008169l,1043479,1043748,269,EVM,mRNA,658049,1565963,269,1.00
ptg008169l,1230004,1230333,329,EVM,mRNA,658049,1565963,329,1.00
ptg008172l,337345,337668,323,EVM,mRNA,257078,415313,323,1.00
ptg008172l,338386,338674,288,EVM,mRNA,257078,415313,288,1.00
ptg008176l,981517,981816,299,EVM,mRNA,749367,1662780,299,1.00
ptg008176l,1467961,1468256,295,EVM,mRNA,749367,1662780,295,1.00
ptg008179l,1549823,1550113,290,EVM,mRNA,926205,1551465,290,1.00
ptg008181l,110371,110689,318,EVM,mRNA,58051,1242041,318,1.00
ptg008181l,813939,814260,321,EVM,mRNA,58051,1242041,321,1.00
ptg008181l,1205129,1205406,277,EVM,mRNA,58051,1242041,277,1.00
ptg008183l,802393,802662,269,EVM,mRNA,802186,952333,269,1.00
ptg008192l,85956,86261,305,EVM,mRNA,3436,223286,305,1.00
ptg008195l,436170,436449,279,EVM,mRNA,375093,500048,279,1.00
ptg008199l,631972,632275,303,EVM,mRNA,404500,1242702,303,1.00
ptg008202l,275199,275495,296,EVM,mRNA,933,1667211,296,1.00
ptg008202l,316443,316770,327,EVM,mRNA,933,1667211,327,1.00
ptg008202l,1062091,1062370,279,EVM,mRNA,933,1667211,279,1.00
ptg008203l,1083100,1083426,326,EVM,mRNA,4116,3349780,326,1.00
ptg008203l,1310957,1311225,268,EVM,mRNA,4116,3349780,268,1.00
ptg008204l,710146,710441,295,EVM,mRNA,110143,3568606,295,1.00
ptg008204l,1735595,1735887,292,EVM,mRNA,110143,3568606,292,1.00
ptg008204l,1875629,1875929,300,EVM,mRNA,110143,3568606,300,1.00
ptg008204l,2694392,2694663,271,EVM,mRNA,110143,3568606,271,1.00
ptg008205l,2240336,2240648,312,EVM,mRNA,1108693,2552140,312,1.00
ptg008205l,2408762,2409068,306,EVM,mRNA,1108693,2552140,306,1.00
ptg008207l,98764,99059,295,EVM,mRNA,82132,165309,295,1.00
ptg008207l,112228,112524,296,EVM,mRNA,82132,165309,296,1.00
ptg008209l,480034,480300,266,EVM,mRNA,479085,726962,266,1.00
ptg008214l,866889,867166,277,EVM,mRNA,10050,1611539,277,1.00
ptg008214l,1294983,1295278,295,EVM,mRNA,10050,1611539,295,1.00
ptg008215l,1087982,1088311,329,EVM,mRNA,64667,1899342,329,1.00
ptg008215l,1133178,1133490,312,EVM,mRNA,64667,1899342,312,1.00
ptg008215l,1133184,1133490,306,EVM,mRNA,64667,1899342,306,1.00
ptg008215l,1168570,1168899,329,EVM,mRNA,64667,1899342,329,1.00
ptg008215l,1330622,1330924,302,EVM,mRNA,64667,1899342,302,1.00
ptg008217l,783623,783905,282,EVM,mRNA,6028,794602,282,1.00
ptg008220l,2033040,2033352,312,EVM,mRNA,1953988,2039425,312,1.00
ptg008223l,277924,278203,279,EVM,mRNA,194521,325032,279,1.00
ptg008231l,302110,302373,263,EVM,mRNA,4682,561171,263,1.00
ptg008231l,872244,872498,254,EVM,mRNA,707985,1030364,254,1.00
ptg008232l,211369,211695,326,EVM,mRNA,166196,391896,326,1.00
ptg008232l,315168,315448,280,EVM,mRNA,166196,391896,280,1.00
ptg008233l,123669,123971,302,EVM,mRNA,9093,883297,302,1.00
ptg008235l,240829,241141,312,EVM,mRNA,202944,1317843,312,1.00
ptg008235l,1226298,1226597,299,EVM,mRNA,202944,1317843,299,1.00
ptg008238l,253646,253952,306,EVM,mRNA,152445,309645,306,1.00
ptg008239l,892255,892579,324,EVM,mRNA,494774,1537547,324,1.00
ptg008239l,955938,956244,306,EVM,mRNA,494774,1537547,306,1.00
ptg008239l,1502069,1502352,283,EVM,mRNA,494774,1537547,283,1.00
ptg008239l,2064417,2064711,294,EVM,mRNA,1586503,2162072,294,1.00
ptg008241l,938897,939205,308,EVM,mRNA,125600,1373093,308,1.00
ptg008241l,1110033,1110345,312,EVM,mRNA,125600,1373093,312,1.00
ptg008241l,1162690,1163006,316,EVM,mRNA,125600,1373093,316,1.00
ptg008252l,1095870,1096134,264,EVM,mRNA,835631,1811778,264,1.00
ptg008252l,1334717,1335035,318,EVM,mRNA,835631,1811778,318,1.00
ptg008253l,733394,733688,294,EVM,mRNA,482576,970244,294,1.00
ptg008255l,365379,365681,302,EVM,mRNA,289533,2395468,302,1.00
ptg008255l,384821,385120,299,EVM,mRNA,289533,2395468,299,1.00
ptg008255l,434149,434439,290,EVM,mRNA,289533,2395468,290,1.00
ptg008255l,1927546,1927872,326,EVM,mRNA,289533,2395468,326,1.00
ptg008255l,1928313,1928626,313,EVM,mRNA,289533,2395468,313,1.00
ptg008255l,2008814,2009118,304,EVM,mRNA,289533,2395468,304,1.00
ptg008255l,2182434,2182734,300,EVM,mRNA,289533,2395468,300,1.00
ptg008260l,2606250,2606545,295,EVM,mRNA,2473798,3653994,295,1.00
ptg008260l,4811194,4811475,281,EVM,mRNA,4754287,4860559,281,1.00
ptg008271l,444895,445221,326,EVM,mRNA,130,3878462,326,1.00
ptg008271l,3052811,3053136,325,EVM,mRNA,130,3878462,325,1.00
ptg008272l,33433,33744,311,EVM,mRNA,1449,401538,311,1.00
ptg008272l,527347,527659,312,EVM,mRNA,506147,901041,312,1.00
ptg008272l,638188,638467,279,EVM,mRNA,506147,901041,279,1.00
ptg008273l,144602,144870,268,EVM,mRNA,71244,183433,268,1.00
ptg008273l,2950759,2951041,282,EVM,mRNA,1864843,3576026,282,1.00
ptg008278l,630013,630325,312,EVM,mRNA,158447,677578,312,1.00
ptg008278l,1722424,1722720,296,EVM,mRNA,1689600,1802387,296,1.00
ptg008278l,2118116,2118431,315,EVM,mRNA,1959393,2215038,315,1.00
ptg008278l,2739938,2740250,312,EVM,mRNA,2717139,3005502,312,1.00
ptg008278l,2936274,2936619,345,EVM,mRNA,2717139,3005502,345,1.00
ptg008278l,3215500,3215766,266,EVM,mRNA,3085001,3325788,266,1.00
ptg008280l,1039049,1039379,330,EVM,mRNA,1010445,1116500,330,1.00
ptg008280l,1260560,1260846,286,EVM,mRNA,1243767,2547465,286,1.00
ptg008280l,1491797,1492076,279,EVM,mRNA,1243767,2547465,279,1.00
ptg008288l,295772,296062,290,EVM,mRNA,201491,1032431,290,1.00
ptg008288l,515953,516239,286,EVM,mRNA,201491,1032431,286,1.00
ptg008288l,1250339,1250651,312,EVM,mRNA,1161309,2303025,312,1.00
ptg008295l,826766,827066,300,EVM,mRNA,726458,879119,300,1.00
ptg008296l,1878688,1878977,289,EVM,mRNA,431795,3439309,289,1.00
ptg008297l,935745,936073,328,EVM,mRNA,934162,2335951,328,1.00
ptg008298l,990147,990470,323,EVM,mRNA,497277,1644707,323,1.00
ptg008305l,114967,115251,284,EVM,mRNA,95412,3405853,284,1.00
ptg008305l,638201,638514,313,EVM,mRNA,95412,3405853,313,1.00
ptg008305l,2670065,2670371,306,EVM,mRNA,95412,3405853,306,1.00
ptg008305l,2927607,2927909,302,EVM,mRNA,95412,3405853,302,1.00
ptg008311l,1377467,1377798,331,EVM,mRNA,1344586,1858678,331,1.00
ptg008311l,2502325,2502629,304,EVM,mRNA,2130920,3449394,304,1.00
ptg008318l,285734,286020,286,EVM,mRNA,277294,727567,286,1.00
ptg008331l,59925,60241,316,EVM,mRNA,18054,342657,316,1.00
ptg008335l,3490952,3491251,299,EVM,mRNA,3303865,4580885,299,1.00
ptg008335l,3853423,3853736,313,EVM,mRNA,3303865,4580885,313,1.00
ptg008337l,968993,969305,312,EVM,mRNA,489031,1076317,312,1.00
ptg008338l,1169933,1170220,287,EVM,mRNA,453593,1867606,287,1.00
ptg008338l,2094558,2094852,294,EVM,mRNA,2092756,2141994,294,1.00
ptg008339l,1881762,1882083,321,EVM,mRNA,142818,2582522,321,1.00
ptg008339l,1910025,1910306,281,EVM,mRNA,142818,2582522,281,1.00
ptg008339l,2373565,2373845,280,EVM,mRNA,142818,2582522,280,1.00
ptg008356l,299353,299671,318,EVM,mRNA,48863,396245,318,1.00
ptg008358l,1077831,1078164,333,EVM,mRNA,681982,2074638,333,1.00
ptg008360l,477447,477727,280,EVM,mRNA,373905,484642,280,1.00
ptg008363l,1934988,1935270,282,EVM,mRNA,1793166,2153805,282,1.00
ptg008363l,1941929,1942250,321,EVM,mRNA,1793166,2153805,321,1.00
ptg008377l,728014,728323,309,EVM,mRNA,9904,829734,309,1.00
ptg008378l,419335,419655,320,EVM,mRNA,376974,1514396,320,1.00
ptg008378l,499056,499352,296,EVM,mRNA,376974,1514396,296,1.00
ptg008378l,615423,615742,319,EVM,mRNA,376974,1514396,319,1.00
ptg008378l,757239,757548,309,EVM,mRNA,376974,1514396,309,1.00
ptg008378l,788482,788807,325,EVM,mRNA,376974,1514396,325,1.00
ptg008378l,898573,898887,314,EVM,mRNA,376974,1514396,314,1.00
ptg008378l,987269,987534,265,EVM,mRNA,376974,1514396,265,1.00
ptg008378l,1339469,1339766,297,EVM,mRNA,376974,1514396,297,1.00
ptg008379l,620504,620822,318,EVM,mRNA,493004,661273,318,1.00
ptg008387l,586840,587150,310,EVM,mRNA,494405,827021,310,1.00
ptg008393l,396955,397280,325,EVM,mRNA,4509,519361,325,1.00
ptg008393l,462398,462730,332,EVM,mRNA,4509,519361,332,1.00
ptg008393l,501177,501495,318,EVM,mRNA,4509,519361,318,1.00
ptg008393l,505768,506071,303,EVM,mRNA,4509,519361,303,1.00
ptg008393l,1813558,1813871,313,EVM,mRNA,908004,2235279,313,1.00
ptg008395l,1048677,1048976,299,EVM,mRNA,24189,1550083,299,1.00
ptg008395l,1082550,1082842,292,EVM,mRNA,24189,1550083,292,1.00
ptg008400l,1749330,1749606,276,EVM,mRNA,846584,2470627,276,1.00
ptg008400l,2322575,2322847,272,EVM,mRNA,846584,2470627,272,1.00
ptg008400l,2382732,2383026,294,EVM,mRNA,846584,2470627,294,1.00
ptg008403l,1480486,1480791,305,EVM,mRNA,21607,3135153,305,1.00
ptg008403l,2815937,2816254,317,EVM,mRNA,21607,3135153,317,1.00
ptg008404l,175362,175658,296,EVM,mRNA,10051,470846,296,1.00
ptg008404l,1157047,1157360,313,EVM,mRNA,1143080,2200245,313,1.00
ptg008404l,1600060,1600339,279,EVM,mRNA,1143080,2200245,279,1.00
ptg008404l,2140177,2140471,294,EVM,mRNA,1143080,2200245,294,1.00
ptg008404l,2964830,2965110,280,EVM,mRNA,2747323,3235545,280,1.00
ptg008404l,3216328,3216568,240,EVM,mRNA,2747323,3235545,240,1.00
ptg008404l,3220749,3221045,296,EVM,mRNA,2747323,3235545,296,1.00
ptg008406l,81004,81298,294,EVM,mRNA,45491,315063,294,1.00
ptg008413l,5902145,5902444,299,EVM,mRNA,5426446,6262156,299,1.00
ptg008415l,610491,610781,290,EVM,mRNA,550750,1123296,290,1.00
ptg008418l,77847,78169,322,EVM,mRNA,4546,2231783,322,1.00
ptg008424l,301393,301712,319,EVM,mRNA,131880,303907,319,1.00
ptg008425l,842118,842430,312,EVM,mRNA,802968,2001474,312,1.00
ptg008425l,1406897,1407201,304,EVM,mRNA,802968,2001474,304,1.00
ptg008425l,1434791,1435106,315,EVM,mRNA,802968,2001474,315,1.00
ptg008433l,1056036,1056363,327,EVM,mRNA,92677,1133404,327,1.00
ptg008435l,946217,946517,300,EVM,mRNA,827634,2581773,300,1.00
ptg008435l,1232985,1233260,275,EVM,mRNA,827634,2581773,275,1.00
ptg008435l,1616133,1616432,299,EVM,mRNA,827634,2581773,299,1.00
ptg008440l,1536097,1536413,316,EVM,mRNA,1244962,1771560,316,1.00
ptg008440l,1653872,1654172,300,EVM,mRNA,1244962,1771560,300,1.00
ptg008446l,116878,117194,316,EVM,mRNA,102999,1521300,316,1.00
ptg008446l,946786,947082,296,EVM,mRNA,102999,1521300,296,1.00
ptg008446l,2015202,2015522,320,EVM,mRNA,1809498,2046450,320,1.00
ptg008449l,1735429,1735698,269,EVM,mRNA,1568624,3704762,269,1.00
ptg008449l,3325039,3325311,272,EVM,mRNA,1568624,3704762,272,1.00
ptg008449l,3496491,3496750,259,EVM,mRNA,1568624,3704762,259,1.00
ptg008451l,833710,833999,289,EVM,mRNA,611618,917637,289,1.00
ptg008452l,1000949,1001282,333,EVM,mRNA,892479,1028337,333,1.00
ptg008454l,71832,72101,269,EVM,mRNA,52249,106790,269,1.00
ptg008454l,1685546,1685870,324,EVM,mRNA,1675085,1689888,324,1.00
ptg008456l,784167,784457,290,EVM,mRNA,675064,857899,290,1.00
ptg008459l,19097,19420,323,EVM,mRNA,2914,394870,323,1.00
ptg008460l,3910784,3911099,315,EVM,mRNA,3515876,4000593,315,1.00
ptg008462l,382869,383144,275,EVM,mRNA,100819,1007337,275,1.00
ptg008464l,957303,957619,316,EVM,mRNA,37078,977066,316,1.00
ptg008467l,438238,438549,311,EVM,mRNA,27970,1089351,311,1.00
ptg008467l,686816,687142,326,EVM,mRNA,27970,1089351,326,1.00
ptg008467l,1473294,1473572,278,EVM,mRNA,1195617,1781442,278,1.00
ptg008467l,1591166,1591452,286,EVM,mRNA,1195617,1781442,286,1.00
ptg008472l,958844,959130,286,EVM,mRNA,102264,3038341,286,1.00
ptg008472l,1623933,1624224,291,EVM,mRNA,102264,3038341,291,1.00
ptg008473l,2015827,2016147,320,EVM,mRNA,1873712,2669575,320,1.00
ptg008482l,678057,678344,287,EVM,mRNA,14407,1602615,287,1.00
ptg008482l,1156126,1156417,291,EVM,mRNA,14407,1602615,291,1.00
ptg008491l,500254,500552,298,EVM,mRNA,363724,523182,298,1.00
ptg008491l,999462,999741,279,EVM,mRNA,791675,1251804,279,1.00
ptg008492l,1551277,1551574,297,EVM,mRNA,967994,2078154,297,1.00
ptg008492l,1641716,1642013,297,EVM,mRNA,967994,2078154,297,1.00
ptg008492l,1942975,1943273,298,EVM,mRNA,967994,2078154,298,1.00
ptg008492l,1949364,1949639,275,EVM,mRNA,967994,2078154,275,1.00
ptg008493l,251266,251598,332,EVM,mRNA,250283,276574,332,1.00
ptg008496l,617042,617343,301,EVM,mRNA,4196,1330704,301,1.00
ptg008496l,774658,774970,312,EVM,mRNA,4196,1330704,312,1.00
ptg008496l,1038832,1039149,317,EVM,mRNA,4196,1330704,317,1.00
ptg008498l,661018,661337,319,EVM,mRNA,505539,902063,319,1.00
ptg008501l,469964,470249,285,EVM,mRNA,467125,776364,285,1.00
ptg008502l,324457,324747,290,EVM,mRNA,27924,1393625,290,1.00
ptg008506l,371547,371834,287,EVM,mRNA,244965,535614,287,1.00
ptg008506l,1113261,1113549,288,EVM,mRNA,1077492,1174044,288,1.00
ptg008506l,1552357,1552665,308,EVM,mRNA,1507102,1875946,308,1.00
ptg008507l,3333065,3333378,313,EVM,mRNA,1512383,3583327,313,1.00
ptg008514l,873205,873515,310,EVM,mRNA,60093,1247595,310,1.00
ptg008515l,496769,497054,285,EVM,mRNA,225873,717002,285,1.00
ptg008516l,685911,686203,292,EVM,mRNA,505157,822373,292,1.00
ptg008516l,762655,762972,317,EVM,mRNA,505157,822373,317,1.00
ptg008519l,899013,899335,322,EVM,mRNA,388018,1860701,322,1.00
ptg008521l,85799,86113,314,EVM,mRNA,63396,158441,314,1.00
ptg008526l,1171652,1171964,312,EVM,mRNA,225185,1676011,312,1.00
ptg008531l,656690,657007,317,EVM,mRNA,610065,1771067,317,1.00
ptg008534l,1467658,1467963,305,EVM,mRNA,1382384,1487467,305,1.00
ptg008539l,1667077,1667400,323,EVM,mRNA,1599384,2082186,323,1.00
ptg008542l,724006,724303,297,EVM,mRNA,695907,1109611,297,1.00
ptg008543l,170150,170443,293,EVM,mRNA,7772,1165126,293,1.00
ptg008543l,1042544,1042840,296,EVM,mRNA,7772,1165126,296,1.00
ptg008543l,2789454,2789756,302,EVM,mRNA,2142738,3395777,302,1.00
ptg008544l,832615,832933,318,EVM,mRNA,594225,2843007,318,1.00
ptg008544l,1318441,1318741,300,EVM,mRNA,594225,2843007,300,1.00
ptg008544l,1623466,1623779,313,EVM,mRNA,594225,2843007,313,1.00
ptg008544l,1807567,1807869,302,EVM,mRNA,594225,2843007,302,1.00
ptg008546l,2162899,2163171,272,EVM,mRNA,631333,2452142,272,1.00
ptg008547l,2504878,2505149,271,EVM,mRNA,2190304,2809131,271,1.00
ptg008547l,2803130,2803443,313,EVM,mRNA,2190304,2809131,313,1.00
ptg008552l,290188,290493,305,EVM,mRNA,250026,412461,305,1.00
ptg008552l,721305,721606,301,EVM,mRNA,690388,1339874,301,1.00
ptg008554l,2053640,2053927,287,EVM,mRNA,1219337,2862960,287,1.00
ptg008554l,2080160,2080455,295,EVM,mRNA,1219337,2862960,295,1.00
ptg008556l,1262738,1263043,305,EVM,mRNA,1129982,1276535,305,1.00
ptg008559l,2872882,2873180,298,EVM,mRNA,2635481,4698217,298,1.00
ptg008559l,3244476,3244776,300,EVM,mRNA,2635481,4698217,300,1.00
ptg008559l,3466167,3466496,329,EVM,mRNA,2635481,4698217,329,1.00
ptg008559l,3628918,3629248,330,EVM,mRNA,2635481,4698217,330,1.00
ptg008559l,3795811,3796114,303,EVM,mRNA,2635481,4698217,303,1.00
ptg008559l,5642531,5642855,324,EVM,mRNA,5102975,6026352,324,1.00
ptg008559l,6556618,6556913,295,EVM,mRNA,6175515,6782899,295,1.00
ptg008561l,602843,603160,317,EVM,mRNA,102461,993000,317,1.00
ptg008562l,1029860,1030153,293,EVM,mRNA,508903,1064753,293,1.00
ptg008563l,631333,631660,327,EVM,mRNA,138841,637876,327,1.00
ptg008565l,359739,360040,301,EVM,mRNA,105382,501800,301,1.00
ptg008574l,450921,451210,289,EVM,mRNA,259864,730706,289,1.00
ptg008579l,1121874,1122194,320,EVM,mRNA,366585,1365437,320,1.00
ptg008579l,2885440,2885769,329,EVM,mRNA,2789858,3062729,329,1.00
ptg008585l,657791,658083,292,EVM,mRNA,475008,1178890,292,1.00
ptg008590l,503731,504034,303,EVM,mRNA,420498,2036027,303,1.00
ptg008590l,731075,731388,313,EVM,mRNA,420498,2036027,313,1.00
ptg008590l,891295,891603,308,EVM,mRNA,420498,2036027,308,1.00
ptg008590l,964853,965135,282,EVM,mRNA,420498,2036027,282,1.00
ptg008590l,1110132,1110448,316,EVM,mRNA,420498,2036027,316,1.00
ptg008590l,1445850,1446169,319,EVM,mRNA,420498,2036027,319,1.00
ptg008590l,1550956,1551261,305,EVM,mRNA,420498,2036027,305,1.00
ptg008590l,1726660,1726913,253,EVM,mRNA,420498,2036027,253,1.00
ptg008592l,583696,584002,306,EVM,mRNA,696,3041531,306,1.00
ptg008592l,727789,728101,312,EVM,mRNA,696,3041531,312,1.00
ptg008592l,1138751,1139076,325,EVM,mRNA,696,3041531,325,1.00
ptg008592l,1556059,1556370,311,EVM,mRNA,696,3041531,311,1.00
ptg008592l,2476372,2476678,306,EVM,mRNA,696,3041531,306,1.00
ptg008593l,758788,759120,332,EVM,mRNA,455452,928021,332,1.00
ptg008593l,1213621,1213946,325,EVM,mRNA,1186837,1428731,325,1.00
ptg008596l,255987,256269,282,EVM,mRNA,241539,447644,282,1.00
ptg008598l,1051037,1051370,333,EVM,mRNA,937815,1583397,333,1.00
ptg008602l,879349,879658,309,EVM,mRNA,683993,1066857,309,1.00
ptg008604l,275151,275439,288,EVM,mRNA,11575,808598,288,1.00
ptg008606l,331012,331313,301,EVM,mRNA,47771,942864,301,1.00
ptg008606l,331012,331313,301,GeneWise,mRNA,78259,942861,301,1.00
ptg008606l,793761,794079,318,EVM,mRNA,47771,942864,318,1.00
ptg008606l,793761,794079,318,GeneWise,mRNA,78259,942861,318,1.00
ptg008616l,849386,849701,315,EVM,mRNA,845889,970411,315,1.00
ptg008618l,190134,190433,299,EVM,mRNA,45370,391582,299,1.00
ptg008618l,298696,298973,277,EVM,mRNA,45370,391582,277,1.00
ptg008619l,1141388,1141723,335,EVM,mRNA,1068554,1259897,335,1.00
ptg008619l,2743605,2743934,329,EVM,mRNA,2071590,3003833,329,1.00
ptg008619l,3573759,3574035,276,EVM,mRNA,3478811,3800955,276,1.00
ptg008621l,788989,789315,326,EVM,mRNA,718600,1100555,326,1.00
ptg008622l,196324,196621,297,EVM,mRNA,145449,244268,297,1.00
ptg008623l,129571,129861,290,EVM,mRNA,62800,412238,290,1.00
ptg008632l,631922,632216,294,EVM,mRNA,263012,677133,294,1.00
ptg008640l,415993,416313,320,EVM,mRNA,81226,718634,320,1.00
ptg008640l,698336,698635,299,EVM,mRNA,81226,718634,299,1.00
ptg008641l,817376,817669,293,EVM,mRNA,746123,1308634,293,1.00
ptg008645l,1155566,1155840,274,EVM,mRNA,1097358,1499377,274,1.00
ptg008646l,715499,715734,235,EVM,mRNA,691369,1162216,235,1.00
ptg008651l,2579547,2579799,252,EVM,mRNA,2344661,3559162,252,1.00
ptg008651l,3245662,3245979,317,EVM,mRNA,2344661,3559162,317,1.00
ptg008655l,489724,490050,326,EVM,mRNA,146900,1081593,326,1.00
ptg008655l,957914,958232,318,EVM,mRNA,146900,1081593,318,1.00
ptg008655l,1013384,1013662,278,EVM,mRNA,146900,1081593,278,1.00
ptg008658l,956214,956516,302,EVM,mRNA,816437,1429017,302,1.00
ptg008661l,279848,280177,329,EVM,mRNA,130476,684503,329,1.00
ptg008661l,589738,590037,299,EVM,mRNA,130476,684503,299,1.00
ptg008665l,789055,789346,291,EVM,mRNA,700655,791203,291,1.00
ptg008665l,1617070,1617364,294,EVM,mRNA,1175484,1839780,294,1.00
ptg008665l,1766315,1766583,268,EVM,mRNA,1175484,1839780,268,1.00
ptg008666l,2246096,2246417,321,EVM,mRNA,1882185,2275718,321,1.00
ptg008669l,405296,405629,333,EVM,mRNA,122366,730543,333,1.00
ptg008669l,603064,603349,285,EVM,mRNA,122366,730543,285,1.00
ptg008679l,1371957,1372231,274,EVM,mRNA,1232383,2937566,274,1.00
ptg008681l,877403,877669,266,EVM,mRNA,810268,1096137,266,1.00
ptg008682l,605409,605709,300,EVM,mRNA,79733,1433224,300,1.00
ptg008682l,872988,873287,299,EVM,mRNA,79733,1433224,299,1.00
ptg008682l,927633,927932,299,EVM,mRNA,79733,1433224,299,1.00
ptg008682l,1007272,1007567,295,EVM,mRNA,79733,1433224,295,1.00
ptg008683l,328441,328731,290,EVM,mRNA,226876,1291341,290,1.00
ptg008683l,1605207,1605506,299,EVM,mRNA,1406485,1819926,299,1.00
ptg008684l,756346,756671,325,EVM,mRNA,627711,1104029,325,1.00
ptg008686l,779237,779557,320,EVM,mRNA,774604,991084,320,1.00
ptg008687l,1989793,1990100,307,EVM,mRNA,1939027,2500578,307,1.00
ptg008687l,2382903,2383194,291,EVM,mRNA,1939027,2500578,291,1.00
ptg008688l,735478,735787,309,EVM,mRNA,701935,750749,309,1.00
ptg008688l,1422878,1423190,312,EVM,mRNA,994512,1960009,312,1.00
ptg008688l,1447771,1448074,303,EVM,mRNA,994512,1960009,303,1.00
ptg008690l,55472,55785,313,EVM,mRNA,3878,161357,313,1.00
ptg008690l,86908,87229,321,EVM,mRNA,3878,161357,321,1.00
ptg008691l,659541,659851,310,EVM,mRNA,636846,850250,310,1.00
ptg008696l,1227499,1227798,299,EVM,mRNA,389182,1343827,299,1.00
ptg008700l,883839,884130,291,EVM,mRNA,883232,1196315,291,1.00
ptg008700l,3004415,3004744,329,EVM,mRNA,1773026,3886539,329,1.00
ptg008700l,4136810,4137098,288,EVM,mRNA,4109766,4259595,288,1.00
ptg008700l,4173557,4173817,260,EVM,mRNA,4109766,4259595,260,1.00
ptg008707l,659678,659994,316,EVM,mRNA,294508,1510117,316,1.00
ptg008707l,795977,796289,312,EVM,mRNA,294508,1510117,312,1.00
ptg008707l,801348,801660,312,EVM,mRNA,294508,1510117,312,1.00
ptg008707l,1099123,1099434,311,EVM,mRNA,294508,1510117,311,1.00
ptg008707l,1319102,1319399,297,EVM,mRNA,294508,1510117,297,1.00
ptg008711l,1568199,1568515,316,EVM,mRNA,1229422,1814166,316,1.00
ptg008712l,306463,306737,274,EVM,mRNA,295668,367630,274,1.00
ptg008712l,647553,647843,290,EVM,mRNA,590826,773184,290,1.00
ptg008712l,1143142,1143422,280,EVM,mRNA,876282,1234119,280,1.00
ptg008716l,1492357,1492625,268,EVM,mRNA,1275930,3605647,268,1.00
ptg008716l,1587780,1588023,243,EVM,mRNA,1275930,3605647,243,1.00
ptg008716l,1861686,1862016,330,EVM,mRNA,1275930,3605647,330,1.00
ptg008716l,2306319,2306614,295,EVM,mRNA,1275930,3605647,295,1.00
ptg008716l,3136735,3137032,297,EVM,mRNA,1275930,3605647,297,1.00
ptg008716l,3375433,3375741,308,EVM,mRNA,1275930,3605647,308,1.00
ptg008716l,4162979,4163236,257,EVM,mRNA,4162602,4331683,257,1.00
ptg008716l,4172267,4172516,249,EVM,mRNA,4162602,4331683,249,1.00
ptg008717l,400413,400733,320,EVM,mRNA,330957,2709682,320,1.00
ptg008717l,1280753,1281066,313,EVM,mRNA,330957,2709682,313,1.00
ptg008717l,1721985,1722266,281,EVM,mRNA,330957,2709682,281,1.00
ptg008717l,1880396,1880702,306,EVM,mRNA,330957,2709682,306,1.00
ptg008718l,1100259,1100562,303,EVM,mRNA,908517,2364284,303,1.00
ptg008718l,2354538,2354787,249,EVM,mRNA,908517,2364284,249,1.00
ptg008721l,436632,436949,317,EVM,mRNA,254,1136927,317,1.00
ptg008721l,515826,516131,305,EVM,mRNA,254,1136927,305,1.00
ptg008721l,2244182,2244522,340,EVM,mRNA,1511172,3344773,340,1.00
ptg008721l,2445083,2445424,341,EVM,mRNA,1511172,3344773,341,1.00
ptg008721l,2585546,2585842,296,EVM,mRNA,1511172,3344773,296,1.00
ptg008721l,2811088,2811390,302,EVM,mRNA,1511172,3344773,302,1.00
ptg008727l,2898149,2898470,321,EVM,mRNA,2836370,2906225,321,1.00
ptg008727l,3807538,3807845,307,EVM,mRNA,2952328,4120218,307,1.00
ptg008729l,3036913,3037204,291,EVM,mRNA,2670161,3343939,291,1.00
ptg008729l,3156262,3156555,293,EVM,mRNA,2670161,3343939,293,1.00
ptg008731l,3860735,3861049,314,EVM,mRNA,3200600,5868714,314,1.00
ptg008731l,4869724,4870042,318,EVM,mRNA,3200600,5868714,318,1.00
ptg008736l,443092,443403,311,EVM,mRNA,311172,873021,311,1.00
ptg008736l,467823,468110,287,EVM,mRNA,311172,873021,287,1.00
ptg008740l,1797856,1798133,277,EVM,mRNA,1791089,2189674,277,1.00
ptg008741l,751153,751426,273,EVM,mRNA,739918,922121,273,1.00
ptg008741l,842950,843253,303,EVM,mRNA,739918,922121,303,1.00
ptg008741l,3784587,3784892,305,EVM,mRNA,3037705,3972879,305,1.00
ptg008749l,1212211,1212494,283,EVM,mRNA,1188696,1220895,283,1.00
ptg008749l,2368319,2368606,287,EVM,mRNA,1938750,2873326,287,1.00
ptg008751l,179692,180004,312,EVM,mRNA,87955,212931,312,1.00
ptg008754l,573033,573339,306,EVM,mRNA,559588,573517,306,1.00
ptg008760l,552706,552998,292,EVM,mRNA,219499,2204699,292,1.00
ptg008760l,681289,681567,278,EVM,mRNA,219499,2204699,278,1.00
ptg008760l,1062533,1062837,304,EVM,mRNA,219499,2204699,304,1.00
ptg008760l,1210509,1210808,299,EVM,mRNA,219499,2204699,299,1.00
ptg008760l,1478851,1479123,272,EVM,mRNA,219499,2204699,272,1.00
ptg008760l,1687579,1687895,316,EVM,mRNA,219499,2204699,316,1.00
ptg008760l,1977772,1978056,284,EVM,mRNA,219499,2204699,284,1.00
ptg008760l,2038319,2038618,299,EVM,mRNA,219499,2204699,299,1.00
ptg008762l,210079,210396,317,EVM,mRNA,207381,719747,317,1.00
ptg008762l,352894,353221,327,EVM,mRNA,207381,719747,327,1.00
ptg008762l,495634,495933,299,EVM,mRNA,207381,719747,299,1.00
ptg008762l,583235,583549,314,EVM,mRNA,207381,719747,314,1.00
ptg008769l,1031501,1031819,318,EVM,mRNA,884513,1256932,318,1.00
ptg008775l,1379568,1379869,301,EVM,mRNA,941361,2230460,301,1.00
ptg008778l,3618041,3618363,322,EVM,mRNA,3512169,4506620,322,1.00
ptg008778l,4199319,4199588,269,EVM,mRNA,3512169,4506620,269,1.00
ptg008785l,744581,744899,318,EVM,mRNA,665385,857339,318,1.00
ptg008787l,2231225,2231541,316,EVM,mRNA,1421268,3581424,316,1.00
ptg008787l,2668151,2668434,283,EVM,mRNA,1421268,3581424,283,1.00
ptg008789l,270321,270632,311,EVM,mRNA,30348,1556978,311,1.00
ptg008789l,370402,370683,281,EVM,mRNA,30348,1556978,281,1.00
ptg008789l,1346633,1346940,307,EVM,mRNA,30348,1556978,307,1.00
ptg008790l,1468373,1468682,309,EVM,mRNA,957236,1481437,309,1.00
ptg008790l,2588350,2588609,259,EVM,mRNA,1890194,2788101,259,1.00
ptg008795l,1285443,1285747,304,EVM,mRNA,951762,2325291,304,1.00
ptg008806l,1322225,1322540,315,EVM,mRNA,1180599,1578519,315,1.00
ptg008813l,642270,642606,336,EVM,mRNA,120199,929442,336,1.00
ptg008818l,615562,615843,281,EVM,mRNA,175794,1669723,281,1.00
ptg008818l,622704,622985,281,EVM,mRNA,175794,1669723,281,1.00
ptg008818l,942311,942607,296,EVM,mRNA,175794,1669723,296,1.00
ptg008818l,1101867,1102169,302,EVM,mRNA,175794,1669723,302,1.00
ptg008820l,404633,404912,279,EVM,mRNA,187081,967052,279,1.00
ptg008820l,618441,618743,302,EVM,mRNA,187081,967052,302,1.00
ptg008828l,903290,903605,315,EVM,mRNA,886694,1156659,315,1.00
ptg008830l,128979,129272,293,EVM,mRNA,10997,477311,293,1.00
ptg008832l,688679,689004,325,EVM,mRNA,329734,1248080,325,1.00
ptg008838l,201586,201858,272,EVM,mRNA,12096,3687058,272,1.00
ptg008838l,1885647,1885948,301,EVM,mRNA,12096,3687058,301,1.00
ptg008838l,2143009,2143323,314,EVM,mRNA,12096,3687058,314,1.00
ptg008838l,2961236,2961566,330,EVM,mRNA,12096,3687058,330,1.00
ptg008838l,3047683,3047996,313,EVM,mRNA,12096,3687058,313,1.00
ptg008838l,3668721,3669003,282,EVM,mRNA,12096,3687058,282,1.00
ptg008842l,210045,210334,289,EVM,mRNA,1267,210821,289,1.00
ptg008843l,383800,384102,302,EVM,mRNA,20965,1058332,302,1.00
ptg008843l,899427,899760,333,EVM,mRNA,20965,1058332,333,1.00
ptg008843l,1268409,1268740,331,EVM,mRNA,1074446,1390688,331,1.00
ptg008843l,1273360,1273677,317,EVM,mRNA,1074446,1390688,317,1.00
ptg008845l,1488477,1488800,323,EVM,mRNA,1445627,1810630,323,1.00
ptg008845l,2364439,2364737,298,EVM,mRNA,1848015,2779715,298,1.00
ptg008850l,665045,665347,302,EVM,mRNA,115770,2060791,302,1.00
ptg008854l,842343,842623,280,EVM,mRNA,709350,1095256,280,1.00
ptg008854l,1288990,1289301,311,EVM,mRNA,1153241,1581106,311,1.00
ptg008855l,2867130,2867456,326,EVM,mRNA,2766529,3280365,326,1.00
ptg008855l,2905612,2905926,314,EVM,mRNA,2766529,3280365,314,1.00
ptg008855l,3140946,3141262,316,EVM,mRNA,2766529,3280365,316,1.00
ptg008856l,523992,524316,324,EVM,mRNA,387521,1143790,324,1.00
ptg008856l,524505,524854,349,EVM,mRNA,387521,1143790,349,1.00
ptg008856l,806933,807236,303,EVM,mRNA,387521,1143790,303,1.00
ptg008856l,2615704,2615998,294,EVM,mRNA,1852354,2640403,294,1.00
ptg008862l,1099596,1099894,298,EVM,mRNA,811273,1470142,298,1.00
ptg008866l,296238,296577,339,EVM,mRNA,34646,664428,339,1.00
ptg008868l,1246749,1247089,340,EVM,mRNA,1095523,1436413,340,1.00
ptg008877l,230937,231238,301,EVM,mRNA,32944,1133828,301,1.00
ptg008877l,257832,258127,295,EVM,mRNA,32944,1133828,295,1.00
ptg008877l,542735,542988,253,EVM,mRNA,32944,1133828,253,1.00
ptg008877l,835202,835463,261,EVM,mRNA,32944,1133828,261,1.00
ptg008880l,540414,540750,336,EVM,mRNA,270442,571811,336,1.00
ptg008883l,2186673,2186957,284,EVM,mRNA,2183611,2380530,284,1.00
ptg008884l,447896,448192,296,EVM,mRNA,442001,449617,296,1.00
ptg008884l,1136072,1136393,321,EVM,mRNA,1081360,1254459,321,1.00
ptg008886l,912561,912840,279,EVM,mRNA,634133,1117604,279,1.00
ptg008890l,1028774,1029070,296,EVM,mRNA,930142,1606943,296,1.00
ptg008895l,930399,930724,325,EVM,mRNA,842098,1143181,325,1.00
ptg008895l,1090646,1090938,292,EVM,mRNA,842098,1143181,292,1.00
ptg008906l,2145953,2146247,294,EVM,mRNA,29990,2266271,294,1.00
ptg008907l,195514,195796,282,EVM,mRNA,153193,505258,282,1.00
ptg008907l,503293,503592,299,EVM,mRNA,153193,505258,299,1.00
ptg008908l,517868,518158,290,EVM,mRNA,400692,545786,290,1.00
ptg008910l,507762,508061,299,EVM,mRNA,375603,590568,299,1.00
ptg008910l,1196836,1197164,328,EVM,mRNA,1086148,1207130,328,1.00
ptg008910l,1864286,1864558,272,EVM,mRNA,1315236,2151594,272,1.00
ptg008910l,2034446,2034754,308,EVM,mRNA,1315236,2151594,308,1.00
ptg008911l,206393,206691,298,EVM,mRNA,5235,990915,298,1.00
ptg008912l,626670,626976,306,EVM,mRNA,576191,878043,306,1.00
ptg008915l,1233714,1234036,322,EVM,mRNA,459263,1659860,322,1.00
ptg008915l,1353831,1354145,314,EVM,mRNA,459263,1659860,314,1.00
ptg008916l,72194,72493,299,EVM,mRNA,42570,255602,299,1.00
ptg008917l,924759,925072,313,EVM,mRNA,852779,1711767,313,1.00
ptg008921l,275354,275651,297,EVM,mRNA,80164,1402844,297,1.00
ptg008928l,1011549,1011829,280,EVM,mRNA,713289,1245904,280,1.00
ptg008928l,1120834,1121148,314,EVM,mRNA,713289,1245904,314,1.00
ptg008929l,395670,395964,294,EVM,mRNA,184995,695636,294,1.00
ptg008931l,2101867,2102180,313,EVM,mRNA,1794652,2799135,313,1.00
ptg008931l,2363314,2363631,317,EVM,mRNA,1794652,2799135,317,1.00
ptg008933l,630487,630782,295,EVM,mRNA,174000,1158583,295,1.00
ptg008934l,1512102,1512373,271,EVM,mRNA,397779,1542742,271,1.00
ptg008935l,22715,23024,309,EVM,mRNA,2546,225250,309,1.00
ptg008937l,1479897,1480161,264,EVM,mRNA,1212135,1818995,264,1.00
ptg008958l,886660,886957,297,EVM,mRNA,768871,1851135,297,1.00
ptg008963l,1877268,1877574,306,EVM,mRNA,1454473,2108874,306,1.00
ptg008969l,3421155,3421425,270,EVM,mRNA,2707029,3992610,270,1.00
ptg008973l,956221,956550,329,EVM,mRNA,928789,987613,329,1.00
ptg008974l,181419,181726,307,EVM,mRNA,86606,531179,307,1.00
ptg008982l,3363619,3363932,313,EVM,mRNA,3271779,3436513,313,1.00
ptg008990l,1181064,1181335,271,EVM,mRNA,193245,1343395,271,1.00
ptg008990l,1314301,1314600,299,EVM,mRNA,193245,1343395,299,1.00
ptg008990l,1965731,1966037,306,EVM,mRNA,1548516,2618543,306,1.00
ptg008991l,1679663,1679929,266,EVM,mRNA,1583523,1825248,266,1.00
ptg008991l,2063089,2063424,335,EVM,mRNA,2021349,2365335,335,1.00
ptg008992l,2741988,2742285,297,EVM,mRNA,2404247,3502103,297,1.00
ptg008998l,145684,145969,285,EVM,mRNA,9083,617429,285,1.00
ptg008998l,153694,153993,299,EVM,mRNA,9083,617429,299,1.00
ptg008999l,754127,754425,298,EVM,mRNA,212359,1059362,298,1.00
ptg009001l,1322268,1322587,319,EVM,mRNA,784636,1508785,319,1.00
ptg009012l,1003578,1003875,297,EVM,mRNA,919829,2711017,297,1.00
ptg009012l,1006894,1007222,328,EVM,mRNA,919829,2711017,328,1.00
ptg009012l,1207115,1207421,306,EVM,mRNA,919829,2711017,306,1.00
ptg009019l,537671,537986,315,EVM,mRNA,211744,919221,315,1.00
ptg009020l,1081666,1081960,294,EVM,mRNA,583212,1691112,294,1.00
ptg009028l,2328137,2328437,300,EVM,mRNA,1762739,2352244,300,1.00
ptg009028l,2572849,2573148,299,EVM,mRNA,2471116,2779180,299,1.00
ptg009029l,346900,347173,273,EVM,mRNA,331846,379979,273,1.00
ptg009029l,3259053,3259345,292,EVM,mRNA,689773,5012560,292,1.00
ptg009029l,3432420,3432748,328,EVM,mRNA,689773,5012560,328,1.00
ptg009029l,3564995,3565271,276,EVM,mRNA,689773,5012560,276,1.00
ptg009033l,116609,116910,301,EVM,mRNA,104426,520851,301,1.00
ptg009033l,290135,290442,307,EVM,mRNA,104426,520851,307,1.00
ptg009039l,152180,152501,321,EVM,mRNA,17320,505443,321,1.00
ptg009039l,1479449,1479745,296,EVM,mRNA,579350,1768165,296,1.00
ptg009039l,1505077,1505399,322,EVM,mRNA,579350,1768165,322,1.00
ptg009045l,1787685,1788008,323,EVM,mRNA,1605530,2229282,323,1.00
ptg009047l,919860,920150,290,EVM,mRNA,98123,1346565,290,1.00
ptg009047l,1174423,1174728,305,EVM,mRNA,98123,1346565,305,1.00
ptg009047l,1179766,1180056,290,EVM,mRNA,98123,1346565,290,1.00
ptg009048l,355239,355548,309,EVM,mRNA,124249,1609524,309,1.00
ptg009048l,379578,379874,296,EVM,mRNA,124249,1609524,296,1.00
ptg009048l,874884,875207,323,EVM,mRNA,124249,1609524,323,1.00
ptg009048l,962817,963123,306,EVM,mRNA,124249,1609524,306,1.00
ptg009048l,1005151,1005479,328,EVM,mRNA,124249,1609524,328,1.00
ptg009048l,1255321,1255589,268,EVM,mRNA,124249,1609524,268,1.00
ptg009048l,1357507,1357802,295,EVM,mRNA,124249,1609524,295,1.00
ptg009048l,1554554,1554888,334,EVM,mRNA,124249,1609524,334,1.00
ptg009060l,829440,829752,312,EVM,mRNA,662567,1049007,312,1.00
ptg009062l,667731,668050,319,EVM,mRNA,516312,1251697,319,1.00
ptg009064l,286241,286561,320,EVM,mRNA,225025,3017806,320,1.00
ptg009064l,615709,615959,250,EVM,mRNA,225025,3017806,250,1.00
ptg009064l,2546543,2546828,285,EVM,mRNA,225025,3017806,285,1.00
ptg009064l,2770448,2770757,309,EVM,mRNA,225025,3017806,309,1.00
ptg009065l,2152701,2152978,277,EVM,mRNA,2108376,2700716,277,1.00
ptg009065l,2172463,2172747,284,EVM,mRNA,2108376,2700716,284,1.00
ptg009078l,869197,869510,313,EVM,mRNA,835037,882855,313,1.00
ptg009080l,1237880,1238159,279,EVM,mRNA,1076041,1572674,279,1.00
ptg009082l,1428120,1428390,270,EVM,mRNA,707927,1465918,270,1.00
ptg009082l,2136479,2136748,269,EVM,mRNA,2041544,2242298,269,1.00
ptg009084l,1181025,1181314,289,EVM,mRNA,1035056,1227779,289,1.00
ptg009084l,1187964,1188244,280,EVM,mRNA,1035056,1227779,280,1.00
ptg009085l,1080301,1080580,279,EVM,mRNA,852870,1270941,279,1.00
ptg009086l,398457,398753,296,EVM,mRNA,55643,749203,296,1.00
ptg009088l,1428085,1428385,300,EVM,mRNA,1334946,1469106,300,1.00
ptg009091l,2250456,2250744,288,EVM,mRNA,1902703,3305954,288,1.00
ptg009091l,2616428,2616687,259,EVM,mRNA,1902703,3305954,259,1.00
ptg009107l,683957,684258,301,EVM,mRNA,664496,779155,301,1.00
ptg009107l,1919179,1919464,285,EVM,mRNA,985970,2209200,285,1.00
ptg009107l,2199208,2199502,294,EVM,mRNA,985970,2209200,294,1.00
ptg009120l,764099,764405,306,EVM,mRNA,405066,1070996,306,1.00
ptg009120l,1029176,1029473,297,EVM,mRNA,405066,1070996,297,1.00
ptg009120l,1422753,1423053,300,EVM,mRNA,1332169,1696238,300,1.00
ptg009121l,250685,250978,293,EVM,mRNA,214562,316733,293,1.00
ptg009121l,255548,255852,304,EVM,mRNA,214562,316733,304,1.00
ptg009124l,843149,843448,299,EVM,mRNA,600956,922998,299,1.00
ptg009125l,478854,479174,320,EVM,mRNA,247677,1066340,320,1.00
ptg009127l,521563,521842,279,EVM,mRNA,161955,775293,279,1.00
ptg009128l,641724,642005,281,EVM,mRNA,632953,656356,281,1.00
ptg009130l,844540,844839,299,EVM,mRNA,487552,1004527,299,1.00
ptg009133l,1051239,1051571,332,EVM,mRNA,691711,1164224,332,1.00
ptg009133l,1142385,1142697,312,EVM,mRNA,691711,1164224,312,1.00
ptg009143l,443519,443819,300,EVM,mRNA,221989,578232,300,1.00
ptg009150l,222904,223203,299,EVM,mRNA,182168,2194657,299,1.00
ptg009151l,1078696,1078998,302,EVM,mRNA,932911,1747226,302,1.00
ptg009161l,1141207,1141519,312,EVM,mRNA,382524,1475809,312,1.00
ptg009162l,24646,24965,319,EVM,mRNA,22801,1580226,319,1.00
ptg009162l,2319203,2319512,309,EVM,mRNA,1785461,3050727,309,1.00
ptg009169l,68054,68372,318,EVM,mRNA,11007,432646,318,1.00
ptg009169l,379862,380129,267,EVM,mRNA,11007,432646,267,1.00
ptg009171l,263531,263847,316,EVM,mRNA,47152,710830,316,1.00
ptg009171l,527203,527504,301,EVM,mRNA,47152,710830,301,1.00
ptg009171l,709110,709405,295,EVM,mRNA,47152,710830,295,1.00
ptg009173l,341011,341300,289,EVM,mRNA,2854,375115,289,1.00
ptg009178l,1569724,1570027,303,EVM,mRNA,1335491,2276322,303,1.00
ptg009178l,2152722,2153026,304,EVM,mRNA,1335491,2276322,304,1.00
ptg009179l,814021,814308,287,EVM,mRNA,52408,1091700,287,1.00
ptg009179l,1882621,1882914,293,EVM,mRNA,1132190,2994991,293,1.00
ptg009179l,1898690,1899003,313,EVM,mRNA,1132190,2994991,313,1.00
ptg009180l,1626438,1626724,286,EVM,mRNA,871483,1992134,286,1.00
ptg009182l,22865,23190,325,EVM,mRNA,1252,718877,325,1.00
ptg009187l,153484,153766,282,EVM,mRNA,135550,978830,282,1.00
ptg009187l,804930,805227,297,EVM,mRNA,135550,978830,297,1.00
ptg009188l,590549,590835,286,EVM,mRNA,543352,1926973,286,1.00
ptg009188l,1155951,1156247,296,EVM,mRNA,543352,1926973,296,1.00
ptg009188l,1190591,1190875,284,EVM,mRNA,543352,1926973,284,1.00
ptg009190l,690014,690300,286,EVM,mRNA,178531,2270480,286,1.00
ptg009190l,785958,786263,305,EVM,mRNA,178531,2270480,305,1.00
ptg009190l,1157578,1157865,287,EVM,mRNA,178531,2270480,287,1.00
ptg009190l,1297203,1297491,288,EVM,mRNA,178531,2270480,288,1.00
ptg009190l,2207768,2208076,308,EVM,mRNA,178531,2270480,308,1.00
ptg009197l,1564830,1565134,304,EVM,mRNA,1521604,2233185,304,1.00
ptg009201l,842754,843036,282,EVM,mRNA,808199,1112170,282,1.00
ptg009206l,2619972,2620266,294,EVM,mRNA,2203596,2943179,294,1.00
ptg009217l,392165,392479,314,EVM,mRNA,182908,500513,314,1.00
ptg009219l,2110668,2110961,293,EVM,mRNA,526582,2436565,293,1.00
ptg009221l,2111876,2112136,260,EVM,mRNA,2030250,2283044,260,1.00
ptg009221l,2137249,2137569,320,EVM,mRNA,2030250,2283044,320,1.00
ptg009221l,2222952,2223266,314,EVM,mRNA,2030250,2283044,314,1.00
ptg009223l,1327862,1328163,301,EVM,mRNA,41502,1446788,301,1.00
ptg009224l,1551702,1552018,316,EVM,mRNA,860577,5408342,316,1.00
ptg009224l,1670887,1671203,316,EVM,mRNA,860577,5408342,316,1.00
ptg009224l,2322257,2322545,288,EVM,mRNA,860577,5408342,288,1.00
ptg009224l,2918944,2919225,281,EVM,mRNA,860577,5408342,281,1.00
ptg009224l,4114583,4114901,318,EVM,mRNA,860577,5408342,318,1.00
ptg009224l,4922563,4922828,265,EVM,mRNA,860577,5408342,265,1.00
ptg009225l,1333477,1333745,268,EVM,mRNA,698103,1834906,268,1.00
ptg009226l,1436684,1436982,298,EVM,mRNA,1374797,1592877,298,1.00
ptg009227l,267917,268193,276,EVM,mRNA,263718,968872,276,1.00
ptg009229l,519560,519859,299,EVM,mRNA,225483,870924,299,1.00
ptg009233l,265209,265547,338,EVM,mRNA,44035,752854,338,1.00
ptg009234l,132517,132814,297,EVM,mRNA,32007,150807,297,1.00
ptg009235l,964373,964666,293,EVM,mRNA,173469,1241156,293,1.00
ptg009238l,1747453,1747748,295,EVM,mRNA,1714842,1782376,295,1.00
ptg009250l,435453,435761,308,EVM,mRNA,134943,631827,308,1.00
ptg009250l,1582170,1582463,293,EVM,mRNA,783781,2311816,293,1.00
ptg009250l,1826829,1827114,285,EVM,mRNA,783781,2311816,285,1.00
ptg009255l,1073508,1073831,323,EVM,mRNA,384483,4004544,323,1.00
ptg009255l,1094960,1095247,287,EVM,mRNA,384483,4004544,287,1.00
ptg009255l,3306293,3306624,331,EVM,mRNA,384483,4004544,331,1.00
ptg009255l,3423640,3423915,275,EVM,mRNA,384483,4004544,275,1.00
ptg009255l,3583689,3583951,262,EVM,mRNA,384483,4004544,262,1.00
ptg009255l,3872210,3872498,288,EVM,mRNA,384483,4004544,288,1.00
ptg009256l,753242,753524,282,EVM,mRNA,650737,754794,282,1.00
ptg009258l,296684,297004,320,EVM,mRNA,258565,708082,320,1.00
ptg009258l,1913089,1913385,296,EVM,mRNA,1373143,2038435,296,1.00
ptg009262l,667272,667580,308,EVM,mRNA,308,719589,308,1.00
ptg009262l,1303564,1303878,314,EVM,mRNA,1298197,2402159,314,1.00
ptg009262l,1679388,1679687,299,EVM,mRNA,1298197,2402159,299,1.00
ptg009262l,2042931,2043212,281,EVM,mRNA,1298197,2402159,281,1.00
ptg009262l,3202708,3202976,268,EVM,mRNA,3149785,3721721,268,1.00
ptg009271l,265359,265686,327,EVM,mRNA,85186,1316289,327,1.00
ptg009271l,460543,460847,304,EVM,mRNA,85186,1316289,304,1.00
ptg009277l,672362,672660,298,EVM,mRNA,358106,1541800,298,1.00
ptg009285l,1375201,1375497,296,EVM,mRNA,1043056,1751281,296,1.00
ptg009286l,951455,951784,329,EVM,mRNA,353544,1628420,329,1.00
ptg009287l,243525,243785,260,EVM,mRNA,134304,353700,260,1.00
ptg009288l,139203,139523,320,EVM,mRNA,37186,306530,320,1.00
ptg009288l,819930,820227,297,EVM,mRNA,562389,1648314,297,1.00
ptg009288l,1095317,1095630,313,EVM,mRNA,562389,1648314,313,1.00
ptg009288l,1125265,1125582,317,EVM,mRNA,562389,1648314,317,1.00
ptg009288l,1274415,1274715,300,EVM,mRNA,562389,1648314,300,1.00
ptg009298l,2687357,2687638,281,EVM,mRNA,2603954,3494474,281,1.00
ptg009298l,3107681,3107980,299,EVM,mRNA,2603954,3494474,299,1.00
ptg009298l,3213326,3213621,295,EVM,mRNA,2603954,3494474,295,1.00
ptg009300l,1324849,1325163,314,EVM,mRNA,859281,1949201,314,1.00
ptg009300l,1628920,1629206,286,EVM,mRNA,859281,1949201,286,1.00
ptg009309l,2145376,2145679,303,EVM,mRNA,749017,2173440,303,1.00
ptg009311l,372831,373158,327,EVM,mRNA,1121,630815,327,1.00
ptg009318l,2654937,2655219,282,EVM,mRNA,2612544,2825073,282,1.00
ptg009318l,3997299,3997574,275,EVM,mRNA,3595339,4783535,275,1.00
ptg009318l,5470913,5471208,295,EVM,mRNA,5329321,5575446,295,1.00
ptg009318l,5909405,5909668,263,EVM,mRNA,5591483,5936323,263,1.00
ptg009322l,878043,878335,292,EVM,mRNA,230819,1793370,292,1.00
ptg009323l,868229,868560,331,EVM,mRNA,356224,1564519,331,1.00
ptg009323l,1133731,1134027,296,EVM,mRNA,356224,1564519,296,1.00
ptg009323l,1136879,1137179,300,EVM,mRNA,356224,1564519,300,1.00
ptg009323l,1497039,1497298,259,EVM,mRNA,356224,1564519,259,1.00
ptg009323l,1519426,1519741,315,EVM,mRNA,356224,1564519,315,1.00
ptg009325l,753130,753445,315,EVM,mRNA,622465,1044524,315,1.00
ptg009325l,792991,793316,325,EVM,mRNA,622465,1044524,325,1.00
ptg009331l,404348,404633,285,EVM,mRNA,64676,2521865,285,1.00
ptg009331l,1024139,1024441,302,EVM,mRNA,64676,2521865,302,1.00
ptg009331l,1824327,1824646,319,EVM,mRNA,64676,2521865,319,1.00
ptg009331l,1993912,1994184,272,EVM,mRNA,64676,2521865,272,1.00
ptg009335l,758603,758889,286,EVM,mRNA,320174,906912,286,1.00
ptg009336l,296309,296636,327,EVM,mRNA,285091,304382,327,1.00
ptg009336l,1501788,1502108,320,EVM,mRNA,1090324,1801514,320,1.00
ptg009336l,1636440,1636763,323,EVM,mRNA,1090324,1801514,323,1.00
ptg009339l,1104198,1104452,254,EVM,mRNA,1077411,1206185,254,1.00
ptg009342l,218915,219214,299,EVM,mRNA,165378,660351,299,1.00
ptg009349l,2858518,2858781,263,EVM,mRNA,2765788,2950482,263,1.00
ptg009353l,89379,89683,304,EVM,mRNA,21777,101457,304,1.00
ptg009353l,1980486,1980806,320,EVM,mRNA,1948397,2063678,320,1.00
ptg009353l,2010952,2011230,278,EVM,mRNA,1948397,2063678,278,1.00
ptg009353l,2684088,2684413,325,EVM,mRNA,2374780,2703250,325,1.00
ptg009367l,374075,374378,303,EVM,mRNA,15080,779294,303,1.00
ptg009367l,890101,890400,299,EVM,mRNA,883052,1218879,299,1.00
ptg009367l,906791,907098,307,EVM,mRNA,883052,1218879,307,1.00
ptg009370l,1358483,1358789,306,EVM,mRNA,995855,5551067,306,1.00
ptg009370l,4007478,4007789,311,EVM,mRNA,995855,5551067,311,1.00
ptg009373l,1975537,1975816,279,EVM,mRNA,1891575,2029336,279,1.00
ptg009375l,1362678,1362977,299,EVM,mRNA,1075056,1613274,299,1.00
ptg009385l,542768,543051,283,EVM,mRNA,534656,1234683,283,1.00
ptg009385l,559827,560108,281,EVM,mRNA,534656,1234683,281,1.00
ptg009386l,10973,11236,263,EVM,mRNA,8930,235515,263,1.00
ptg009387l,2275679,2275990,311,EVM,mRNA,1245858,3743518,311,1.00
ptg009387l,2294465,2294756,291,EVM,mRNA,1245858,3743518,291,1.00
ptg009387l,2546697,2547024,327,EVM,mRNA,1245858,3743518,327,1.00
ptg009387l,3460875,3461183,308,EVM,mRNA,1245858,3743518,308,1.00
ptg009387l,4544266,4544565,299,EVM,mRNA,4258030,5189616,299,1.00
ptg009387l,4550349,4550641,292,EVM,mRNA,4258030,5189616,292,1.00
ptg009387l,4579120,4579423,303,EVM,mRNA,4258030,5189616,303,1.00
ptg009389l,442466,442761,295,EVM,mRNA,52012,771910,295,1.00
ptg009391l,244554,244846,292,EVM,mRNA,177248,1763486,292,1.00
ptg009391l,573237,573568,331,EVM,mRNA,177248,1763486,331,1.00
ptg009391l,767112,767411,299,EVM,mRNA,177248,1763486,299,1.00
ptg009391l,792927,793216,289,EVM,mRNA,177248,1763486,289,1.00
ptg009393l,1383818,1384139,321,EVM,mRNA,98599,2629256,321,1.00
ptg009394l,209843,210159,316,EVM,mRNA,114724,559848,316,1.00
ptg009404l,1032027,1032284,257,EVM,mRNA,679907,1527394,257,1.00
ptg009409l,1767166,1767436,270,EVM,mRNA,1704297,1857734,270,1.00
ptg009409l,1816065,1816371,306,EVM,mRNA,1704297,1857734,306,1.00
ptg009411l,1042187,1042482,295,EVM,mRNA,582886,1140377,295,1.00
ptg009423l,260557,260834,277,EVM,mRNA,1643,285733,277,1.00
ptg009423l,269568,269879,311,EVM,mRNA,1643,285733,311,1.00
ptg009433l,786023,786291,268,EVM,mRNA,679450,1158404,268,1.00
ptg009433l,905158,905472,314,EVM,mRNA,679450,1158404,314,1.00
ptg009433l,928547,928845,298,EVM,mRNA,679450,1158404,298,1.00
ptg009441l,1140080,1140394,314,EVM,mRNA,770270,1608303,314,1.00
ptg009441l,1454608,1454875,267,EVM,mRNA,770270,1608303,267,1.00
ptg009443l,208599,208897,298,EVM,mRNA,158944,305280,298,1.00
ptg009449l,458794,459092,298,EVM,mRNA,48557,1457481,298,1.00
ptg009449l,1096878,1097183,305,EVM,mRNA,48557,1457481,305,1.00
ptg009449l,1402800,1403089,289,EVM,mRNA,48557,1457481,289,1.00
ptg009451l,1004268,1004591,323,EVM,mRNA,881025,1315001,323,1.00
ptg009452l,2294677,2294987,310,EVM,mRNA,2035150,2469142,310,1.00
ptg009460l,55602,55875,273,EVM,mRNA,20205,853170,273,1.00
ptg009460l,358269,358546,277,EVM,mRNA,20205,853170,277,1.00
ptg009465l,1035820,1036113,293,EVM,mRNA,743686,1374151,293,1.00
ptg009465l,2600784,2601078,294,EVM,mRNA,2131972,2840392,294,1.00
ptg009470l,2715939,2716238,299,EVM,mRNA,2571274,2904989,299,1.00
ptg009471l,1734163,1734466,303,EVM,mRNA,1390430,1774726,303,1.00
ptg009473l,412956,413238,282,EVM,mRNA,140072,1419636,282,1.00
ptg009476l,518913,519243,330,EVM,mRNA,430453,1022777,330,1.00
ptg009481l,594979,595278,299,EVM,mRNA,4763,1121622,299,1.00
ptg009484l,257022,257340,318,EVM,mRNA,244704,866394,318,1.00
ptg009491l,340065,340340,275,EVM,mRNA,178837,1174020,275,1.00
ptg009491l,455445,455719,274,EVM,mRNA,178837,1174020,274,1.00
ptg009492l,2123128,2123402,274,EVM,mRNA,1649956,3003720,274,1.00
ptg009492l,2897618,2897902,284,EVM,mRNA,1649956,3003720,284,1.00
ptg009492l,3828233,3828511,278,EVM,mRNA,3295259,3950970,278,1.00
ptg009499l,2336979,2337298,319,EVM,mRNA,2034579,2384385,319,1.00
ptg009515l,139806,140082,276,EVM,mRNA,89512,706583,276,1.00
ptg009515l,580874,581168,294,EVM,mRNA,89512,706583,294,1.00
ptg009516l,375809,376123,314,EVM,mRNA,325617,818268,314,1.00
ptg009516l,543586,543872,286,EVM,mRNA,325617,818268,286,1.00
ptg009516l,2068436,2068751,315,EVM,mRNA,1955040,5211251,315,1.00
ptg009516l,3365906,3366195,289,EVM,mRNA,1955040,5211251,289,1.00
ptg009516l,3695271,3695570,299,EVM,mRNA,1955040,5211251,299,1.00
ptg009516l,3928654,3928981,327,EVM,mRNA,1955040,5211251,327,1.00
ptg009516l,4157357,4157656,299,EVM,mRNA,1955040,5211251,299,1.00
ptg009516l,4502072,4502367,295,EVM,mRNA,1955040,5211251,295,1.00
ptg009516l,6389718,6390017,299,EVM,mRNA,6271759,6940264,299,1.00
ptg009521l,315104,315401,297,EVM,mRNA,14,447549,297,1.00
ptg009521l,3611295,3611583,288,EVM,mRNA,3575000,3861989,288,1.00
ptg009521l,3735906,3736206,300,EVM,mRNA,3575000,3861989,300,1.00
ptg009528l,1186341,1186640,299,EVM,mRNA,742373,1253547,299,1.00
ptg009533l,1030804,1031090,286,EVM,mRNA,936748,1684056,286,1.00
ptg009533l,1172444,1172755,311,EVM,mRNA,936748,1684056,311,1.00
ptg009535l,2348071,2348371,300,EVM,mRNA,885298,2886362,300,1.00
ptg009535l,2656919,2657245,326,EVM,mRNA,885298,2886362,326,1.00
ptg009535l,5859448,5859751,303,EVM,mRNA,5720679,6515496,303,1.00
ptg009536l,579766,580068,302,EVM,mRNA,556443,702158,302,1.00
ptg009540l,228303,228589,286,EVM,mRNA,161877,566492,286,1.00
ptg009540l,711310,711619,309,EVM,mRNA,626877,959444,309,1.00
ptg009544l,274776,275074,298,EVM,mRNA,113223,299763,298,1.00
ptg009544l,281962,282244,282,EVM,mRNA,113223,299763,282,1.00
ptg009546l,1383228,1383525,297,EVM,mRNA,1280554,1973631,297,1.00
ptg009546l,1392259,1392556,297,EVM,mRNA,1280554,1973631,297,1.00
ptg009546l,1723732,1724033,301,EVM,mRNA,1280554,1973631,301,1.00
ptg009546l,1947641,1947919,278,EVM,mRNA,1280554,1973631,278,1.00
ptg009549l,1729215,1729481,266,EVM,mRNA,1722947,2042566,266,1.00
ptg009551l,370001,370307,306,EVM,mRNA,13414,1581626,306,1.00
ptg009551l,373734,374049,315,EVM,mRNA,13414,1581626,315,1.00
ptg009559l,127021,127302,281,EVM,mRNA,80028,536798,281,1.00
ptg009559l,315468,315767,299,EVM,mRNA,80028,536798,299,1.00
ptg009563l,206434,206739,305,EVM,mRNA,126935,340778,305,1.00
ptg009563l,513530,513825,295,EVM,mRNA,359869,835325,295,1.00
ptg009565l,1297838,1298158,320,EVM,mRNA,1233581,1346467,320,1.00
ptg009568l,1655200,1655474,274,EVM,mRNA,46739,1976090,274,1.00
ptg009568l,2448353,2448666,313,EVM,mRNA,2167819,2683201,313,1.00
ptg009573l,807752,808053,301,EVM,mRNA,800592,891265,301,1.00
ptg009579l,182094,182410,316,EVM,mRNA,68980,210752,316,1.00
ptg009582l,1209974,1210298,324,EVM,mRNA,952383,1509101,324,1.00
ptg009586l,563384,563704,320,EVM,mRNA,493060,613358,320,1.00
ptg009586l,595380,595658,278,EVM,mRNA,493060,613358,278,1.00
ptg009586l,1356457,1356744,287,EVM,mRNA,1112121,1641342,287,1.00
ptg009588l,432245,432538,293,EVM,mRNA,134661,524335,293,1.00
ptg009588l,512560,512843,283,EVM,mRNA,134661,524335,283,1.00
ptg009588l,1571267,1571565,298,EVM,mRNA,1459105,1761758,298,1.00
ptg009588l,1703287,1703604,317,EVM,mRNA,1459105,1761758,317,1.00
ptg009590l,362661,362961,300,EVM,mRNA,83049,377160,300,1.00
ptg009592l,2568586,2568892,306,EVM,mRNA,2562853,2904028,306,1.00
ptg009597l,364521,364819,298,EVM,mRNA,294398,894093,298,1.00
ptg009597l,743126,743442,316,EVM,mRNA,294398,894093,316,1.00
ptg009598l,1823451,1823749,298,EVM,mRNA,1695489,2262240,298,1.00
ptg009600l,212285,212584,299,EVM,mRNA,78708,871904,299,1.00
ptg009600l,247594,247901,307,EVM,mRNA,78708,871904,307,1.00
ptg009607l,448588,448882,294,EVM,mRNA,272572,812312,294,1.00
ptg009607l,633546,633857,311,EVM,mRNA,272572,812312,311,1.00
ptg009607l,682071,682360,289,EVM,mRNA,272572,812312,289,1.00
ptg009607l,1161616,1161900,284,EVM,mRNA,1067565,1416561,284,1.00
ptg009607l,1281422,1281739,317,EVM,mRNA,1067565,1416561,317,1.00
ptg009617l,268839,269136,297,EVM,mRNA,42005,500332,297,1.00
ptg009618l,620541,620853,312,EVM,mRNA,575877,758636,312,1.00
ptg009619l,799208,799512,304,EVM,mRNA,345951,1063396,304,1.00
ptg009619l,3163083,3163373,290,EVM,mRNA,2709709,3262776,290,1.00
ptg009621l,579883,580173,290,EVM,mRNA,573128,1063676,290,1.00
ptg009621l,622652,622946,294,EVM,mRNA,573128,1063676,294,1.00
ptg009621l,629838,630119,281,EVM,mRNA,573128,1063676,281,1.00
ptg009629l,1663755,1664060,305,EVM,mRNA,2915,2001779,305,1.00
ptg009632l,582167,582474,307,EVM,mRNA,473350,587659,307,1.00
ptg009633l,1436650,1436947,297,EVM,mRNA,1247189,1548212,297,1.00
ptg009638l,670140,670444,304,EVM,mRNA,580968,718318,304,1.00
ptg009643l,1549438,1549762,324,EVM,mRNA,1254080,1609648,324,1.00
ptg009643l,2705370,2705670,300,EVM,mRNA,2587419,3235117,300,1.00
ptg009646l,785319,785618,299,EVM,mRNA,51335,1584592,299,1.00
ptg009646l,1973868,1974156,288,EVM,mRNA,1847520,2092961,288,1.00
ptg009646l,5045474,5045782,308,EVM,mRNA,4680104,5781047,308,1.00
ptg009646l,6958526,6958824,298,EVM,mRNA,6063915,7823754,298,1.00
ptg009652l,2146690,2146988,298,EVM,mRNA,387461,2311190,298,1.00
ptg009652l,2607987,2608284,297,EVM,mRNA,2466999,2762724,297,1.00
ptg009652l,2709344,2709628,284,EVM,mRNA,2466999,2762724,284,1.00
ptg009653l,289575,289897,322,EVM,mRNA,163576,1271483,322,1.00
ptg009653l,633569,633874,305,EVM,mRNA,163576,1271483,305,1.00
ptg009656l,1670256,1670565,309,EVM,mRNA,838168,1859091,309,1.00
ptg009657l,225191,225476,285,EVM,mRNA,1090,499937,285,1.00
ptg009657l,329038,329317,279,EVM,mRNA,1090,499937,279,1.00
ptg009657l,384554,384848,294,EVM,mRNA,1090,499937,294,1.00
ptg009660l,164007,164336,329,EVM,mRNA,228,359786,329,1.00
ptg009660l,1635930,1636217,287,EVM,mRNA,736353,1906347,287,1.00
ptg009660l,1721856,1722193,337,EVM,mRNA,736353,1906347,337,1.00
ptg009664l,3687138,3687441,303,EVM,mRNA,2942186,5130463,303,1.00
ptg009667l,466337,466643,306,EVM,mRNA,388866,1008256,306,1.00
ptg009667l,661833,662167,334,EVM,mRNA,388866,1008256,334,1.00
ptg009667l,805093,805400,307,EVM,mRNA,388866,1008256,307,1.00
ptg009685l,2294438,2294735,297,EVM,mRNA,1504310,2402917,297,1.00
ptg009688l,1110499,1110825,326,EVM,mRNA,810089,1222878,326,1.00
ptg009693l,568707,569019,312,EVM,mRNA,195280,1934623,312,1.00
ptg009693l,641285,641582,297,EVM,mRNA,195280,1934623,297,1.00
ptg009693l,806162,806449,287,EVM,mRNA,195280,1934623,287,1.00
ptg009693l,1658273,1658587,314,EVM,mRNA,195280,1934623,314,1.00
ptg009693l,1862265,1862562,297,EVM,mRNA,195280,1934623,297,1.00
ptg009698l,1095257,1095554,297,EVM,mRNA,555738,1177426,297,1.00
ptg009700l,199684,200010,326,EVM,mRNA,45013,721515,326,1.00
ptg009700l,1228078,1228358,280,EVM,mRNA,1049088,1283745,280,1.00
ptg009700l,1256754,1257036,282,EVM,mRNA,1049088,1283745,282,1.00
ptg009700l,1257085,1257383,298,EVM,mRNA,1049088,1283745,298,1.00
ptg009701l,54900,55164,264,EVM,mRNA,221,69451,264,1.00
ptg009701l,1001291,1001610,319,EVM,mRNA,673806,1486685,319,1.00
ptg009701l,1214305,1214586,281,EVM,mRNA,673806,1486685,281,1.00
ptg009701l,1343805,1344096,291,EVM,mRNA,673806,1486685,291,1.00
ptg009705l,1739470,1739760,290,EVM,mRNA,1571187,1804697,290,1.00
ptg009710l,1616054,1616371,317,EVM,mRNA,1349656,1892308,317,1.00
ptg009713l,677030,677344,314,EVM,mRNA,279367,1928021,314,1.00
ptg009714l,207447,207745,298,EVM,mRNA,31476,455509,298,1.00
ptg009714l,1725815,1726112,297,EVM,mRNA,1327998,1771665,297,1.00
ptg009721l,1359559,1359827,268,EVM,mRNA,1255107,2881232,268,1.00
ptg009721l,2085063,2085397,334,EVM,mRNA,1255107,2881232,334,1.00
ptg009721l,2170257,2170529,272,EVM,mRNA,1255107,2881232,272,1.00
ptg009721l,2258810,2259116,306,EVM,mRNA,1255107,2881232,306,1.00
ptg009721l,2493576,2493886,310,EVM,mRNA,1255107,2881232,310,1.00
ptg009721l,2709324,2709610,286,EVM,mRNA,1255107,2881232,286,1.00
ptg009728l,702275,702578,303,EVM,mRNA,286659,1548294,303,1.00
ptg009731l,1867829,1868111,282,EVM,mRNA,1370971,2017817,282,1.00
ptg009732l,572538,572821,283,EVM,mRNA,491418,671291,283,1.00
ptg009732l,617068,617397,329,EVM,mRNA,491418,671291,329,1.00
ptg009748l,3184082,3184410,328,EVM,mRNA,963345,3825977,328,1.00
ptg009750l,1481136,1481431,295,EVM,mRNA,97120,1893834,295,1.00
ptg009752l,413947,414251,304,EVM,mRNA,370619,517321,304,1.00
ptg009755l,627024,627316,292,EVM,mRNA,624998,2545344,292,1.00
ptg009758l,185960,186255,295,EVM,mRNA,48403,827838,295,1.00
ptg009758l,239984,240283,299,EVM,mRNA,48403,827838,299,1.00
ptg009758l,1532577,1532861,284,EVM,mRNA,1480030,2968232,284,1.00
ptg009758l,2104089,2104388,299,EVM,mRNA,1480030,2968232,299,1.00
ptg009758l,2120042,2120342,300,EVM,mRNA,1480030,2968232,300,1.00
ptg009758l,2146007,2146306,299,EVM,mRNA,1480030,2968232,299,1.00
ptg009760l,945303,945618,315,EVM,mRNA,172742,1376963,315,1.00
ptg009762l,1420662,1420959,297,EVM,mRNA,175363,2597567,297,1.00
ptg009763l,307393,307698,305,EVM,mRNA,4295,373477,305,1.00
ptg009765l,529530,529854,324,EVM,mRNA,463965,713613,324,1.00
ptg009773l,737578,737900,322,EVM,mRNA,11654,942895,322,1.00
ptg009773l,822178,822495,317,EVM,mRNA,11654,942895,317,1.00
ptg009774l,1635805,1636089,284,EVM,mRNA,1613045,1688003,284,1.00
ptg009775l,918819,919101,282,EVM,mRNA,852343,1176372,282,1.00
ptg009778l,592269,592576,307,EVM,mRNA,962,874098,307,1.00
ptg009778l,635967,636243,276,EVM,mRNA,962,874098,276,1.00
ptg009779l,1065481,1065786,305,EVM,mRNA,947824,1289630,305,1.00
ptg009779l,1247088,1247366,278,EVM,mRNA,947824,1289630,278,1.00
ptg009785l,851327,851614,287,EVM,mRNA,822462,868840,287,1.00
ptg009791l,1013617,1013907,290,EVM,mRNA,580816,2246825,290,1.00
ptg009793l,436250,436556,306,EVM,mRNA,121677,3119890,306,1.00
ptg009793l,2899471,2899780,309,EVM,mRNA,121677,3119890,309,1.00
ptg009815l,1130168,1130427,259,EVM,mRNA,966340,1431005,259,1.00
ptg009816l,797114,797397,283,EVM,mRNA,10034,1175281,283,1.00
ptg009819l,510034,510350,316,EVM,mRNA,196254,788203,316,1.00
ptg009831l,737900,738213,313,EVM,mRNA,406361,1480170,313,1.00
ptg009832l,755411,755736,325,EVM,mRNA,513768,1753814,325,1.00
ptg009836l,1024704,1025009,305,EVM,mRNA,1024303,1067906,305,1.00
ptg009842l,542977,543303,326,EVM,mRNA,8480,923914,326,1.00
ptg009846l,228260,228564,304,EVM,mRNA,39812,360684,304,1.00
ptg009849l,315293,315614,321,EVM,mRNA,217826,468858,321,1.00
ptg009852l,693453,693768,315,EVM,mRNA,207259,1677241,315,1.00
ptg009852l,749327,749630,303,EVM,mRNA,207259,1677241,303,1.00
ptg009852l,973705,974034,329,EVM,mRNA,207259,1677241,329,1.00
ptg009852l,1475020,1475324,304,EVM,mRNA,207259,1677241,304,1.00
ptg009852l,1486558,1486862,304,EVM,mRNA,207259,1677241,304,1.00
ptg009852l,1598188,1598469,281,EVM,mRNA,207259,1677241,281,1.00
ptg009854l,570874,571173,299,EVM,mRNA,4789,931801,299,1.00
ptg009855l,1238004,1238292,288,EVM,mRNA,914454,2174373,288,1.00
ptg009855l,2048222,2048539,317,EVM,mRNA,914454,2174373,317,1.00
ptg009860l,498212,498545,333,EVM,mRNA,217,507930,333,1.00
ptg009861l,412209,412518,309,EVM,mRNA,59895,914486,309,1.00
ptg009862l,1814138,1814438,300,EVM,mRNA,1636282,1921350,300,1.00
ptg009869l,203184,203509,325,EVM,mRNA,77563,1097297,325,1.00
ptg009872l,1577359,1577670,311,EVM,mRNA,684899,1816755,311,1.00
ptg009877l,412273,412604,331,EVM,mRNA,383376,877186,331,1.00
ptg009877l,1113350,1113653,303,EVM,mRNA,950111,1221649,303,1.00
ptg009879l,3337550,3337856,306,EVM,mRNA,3298428,3432959,306,1.00
ptg009881l,1174834,1175140,306,EVM,mRNA,207828,1882306,306,1.00
ptg009884l,152358,152690,332,EVM,mRNA,6314,242707,332,1.00
ptg009884l,932847,933164,317,EVM,mRNA,402110,1152058,317,1.00
ptg009884l,1049448,1049723,275,EVM,mRNA,402110,1152058,275,1.00
ptg009884l,1082743,1083051,308,EVM,mRNA,402110,1152058,308,1.00
ptg009887l,2285278,2285581,303,EVM,mRNA,2143800,2446015,303,1.00
ptg009892l,642538,642796,258,EVM,mRNA,642315,768335,258,1.00
ptg009893l,478560,478870,310,EVM,mRNA,46933,2111595,310,1.00
ptg009893l,1722916,1723211,295,EVM,mRNA,46933,2111595,295,1.00
ptg009893l,1985557,1985874,317,EVM,mRNA,46933,2111595,317,1.00
ptg009898l,3591124,3591442,318,EVM,mRNA,3057026,3660526,318,1.00
ptg009913l,98037,98316,279,EVM,mRNA,1330,272562,279,1.00
ptg009913l,730771,731070,299,EVM,mRNA,709342,914343,299,1.00
ptg009913l,862160,862473,313,EVM,mRNA,709342,914343,313,1.00
ptg009915l,489258,489571,313,EVM,mRNA,327757,1082890,313,1.00
ptg009915l,512077,512358,281,EVM,mRNA,327757,1082890,281,1.00
ptg009915l,1067871,1068170,299,EVM,mRNA,327757,1082890,299,1.00
ptg009918l,901382,901677,295,EVM,mRNA,879852,1444190,295,1.00
ptg009918l,918595,918868,273,EVM,mRNA,879852,1444190,273,1.00
ptg009918l,1039176,1039465,289,EVM,mRNA,879852,1444190,289,1.00
ptg009918l,2139153,2139431,278,EVM,mRNA,1992712,2193104,278,1.00
ptg009919l,1217654,1217954,300,EVM,mRNA,798985,1864256,300,1.00
ptg009919l,1720819,1721126,307,EVM,mRNA,798985,1864256,307,1.00
ptg009919l,3012761,3013029,268,EVM,mRNA,2879692,3702136,268,1.00
ptg009925l,278890,279159,269,EVM,mRNA,83068,302036,269,1.00
ptg009928l,689254,689562,308,EVM,mRNA,17703,1311994,308,1.00
ptg009929l,439159,439465,306,EVM,mRNA,14745,1156402,306,1.00
ptg009931l,539514,539833,319,EVM,mRNA,163013,2842330,319,1.00
ptg009931l,2328781,2329084,303,EVM,mRNA,163013,2842330,303,1.00
ptg009945l,1754860,1755152,292,EVM,mRNA,1753297,2071390,292,1.00
ptg009945l,1835743,1836056,313,EVM,mRNA,1753297,2071390,313,1.00
ptg009945l,1864624,1864938,314,EVM,mRNA,1753297,2071390,314,1.00
ptg009948l,2005358,2005680,322,EVM,mRNA,1897216,2248289,322,1.00
ptg009954l,99014,99308,294,EVM,mRNA,22753,1360250,294,1.00
ptg009954l,621532,621852,320,EVM,mRNA,22753,1360250,320,1.00
ptg009962l,448496,448799,303,EVM,mRNA,410827,609405,303,1.00
ptg009962l,591244,591562,318,EVM,mRNA,410827,609405,318,1.00
ptg009979l,709336,709635,299,EVM,mRNA,346084,1031398,299,1.00
ptg009979l,1031321,1031645,324,EVM,mRNA,346084,1031398,77,0.24
ptg009984l,3902561,3902866,305,EVM,mRNA,1866363,3983525,305,1.00
ptg009984l,4358190,4358490,300,EVM,mRNA,4358387,4359115,104,0.35
ptg009989l,1093938,1094219,281,EVM,mRNA,229339,1094359,281,1.00
ptg009995l,604401,604686,285,EVM,mRNA,523114,655390,285,1.00
ptg009995l,1240827,1241122,295,EVM,mRNA,950484,2064810,295,1.00
ptg009995l,3149815,3150125,310,EVM,mRNA,2673163,3470312,310,1.00
ptg009996l,1146547,1146835,288,EVM,mRNA,683427,1183752,288,1.00
ptg009996l,1168862,1169165,303,EVM,mRNA,683427,1183752,303,1.00
ptg010000l,983645,983952,307,EVM,mRNA,722862,1064632,307,1.00
ptg010000l,1900356,1900648,292,EVM,mRNA,1900201,1901034,292,1.00
ptg010001l,1814490,1814797,307,EVM,mRNA,1656402,2919580,307,1.00
ptg010001l,2654730,2655054,324,EVM,mRNA,1656402,2919580,324,1.00
ptg010008l,2822483,2822784,301,EVM,mRNA,2819785,3062958,301,1.00
ptg010010l,3220208,3220520,312,EVM,mRNA,2957503,3764800,312,1.00
ptg010010l,3264708,3264995,287,EVM,mRNA,2957503,3764800,287,1.00
ptg010011l,1022209,1022497,288,EVM,mRNA,492657,1062783,288,1.00
ptg010014l,227178,227496,318,EVM,mRNA,10227,322331,318,1.00
ptg010015l,105858,106162,304,EVM,mRNA,29781,255936,304,1.00
ptg010028l,886460,886757,297,EVM,mRNA,677941,899468,297,1.00
ptg010031l,356441,356724,283,EVM,mRNA,7721,895345,283,1.00
ptg010042l,567001,567310,309,EVM,mRNA,2389,1854470,309,1.00
ptg010042l,1133755,1134043,288,EVM,mRNA,2389,1854470,288,1.00
ptg010043l,550129,550441,312,EVM,mRNA,540673,552321,312,1.00
ptg010047l,1513606,1513884,278,EVM,mRNA,1501158,1686990,278,1.00
ptg010047l,1682632,1682933,301,EVM,mRNA,1501158,1686990,301,1.00
ptg010049l,678197,678490,293,EVM,mRNA,674340,681773,293,1.00
ptg010061l,519038,519355,317,EVM,mRNA,457298,661147,317,1.00
ptg010063l,2932662,2932961,299,EVM,mRNA,2714508,4552635,299,1.00
ptg010063l,3129704,3130024,320,EVM,mRNA,2714508,4552635,320,1.00
ptg010063l,3145593,3145894,301,EVM,mRNA,2714508,4552635,301,1.00
ptg010063l,4164745,4165058,313,EVM,mRNA,2714508,4552635,313,1.00
ptg010067l,280828,281138,310,EVM,mRNA,217985,477024,310,1.00
ptg010067l,403214,403529,315,EVM,mRNA,217985,477024,315,1.00
ptg010068l,681072,681371,299,EVM,mRNA,415073,963595,299,1.00
ptg010077l,561848,562152,304,EVM,mRNA,531435,1272475,304,1.00
ptg010080l,974703,974975,272,EVM,mRNA,908107,1708558,272,1.00
ptg010080l,1055314,1055623,309,EVM,mRNA,908107,1708558,309,1.00
ptg010080l,1457613,1457920,307,EVM,mRNA,908107,1708558,307,1.00
ptg010085l,1304153,1304456,303,EVM,mRNA,1300285,1686963,303,1.00
ptg010085l,2416078,2416406,328,EVM,mRNA,2410507,2426066,328,1.00
ptg010086l,687483,687796,313,EVM,mRNA,198855,2324396,313,1.00
ptg010088l,306848,307146,298,EVM,mRNA,12063,654207,298,1.00
ptg010088l,506958,507270,312,EVM,mRNA,12063,654207,312,1.00
ptg010088l,5135350,5135655,305,EVM,mRNA,5039412,5337213,305,1.00
ptg010088l,5282132,5282427,295,EVM,mRNA,5039412,5337213,295,1.00
ptg010092l,1069219,1069531,312,EVM,mRNA,601896,1158797,312,1.00
ptg010094l,442526,442838,312,EVM,mRNA,45800,639674,312,1.00
ptg010095l,214122,214431,309,EVM,mRNA,47907,1038512,309,1.00
ptg010096l,2133112,2133425,313,EVM,mRNA,53097,2226623,313,1.00
ptg010097l,371152,371428,276,EVM,mRNA,164931,1158487,276,1.00
ptg010102l,904935,905248,313,EVM,mRNA,757258,1105150,313,1.00
ptg010106l,1411744,1412057,313,EVM,mRNA,1258259,1952708,313,1.00
ptg010110l,158269,158557,288,EVM,mRNA,2129,444533,288,1.00
ptg010111l,1672329,1672636,307,EVM,mRNA,1653274,1740931,307,1.00
ptg010124l,42584,42854,270,EVM,mRNA,13036,174836,270,1.00
ptg010129l,1514850,1515127,277,EVM,mRNA,1424591,2170700,277,1.00
ptg010129l,4194870,4195176,306,EVM,mRNA,4157722,4318827,306,1.00
ptg010129l,4309905,4310210,305,EVM,mRNA,4157722,4318827,305,1.00
ptg010130l,1210004,1210328,324,EVM,mRNA,1017477,2380207,324,1.00
ptg010130l,1680981,1681265,284,EVM,mRNA,1017477,2380207,284,1.00
ptg010130l,1957090,1957381,291,EVM,mRNA,1017477,2380207,291,1.00
ptg010138l,259494,259788,294,EVM,mRNA,159281,806502,294,1.00
ptg010139l,528277,528603,326,EVM,mRNA,166356,528935,326,1.00
ptg010139l,2231208,2231508,300,EVM,mRNA,1182819,2710381,300,1.00
ptg010139l,2397327,2397599,272,EVM,mRNA,1182819,2710381,272,1.00
ptg010141l,4314199,4314500,301,EVM,mRNA,3840722,4658078,301,1.00
ptg010141l,4639155,4639472,317,EVM,mRNA,3840722,4658078,317,1.00
ptg010144l,1091760,1092030,270,EVM,mRNA,897692,1171424,270,1.00
ptg010147l,1527199,1527479,280,EVM,mRNA,1201777,1527338,139,0.50
ptg010151l,1366246,1366527,281,EVM,mRNA,27632,1405006,281,1.00
ptg010154l,1327008,1327300,292,EVM,mRNA,1313610,1385721,292,1.00
ptg010156l,1434902,1435204,302,EVM,mRNA,955382,1710122,302,1.00
ptg010158l,156144,156479,335,EVM,mRNA,47395,179333,335,1.00
ptg010161l,1960637,1960918,281,EVM,mRNA,1471449,2104670,281,1.00
ptg010168l,824761,825056,295,EVM,mRNA,626584,878603,295,1.00
ptg010171l,844423,844726,303,EVM,mRNA,293373,853067,303,1.00
ptg010193l,935045,935337,292,EVM,mRNA,278566,996023,292,1.00
ptg010194l,2093484,2093770,286,EVM,mRNA,2033987,2310114,286,1.00
ptg010197l,987993,988265,272,EVM,mRNA,242786,1210895,272,1.00
ptg010198l,678734,679044,310,EVM,mRNA,326094,746233,310,1.00
ptg010201l,1579831,1580122,291,EVM,mRNA,1563342,2081853,291,1.00
ptg010201l,2598093,2598375,282,EVM,mRNA,2574282,2726913,282,1.00
ptg010202l,604761,605073,312,EVM,mRNA,563626,1197160,312,1.00
ptg010210l,1160290,1160596,306,EVM,mRNA,592605,1930857,306,1.00
ptg010213l,203629,203941,312,EVM,mRNA,163053,269257,312,1.00
ptg010213l,1484239,1484533,294,EVM,mRNA,598676,1536482,294,1.00
ptg010216l,910650,910964,314,EVM,mRNA,342420,1432572,314,1.00
ptg010223l,630360,630640,280,EVM,mRNA,279276,1151321,280,1.00
ptg010223l,655844,656175,331,EVM,mRNA,279276,1151321,331,1.00
ptg010223l,796844,797157,313,EVM,mRNA,279276,1151321,313,1.00
ptg010224l,1644735,1645026,291,EVM,mRNA,1530420,1730234,291,1.00
ptg010226l,288466,288756,290,EVM,mRNA,15135,659855,290,1.00
ptg010226l,461777,462073,296,EVM,mRNA,15135,659855,296,1.00
ptg010226l,1038084,1038406,322,EVM,mRNA,946516,1244113,322,1.00
ptg010230l,135953,136255,302,EVM,mRNA,1147,305150,302,1.00
ptg010230l,221690,221973,283,EVM,mRNA,1147,305150,283,1.00
ptg010230l,955919,956225,306,EVM,mRNA,556220,1103158,306,1.00
ptg010230l,1410369,1410666,297,EVM,mRNA,1323159,1829137,297,1.00
ptg010242l,1149872,1150183,311,EVM,mRNA,1146305,1834506,311,1.00
ptg010242l,1615892,1616162,270,EVM,mRNA,1146305,1834506,270,1.00
ptg010244l,1157601,1157906,305,EVM,mRNA,1104914,1375764,305,1.00
ptg010244l,1618454,1618745,291,EVM,mRNA,1477021,1687727,291,1.00
ptg010248l,2308400,2308693,293,EVM,mRNA,2226082,2358118,293,1.00
ptg010249l,649674,649980,306,EVM,mRNA,170462,762916,306,1.00
ptg010249l,1632004,1632318,314,EVM,mRNA,921332,1909843,314,1.00
ptg010249l,1691851,1692183,332,EVM,mRNA,921332,1909843,332,1.00
ptg010251l,3210700,3211009,309,EVM,mRNA,2257427,3624871,309,1.00
ptg010254l,257319,257603,284,EVM,mRNA,219477,810437,284,1.00
ptg010254l,607260,607587,327,EVM,mRNA,219477,810437,327,1.00
ptg010261l,64589,64908,319,EVM,mRNA,28203,163110,319,1.00
ptg010261l,682008,682318,310,EVM,mRNA,596257,875853,310,1.00
ptg010261l,846132,846438,306,EVM,mRNA,596257,875853,306,1.00
ptg010264l,2130575,2130880,305,EVM,mRNA,1844238,2183290,305,1.00
ptg010266l,178173,178436,263,EVM,mRNA,126410,261935,263,1.00
ptg010272l,1045291,1045567,276,EVM,mRNA,855639,1076998,276,1.00
ptg010276l,348148,348463,315,EVM,mRNA,117294,674844,315,1.00
ptg010285l,387507,387781,274,EVM,mRNA,27141,1061383,274,1.00
ptg010285l,400804,401099,295,EVM,mRNA,27141,1061383,295,1.00
ptg010292l,81024,81309,285,EVM,mRNA,39607,228675,285,1.00
ptg010292l,422124,422442,318,EVM,mRNA,348734,465599,318,1.00
ptg010297l,509306,509609,303,EVM,mRNA,52,677422,303,1.00
ptg010304l,580074,580354,280,EVM,mRNA,444594,1278378,280,1.00
ptg010304l,792675,793004,329,EVM,mRNA,444594,1278378,329,1.00
ptg010304l,861470,861753,283,EVM,mRNA,444594,1278378,283,1.00
ptg010304l,970174,970464,290,EVM,mRNA,444594,1278378,290,1.00
ptg010304l,976920,977208,288,EVM,mRNA,444594,1278378,288,1.00
ptg010322l,1411639,1411945,306,EVM,mRNA,656944,2048003,306,1.00
ptg010325l,1340930,1341229,299,EVM,mRNA,774535,4537136,299,1.00
ptg010325l,1350747,1351058,311,EVM,mRNA,774535,4537136,311,1.00
ptg010325l,1422772,1423068,296,EVM,mRNA,774535,4537136,296,1.00
ptg010325l,3501215,3501504,289,EVM,mRNA,774535,4537136,289,1.00
ptg010325l,3629807,3630104,297,EVM,mRNA,774535,4537136,297,1.00
ptg010325l,4202479,4202769,290,EVM,mRNA,774535,4537136,290,1.00
ptg010332l,890867,891180,313,EVM,mRNA,436456,1021487,313,1.00
ptg010340l,1724287,1724567,280,EVM,mRNA,1526713,2404662,280,1.00
ptg010340l,1967943,1968256,313,EVM,mRNA,1526713,2404662,313,1.00
ptg010340l,1975973,1976287,314,EVM,mRNA,1526713,2404662,314,1.00
ptg010340l,2203552,2203867,315,EVM,mRNA,1526713,2404662,315,1.00
ptg010343l,320702,321020,318,EVM,mRNA,30561,960341,318,1.00
ptg010349l,345955,346249,294,EVM,mRNA,16,580092,294,1.00
ptg010354l,561979,562260,281,EVM,mRNA,194054,1232003,281,1.00
ptg010359l,1553913,1554211,298,EVM,mRNA,1495987,1669190,298,1.00
ptg010363l,992585,992881,296,EVM,mRNA,767289,1372486,296,1.00
ptg010363l,1018101,1018349,248,EVM,mRNA,767289,1372486,248,1.00
ptg010364l,52726,53025,299,EVM,mRNA,48347,571962,299,1.00
ptg010368l,260292,260580,288,EVM,mRNA,81144,315635,288,1.00
ptg010372l,1101633,1101958,325,EVM,mRNA,767606,1130849,325,1.00
ptg010374l,1640256,1640523,267,EVM,mRNA,45589,1924614,267,1.00
ptg010382l,374058,374370,312,EVM,mRNA,269515,4295384,312,1.00
ptg010382l,1086469,1086768,299,EVM,mRNA,269515,4295384,299,1.00
ptg010382l,1461940,1462249,309,EVM,mRNA,269515,4295384,309,1.00
ptg010382l,1699576,1699875,299,EVM,mRNA,269515,4295384,299,1.00
ptg010382l,2361476,2361788,312,EVM,mRNA,269515,4295384,312,1.00
ptg010382l,3028438,3028768,330,EVM,mRNA,269515,4295384,330,1.00
ptg010382l,3948954,3949252,298,EVM,mRNA,269515,4295384,298,1.00
ptg010388l,841086,841385,299,EVM,mRNA,384211,940080,299,1.00
ptg010398l,1987214,1987509,295,EVM,mRNA,1865949,3046418,295,1.00
ptg010398l,1996647,1996946,299,EVM,mRNA,1865949,3046418,299,1.00
ptg010398l,2041776,2042071,295,EVM,mRNA,1865949,3046418,295,1.00
ptg010398l,2920202,2920503,301,EVM,mRNA,1865949,3046418,301,1.00
ptg010405l,1051817,1052119,302,EVM,mRNA,837788,1123082,302,1.00
ptg010407l,679277,679593,316,EVM,mRNA,14,1257773,316,1.00
ptg010407l,1123687,1123957,270,EVM,mRNA,14,1257773,270,1.00
ptg010408l,199887,200168,281,EVM,mRNA,169971,220207,281,1.00
ptg010415l,4730806,4731084,278,EVM,mRNA,4234026,5045656,278,1.00
ptg010415l,4778799,4779083,284,EVM,mRNA,4234026,5045656,284,1.00
ptg010415l,4995770,4996053,283,EVM,mRNA,4234026,5045656,283,1.00
ptg010416l,368761,369074,313,EVM,mRNA,252450,394676,313,1.00
ptg010416l,1760379,1760668,289,EVM,mRNA,1643007,2640213,289,1.00
ptg010426l,412797,413078,281,EVM,mRNA,11219,444057,281,1.00
ptg010426l,419983,420266,283,EVM,mRNA,11219,444057,283,1.00
ptg010427l,1018486,1018768,282,EVM,mRNA,722667,1718091,282,1.00
ptg010427l,1111030,1111316,286,EVM,mRNA,722667,1718091,286,1.00
ptg010427l,1682594,1682899,305,EVM,mRNA,722667,1718091,305,1.00
ptg010428l,218558,218854,296,EVM,mRNA,66090,282504,296,1.00
ptg010435l,1855792,1856104,312,EVM,mRNA,1834856,2149194,312,1.00
ptg010438l,3482284,3482614,330,EVM,mRNA,2924854,3727676,330,1.00
ptg010446l,886018,886316,298,EVM,mRNA,191034,1569420,298,1.00
ptg010446l,1102523,1102832,309,EVM,mRNA,191034,1569420,309,1.00
ptg010449l,173674,173989,315,EVM,mRNA,133693,299275,315,1.00
ptg010450l,87170,87442,272,EVM,mRNA,58294,484382,272,1.00
ptg010452l,1150158,1150451,293,EVM,mRNA,391606,1324319,293,1.00
ptg010459l,842449,842734,285,EVM,mRNA,119033,1032340,285,1.00
ptg010459l,869677,869979,302,EVM,mRNA,119033,1032340,302,1.00
ptg010460l,325635,325932,297,EVM,mRNA,274316,352047,297,1.00
ptg010460l,736902,737156,254,EVM,mRNA,620763,745319,254,1.00
ptg010464l,1832129,1832454,325,EVM,mRNA,265300,2349540,325,1.00
ptg010464l,2076466,2076744,278,EVM,mRNA,265300,2349540,278,1.00
ptg010464l,2078036,2078358,322,EVM,mRNA,265300,2349540,322,1.00
ptg010464l,3080073,3080372,299,EVM,mRNA,2808594,4586836,299,1.00
ptg010464l,4348411,4348696,285,EVM,mRNA,2808594,4586836,285,1.00
ptg010469l,410304,410622,318,EVM,mRNA,405744,764973,318,1.00
ptg010469l,683461,683760,299,EVM,mRNA,405744,764973,299,1.00
ptg010472l,1152619,1152911,292,EVM,mRNA,1149747,1443370,292,1.00
ptg010472l,1900078,1900396,318,EVM,mRNA,1522401,2282442,318,1.00
ptg010472l,2020915,2021172,257,EVM,mRNA,1522401,2282442,257,1.00
ptg010472l,2125967,2126280,313,EVM,mRNA,1522401,2282442,313,1.00
ptg010472l,2131329,2131613,284,EVM,mRNA,1522401,2282442,284,1.00
ptg010473l,1232459,1232763,304,EVM,mRNA,142434,1335457,304,1.00
ptg010484l,1980836,1981135,299,EVM,mRNA,1284295,1986505,299,1.00
ptg010485l,213009,213299,290,EVM,mRNA,209830,874149,290,1.00
ptg010485l,447398,447664,266,EVM,mRNA,209830,874149,266,1.00
ptg010488l,134898,135215,317,EVM,mRNA,72719,186058,317,1.00
ptg010496l,147006,147309,303,EVM,mRNA,50600,861303,303,1.00
ptg010496l,206264,206577,313,EVM,mRNA,50600,861303,313,1.00
ptg010502l,617089,617390,301,EVM,mRNA,610144,631260,301,1.00
ptg010517l,2307542,2307841,299,EVM,mRNA,2002118,2906663,299,1.00
ptg010518l,1911572,1911872,300,EVM,mRNA,1716479,3490280,300,1.00
ptg010519l,260060,260331,271,EVM,mRNA,183416,1240255,271,1.00
ptg010519l,1070850,1071145,295,EVM,mRNA,183416,1240255,295,1.00
ptg010522l,150039,150357,318,EVM,mRNA,150090,1149426,268,0.84
ptg010522l,222428,222733,305,EVM,mRNA,150090,1149426,305,1.00
ptg010522l,708719,709002,283,EVM,mRNA,150090,1149426,283,1.00
ptg010523l,56347,56489,142,EVM,mRNA,26710,209294,142,1.00
ptg010528l,705825,706100,275,EVM,mRNA,9503,1994135,275,1.00
ptg010528l,1145863,1146147,284,EVM,mRNA,9503,1994135,284,1.00
ptg010528l,3404061,3404338,277,EVM,mRNA,2465296,3459204,277,1.00
ptg010531l,740948,741263,315,EVM,mRNA,624292,847722,315,1.00
ptg010531l,1022117,1022430,313,EVM,mRNA,849202,1024827,313,1.00
ptg010532l,1045560,1045869,309,EVM,mRNA,1007469,1141394,309,1.00
ptg010535l,1031875,1032192,317,EVM,mRNA,1020757,1413690,317,1.00
ptg010544l,233885,234187,302,EVM,mRNA,178384,1267525,302,1.00
ptg010544l,338589,338899,310,EVM,mRNA,178384,1267525,310,1.00
ptg010544l,560395,560537,142,EVM,mRNA,178384,1267525,142,1.00
ptg010544l,862091,862407,316,EVM,mRNA,178384,1267525,316,1.00
ptg010548l,1380221,1380516,295,EVM,mRNA,1371744,3698796,295,1.00
ptg010548l,2494619,2494907,288,EVM,mRNA,1371744,3698796,288,1.00
ptg010548l,3205893,3206205,312,EVM,mRNA,1371744,3698796,312,1.00
ptg010548l,3450736,3450997,261,EVM,mRNA,1371744,3698796,261,1.00
ptg010548l,3521998,3522287,289,EVM,mRNA,1371744,3698796,289,1.00
ptg010552l,97156,97483,327,EVM,mRNA,11530,2976067,327,1.00
ptg010552l,99444,99712,268,EVM,mRNA,11530,2976067,268,1.00
ptg010552l,133035,133366,331,EVM,mRNA,11530,2976067,331,1.00
ptg010552l,201557,201861,304,EVM,mRNA,11530,2976067,304,1.00
ptg010552l,773188,773500,312,EVM,mRNA,11530,2976067,312,1.00
ptg010552l,970420,970701,281,EVM,mRNA,11530,2976067,281,1.00
ptg010552l,1142556,1142869,313,EVM,mRNA,11530,2976067,313,1.00
ptg010552l,1146256,1146565,309,EVM,mRNA,11530,2976067,309,1.00
ptg010552l,1488661,1488954,293,EVM,mRNA,11530,2976067,293,1.00
ptg010552l,2329087,2329388,301,EVM,mRNA,11530,2976067,301,1.00
ptg010563l,538172,538474,302,EVM,mRNA,325740,1131418,302,1.00
ptg010563l,695491,695787,296,EVM,mRNA,325740,1131418,296,1.00
ptg010573l,266246,266559,313,EVM,mRNA,160331,301976,313,1.00
ptg010573l,1983635,1983926,291,EVM,mRNA,1702115,2235381,291,1.00
ptg010573l,2506041,2506336,295,EVM,mRNA,2346008,2936301,295,1.00
ptg010574l,2167634,2167971,337,EVM,mRNA,129988,2435507,337,1.00
ptg010574l,2290214,2290493,279,EVM,mRNA,129988,2435507,279,1.00
ptg010576l,303687,304002,315,EVM,mRNA,1397,495461,315,1.00
ptg010581l,994505,994809,304,EVM,mRNA,848856,1133164,304,1.00
ptg010585l,1523551,1523842,291,EVM,mRNA,217315,1932665,291,1.00
ptg010588l,2155051,2155367,316,EVM,mRNA,1833660,2745871,316,1.00
ptg010588l,2655420,2655745,325,EVM,mRNA,1833660,2745871,325,1.00
ptg010588l,2696655,2696981,326,EVM,mRNA,1833660,2745871,326,1.00
ptg010593l,305076,305349,273,EVM,mRNA,136929,859648,273,1.00
ptg010597l,543479,543759,280,EVM,mRNA,331101,959176,280,1.00
ptg010599l,1165564,1165880,316,EVM,mRNA,532138,1622690,316,1.00
ptg010599l,1284166,1284483,317,EVM,mRNA,532138,1622690,317,1.00
ptg010613l,2212271,2212574,303,EVM,mRNA,2617,2647361,303,1.00
ptg010613l,3005897,3006209,312,EVM,mRNA,2972440,3035133,312,1.00
ptg010613l,3017925,3018226,301,EVM,mRNA,2972440,3035133,301,1.00
ptg010619l,1261261,1261564,303,EVM,mRNA,4643,1502728,303,1.00
ptg010619l,1428621,1428901,280,EVM,mRNA,4643,1502728,280,1.00
ptg010621l,178575,178879,304,EVM,mRNA,19959,1847668,304,1.00
ptg010621l,709033,709315,282,EVM,mRNA,19959,1847668,282,1.00
ptg010621l,986694,986996,302,EVM,mRNA,19959,1847668,302,1.00
ptg010621l,1135921,1136212,291,EVM,mRNA,19959,1847668,291,1.00
ptg010621l,1407703,1408009,306,EVM,mRNA,19959,1847668,306,1.00
ptg010622l,643720,644021,301,EVM,mRNA,597005,719041,301,1.00
ptg010624l,227211,227535,324,EVM,mRNA,142671,604461,324,1.00
ptg010624l,594219,594503,284,EVM,mRNA,142671,604461,284,1.00
ptg010625l,2571014,2571313,299,EVM,mRNA,1191022,2639095,299,1.00
ptg010629l,370962,371277,315,EVM,mRNA,243638,405430,315,1.00
ptg010630l,738054,738347,293,EVM,mRNA,544660,978600,293,1.00
ptg010630l,841532,841807,275,EVM,mRNA,544660,978600,275,1.00
ptg010630l,906536,906836,300,EVM,mRNA,544660,978600,300,1.00
ptg010637l,1394279,1394612,333,EVM,mRNA,1346436,1562424,333,1.00
ptg010638l,512869,513190,321,EVM,mRNA,2057,661460,321,1.00
ptg010642l,684127,684439,312,EVM,mRNA,383441,853873,312,1.00
ptg010646l,1803242,1803541,299,EVM,mRNA,1741365,1833017,299,1.00
ptg010647l,1213930,1214238,308,EVM,mRNA,918930,1434005,308,1.00
ptg010647l,1319849,1320177,328,EVM,mRNA,918930,1434005,328,1.00
ptg010649l,866427,866743,316,EVM,mRNA,700783,934132,316,1.00
ptg010651l,205238,205558,320,EVM,mRNA,19703,289980,320,1.00
ptg010651l,245786,246085,299,EVM,mRNA,19703,289980,299,1.00
ptg010653l,467438,467726,288,EVM,mRNA,431192,680116,288,1.00
ptg010654l,62420,62717,297,EVM,mRNA,3,93498,297,1.00
ptg010659l,283033,283340,307,EVM,mRNA,233008,587421,307,1.00
ptg010665l,796940,797252,312,EVM,mRNA,35763,2046470,312,1.00
ptg010665l,3036681,3036979,298,EVM,mRNA,3015189,3155460,298,1.00
ptg010665l,4604426,4604737,311,EVM,mRNA,4166323,4876868,311,1.00
ptg010672l,223345,223626,281,EVM,mRNA,195271,1188961,281,1.00
ptg010672l,477938,478226,288,EVM,mRNA,195271,1188961,288,1.00
ptg010672l,521073,521366,293,EVM,mRNA,195271,1188961,293,1.00
ptg010672l,585428,585744,316,EVM,mRNA,195271,1188961,316,1.00
ptg010678l,596164,596481,317,EVM,mRNA,464751,1850185,317,1.00
ptg010678l,946960,947284,324,EVM,mRNA,464751,1850185,324,1.00
ptg010678l,964191,964473,282,EVM,mRNA,464751,1850185,282,1.00
ptg010678l,1061102,1061419,317,EVM,mRNA,464751,1850185,317,1.00
ptg010678l,1188271,1188578,307,EVM,mRNA,464751,1850185,307,1.00
ptg010678l,1418631,1418957,326,EVM,mRNA,464751,1850185,326,1.00
ptg010678l,1701339,1701635,296,EVM,mRNA,464751,1850185,296,1.00
ptg010678l,3499014,3499308,294,EVM,mRNA,2447867,4246698,294,1.00
ptg010678l,4039645,4039956,311,EVM,mRNA,2447867,4246698,311,1.00
ptg010678l,4191069,4191395,326,EVM,mRNA,2447867,4246698,326,1.00
ptg010681l,1234686,1234967,281,EVM,mRNA,964049,1774105,281,1.00
ptg010682l,752414,752718,304,EVM,mRNA,20976,1430870,304,1.00
ptg010684l,500534,500826,292,EVM,mRNA,5356,795656,292,1.00
ptg010684l,532229,532544,315,EVM,mRNA,5356,795656,315,1.00
ptg010684l,691065,691368,303,EVM,mRNA,5356,795656,303,1.00
ptg010684l,754997,755301,304,EVM,mRNA,5356,795656,304,1.00
ptg010685l,329137,329418,281,EVM,mRNA,323216,423644,281,1.00
ptg010687l,1218860,1219151,291,EVM,mRNA,1155341,1399602,291,1.00
ptg010688l,734523,734809,286,EVM,mRNA,4501,1240995,286,1.00
ptg010697l,496515,496798,283,EVM,mRNA,346933,742141,283,1.00
ptg010698l,1365462,1365747,285,EVM,mRNA,1262875,2615385,285,1.00
ptg010698l,2561053,2561349,296,EVM,mRNA,1262875,2615385,296,1.00
ptg010698l,3021092,3021408,316,EVM,mRNA,3014455,3167555,316,1.00
ptg010698l,3933403,3933681,278,EVM,mRNA,3236609,4047546,278,1.00
ptg010699l,2472188,2472480,292,EVM,mRNA,2263813,2750643,292,1.00
ptg010701l,461212,461512,300,EVM,mRNA,167123,643810,300,1.00
ptg010706l,231218,231545,327,EVM,mRNA,1899,843392,327,1.00
ptg010706l,554661,554978,317,EVM,mRNA,1899,843392,317,1.00
ptg010710l,41020,41315,295,EVM,mRNA,10578,1198278,295,1.00
ptg010711l,2974026,2974340,314,EVM,mRNA,2836682,3217520,314,1.00
ptg010719l,868491,868799,308,EVM,mRNA,426067,1101778,308,1.00
ptg010720l,3108821,3109102,281,EVM,mRNA,3000154,3138656,281,1.00
ptg010725l,1575709,1576024,315,EVM,mRNA,1014144,2179713,315,1.00
ptg010733l,181602,181905,303,EVM,mRNA,4346,652134,303,1.00
ptg010737l,2683854,2684157,303,EVM,mRNA,2515952,2749629,303,1.00
ptg010741l,2448922,2449253,331,EVM,mRNA,2122091,2996246,331,1.00
ptg010741l,2879675,2879983,308,EVM,mRNA,2122091,2996246,308,1.00
ptg010749l,395789,396101,312,EVM,mRNA,88880,916648,312,1.00
ptg010749l,570870,571142,272,EVM,mRNA,88880,916648,272,1.00
ptg010749l,633750,634071,321,EVM,mRNA,88880,916648,321,1.00
ptg010751l,540097,540391,294,EVM,mRNA,390763,548851,294,1.00
ptg010752l,393681,393976,295,EVM,mRNA,48639,2545661,295,1.00
ptg010752l,1184442,1184731,289,EVM,mRNA,48639,2545661,289,1.00
ptg010752l,1609153,1609467,314,EVM,mRNA,48639,2545661,314,1.00
ptg010752l,2193334,2193645,311,EVM,mRNA,48639,2545661,311,1.00
ptg010752l,2303906,2304184,278,EVM,mRNA,48639,2545661,278,1.00
ptg010752l,2395270,2395543,273,EVM,mRNA,48639,2545661,273,1.00
ptg010761l,1350376,1350669,293,EVM,mRNA,542448,1356678,293,1.00
ptg010761l,2032268,2032571,303,EVM,mRNA,2018692,2045517,303,1.00
ptg010766l,693819,694139,320,EVM,mRNA,646926,783162,320,1.00
ptg010767l,365004,365324,320,EVM,mRNA,60927,3164976,320,1.00
ptg010773l,944388,944703,315,EVM,mRNA,334590,946688,315,1.00
ptg010773l,1744132,1744437,305,EVM,mRNA,1687638,2257744,305,1.00
ptg010773l,4805987,4806299,312,EVM,mRNA,4687290,5143167,312,1.00
ptg010773l,5067210,5067521,311,EVM,mRNA,4687290,5143167,311,1.00
ptg010778l,748175,748455,280,EVM,mRNA,8326,875060,280,1.00
ptg010787l,479250,479569,319,EVM,mRNA,343536,1362396,319,1.00
ptg010787l,503121,503413,292,EVM,mRNA,343536,1362396,292,1.00
ptg010787l,599556,599838,282,EVM,mRNA,343536,1362396,282,1.00
ptg010787l,818207,818488,281,EVM,mRNA,343536,1362396,281,1.00
ptg010793l,2510426,2510717,291,EVM,mRNA,2235385,2731093,291,1.00
ptg010793l,2701895,2702219,324,EVM,mRNA,2235385,2731093,324,1.00
ptg010798l,858893,859195,302,EVM,mRNA,838485,974137,302,1.00
ptg010800l,668289,668580,291,EVM,mRNA,423319,1656727,291,1.00
ptg010802l,473197,473519,322,EVM,mRNA,142852,1004163,322,1.00
ptg010802l,1562845,1563160,315,EVM,mRNA,1096274,1782604,315,1.00
ptg010811l,433404,433673,269,EVM,mRNA,174125,582916,269,1.00
ptg010813l,168688,168986,298,EVM,mRNA,9765,201761,298,1.00
ptg010813l,497398,497679,281,EVM,mRNA,274086,689684,281,1.00
ptg010814l,788032,788348,316,EVM,mRNA,66506,1189794,316,1.00
ptg010819l,1683538,1683851,313,EVM,mRNA,98576,1755696,313,1.00
ptg010821l,484512,484802,290,EVM,mRNA,412832,605498,290,1.00
ptg010821l,499354,499648,294,EVM,mRNA,412832,605498,294,1.00
ptg010822l,191243,191534,291,EVM,mRNA,11783,664276,291,1.00
ptg010822l,1011365,1011685,320,EVM,mRNA,784173,1087555,320,1.00
ptg010826l,582265,582551,286,EVM,mRNA,220263,2496558,286,1.00
ptg010826l,2081254,2081550,296,EVM,mRNA,220263,2496558,296,1.00
ptg010832l,1333758,1334042,284,EVM,mRNA,944198,2148590,284,1.00
ptg010834l,587883,588164,281,EVM,mRNA,399006,1246442,281,1.00
ptg010837l,1584748,1585066,318,EVM,mRNA,1167941,1595704,318,1.00
ptg010843l,440530,440848,318,EVM,mRNA,211278,1827099,318,1.00
ptg010843l,1179702,1180003,301,EVM,mRNA,211278,1827099,301,1.00
ptg010843l,1312888,1313203,315,EVM,mRNA,211278,1827099,315,1.00
ptg010844l,688140,688451,311,EVM,mRNA,670876,3123905,311,1.00
ptg010849l,404194,404499,305,EVM,mRNA,96674,445501,305,1.00
ptg010849l,2290106,2290386,280,EVM,mRNA,2004805,3058981,280,1.00
ptg010849l,2489782,2490092,310,EVM,mRNA,2004805,3058981,310,1.00
ptg010849l,3028842,3029143,301,EVM,mRNA,2004805,3058981,301,1.00
ptg010850l,699084,699390,306,EVM,mRNA,595245,877765,306,1.00
ptg010853l,907089,907398,309,EVM,mRNA,850110,984795,309,1.00
ptg010857l,282280,282566,286,EVM,mRNA,122524,578067,286,1.00
ptg010859l,727579,727885,306,EVM,mRNA,26129,1787985,306,1.00
ptg010859l,1515876,1516153,277,EVM,mRNA,26129,1787985,277,1.00
ptg010869l,944338,944624,286,EVM,mRNA,303475,1498752,286,1.00
ptg010870l,465670,465986,316,EVM,mRNA,98855,1426274,316,1.00
ptg010876l,785951,786221,270,EVM,mRNA,538749,860911,270,1.00
ptg010876l,1157780,1158087,307,EVM,mRNA,862403,1297451,307,1.00
ptg010879l,4252834,4253147,313,EVM,mRNA,3266467,5714017,313,1.00
ptg010879l,4317389,4317676,287,EVM,mRNA,3266467,5714017,287,1.00
ptg010879l,4320608,4320902,294,EVM,mRNA,3266467,5714017,294,1.00
ptg010879l,4385429,4385699,270,EVM,mRNA,3266467,5714017,270,1.00
ptg010881l,199095,199423,328,EVM,mRNA,199019,286284,328,1.00
ptg010898l,1542433,1542710,277,EVM,mRNA,794899,2012432,277,1.00
ptg010899l,1029586,1029902,316,EVM,mRNA,181751,1160250,316,1.00
ptg010899l,1107183,1107473,290,EVM,mRNA,181751,1160250,290,1.00
ptg010899l,1425384,1425667,283,EVM,mRNA,1272665,1562891,283,1.00
ptg010899l,2679508,2679786,278,EVM,mRNA,2646112,2692082,278,1.00
ptg010913l,362938,363259,321,EVM,mRNA,359310,406429,321,1.00
ptg010922l,7911,8209,298,EVM,mRNA,5484,647347,298,1.00
ptg010922l,489938,490247,309,EVM,mRNA,5484,647347,309,1.00
ptg010922l,576563,576854,291,EVM,mRNA,5484,647347,291,1.00
ptg010927l,1713811,1714089,278,EVM,mRNA,1702272,1829356,278,1.00
ptg010929l,124994,125284,290,EVM,mRNA,120632,342283,290,1.00
ptg010930l,159072,159375,303,EVM,mRNA,146536,724642,303,1.00
ptg010930l,1682289,1682590,301,EVM,mRNA,1544925,1754903,301,1.00
ptg010934l,203276,203589,313,EVM,mRNA,122241,229306,313,1.00
ptg010938l,1970009,1970289,280,EVM,mRNA,1638530,3756297,280,1.00
ptg010941l,426304,426622,318,EVM,mRNA,208655,445107,318,1.00
ptg010941l,1058359,1058653,294,EVM,mRNA,596243,1434854,294,1.00
ptg010945l,152838,153112,274,EVM,mRNA,14906,1201028,274,1.00
ptg010945l,344499,344800,301,EVM,mRNA,14906,1201028,301,1.00
ptg010945l,489241,489534,293,EVM,mRNA,14906,1201028,293,1.00
ptg010945l,652993,653265,272,EVM,mRNA,14906,1201028,272,1.00
ptg010945l,784341,784660,319,EVM,mRNA,14906,1201028,319,1.00
ptg010945l,833088,833387,299,EVM,mRNA,14906,1201028,299,1.00
ptg010945l,855347,855658,311,EVM,mRNA,14906,1201028,311,1.00
ptg010945l,879562,879849,287,EVM,mRNA,14906,1201028,287,1.00
ptg010945l,1117406,1117682,276,EVM,mRNA,14906,1201028,276,1.00
ptg010947l,259530,259826,296,EVM,mRNA,147692,331122,296,1.00
ptg010950l,307567,307898,331,EVM,mRNA,219208,537118,331,1.00
ptg010951l,1029885,1030201,316,EVM,mRNA,907200,1101999,316,1.00
ptg010951l,1561511,1561787,276,EVM,mRNA,1444342,1688653,276,1.00
ptg010953l,774380,774698,318,EVM,mRNA,35594,1208645,318,1.00
ptg010959l,1198873,1199177,304,EVM,mRNA,392797,1482544,304,1.00
ptg010959l,1288551,1288863,312,EVM,mRNA,392797,1482544,312,1.00
ptg010959l,1427347,1427612,265,EVM,mRNA,392797,1482544,265,1.00
ptg010960l,773352,773679,327,EVM,mRNA,228311,834477,327,1.00
ptg010964l,612042,612360,318,EVM,mRNA,542753,675087,318,1.00
ptg010964l,801128,801416,288,EVM,mRNA,716198,1094493,288,1.00
ptg010964l,1013468,1013755,287,EVM,mRNA,716198,1094493,287,1.00
ptg010964l,1073559,1073822,263,EVM,mRNA,716198,1094493,263,1.00
ptg010964l,1311964,1312280,316,EVM,mRNA,1263114,1647360,316,1.00
ptg010971l,287652,287923,271,EVM,mRNA,260432,460393,271,1.00
ptg010971l,1781436,1781745,309,EVM,mRNA,918826,2806014,309,1.00
ptg010971l,2007006,2007316,310,EVM,mRNA,918826,2806014,310,1.00
ptg010971l,2256791,2257098,307,EVM,mRNA,918826,2806014,307,1.00
ptg010973l,2642120,2642382,262,EVM,mRNA,2276204,2691764,262,1.00
ptg010976l,218230,218566,336,EVM,mRNA,129811,589061,336,1.00
ptg010976l,356710,357028,318,EVM,mRNA,129811,589061,318,1.00
ptg010976l,1277493,1277808,315,EVM,mRNA,709708,1699347,315,1.00
ptg010976l,1382423,1382734,311,EVM,mRNA,709708,1699347,311,1.00
ptg010976l,1497002,1497279,277,EVM,mRNA,709708,1699347,277,1.00
ptg010976l,1585435,1585749,314,EVM,mRNA,709708,1699347,314,1.00
ptg010977l,2339008,2339308,300,EVM,mRNA,2030195,2344673,300,1.00
ptg010977l,2890701,2890990,289,EVM,mRNA,2722918,3440339,289,1.00
ptg010978l,327606,327891,285,EVM,mRNA,98984,454429,285,1.00
ptg010983l,1034444,1034755,311,EVM,mRNA,733670,2891218,311,1.00
ptg010983l,1398774,1399087,313,EVM,mRNA,733670,2891218,313,1.00
ptg010983l,1918603,1918927,324,EVM,mRNA,733670,2891218,324,1.00
ptg010983l,2319999,2320304,305,EVM,mRNA,733670,2891218,305,1.00
ptg010986l,440207,440507,300,EVM,mRNA,74676,1486709,300,1.00
ptg010986l,684536,684871,335,EVM,mRNA,74676,1486709,335,1.00
ptg010986l,687248,687556,308,EVM,mRNA,74676,1486709,308,1.00
ptg010988l,219875,220154,279,EVM,mRNA,12172,316508,279,1.00
ptg010995l,690969,691285,316,EVM,mRNA,285327,1084741,316,1.00
ptg010997l,741969,742299,330,EVM,mRNA,608519,841564,330,1.00
ptg010999l,1011079,1011408,329,EVM,mRNA,962885,1649261,329,1.00
ptg010999l,1027885,1028184,299,EVM,mRNA,962885,1649261,299,1.00
ptg011006l,462219,462553,334,EVM,mRNA,428715,491449,334,1.00
ptg011009l,569869,570207,338,EVM,mRNA,2400,766630,338,1.00
ptg011010l,968612,968907,295,EVM,mRNA,968382,985086,295,1.00
ptg011012l,778355,778665,310,EVM,mRNA,245150,1040265,310,1.00
ptg011014l,1104708,1105033,325,EVM,mRNA,1069669,1183145,325,1.00
ptg011014l,1594318,1594623,305,EVM,mRNA,1474296,1724972,305,1.00
ptg011023l,233213,233529,316,EVM,mRNA,223356,266779,316,1.00
ptg011034l,1287482,1287768,286,EVM,mRNA,3072,1700992,286,1.00
ptg011036l,695144,695459,315,EVM,mRNA,78331,1093115,315,1.00
ptg011042l,454720,455007,287,EVM,mRNA,239649,613063,287,1.00
ptg011042l,1175041,1175328,287,EVM,mRNA,1157494,1189312,287,1.00
ptg011043l,1572425,1572706,281,EVM,mRNA,238132,2079176,281,1.00
ptg011046l,28350,28659,309,EVM,mRNA,6123,459599,309,1.00
ptg011053l,333829,334142,313,EVM,mRNA,199,404724,313,1.00
ptg011053l,826958,827291,333,EVM,mRNA,791727,952135,333,1.00
ptg011054l,1475981,1476276,295,EVM,mRNA,131192,1610209,295,1.00
ptg011062l,1687346,1687636,290,EVM,mRNA,1392360,1695011,290,1.00
ptg011068l,3912357,3912666,309,EVM,mRNA,2445394,4573255,309,1.00
ptg011068l,4483891,4484174,283,EVM,mRNA,2445394,4573255,283,1.00
ptg011071l,640205,640502,297,EVM,mRNA,498373,1900404,297,1.00
ptg011087l,1784351,1784640,289,EVM,mRNA,919910,3969077,289,1.00
ptg011087l,1933188,1933465,277,EVM,mRNA,919910,3969077,277,1.00
ptg011087l,2688491,2688778,287,EVM,mRNA,919910,3969077,287,1.00
ptg011087l,3313151,3313427,276,EVM,mRNA,919910,3969077,276,1.00
ptg011087l,3440611,3440922,311,EVM,mRNA,919910,3969077,311,1.00
ptg011087l,3943912,3944225,313,EVM,mRNA,919910,3969077,313,1.00
ptg011088l,1052893,1053210,317,EVM,mRNA,653865,1907038,317,1.00
ptg011091l,1326122,1326393,271,EVM,mRNA,1306339,1344319,271,1.00
ptg011092l,833221,833504,283,EVM,mRNA,734897,1633704,283,1.00
ptg011092l,1619789,1620099,310,EVM,mRNA,734897,1633704,310,1.00
ptg011092l,2238685,2238994,309,EVM,mRNA,1791837,3697893,309,1.00
ptg011092l,2392325,2392656,331,EVM,mRNA,1791837,3697893,331,1.00
ptg011093l,330475,330788,313,EVM,mRNA,182126,1198983,313,1.00
ptg011093l,553373,553640,267,EVM,mRNA,182126,1198983,267,1.00
ptg011093l,991318,991583,265,EVM,mRNA,182126,1198983,265,1.00
ptg011093l,1131223,1131517,294,EVM,mRNA,182126,1198983,294,1.00
ptg011093l,1176552,1176889,337,EVM,mRNA,182126,1198983,337,1.00
ptg011094l,171225,171548,323,EVM,mRNA,2878,536518,323,1.00
ptg011097l,914683,914990,307,EVM,mRNA,1301,2700134,307,1.00
ptg011102l,784767,785070,303,EVM,mRNA,174478,1252472,303,1.00
ptg011102l,903878,904200,322,EVM,mRNA,174478,1252472,322,1.00
ptg011105l,1085264,1085568,304,EVM,mRNA,609817,1163370,304,1.00
ptg011106l,1181193,1181496,303,EVM,mRNA,57305,2606507,303,1.00
ptg011106l,2604499,2604831,332,EVM,mRNA,57305,2606507,332,1.00
ptg011108l,455232,455552,320,EVM,mRNA,392364,1917464,320,1.00
ptg011112l,1720979,1721304,325,EVM,mRNA,1598569,1948858,325,1.00
ptg011115l,418809,419043,234,EVM,mRNA,416611,435834,234,1.00
ptg011120l,408348,408627,279,EVM,mRNA,251635,421785,279,1.00
ptg011123l,460124,460421,297,EVM,mRNA,46772,901337,297,1.00
ptg011126l,729847,730129,282,EVM,mRNA,651010,1096461,282,1.00
ptg011129l,660548,660872,324,EVM,mRNA,511989,894299,324,1.00
ptg011131l,443985,444271,286,EVM,mRNA,333746,604891,286,1.00
ptg011132l,2626507,2626803,296,EVM,mRNA,2616018,2685811,296,1.00
ptg011134l,587714,588030,316,EVM,mRNA,110,1597474,316,1.00
ptg011136l,297860,298184,324,EVM,mRNA,102196,662612,324,1.00
ptg011139l,519870,520158,288,EVM,mRNA,492326,623278,288,1.00
ptg011139l,559937,560229,292,EVM,mRNA,492326,623278,292,1.00
ptg011139l,622184,622489,305,EVM,mRNA,492326,623278,305,1.00
ptg011145l,930762,931017,255,EVM,mRNA,618977,1010909,255,1.00
ptg011151l,1532563,1532857,294,EVM,mRNA,1521089,1625216,294,1.00
ptg011151l,1737954,1738253,299,EVM,mRNA,1702576,2180899,299,1.00
ptg011159l,814963,815262,299,EVM,mRNA,416740,1390798,299,1.00
ptg011163l,877487,877789,302,EVM,mRNA,609242,1421388,302,1.00
ptg011163l,2914323,2914635,312,EVM,mRNA,2902445,3288178,312,1.00
ptg011165l,676445,676765,320,EVM,mRNA,200119,790118,320,1.00
ptg011187l,299781,300071,290,EVM,mRNA,11951,855010,290,1.00
ptg011187l,2185498,2185802,304,EVM,mRNA,2119191,2275535,304,1.00
ptg011194l,684207,684486,279,EVM,mRNA,7566,861014,279,1.00
ptg011214l,1053701,1053999,298,EVM,mRNA,476759,1467650,298,1.00
ptg011214l,1460993,1461264,271,EVM,mRNA,476759,1467650,271,1.00
ptg011215l,783378,783710,332,EVM,mRNA,526236,2251909,332,1.00
ptg011216l,103955,104267,312,EVM,mRNA,3773,610134,312,1.00
ptg011216l,539552,539882,330,EVM,mRNA,3773,610134,330,1.00
ptg011219l,123588,123867,279,EVM,mRNA,74871,247253,279,1.00
ptg011222l,656743,657046,303,EVM,mRNA,12999,975595,303,1.00
ptg011224l,388316,388606,290,EVM,mRNA,175533,1107119,290,1.00
ptg011232l,1653881,1654182,301,EVM,mRNA,1645200,2067899,301,1.00
ptg011235l,863392,863687,295,EVM,mRNA,123425,1213134,295,1.00
ptg011236l,838590,838915,325,EVM,mRNA,837977,901349,325,1.00
ptg011236l,1301121,1301383,262,EVM,mRNA,1293986,1440966,262,1.00
ptg011237l,349558,349863,305,EVM,mRNA,347436,1023090,305,1.00
ptg011238l,468095,468387,292,EVM,mRNA,7809,761317,292,1.00
ptg011238l,1374284,1374610,326,EVM,mRNA,958720,2027537,326,1.00
ptg011238l,1384880,1385172,292,EVM,mRNA,958720,2027537,292,1.00
ptg011238l,1813010,1813306,296,EVM,mRNA,958720,2027537,296,1.00
ptg011242l,215167,215441,274,EVM,mRNA,117672,241954,274,1.00
ptg011246l,450664,450955,291,EVM,mRNA,34130,1039230,291,1.00
ptg011251l,143070,143369,299,EVM,mRNA,137464,265060,299,1.00
ptg011252l,1507804,1508107,303,EVM,mRNA,1491326,1613277,303,1.00
ptg011252l,1798865,1799185,320,EVM,mRNA,1617075,2478634,320,1.00
ptg011252l,2453744,2454057,313,EVM,mRNA,1617075,2478634,313,1.00
ptg011256l,691906,692220,314,EVM,mRNA,339283,823180,314,1.00
ptg011256l,3846637,3846952,315,EVM,mRNA,3393273,4519568,315,1.00
ptg011256l,3875664,3875956,292,EVM,mRNA,3393273,4519568,292,1.00
ptg011256l,3967822,3968136,314,EVM,mRNA,3393273,4519568,314,1.00
ptg011258l,1794844,1795129,285,EVM,mRNA,1565114,2231627,285,1.00
ptg011263l,1282489,1282773,284,EVM,mRNA,1192143,2089494,284,1.00
ptg011263l,4500770,4501062,292,EVM,mRNA,4076193,4639194,292,1.00
ptg011263l,4626218,4626523,305,EVM,mRNA,4076193,4639194,305,1.00
ptg011268l,1543087,1543422,335,EVM,mRNA,1172320,1631549,335,1.00
ptg011270l,2175165,2175432,267,EVM,mRNA,2147292,3137176,267,1.00
ptg011270l,2795286,2795589,303,EVM,mRNA,2147292,3137176,303,1.00
ptg011270l,3614975,3615265,290,EVM,mRNA,3502902,4028580,290,1.00
ptg011272l,2033693,2033973,280,EVM,mRNA,1723341,2286315,280,1.00
ptg011278l,137653,137968,315,EVM,mRNA,74740,534916,315,1.00
ptg011278l,476561,476871,310,EVM,mRNA,74740,534916,310,1.00
ptg011282l,1641159,1641474,315,EVM,mRNA,1534670,3229348,315,1.00
ptg011282l,1645163,1645471,308,EVM,mRNA,1534670,3229348,308,1.00
ptg011282l,1772890,1773138,248,EVM,mRNA,1534670,3229348,248,1.00
ptg011282l,2306194,2306474,280,EVM,mRNA,1534670,3229348,280,1.00
ptg011282l,3093481,3093755,274,EVM,mRNA,1534670,3229348,274,1.00
ptg011282l,3094864,3095186,322,EVM,mRNA,1534670,3229348,322,1.00
ptg011288l,355008,355315,307,EVM,mRNA,345969,422711,307,1.00
ptg011290l,222538,222853,315,EVM,mRNA,113458,617647,315,1.00
ptg011290l,516708,517016,308,EVM,mRNA,113458,617647,308,1.00
ptg011290l,1158675,1158999,324,EVM,mRNA,1052645,1320887,324,1.00
ptg011294l,1601907,1602193,286,EVM,mRNA,1540242,1687047,286,1.00
ptg011294l,2291098,2291411,313,EVM,mRNA,2033840,5507627,313,1.00
ptg011294l,8054135,8054453,318,EVM,mRNA,7995007,8130019,318,1.00
ptg011299l,785279,785575,296,EVM,mRNA,201510,1357978,296,1.00
ptg011308l,617110,617390,280,EVM,mRNA,107900,1046057,280,1.00
ptg011308l,631300,631580,280,EVM,mRNA,107900,1046057,280,1.00
ptg011308l,647193,647513,320,EVM,mRNA,107900,1046057,320,1.00
ptg011311l,502742,503034,292,EVM,mRNA,448772,548796,292,1.00
ptg011311l,2173039,2173360,321,EVM,mRNA,2093421,2174919,321,1.00
ptg011326l,847988,848308,320,EVM,mRNA,48640,1748691,320,1.00
ptg011330l,852790,853068,278,EVM,mRNA,807675,1309313,278,1.00
ptg011330l,859063,859365,302,EVM,mRNA,807675,1309313,302,1.00
ptg011330l,943475,943791,316,EVM,mRNA,807675,1309313,316,1.00
ptg011331l,1417232,1417544,312,EVM,mRNA,977251,1794117,312,1.00
ptg011331l,1464077,1464351,274,EVM,mRNA,977251,1794117,274,1.00
ptg011334l,169777,170100,323,EVM,mRNA,126295,219595,323,1.00
ptg011343l,1017671,1017985,314,EVM,mRNA,540742,1523886,314,1.00
ptg011348l,122996,123316,320,EVM,mRNA,101580,142418,320,1.00
ptg011348l,1395368,1395657,289,EVM,mRNA,1154445,2586538,289,1.00
ptg011348l,1916902,1917202,300,EVM,mRNA,1154445,2586538,300,1.00
ptg011348l,2203121,2203438,317,EVM,mRNA,1154445,2586538,317,1.00
ptg011348l,2224735,2225025,290,EVM,mRNA,1154445,2586538,290,1.00
ptg011348l,2248049,2248302,253,EVM,mRNA,1154445,2586538,253,1.00
ptg011348l,2410675,2410983,308,EVM,mRNA,1154445,2586538,308,1.00
ptg011352l,198184,198505,321,EVM,mRNA,170890,1678025,321,1.00
ptg011352l,661351,661662,311,EVM,mRNA,170890,1678025,311,1.00
ptg011357l,1469860,1470177,317,EVM,mRNA,11783,1580511,317,1.00
ptg011359l,681117,681415,298,EVM,mRNA,583456,2620012,298,1.00
ptg011359l,789179,789492,313,EVM,mRNA,583456,2620012,313,1.00
ptg011359l,961499,961765,266,EVM,mRNA,583456,2620012,266,1.00
ptg011359l,2048018,2048308,290,EVM,mRNA,583456,2620012,290,1.00
ptg011359l,2361033,2361338,305,EVM,mRNA,583456,2620012,305,1.00
ptg011365l,448829,449122,293,EVM,mRNA,107211,589104,293,1.00
ptg011365l,663057,663331,274,EVM,mRNA,595552,825724,274,1.00
ptg011365l,671010,671284,274,EVM,mRNA,595552,825724,274,1.00
ptg011367l,426892,427202,310,EVM,mRNA,151147,844821,310,1.00
ptg011367l,698963,699252,289,EVM,mRNA,151147,844821,289,1.00
ptg011367l,754854,755134,280,EVM,mRNA,151147,844821,280,1.00
ptg011367l,795460,795772,312,EVM,mRNA,151147,844821,312,1.00
ptg011368l,607637,607902,265,EVM,mRNA,418711,804343,265,1.00
ptg011368l,803200,803506,306,EVM,mRNA,418711,804343,306,1.00
ptg011368l,1584011,1584275,264,EVM,mRNA,1369932,1791295,264,1.00
ptg011368l,1790153,1790458,305,EVM,mRNA,1369932,1791295,305,1.00
ptg011369l,168717,168997,280,EVM,mRNA,17486,203646,280,1.00
ptg011371l,768455,768768,313,EVM,mRNA,303340,1040454,313,1.00
ptg011374l,523576,523889,313,EVM,mRNA,26191,958490,313,1.00
ptg011378l,587549,587849,300,EVM,mRNA,563690,1321499,300,1.00
ptg011378l,1748529,1748843,314,EVM,mRNA,1429952,1878568,314,1.00
ptg011379l,762762,763061,299,EVM,mRNA,51356,1057173,299,1.00
ptg011379l,1691233,1691560,327,EVM,mRNA,1279997,2489456,327,1.00
ptg011379l,3413794,3414102,308,EVM,mRNA,2610269,3521856,308,1.00
ptg011382l,1476681,1476958,277,EVM,mRNA,1377606,1479903,277,1.00
ptg011384l,1754415,1754742,327,EVM,mRNA,1592730,2117309,327,1.00
ptg011384l,3052444,3052709,265,EVM,mRNA,2826241,3074057,265,1.00
ptg011394l,493211,493535,324,EVM,mRNA,472716,1527925,324,1.00
ptg011397l,259012,259306,294,EVM,mRNA,86169,280692,294,1.00
ptg011397l,1839265,1839559,294,EVM,mRNA,1658580,1884426,294,1.00
ptg011397l,2570621,2570956,335,EVM,mRNA,2520825,2960981,335,1.00
ptg011397l,2594393,2594692,299,EVM,mRNA,2520825,2960981,299,1.00
ptg011397l,3374686,3375006,320,EVM,mRNA,3112269,3425071,320,1.00
ptg011404l,479455,479752,297,EVM,mRNA,55448,632015,297,1.00
ptg011404l,1320302,1320603,301,EVM,mRNA,940696,1346567,301,1.00
ptg011404l,1330199,1330704,505,EVM,mRNA,940696,1346567,505,1.00
ptg011408l,2536895,2537204,309,EVM,mRNA,1788345,2611697,309,1.00
ptg011409l,66634,66918,284,EVM,mRNA,32632,115848,284,1.00
ptg011409l,1470505,1470767,262,EVM,mRNA,295604,1965442,262,1.00
ptg011414l,440063,440399,336,EVM,mRNA,334016,789546,336,1.00
ptg011414l,689588,689892,304,EVM,mRNA,334016,789546,304,1.00
ptg011414l,787604,787938,334,EVM,mRNA,334016,789546,334,1.00
ptg011418l,1146608,1146924,316,EVM,mRNA,1132292,1282356,316,1.00
ptg011430l,1051067,1051369,302,EVM,mRNA,19463,1771330,302,1.00
ptg011431l,3562434,3562734,300,EVM,mRNA,3184013,3587895,300,1.00
ptg011432l,830019,830329,310,EVM,mRNA,1547,1502438,310,1.00
ptg011442l,633140,633462,322,EVM,mRNA,172892,3052680,322,1.00
ptg011442l,997142,997450,308,EVM,mRNA,172892,3052680,308,1.00
ptg011442l,1531301,1531620,319,EVM,mRNA,172892,3052680,319,1.00
ptg011442l,2059490,2059800,310,EVM,mRNA,172892,3052680,310,1.00
ptg011442l,2989725,2990024,299,EVM,mRNA,172892,3052680,299,1.00
ptg011449l,505684,505988,304,EVM,mRNA,505987,506190,2,0.01
ptg011449l,840733,841000,267,EVM,mRNA,819929,909325,267,1.00
ptg011451l,1050451,1050746,295,EVM,mRNA,961833,1114385,295,1.00
ptg011465l,549999,550262,263,EVM,mRNA,391822,846488,263,1.00
ptg011465l,728237,728539,302,EVM,mRNA,391822,846488,302,1.00
ptg011465l,2057219,2057537,318,EVM,mRNA,1865728,2323209,318,1.00
ptg011469l,277872,278155,283,EVM,mRNA,140954,439904,283,1.00
ptg011469l,331215,331543,328,EVM,mRNA,140954,439904,328,1.00
ptg011474l,2147770,2148049,279,EVM,mRNA,1516146,2753811,279,1.00
ptg011479l,2781744,2782038,294,EVM,mRNA,2486975,2855557,294,1.00
ptg011480l,624630,624921,291,EVM,mRNA,94319,639872,291,1.00
ptg011482l,1214965,1215249,284,EVM,mRNA,1091280,1430566,284,1.00
ptg011489l,1064326,1064647,321,EVM,mRNA,350468,2806381,321,1.00
ptg011489l,1748751,1749073,322,EVM,mRNA,350468,2806381,322,1.00
ptg011498l,171652,171945,293,EVM,mRNA,112578,201503,293,1.00
ptg011507l,250086,250386,300,EVM,mRNA,210787,526654,300,1.00
ptg011511l,834876,835158,282,EVM,mRNA,777239,902898,282,1.00
ptg011512l,960999,961330,331,EVM,mRNA,736618,1227153,331,1.00
ptg011516l,271625,271961,336,EVM,mRNA,84262,789379,336,1.00
ptg011516l,375117,375409,292,EVM,mRNA,84262,789379,292,1.00
ptg011523l,18551,18882,331,EVM,mRNA,11177,280302,331,1.00
ptg011531l,385646,385944,298,EVM,mRNA,111,544250,298,1.00
ptg011531l,1388676,1388958,282,EVM,mRNA,967273,1436516,282,1.00
ptg011531l,1612303,1612598,295,EVM,mRNA,1464460,1745876,295,1.00
ptg011531l,2972351,2972641,290,EVM,mRNA,1995094,3857858,290,1.00
ptg011532l,1288322,1288618,296,EVM,mRNA,1186957,1511329,296,1.00
ptg011536l,60488,60818,330,EVM,mRNA,24411,858845,330,1.00
ptg011537l,2010826,2011149,323,EVM,mRNA,1832491,2330188,323,1.00
ptg011537l,2254747,2255061,314,EVM,mRNA,1832491,2330188,314,1.00
ptg011539l,1048555,1048864,309,EVM,mRNA,849461,1495119,309,1.00
ptg011543l,1592600,1592904,304,EVM,mRNA,1115154,1656072,304,1.00
ptg011546l,1754826,1755116,290,EVM,mRNA,89188,2560630,290,1.00
ptg011547l,1681144,1681412,268,EVM,mRNA,1386736,2467936,268,1.00
ptg011547l,1843717,1844016,299,EVM,mRNA,1386736,2467936,299,1.00
ptg011547l,2058753,2059043,290,EVM,mRNA,1386736,2467936,290,1.00
ptg011549l,232531,232837,306,EVM,mRNA,13077,1240904,306,1.00
ptg011549l,449334,449611,277,EVM,mRNA,13077,1240904,277,1.00
ptg011558l,778017,778302,285,EVM,mRNA,21309,1489286,285,1.00
ptg011559l,874283,874595,312,EVM,mRNA,30885,1363725,312,1.00
ptg011560l,739241,739546,305,EVM,mRNA,640489,813957,305,1.00
ptg011562l,1644811,1645091,280,EVM,mRNA,1068493,1721918,280,1.00
ptg011563l,394138,394409,271,EVM,mRNA,326504,463921,271,1.00
ptg011568l,1170235,1170556,321,EVM,mRNA,723381,2408286,321,1.00
ptg011568l,1404468,1404783,315,EVM,mRNA,723381,2408286,315,1.00
ptg011568l,1731276,1731557,281,EVM,mRNA,723381,2408286,281,1.00
ptg011571l,176248,176564,316,EVM,mRNA,143873,479618,316,1.00
ptg011573l,753271,753564,293,EVM,mRNA,595913,896355,293,1.00
ptg011575l,1695214,1695530,316,EVM,mRNA,1566449,2297268,316,1.00
ptg011576l,588198,588493,295,EVM,mRNA,261699,762549,295,1.00
ptg011576l,628701,629000,299,EVM,mRNA,261699,762549,299,1.00
ptg011577l,1704767,1705079,312,EVM,mRNA,1666558,1884219,312,1.00
ptg011578l,213282,213546,264,EVM,mRNA,13204,405065,264,1.00
ptg011578l,224510,224827,317,EVM,mRNA,13204,405065,317,1.00
ptg011578l,339968,340263,295,EVM,mRNA,13204,405065,295,1.00
ptg011585l,928301,928557,256,EVM,mRNA,465955,994331,256,1.00
ptg011588l,35216,35539,323,EVM,mRNA,27188,694263,323,1.00
ptg011588l,110417,110693,276,EVM,mRNA,27188,694263,276,1.00
ptg011588l,180906,181196,290,EVM,mRNA,27188,694263,290,1.00
ptg011589l,1045375,1045693,318,EVM,mRNA,998768,1667230,318,1.00
ptg011598l,76880,77158,278,EVM,mRNA,9551,1479845,278,1.00
ptg011598l,1088179,1088458,279,EVM,mRNA,9551,1479845,279,1.00
ptg011598l,1470099,1470373,274,EVM,mRNA,9551,1479845,274,1.00
ptg011600l,1584820,1585108,288,EVM,mRNA,1482530,1728174,288,1.00
ptg011602l,691902,692205,303,EVM,mRNA,116732,1627638,303,1.00
ptg011617l,251704,251984,280,EVM,mRNA,240725,263144,280,1.00
ptg011625l,324920,325247,327,EVM,mRNA,1527,370456,327,1.00
ptg011638l,189259,189536,277,EVM,mRNA,150398,1169338,277,1.00
ptg011638l,450437,450730,293,EVM,mRNA,150398,1169338,293,1.00
ptg011638l,868325,868596,271,EVM,mRNA,150398,1169338,271,1.00
ptg011646l,776723,776997,274,EVM,mRNA,289585,1606243,274,1.00
ptg011647l,598196,598484,288,EVM,mRNA,224979,798281,288,1.00
ptg011647l,598913,599224,311,EVM,mRNA,224979,798281,311,1.00
ptg011650l,277162,277438,276,EVM,mRNA,69058,703920,276,1.00
ptg011650l,398141,398416,275,EVM,mRNA,69058,703920,275,1.00
ptg011651l,505404,505733,329,EVM,mRNA,364947,2309860,329,1.00
ptg011654l,280887,281195,308,EVM,mRNA,5547,482796,308,1.00
ptg011657l,2072422,2072713,291,EVM,mRNA,1869703,3268834,291,1.00
ptg011681l,245927,246214,287,EVM,mRNA,61490,266992,287,1.00
ptg011684l,405479,405800,321,EVM,mRNA,237801,1031103,321,1.00
ptg011685l,987782,988073,291,EVM,mRNA,934388,1327324,291,1.00
ptg011686l,643600,643896,296,EVM,mRNA,449955,1182903,296,1.00
ptg011686l,680857,681162,305,EVM,mRNA,449955,1182903,305,1.00
ptg011696l,1827487,1827792,305,EVM,mRNA,1768712,1941255,305,1.00
ptg011696l,2291741,2292045,304,EVM,mRNA,2104372,2547325,304,1.00
ptg011696l,3130595,3130887,292,EVM,mRNA,2775487,3140178,292,1.00
ptg011697l,623709,624014,305,EVM,mRNA,324701,1126045,305,1.00
ptg011708l,799948,800222,274,EVM,mRNA,786484,1002913,274,1.00
ptg011708l,957628,957959,331,EVM,mRNA,786484,1002913,331,1.00
ptg011721l,387131,387449,318,EVM,mRNA,246539,605345,318,1.00
ptg011721l,713283,713613,330,EVM,mRNA,686683,758631,330,1.00
ptg011721l,1045075,1045375,300,EVM,mRNA,978221,1176149,300,1.00
ptg011724l,897158,897475,317,EVM,mRNA,804111,1109638,317,1.00
ptg011724l,1096026,1096316,290,EVM,mRNA,804111,1109638,290,1.00
ptg011729l,236305,236597,292,EVM,mRNA,12116,329394,292,1.00
ptg011729l,735585,735887,302,EVM,mRNA,556083,798971,302,1.00
ptg011733l,1055625,1055941,316,EVM,mRNA,1015013,1212952,316,1.00
ptg011733l,1130423,1130726,303,EVM,mRNA,1015013,1212952,303,1.00
ptg011735l,1708325,1708613,288,EVM,mRNA,692269,2098445,288,1.00
ptg011737l,636573,636887,314,EVM,mRNA,257041,841176,314,1.00
ptg011739l,1353307,1353609,302,EVM,mRNA,1290324,1430207,302,1.00
ptg011742l,882153,882451,298,EVM,mRNA,144290,1476744,298,1.00
ptg011742l,948951,949273,322,EVM,mRNA,144290,1476744,322,1.00
ptg011743l,542323,542653,330,EVM,mRNA,56221,565051,330,1.00
ptg011748l,1121336,1121616,280,EVM,mRNA,1038622,1154892,280,1.00
ptg011754l,830742,831014,272,EVM,mRNA,126229,1100921,272,1.00
ptg011754l,1037760,1038071,311,EVM,mRNA,126229,1100921,311,1.00
ptg011755l,575366,575696,330,EVM,mRNA,39705,1374272,330,1.00
ptg011757l,192301,192593,292,EVM,mRNA,136076,506729,292,1.00
ptg011761l,585405,585547,142,EVM,mRNA,380466,914860,142,1.00
ptg011767l,585015,585307,292,EVM,mRNA,437816,1269923,292,1.00
ptg011768l,215559,215872,313,EVM,mRNA,352,311092,313,1.00
ptg011772l,520849,521156,307,EVM,mRNA,295150,899557,307,1.00
ptg011781l,1049812,1050133,321,EVM,mRNA,983229,1546946,321,1.00
ptg011782l,422911,423187,276,EVM,mRNA,3476,1491424,276,1.00
ptg011782l,744922,745202,280,EVM,mRNA,3476,1491424,280,1.00
ptg011784l,942808,943125,317,EVM,mRNA,189254,1391810,317,1.00
ptg011785l,222104,222369,265,EVM,mRNA,218193,785772,265,1.00
ptg011787l,190403,190736,333,EVM,mRNA,83866,215079,333,1.00
ptg011787l,357683,358016,333,EVM,mRNA,217107,583355,333,1.00
ptg011787l,452540,452869,329,EVM,mRNA,217107,583355,329,1.00
ptg011797l,293540,293805,265,EVM,mRNA,287102,331259,265,1.00
ptg011799l,1032639,1032964,325,EVM,mRNA,474,1036638,325,1.00
ptg011800l,336548,336847,299,EVM,mRNA,134301,626940,299,1.00
ptg011800l,477494,477777,283,EVM,mRNA,134301,626940,283,1.00
ptg011803l,1772094,1772393,299,EVM,mRNA,651559,1961460,299,1.00
ptg011806l,128015,128322,307,EVM,mRNA,77477,396502,307,1.00
ptg011813l,83436,83741,305,EVM,mRNA,63940,196167,305,1.00
ptg011815l,303610,303900,290,EVM,mRNA,32775,642070,290,1.00
ptg011816l,727172,727479,307,EVM,mRNA,432772,874188,307,1.00
ptg011818l,30135,30427,292,EVM,mRNA,9848,1147583,292,1.00
ptg011818l,736642,736928,286,EVM,mRNA,9848,1147583,286,1.00
ptg011818l,800927,801243,316,EVM,mRNA,9848,1147583,316,1.00
ptg011821l,360193,360501,308,EVM,mRNA,182408,1238430,308,1.00
ptg011821l,588565,588863,298,EVM,mRNA,182408,1238430,298,1.00
ptg011824l,235821,236130,309,EVM,mRNA,212560,864392,309,1.00
ptg011827l,670945,671257,312,EVM,mRNA,488031,1656099,312,1.00
ptg011827l,688465,688772,307,EVM,mRNA,488031,1656099,307,1.00
ptg011832l,579765,580074,309,EVM,mRNA,389555,789441,309,1.00
ptg011836l,19425,19741,316,EVM,mRNA,19001,239819,316,1.00
ptg011836l,64989,65269,280,EVM,mRNA,19001,239819,280,1.00
ptg011838l,1311565,1311859,294,EVM,mRNA,511609,1892228,294,1.00
ptg011847l,231398,231714,316,EVM,mRNA,218016,233055,316,1.00
ptg011859l,2664302,2664624,322,EVM,mRNA,2562441,3088152,322,1.00
ptg011859l,2677118,2677429,311,EVM,mRNA,2562441,3088152,311,1.00
ptg011860l,750881,751162,281,EVM,mRNA,52130,791278,281,1.00
ptg011861l,731637,731963,326,EVM,mRNA,589298,1126256,326,1.00
ptg011861l,810555,810808,253,EVM,mRNA,589298,1126256,253,1.00
ptg011861l,2088653,2088964,311,EVM,mRNA,1878400,2091809,311,1.00
ptg011863l,988934,989246,312,EVM,mRNA,989039,1425997,208,0.67
ptg011888l,3153725,3154049,324,EVM,mRNA,3122783,3287471,324,1.00
ptg011888l,3170604,3170920,316,EVM,mRNA,3122783,3287471,316,1.00
ptg011903l,2131990,2132287,297,EVM,mRNA,1204595,3190624,297,1.00
ptg011903l,2594584,2594888,304,EVM,mRNA,1204595,3190624,304,1.00
ptg011903l,2642194,2642511,317,EVM,mRNA,1204595,3190624,317,1.00
ptg011903l,2723688,2723991,303,EVM,mRNA,1204595,3190624,303,1.00
ptg011907l,180091,180372,281,EVM,mRNA,179090,607890,281,1.00
ptg011907l,1662864,1663182,318,EVM,mRNA,1452430,1721108,318,1.00
ptg011911l,210798,211092,294,EVM,mRNA,8981,222885,294,1.00
ptg011918l,54413,54730,317,EVM,mRNA,14702,185326,317,1.00
ptg011918l,288827,289152,325,EVM,mRNA,269366,409525,325,1.00
ptg011925l,1001866,1002177,311,EVM,mRNA,235465,1745000,311,1.00
ptg011925l,1311346,1311644,298,EVM,mRNA,235465,1745000,298,1.00
ptg011926l,640858,641137,279,EVM,mRNA,245693,686882,279,1.00
ptg011927l,469955,470253,298,EVM,mRNA,233260,526388,298,1.00
ptg011932l,287186,287463,277,EVM,mRNA,268133,374009,277,1.00
ptg011940l,869504,869825,321,EVM,mRNA,413749,1321366,321,1.00
ptg011947l,452663,452957,294,EVM,mRNA,120577,526468,294,1.00
ptg011948l,187131,187415,284,EVM,mRNA,149746,349523,284,1.00
ptg011955l,313045,313345,300,EVM,mRNA,355,588442,300,1.00
ptg011958l,1328905,1329211,306,EVM,mRNA,1304144,1352651,306,1.00
ptg011959l,1692412,1692742,330,EVM,mRNA,1577383,1853147,330,1.00
ptg011959l,4099053,4099343,290,EVM,mRNA,3465155,4142583,290,1.00
ptg011977l,305178,305464,286,EVM,mRNA,49231,455939,286,1.00
ptg011977l,394587,394880,293,EVM,mRNA,49231,455939,293,1.00
ptg011977l,907713,908037,324,EVM,mRNA,501302,1044328,324,1.00
ptg011977l,4655304,4655604,300,EVM,mRNA,4423122,6617971,300,1.00
ptg011978l,1513054,1513375,321,EVM,mRNA,915892,1570884,321,1.00
ptg011978l,2672684,2673004,320,EVM,mRNA,2531134,6749144,320,1.00
ptg011978l,3162964,3163263,299,EVM,mRNA,2531134,6749144,299,1.00
ptg011978l,3687335,3687622,287,EVM,mRNA,2531134,6749144,287,1.00
ptg011978l,4410562,4410859,297,EVM,mRNA,2531134,6749144,297,1.00
ptg011978l,4441526,4441792,266,EVM,mRNA,2531134,6749144,266,1.00
ptg011978l,4776567,4776888,321,EVM,mRNA,2531134,6749144,321,1.00
ptg011978l,5596485,5596765,280,EVM,mRNA,2531134,6749144,280,1.00
ptg011978l,5606444,5606769,325,EVM,mRNA,2531134,6749144,325,1.00
ptg011978l,7548876,7549182,306,EVM,mRNA,7338791,8126259,306,1.00
ptg011978l,8044368,8044651,283,EVM,mRNA,7338791,8126259,283,1.00
ptg011979l,418125,418451,326,EVM,mRNA,366684,728173,326,1.00
ptg011979l,558526,558853,327,EVM,mRNA,366684,728173,327,1.00
ptg011979l,724398,724719,321,EVM,mRNA,366684,728173,321,1.00
ptg011984l,49749,50027,278,EVM,mRNA,30859,265856,278,1.00
ptg011986l,1625645,1625946,301,EVM,mRNA,1562519,1821039,301,1.00
ptg011989l,2225585,2225868,283,EVM,mRNA,1599491,2303601,283,1.00
ptg011996l,874807,875109,302,EVM,mRNA,794163,1552247,302,1.00
ptg011999l,409491,409819,328,EVM,mRNA,385606,556304,328,1.00
ptg012002l,350999,351286,287,EVM,mRNA,7010,976868,287,1.00
ptg012011l,172191,172471,280,EVM,mRNA,75689,340047,280,1.00
ptg012019l,844779,845097,318,EVM,mRNA,374643,1087137,318,1.00
ptg012019l,845244,845534,290,EVM,mRNA,374643,1087137,290,1.00
ptg012025l,2084391,2084689,298,EVM,mRNA,1163216,2465599,298,1.00
ptg012025l,2319290,2319595,305,EVM,mRNA,1163216,2465599,305,1.00
ptg012029l,618407,618670,263,EVM,mRNA,12854,870069,263,1.00
ptg012029l,740542,740861,319,EVM,mRNA,12854,870069,319,1.00
ptg012031l,1073035,1073318,283,EVM,mRNA,853774,1524646,283,1.00
ptg012040l,1563236,1563554,318,EVM,mRNA,123646,1976574,318,1.00
ptg012041l,1490209,1490505,296,EVM,mRNA,1329230,2656705,296,1.00
ptg012041l,1533634,1533913,279,EVM,mRNA,1329230,2656705,279,1.00
ptg012044l,994604,994893,289,EVM,mRNA,562487,1172319,289,1.00
ptg012048l,1049071,1049369,298,EVM,mRNA,360355,1625869,298,1.00
ptg012048l,1520974,1521275,301,EVM,mRNA,360355,1625869,301,1.00
ptg012049l,1443388,1443709,321,EVM,mRNA,1393574,1705208,321,1.00
ptg012049l,1872323,1872631,308,EVM,mRNA,1790194,1944391,308,1.00
ptg012052l,1255296,1255600,304,EVM,mRNA,329496,1412120,304,1.00
ptg012058l,2382470,2382758,288,EVM,mRNA,2038893,4125713,288,1.00
ptg012058l,2869950,2870276,326,EVM,mRNA,2038893,4125713,326,1.00
ptg012058l,3576206,3576520,314,EVM,mRNA,2038893,4125713,314,1.00
ptg012059l,223810,224114,304,EVM,mRNA,107285,530409,304,1.00
ptg012059l,456922,457229,307,EVM,mRNA,107285,530409,307,1.00
ptg012059l,1661935,1662251,316,EVM,mRNA,632584,1702890,316,1.00
ptg012061l,316910,317228,318,EVM,mRNA,35025,342310,318,1.00
ptg012064l,437574,437879,305,EVM,mRNA,437849,438259,31,0.10
ptg012065l,1662338,1662643,305,EVM,mRNA,1184750,2121775,305,1.00
ptg012070l,114301,114601,300,EVM,mRNA,11245,1329183,300,1.00
ptg012070l,418170,418466,296,EVM,mRNA,11245,1329183,296,1.00
ptg012070l,1980271,1980561,290,EVM,mRNA,1856053,2931463,290,1.00
ptg012070l,2393948,2394244,296,EVM,mRNA,1856053,2931463,296,1.00
ptg012073l,370164,370472,308,EVM,mRNA,349513,416855,308,1.00
ptg012081l,687337,687644,307,EVM,mRNA,231466,1938011,307,1.00
ptg012082l,1161865,1162181,316,EVM,mRNA,247938,1303888,316,1.00
ptg012091l,895179,895489,310,EVM,mRNA,629449,1249023,310,1.00
ptg012095l,780609,780927,318,EVM,mRNA,757740,917174,318,1.00
ptg012096l,281591,281906,315,EVM,mRNA,234739,376536,315,1.00
ptg012096l,1211575,1211888,313,EVM,mRNA,796689,2223749,313,1.00
ptg012101l,382668,382968,300,EVM,mRNA,2441,1706756,300,1.00
ptg012101l,693876,694202,326,EVM,mRNA,2441,1706756,326,1.00
ptg012101l,727078,727371,293,EVM,mRNA,2441,1706756,293,1.00
ptg012101l,1105080,1105382,302,EVM,mRNA,2441,1706756,302,1.00
ptg012106l,769116,769424,308,EVM,mRNA,2379,799591,308,1.00
ptg012110l,930383,930717,334,EVM,mRNA,310956,1327481,334,1.00
ptg012116l,844370,844642,272,EVM,mRNA,785339,2344304,272,1.00
ptg012116l,1914102,1914408,306,EVM,mRNA,785339,2344304,306,1.00
ptg012116l,2247646,2247957,311,EVM,mRNA,785339,2344304,311,1.00
ptg012117l,1504377,1504690,313,EVM,mRNA,314802,1505369,313,1.00
ptg012117l,2856073,2856372,299,EVM,mRNA,1885781,4200355,299,1.00
ptg012117l,2880050,2880332,282,EVM,mRNA,1885781,4200355,282,1.00
ptg012129l,533659,533955,296,EVM,mRNA,493444,941812,296,1.00
ptg012134l,213612,213928,316,EVM,mRNA,78467,712718,316,1.00
ptg012134l,2106831,2107126,295,EVM,mRNA,2089847,2291504,295,1.00
ptg012146l,740666,740950,284,EVM,mRNA,690307,777832,284,1.00
ptg012149l,455560,455846,286,EVM,mRNA,396175,494381,286,1.00
ptg012164l,383397,383717,320,EVM,mRNA,280527,431994,320,1.00
ptg012171l,1593667,1593963,296,EVM,mRNA,808430,1984369,296,1.00
ptg012171l,1901494,1901805,311,EVM,mRNA,808430,1984369,311,1.00
ptg012173l,2343439,2343754,315,EVM,mRNA,1810545,2425583,315,1.00
ptg012175l,474478,474792,314,EVM,mRNA,382136,482539,314,1.00
ptg012175l,1429802,1430125,323,EVM,mRNA,906756,1626244,323,1.00
ptg012187l,1076070,1076383,313,EVM,mRNA,204165,1092176,313,1.00
ptg012190l,1002207,1002521,314,EVM,mRNA,873894,1228280,314,1.00
ptg012190l,1174552,1174883,331,EVM,mRNA,873894,1228280,331,1.00
ptg012191l,483447,483750,303,EVM,mRNA,122483,2309691,303,1.00
ptg012191l,1312885,1313164,279,EVM,mRNA,122483,2309691,279,1.00
ptg012197l,1470520,1470803,283,EVM,mRNA,1466554,2051572,283,1.00
ptg012197l,2015778,2016090,312,EVM,mRNA,1466554,2051572,312,1.00
ptg012197l,3223207,3223528,321,EVM,mRNA,3179048,4663514,321,1.00
ptg012197l,3706329,3706642,313,EVM,mRNA,3179048,4663514,313,1.00
ptg012197l,4277170,4277466,296,EVM,mRNA,3179048,4663514,296,1.00
ptg012197l,4644343,4644614,271,EVM,mRNA,3179048,4663514,271,1.00
ptg012198l,1132030,1132342,312,EVM,mRNA,103420,1422786,312,1.00
ptg012199l,1913262,1913581,319,EVM,mRNA,1709488,2170528,319,1.00
ptg012199l,1937600,1937908,308,EVM,mRNA,1709488,2170528,308,1.00
ptg012201l,1077545,1077841,296,EVM,mRNA,946896,1108649,296,1.00
ptg012205l,54978,55252,274,EVM,mRNA,21193,722952,274,1.00
ptg012205l,716007,716330,323,EVM,mRNA,21193,722952,323,1.00
ptg012205l,867564,867883,319,EVM,mRNA,865540,1093153,319,1.00
ptg012205l,1951748,1952059,311,EVM,mRNA,1153545,2237020,311,1.00
ptg012209l,796114,796417,303,EVM,mRNA,60912,951334,303,1.00
ptg012213l,755619,755928,309,EVM,mRNA,602305,1830335,309,1.00
ptg012213l,782226,782498,272,EVM,mRNA,602305,1830335,272,1.00
ptg012213l,1155541,1155867,326,EVM,mRNA,602305,1830335,326,1.00
ptg012221l,103372,103669,297,EVM,mRNA,6886,111844,297,1.00
ptg012221l,501103,501434,331,EVM,mRNA,459177,512316,331,1.00
ptg012222l,72972,73254,282,EVM,mRNA,21744,438139,282,1.00
ptg012236l,93264,93578,314,EVM,mRNA,16260,1178329,314,1.00
ptg012236l,454988,455306,318,EVM,mRNA,16260,1178329,318,1.00
ptg012236l,1171323,1171648,325,EVM,mRNA,16260,1178329,325,1.00
ptg012242l,991425,991723,298,EVM,mRNA,812499,1118168,298,1.00
ptg012242l,1057768,1058051,283,EVM,mRNA,812499,1118168,283,1.00
ptg012249l,2360512,2360821,309,EVM,mRNA,1593776,2415381,309,1.00
ptg012250l,1291539,1291848,309,EVM,mRNA,1251707,1435821,309,1.00
ptg012278l,311811,312128,317,EVM,mRNA,68715,414030,317,1.00
ptg012280l,131171,131483,312,EVM,mRNA,20669,1739921,312,1.00
ptg012280l,534124,534399,275,EVM,mRNA,20669,1739921,275,1.00
ptg012280l,1029345,1029636,291,EVM,mRNA,20669,1739921,291,1.00
ptg012294l,293084,293362,278,EVM,mRNA,92591,2323678,278,1.00
ptg012294l,309413,309710,297,EVM,mRNA,92591,2323678,297,1.00
ptg012294l,435330,435587,257,EVM,mRNA,92591,2323678,257,1.00
ptg012294l,581561,581856,295,EVM,mRNA,92591,2323678,295,1.00
ptg012294l,695717,696016,299,EVM,mRNA,92591,2323678,299,1.00
ptg012294l,1610404,1610694,290,EVM,mRNA,92591,2323678,290,1.00
ptg012294l,1750269,1750579,310,EVM,mRNA,92591,2323678,310,1.00
ptg012294l,2465146,2465456,310,EVM,mRNA,2423597,2792615,310,1.00
ptg012294l,2640587,2640865,278,EVM,mRNA,2423597,2792615,278,1.00
ptg012299l,4869681,4869996,315,EVM,mRNA,4681098,4913201,315,1.00
ptg012306l,606041,606317,276,EVM,mRNA,98829,2506574,276,1.00
ptg012306l,975834,976163,329,EVM,mRNA,98829,2506574,329,1.00
ptg012306l,1344834,1345128,294,EVM,mRNA,98829,2506574,294,1.00
ptg012306l,1465557,1465867,310,EVM,mRNA,98829,2506574,310,1.00
ptg012309l,354698,354984,286,EVM,mRNA,30892,547600,286,1.00
ptg012309l,500349,500650,301,EVM,mRNA,30892,547600,301,1.00
ptg012313l,107156,107484,328,EVM,mRNA,3673,188517,328,1.00
ptg012328l,288248,288502,254,EVM,mRNA,223180,800517,254,1.00
ptg012334l,382594,382887,293,EVM,mRNA,16504,710211,293,1.00
ptg012336l,1209550,1209842,292,EVM,mRNA,1183165,1357310,292,1.00
ptg012338l,1205530,1205852,322,EVM,mRNA,1182801,1372125,322,1.00
ptg012356l,1217467,1217769,302,EVM,mRNA,126339,1658166,302,1.00
ptg012359l,326528,326848,320,EVM,mRNA,5320,384065,320,1.00
ptg012365l,258955,259231,276,EVM,mRNA,108614,386253,276,1.00
ptg012375l,420849,421130,281,EVM,mRNA,347252,570676,281,1.00
ptg012375l,1008323,1008630,307,EVM,mRNA,1002035,1088080,307,1.00
ptg012376l,1343764,1344079,315,EVM,mRNA,907136,1414472,315,1.00
ptg012388l,1358111,1358425,314,EVM,mRNA,515562,2265902,314,1.00
ptg012388l,1790819,1791150,331,EVM,mRNA,515562,2265902,331,1.00
ptg012390l,860506,860806,300,EVM,mRNA,859608,995113,300,1.00
ptg012397l,202501,202787,286,EVM,mRNA,82963,656271,286,1.00
ptg012402l,54290,54590,300,EVM,mRNA,9294,57105,300,1.00
ptg012403l,1442924,1443211,287,EVM,mRNA,1253528,1611162,287,1.00
ptg012403l,1500376,1500682,306,EVM,mRNA,1253528,1611162,306,1.00
ptg012409l,675909,676228,319,EVM,mRNA,516537,795320,319,1.00
ptg012410l,948806,949117,311,EVM,mRNA,697045,1010152,311,1.00
ptg012410l,961378,961683,305,EVM,mRNA,697045,1010152,305,1.00
ptg012412l,767240,767553,313,EVM,mRNA,546404,1232088,313,1.00
ptg012414l,1024727,1025024,297,EVM,mRNA,776668,3118387,297,1.00
ptg012414l,1743650,1743955,305,EVM,mRNA,776668,3118387,305,1.00
ptg012420l,2233651,2233945,294,EVM,mRNA,2113747,2476358,294,1.00
ptg012423l,1059694,1060025,331,EVM,mRNA,1056193,1165648,331,1.00
ptg012423l,1106351,1106667,316,EVM,mRNA,1056193,1165648,316,1.00
ptg012434l,1527967,1528249,282,EVM,mRNA,558559,3978078,282,1.00
ptg012434l,1567513,1567822,309,EVM,mRNA,558559,3978078,309,1.00
ptg012434l,2301882,2302163,281,EVM,mRNA,558559,3978078,281,1.00
ptg012434l,3048980,3049286,306,EVM,mRNA,558559,3978078,306,1.00
ptg012444l,759790,760071,281,EVM,mRNA,690926,953422,281,1.00
ptg012444l,919805,920122,317,EVM,mRNA,690926,953422,317,1.00
ptg012447l,302342,302660,318,EVM,mRNA,22089,334570,318,1.00
ptg012449l,1044202,1044474,272,EVM,mRNA,925264,1153193,272,1.00
ptg012456l,1512825,1513139,314,EVM,mRNA,1112062,1547367,314,1.00
ptg012456l,3235897,3236225,328,EVM,mRNA,3180505,3754715,328,1.00
ptg012458l,197449,197755,306,EVM,mRNA,178514,216309,306,1.00
ptg012461l,331975,332274,299,EVM,mRNA,246277,501543,299,1.00
ptg012466l,876522,876795,273,EVM,mRNA,527892,1188000,273,1.00
ptg012466l,1461880,1462201,321,EVM,mRNA,1456712,1529640,321,1.00
ptg012466l,1501646,1501927,281,EVM,mRNA,1456712,1529640,281,1.00
ptg012469l,675376,675671,295,EVM,mRNA,364099,849241,295,1.00
ptg012469l,1423138,1423457,319,EVM,mRNA,1401113,2106496,319,1.00
ptg012470l,947346,947620,274,EVM,mRNA,546267,961012,274,1.00
ptg012470l,2074719,2075026,307,EVM,mRNA,965181,2383157,307,1.00
ptg012476l,383662,383958,296,EVM,mRNA,189205,429216,296,1.00
ptg012476l,384061,384389,328,EVM,mRNA,189205,429216,328,1.00
ptg012477l,1783538,1783858,320,EVM,mRNA,1737924,2070122,320,1.00
ptg012479l,744166,744458,292,EVM,mRNA,662159,827434,292,1.00
ptg012479l,794843,795149,306,EVM,mRNA,662159,827434,306,1.00
ptg012479l,922263,922570,307,EVM,mRNA,857005,1073411,307,1.00
ptg012482l,164030,164314,284,EVM,mRNA,42148,222955,284,1.00
ptg012503l,736335,736623,288,EVM,mRNA,667088,1035166,288,1.00
ptg012503l,1442980,1443277,297,EVM,mRNA,1358630,1667789,297,1.00
ptg012503l,1462212,1462488,276,EVM,mRNA,1358630,1667789,276,1.00
ptg012503l,1515770,1516084,314,EVM,mRNA,1358630,1667789,314,1.00
ptg012503l,1552396,1552712,316,EVM,mRNA,1358630,1667789,316,1.00
ptg012516l,479228,479510,282,EVM,mRNA,411949,681710,282,1.00
ptg012516l,1805693,1805985,292,EVM,mRNA,1247461,2039380,292,1.00
ptg012516l,2324771,2325045,274,EVM,mRNA,2291531,2659424,274,1.00
ptg012516l,2338747,2339005,258,EVM,mRNA,2291531,2659424,258,1.00
ptg012520l,964365,964688,323,EVM,mRNA,599798,1855185,323,1.00
ptg012520l,1756051,1756355,304,EVM,mRNA,599798,1855185,304,1.00
ptg012523l,330851,331150,299,EVM,mRNA,79859,1473321,299,1.00
ptg012523l,830252,830544,292,EVM,mRNA,79859,1473321,292,1.00
ptg012523l,1406707,1407002,295,EVM,mRNA,79859,1473321,295,1.00
ptg012531l,29569,29903,334,EVM,mRNA,4704,56960,334,1.00
ptg012531l,427197,427537,340,EVM,mRNA,303992,814883,340,1.00
ptg012531l,645797,646115,318,EVM,mRNA,303992,814883,318,1.00
ptg012534l,695388,695683,295,EVM,mRNA,695369,695548,160,0.54
ptg012536l,867885,868193,308,EVM,mRNA,42149,1085339,308,1.00
ptg012536l,1075555,1075864,309,EVM,mRNA,42149,1085339,309,1.00
ptg012544l,574997,575321,324,EVM,mRNA,329196,1545185,324,1.00
ptg012544l,1043740,1044052,312,EVM,mRNA,329196,1545185,312,1.00
ptg012547l,964043,964333,290,EVM,mRNA,642045,1219373,290,1.00
ptg012555l,121162,121449,287,EVM,mRNA,54448,394012,287,1.00
ptg012555l,123865,124165,300,EVM,mRNA,54448,394012,300,1.00
ptg012556l,61540,61839,299,EVM,mRNA,56376,244825,299,1.00
ptg012559l,119824,120134,310,EVM,mRNA,16363,1241843,310,1.00
ptg012559l,190789,191078,289,EVM,mRNA,16363,1241843,289,1.00
ptg012565l,1760565,1760864,299,EVM,mRNA,1709178,1770970,299,1.00
ptg012573l,1166053,1166344,291,EVM,mRNA,984210,1255754,291,1.00
ptg012576l,1319230,1319544,314,EVM,mRNA,1313239,1468229,314,1.00
ptg012579l,315676,315977,301,EVM,mRNA,107694,448466,301,1.00
ptg012579l,773128,773401,273,EVM,mRNA,500546,1323358,273,1.00
ptg012579l,2060419,2060719,300,EVM,mRNA,1428414,2388364,300,1.00
ptg012582l,1319725,1320045,320,EVM,mRNA,1239429,1623468,320,1.00
ptg012584l,435316,435589,273,EVM,mRNA,396604,772128,273,1.00
ptg012592l,702881,703176,295,EVM,mRNA,307128,3170090,295,1.00
ptg012592l,3527655,3527952,297,EVM,mRNA,3371009,3695812,297,1.00
ptg012592l,3629572,3629865,293,EVM,mRNA,3371009,3695812,293,1.00
ptg012594l,1038988,1039312,324,EVM,mRNA,562386,3333134,324,1.00
ptg012594l,2073568,2073867,299,EVM,mRNA,562386,3333134,299,1.00
ptg012594l,2159720,2159862,142,EVM,mRNA,562386,3333134,142,1.00
ptg012595l,120277,120594,317,EVM,mRNA,67829,186795,317,1.00
ptg012595l,322412,322726,314,EVM,mRNA,274563,1110847,314,1.00
ptg012595l,853335,853645,310,EVM,mRNA,274563,1110847,310,1.00
ptg012595l,929157,929472,315,EVM,mRNA,274563,1110847,315,1.00
ptg012602l,2650895,2651179,284,EVM,mRNA,1982780,2673059,284,1.00
ptg012606l,137429,137721,292,EVM,mRNA,3085,464472,292,1.00
ptg012606l,137820,138099,279,EVM,mRNA,3085,464472,279,1.00
ptg012606l,299693,299989,296,EVM,mRNA,3085,464472,296,1.00
ptg012606l,384342,384635,293,EVM,mRNA,3085,464472,293,1.00
ptg012609l,497378,497679,301,EVM,mRNA,189143,761139,301,1.00
ptg012609l,1556227,1556542,315,EVM,mRNA,1337089,3024039,315,1.00
ptg012609l,2744697,2744953,256,EVM,mRNA,1337089,3024039,256,1.00
ptg012610l,532597,532879,282,EVM,mRNA,2775,720333,282,1.00
ptg012610l,673973,674272,299,EVM,mRNA,2775,720333,299,1.00
ptg012611l,363998,364277,279,EVM,mRNA,178046,430174,279,1.00
ptg012612l,482717,483016,299,EVM,mRNA,194,1528064,299,1.00
ptg012612l,1399734,1400011,277,EVM,mRNA,194,1528064,277,1.00
ptg012615l,1039280,1039573,293,EVM,mRNA,246571,2122809,293,1.00
ptg012615l,1156185,1156480,295,EVM,mRNA,246571,2122809,295,1.00
ptg012616l,1512649,1512955,306,EVM,mRNA,1140263,1846024,306,1.00
ptg012623l,234140,234454,314,EVM,mRNA,3845,965002,314,1.00
ptg012623l,405233,405524,291,EVM,mRNA,3845,965002,291,1.00
ptg012623l,491075,491400,325,EVM,mRNA,3845,965002,325,1.00
ptg012624l,403330,403656,326,EVM,mRNA,396640,496634,326,1.00
ptg012625l,192019,192300,281,EVM,mRNA,114334,194793,281,1.00
ptg012625l,316365,316694,329,EVM,mRNA,199787,609917,329,1.00
ptg012625l,1305755,1306071,316,EVM,mRNA,1272563,1467794,316,1.00
ptg012625l,3664366,3664665,299,EVM,mRNA,2938442,4029348,299,1.00
ptg012626l,340668,340984,316,EVM,mRNA,279207,518208,316,1.00
ptg012634l,910294,910567,273,EVM,mRNA,22218,2703574,273,1.00
ptg012634l,1235319,1235607,288,EVM,mRNA,22218,2703574,288,1.00
ptg012634l,1619325,1619637,312,EVM,mRNA,22218,2703574,312,1.00
ptg012634l,1761495,1761815,320,EVM,mRNA,22218,2703574,320,1.00
ptg012635l,244068,244381,313,EVM,mRNA,191229,879647,313,1.00
ptg012635l,832887,833206,319,EVM,mRNA,191229,879647,319,1.00
ptg012646l,1877577,1877895,318,EVM,mRNA,1470837,3088379,318,1.00
ptg012646l,2848186,2848488,302,EVM,mRNA,1470837,3088379,302,1.00
ptg012647l,375417,375730,313,EVM,mRNA,305422,628854,313,1.00
ptg012647l,470004,470265,261,EVM,mRNA,305422,628854,261,1.00
ptg012647l,471132,471427,295,EVM,mRNA,305422,628854,295,1.00
ptg012652l,499628,499943,315,EVM,mRNA,419342,685194,315,1.00
ptg012661l,1110779,1111100,321,EVM,mRNA,879102,1152484,321,1.00
ptg012664l,379035,379326,291,EVM,mRNA,13651,392500,291,1.00
ptg012664l,386173,386453,280,EVM,mRNA,13651,392500,280,1.00
ptg012677l,19990,20304,314,EVM,mRNA,4420,780511,314,1.00
ptg012679l,1744502,1744779,277,EVM,mRNA,558786,2085748,277,1.00
ptg012679l,1897295,1897625,330,EVM,mRNA,558786,2085748,330,1.00
ptg012682l,37451,37740,289,EVM,mRNA,343,194303,289,1.00
ptg012682l,71260,71557,297,EVM,mRNA,343,194303,297,1.00
ptg012682l,1085296,1085613,317,EVM,mRNA,826309,1122013,317,1.00
ptg012698l,434844,435175,331,EVM,mRNA,193679,1322463,331,1.00
ptg012698l,773051,773356,305,EVM,mRNA,193679,1322463,305,1.00
ptg012698l,1624806,1625085,279,EVM,mRNA,1419875,1798117,279,1.00
ptg012701l,130711,131018,307,EVM,mRNA,126287,131376,307,1.00
ptg012701l,544325,544613,288,EVM,mRNA,516648,657925,288,1.00
ptg012701l,1659654,1659933,279,EVM,mRNA,1558412,2231932,279,1.00
ptg012701l,1858579,1858874,295,EVM,mRNA,1558412,2231932,295,1.00
ptg012701l,3325862,3326148,286,EVM,mRNA,3281884,3539105,286,1.00
ptg012704l,64024,64334,310,EVM,mRNA,26384,291855,310,1.00
ptg012704l,64784,65056,272,EVM,mRNA,26384,291855,272,1.00
ptg012723l,448088,448406,318,EVM,mRNA,438673,1005854,318,1.00
ptg012723l,1064860,1065185,325,EVM,mRNA,1047369,1120890,325,1.00
ptg012734l,1154460,1154771,311,EVM,mRNA,1032709,1587613,311,1.00
ptg012734l,1415770,1416056,286,EVM,mRNA,1032709,1587613,286,1.00
ptg012743l,548442,548747,305,EVM,mRNA,434304,762725,305,1.00
ptg012749l,1266195,1266487,292,EVM,mRNA,959877,2140883,292,1.00
ptg012749l,1284308,1284599,291,EVM,mRNA,959877,2140883,291,1.00
ptg012749l,1497614,1497900,286,EVM,mRNA,959877,2140883,286,1.00
ptg012749l,1524494,1524796,302,EVM,mRNA,959877,2140883,302,1.00
ptg012749l,2112675,2112907,232,EVM,mRNA,959877,2140883,232,1.00
ptg012752l,171045,171328,283,EVM,mRNA,166314,304597,283,1.00
ptg012752l,209816,210107,291,EVM,mRNA,166314,304597,291,1.00
ptg012758l,24522,24857,335,EVM,mRNA,6601,145547,335,1.00
ptg012758l,1415920,1416243,323,EVM,mRNA,905050,1982673,323,1.00
ptg012758l,1479995,1480317,322,EVM,mRNA,905050,1982673,322,1.00
ptg012758l,1608237,1608526,289,EVM,mRNA,905050,1982673,289,1.00
ptg012758l,1908428,1908750,322,EVM,mRNA,905050,1982673,322,1.00
ptg012759l,329130,329410,280,EVM,mRNA,286453,461544,280,1.00
ptg012765l,1070637,1070916,279,EVM,mRNA,547719,1398713,279,1.00
ptg012768l,382278,382577,299,EVM,mRNA,14177,762584,299,1.00
ptg012773l,545208,545507,299,EVM,mRNA,218124,1893268,299,1.00
ptg012773l,550529,550828,299,EVM,mRNA,218124,1893268,299,1.00
ptg012773l,649403,649697,294,EVM,mRNA,218124,1893268,294,1.00
ptg012773l,687131,687427,296,EVM,mRNA,218124,1893268,296,1.00
ptg012773l,975262,975559,297,EVM,mRNA,218124,1893268,297,1.00
ptg012781l,94407,94706,299,EVM,mRNA,86517,429063,299,1.00
ptg012785l,539962,540263,301,EVM,mRNA,494179,551542,301,1.00
ptg012788l,1804248,1804547,299,EVM,mRNA,667035,1962772,299,1.00
ptg012796l,1343666,1343964,298,EVM,mRNA,1256461,1575014,298,1.00
ptg012799l,222929,223191,262,EVM,mRNA,175242,363695,262,1.00
ptg012800l,1139539,1139853,314,EVM,mRNA,881165,1910057,314,1.00
ptg012801l,884111,884409,298,EVM,mRNA,872593,920013,298,1.00
ptg012806l,515211,515531,320,EVM,mRNA,21830,903355,320,1.00
ptg012810l,649099,649426,327,EVM,mRNA,112980,1018040,327,1.00
ptg012810l,951900,952189,289,EVM,mRNA,112980,1018040,289,1.00
ptg012821l,347482,347765,283,EVM,mRNA,709,363485,283,1.00
ptg012821l,361531,361826,295,EVM,mRNA,709,363485,295,1.00
ptg012821l,2017494,2017812,318,EVM,mRNA,1552209,2348624,318,1.00
ptg012821l,2147025,2147308,283,EVM,mRNA,1552209,2348624,283,1.00
ptg012824l,780616,780937,321,EVM,mRNA,629993,3473323,321,1.00
ptg012826l,204707,205006,299,EVM,mRNA,34275,317752,299,1.00
ptg012826l,631437,631720,283,EVM,mRNA,462909,1321634,283,1.00
ptg012826l,1082005,1082307,302,EVM,mRNA,462909,1321634,302,1.00
ptg012828l,516648,516961,313,EVM,mRNA,474403,895807,313,1.00
ptg012834l,99544,99821,277,EVM,mRNA,2622,706320,277,1.00
ptg012834l,251383,251678,295,EVM,mRNA,2622,706320,295,1.00
ptg012834l,629956,630238,282,EVM,mRNA,2622,706320,282,1.00
ptg012835l,588839,589172,333,EVM,mRNA,413045,2093597,333,1.00
ptg012835l,709194,709471,277,EVM,mRNA,413045,2093597,277,1.00
ptg012835l,1094258,1094548,290,EVM,mRNA,413045,2093597,290,1.00
ptg012835l,1165248,1165539,291,EVM,mRNA,413045,2093597,291,1.00
ptg012835l,1323872,1324185,313,EVM,mRNA,413045,2093597,313,1.00
ptg012835l,1596547,1596828,281,EVM,mRNA,413045,2093597,281,1.00
ptg012835l,1685792,1686100,308,EVM,mRNA,413045,2093597,308,1.00
ptg012844l,190538,190848,310,EVM,mRNA,1350,533579,310,1.00
ptg012854l,1227041,1227326,285,EVM,mRNA,376954,1480722,285,1.00
ptg012859l,7528,7826,298,EVM,mRNA,5285,21037,298,1.00
ptg012863l,559548,559850,302,EVM,mRNA,512020,897829,302,1.00
ptg012864l,2085843,2086103,260,EVM,mRNA,1910007,2358897,260,1.00
ptg012864l,3234764,3235058,294,EVM,mRNA,3232953,3483649,294,1.00
ptg012864l,3409402,3409718,316,EVM,mRNA,3232953,3483649,316,1.00
ptg012867l,1301236,1301543,307,EVM,mRNA,858081,3401309,307,1.00
ptg012870l,1731105,1731404,299,EVM,mRNA,106948,2417495,299,1.00
ptg012870l,1992956,1993255,299,EVM,mRNA,106948,2417495,299,1.00
ptg012870l,2079575,2079875,300,EVM,mRNA,106948,2417495,300,1.00
ptg012870l,2094551,2094872,321,EVM,mRNA,106948,2417495,321,1.00
ptg012872l,583077,583387,310,EVM,mRNA,559806,668241,310,1.00
ptg012874l,188885,189216,331,EVM,mRNA,118672,1360944,331,1.00
ptg012874l,463465,463749,284,EVM,mRNA,118672,1360944,284,1.00
ptg012880l,167104,167403,299,EVM,mRNA,82339,481011,299,1.00
ptg012881l,605033,605337,304,EVM,mRNA,371348,618310,304,1.00
ptg012882l,504880,505160,280,EVM,mRNA,501691,686681,280,1.00
ptg012884l,67714,68031,317,EVM,mRNA,43720,3389543,317,1.00
ptg012884l,2063069,2063375,306,EVM,mRNA,43720,3389543,306,1.00
ptg012884l,3062530,3062848,318,EVM,mRNA,43720,3389543,318,1.00
ptg012889l,92991,93268,277,EVM,mRNA,9003,345813,277,1.00
ptg012893l,661419,661721,302,EVM,mRNA,567547,1088877,302,1.00
ptg012893l,737717,738032,315,EVM,mRNA,567547,1088877,315,1.00
ptg012893l,1033708,1034007,299,EVM,mRNA,567547,1088877,299,1.00
ptg012897l,111751,112004,253,EVM,mRNA,21602,904866,253,1.00
ptg012897l,159558,159836,278,EVM,mRNA,21602,904866,278,1.00
ptg012897l,500418,500742,324,EVM,mRNA,21602,904866,324,1.00
ptg012897l,877051,877324,273,EVM,mRNA,21602,904866,273,1.00
ptg012897l,895486,895778,292,EVM,mRNA,21602,904866,292,1.00
ptg012902l,69406,69717,311,EVM,mRNA,54104,199646,311,1.00
ptg012902l,122528,122909,381,EVM,mRNA,54104,199646,381,1.00
ptg012902l,139567,139851,284,EVM,mRNA,54104,199646,284,1.00
ptg012902l,198925,199213,288,EVM,mRNA,54104,199646,288,1.00
ptg012907l,1177504,1177790,286,EVM,mRNA,110791,1425883,286,1.00
ptg012907l,1181243,1181521,278,EVM,mRNA,110791,1425883,278,1.00
ptg012913l,704255,704534,279,EVM,mRNA,483709,1672857,279,1.00
ptg012913l,1648639,1648929,290,EVM,mRNA,483709,1672857,290,1.00
ptg012919l,587858,588163,305,EVM,mRNA,137587,972796,305,1.00
ptg012925l,134284,134622,338,EVM,mRNA,36120,173617,338,1.00
ptg012926l,883495,883794,299,EVM,mRNA,755195,953745,299,1.00
ptg012927l,733860,734178,318,EVM,mRNA,459342,1389383,318,1.00
ptg012927l,768749,769028,279,EVM,mRNA,459342,1389383,279,1.00
ptg012930l,429447,429750,303,EVM,mRNA,61953,628793,303,1.00
ptg012932l,177726,178030,304,EVM,mRNA,53334,273697,304,1.00
ptg012933l,1155612,1155926,314,EVM,mRNA,473184,1242530,314,1.00
ptg012937l,157324,157604,280,EVM,mRNA,2857,950892,280,1.00
ptg012939l,603338,603635,297,EVM,mRNA,568230,683948,297,1.00
ptg012951l,1556989,1557302,313,EVM,mRNA,1495038,1623647,313,1.00
ptg012952l,63615,63937,322,EVM,mRNA,28025,270997,322,1.00
ptg012954l,1258325,1258591,266,EVM,mRNA,719315,1584100,266,1.00
ptg012954l,1472965,1473294,329,EVM,mRNA,719315,1584100,329,1.00
ptg012961l,216992,217275,283,EVM,mRNA,9907,293158,283,1.00
ptg012963l,67996,68268,272,EVM,mRNA,35235,424943,272,1.00
ptg012969l,791784,792090,306,EVM,mRNA,435641,3769116,306,1.00
ptg012969l,1120597,1120892,295,EVM,mRNA,435641,3769116,295,1.00
ptg012982l,71731,72020,289,EVM,mRNA,62787,734463,289,1.00
ptg012993l,320528,320827,299,EVM,mRNA,131808,507389,299,1.00
ptg012994l,2419572,2419902,330,EVM,mRNA,2372852,2621554,330,1.00
ptg012996l,784670,784981,311,EVM,mRNA,437944,1760240,311,1.00
ptg012996l,1648407,1648707,300,EVM,mRNA,437944,1760240,300,1.00
ptg013002l,595309,595583,274,EVM,mRNA,93097,1384451,274,1.00
ptg013002l,761238,761543,305,EVM,mRNA,93097,1384451,305,1.00
ptg013002l,1683352,1683629,277,EVM,mRNA,1423864,2473403,277,1.00
ptg013008l,267848,268159,311,EVM,mRNA,4909,1343590,311,1.00
ptg013008l,992416,992718,302,EVM,mRNA,4909,1343590,302,1.00
ptg013010l,1450151,1450480,329,EVM,mRNA,320131,1592383,329,1.00
ptg013011l,872407,872725,318,EVM,mRNA,861217,1056471,318,1.00
ptg013020l,1916897,1917216,319,EVM,mRNA,1814155,2759674,319,1.00
ptg013024l,541918,542222,304,EVM,mRNA,406994,583193,304,1.00
ptg013030l,686386,686691,305,EVM,mRNA,462391,727056,305,1.00
ptg013031l,1861563,1861843,280,EVM,mRNA,1632372,1901000,280,1.00
ptg013036l,1257108,1257428,320,EVM,mRNA,1221641,1383013,320,1.00
ptg013042l,814970,815260,290,EVM,mRNA,497972,1234065,290,1.00
ptg013043l,208159,208438,279,EVM,mRNA,116124,268072,279,1.00
ptg013045l,474529,474789,260,EVM,mRNA,60838,716240,260,1.00
ptg013045l,1897576,1897872,296,EVM,mRNA,1634884,2109378,296,1.00
ptg013045l,3543318,3543611,293,EVM,mRNA,3453043,3586711,293,1.00
ptg013053l,209997,210312,315,EVM,mRNA,129206,224898,315,1.00
ptg013062l,1234645,1234925,280,EVM,mRNA,563855,1374792,280,1.00
ptg013068l,656616,656894,278,EVM,mRNA,619974,889437,278,1.00
ptg013068l,1150093,1150413,320,EVM,mRNA,1052605,1189716,320,1.00
ptg013068l,1888556,1888842,286,EVM,mRNA,1471995,2043613,286,1.00
ptg013082l,356474,356787,313,EVM,mRNA,276857,1652918,313,1.00
ptg013082l,906564,906885,321,EVM,mRNA,276857,1652918,321,1.00
ptg013082l,1201078,1201384,306,EVM,mRNA,276857,1652918,306,1.00
ptg013088l,3074510,3074785,275,EVM,mRNA,2698435,3509329,275,1.00
ptg013089l,238780,239049,269,EVM,mRNA,21964,308915,269,1.00
ptg013089l,459851,460156,305,EVM,mRNA,444609,543368,305,1.00
ptg013092l,186604,186914,310,EVM,mRNA,181287,358524,310,1.00
ptg013097l,395090,395403,313,EVM,mRNA,123534,817904,313,1.00
ptg013097l,406039,406339,300,EVM,mRNA,123534,817904,300,1.00
ptg013097l,1922734,1923036,302,EVM,mRNA,874690,2536588,302,1.00
ptg013097l,3863601,3863931,330,EVM,mRNA,3420635,4219310,330,1.00
ptg013097l,4046087,4046393,306,EVM,mRNA,3420635,4219310,306,1.00
ptg013102l,360762,361042,280,EVM,mRNA,210766,415052,280,1.00
ptg013109l,217016,217295,279,EVM,mRNA,157946,231941,279,1.00
ptg013113l,327209,327505,296,EVM,mRNA,83479,1456819,296,1.00
ptg013113l,383076,383406,330,EVM,mRNA,83479,1456819,330,1.00
ptg013113l,932907,933218,311,EVM,mRNA,83479,1456819,311,1.00
ptg013113l,975368,975675,307,EVM,mRNA,83479,1456819,307,1.00
ptg013117l,306999,307315,316,EVM,mRNA,284777,2891690,316,1.00
ptg013117l,767031,767309,278,EVM,mRNA,284777,2891690,278,1.00
ptg013117l,816552,816826,274,EVM,mRNA,284777,2891690,274,1.00
ptg013117l,1370777,1371065,288,EVM,mRNA,284777,2891690,288,1.00
ptg013117l,2733623,2733922,299,EVM,mRNA,284777,2891690,299,1.00
ptg013121l,116302,116589,287,EVM,mRNA,31518,910862,287,1.00
ptg013121l,448817,449145,328,EVM,mRNA,31518,910862,328,1.00
ptg013129l,245102,245399,297,EVM,mRNA,236858,371144,297,1.00
ptg013131l,288445,288719,274,EVM,mRNA,21601,538601,274,1.00
ptg013133l,670032,670348,316,EVM,mRNA,32574,1875452,316,1.00
ptg013133l,1097089,1097399,310,EVM,mRNA,32574,1875452,310,1.00
ptg013133l,1104427,1104708,281,EVM,mRNA,32574,1875452,281,1.00
ptg013133l,1116592,1116901,309,EVM,mRNA,32574,1875452,309,1.00
ptg013140l,816974,817306,332,EVM,mRNA,699722,969019,332,1.00
ptg013148l,94076,94375,299,EVM,mRNA,65925,777145,299,1.00
ptg013148l,217068,217367,299,EVM,mRNA,65925,777145,299,1.00
ptg013148l,363631,363927,296,EVM,mRNA,65925,777145,296,1.00
ptg013148l,384621,384921,300,EVM,mRNA,65925,777145,300,1.00
ptg013149l,350459,350758,299,EVM,mRNA,206644,624814,299,1.00
ptg013152l,717034,717327,293,EVM,mRNA,623853,1086196,293,1.00
ptg013153l,330118,330469,351,EVM,mRNA,222504,855363,351,1.00
ptg013155l,1058685,1058975,290,EVM,mRNA,129485,1170242,290,1.00
ptg013157l,186530,186801,271,EVM,mRNA,28640,226930,271,1.00
ptg013159l,517786,518078,292,EVM,mRNA,437851,997421,292,1.00
ptg013159l,1537604,1537932,328,EVM,mRNA,1177570,1919947,328,1.00
ptg013173l,437668,437955,287,EVM,mRNA,149929,1252685,287,1.00
ptg013173l,647720,648021,301,EVM,mRNA,149929,1252685,301,1.00
ptg013173l,838721,838995,274,EVM,mRNA,149929,1252685,274,1.00
ptg013183l,134485,134803,318,EVM,mRNA,113917,1034848,318,1.00
ptg013193l,1509285,1509557,272,EVM,mRNA,914681,1594398,272,1.00
ptg013193l,2148856,2149163,307,EVM,mRNA,1909608,2406529,307,1.00
ptg013193l,2565451,2565741,290,EVM,mRNA,2554652,2804709,290,1.00
ptg013199l,148617,148924,307,EVM,mRNA,28121,982192,307,1.00
ptg013199l,648458,648740,282,EVM,mRNA,28121,982192,282,1.00
ptg013201l,797853,798182,329,EVM,mRNA,187370,973656,329,1.00
ptg013202l,230123,230439,316,EVM,mRNA,68228,826468,316,1.00
ptg013202l,565125,565441,316,EVM,mRNA,68228,826468,316,1.00
ptg013202l,1014956,1015269,313,EVM,mRNA,922400,1397439,313,1.00
ptg013203l,1015244,1015557,313,EVM,mRNA,447573,1183058,313,1.00
ptg013203l,1078686,1078968,282,EVM,mRNA,447573,1183058,282,1.00
ptg013205l,75786,76073,287,EVM,mRNA,13110,787883,287,1.00
ptg013212l,536304,536601,297,EVM,mRNA,152288,751757,297,1.00
ptg013219l,315546,315862,316,EVM,mRNA,320,702186,316,1.00
ptg013219l,575633,575919,286,EVM,mRNA,320,702186,286,1.00
ptg013221l,176614,176886,272,EVM,mRNA,151959,425004,272,1.00
ptg013221l,2622090,2622403,313,EVM,mRNA,1648417,3046357,313,1.00
ptg013221l,4031442,4031721,279,EVM,mRNA,3928262,5056428,279,1.00
ptg013221l,4133633,4133938,305,EVM,mRNA,3928262,5056428,305,1.00
ptg013226l,788102,788395,293,EVM,mRNA,691561,797160,293,1.00
ptg013231l,502959,503283,324,EVM,mRNA,261137,667757,324,1.00
ptg013234l,1158788,1159106,318,EVM,mRNA,15,1239668,318,1.00
ptg013236l,211017,211298,281,EVM,mRNA,88283,225980,281,1.00
ptg013236l,695674,695944,270,EVM,mRNA,278362,877240,270,1.00
ptg013240l,1393894,1394219,325,EVM,mRNA,633139,1746260,325,1.00
ptg013240l,1655411,1655730,319,EVM,mRNA,633139,1746260,319,1.00
ptg013242l,93323,93609,286,EVM,mRNA,15846,378299,286,1.00
ptg013251l,853953,854272,319,EVM,mRNA,851582,1624692,319,1.00
ptg013251l,903189,903503,314,EVM,mRNA,851582,1624692,314,1.00
ptg013251l,1439398,1439665,267,EVM,mRNA,851582,1624692,267,1.00
ptg013252l,607796,608096,300,EVM,mRNA,485499,2230695,300,1.00
ptg013252l,1055907,1056220,313,EVM,mRNA,485499,2230695,313,1.00
ptg013252l,1091862,1092148,286,EVM,mRNA,485499,2230695,286,1.00
ptg013252l,1216757,1217062,305,EVM,mRNA,485499,2230695,305,1.00
ptg013252l,1737476,1737768,292,EVM,mRNA,485499,2230695,292,1.00
ptg013252l,1968656,1968941,285,EVM,mRNA,485499,2230695,285,1.00
ptg013254l,320883,321189,306,EVM,mRNA,71767,1797303,306,1.00
ptg013254l,358163,358464,301,EVM,mRNA,71767,1797303,301,1.00
ptg013258l,489781,490079,298,EVM,mRNA,280324,526870,298,1.00
ptg013282l,665412,665696,284,EVM,mRNA,655978,2855956,284,1.00
ptg013282l,1393042,1393363,321,EVM,mRNA,655978,2855956,321,1.00
ptg013282l,2092444,2092700,256,EVM,mRNA,655978,2855956,256,1.00
ptg013282l,2805659,2805958,299,EVM,mRNA,655978,2855956,299,1.00
ptg013284l,425551,425836,285,EVM,mRNA,149810,458377,285,1.00
ptg013292l,142570,142879,309,EVM,mRNA,126541,475990,309,1.00
ptg013294l,392418,392721,303,EVM,mRNA,209880,658235,303,1.00
ptg013299l,239972,240277,305,EVM,mRNA,87512,302821,305,1.00
ptg013302l,182364,182665,301,EVM,mRNA,64347,296112,301,1.00
ptg013302l,401652,401941,289,EVM,mRNA,361935,485676,289,1.00
ptg013311l,70314,70597,283,EVM,mRNA,20724,528711,283,1.00
ptg013311l,141636,141944,308,EVM,mRNA,20724,528711,308,1.00
ptg013311l,1713297,1713596,299,EVM,mRNA,1665607,1799141,299,1.00
ptg013318l,207024,207303,279,EVM,mRNA,160118,256043,279,1.00
ptg013320l,393796,394112,316,EVM,mRNA,24151,978773,316,1.00
ptg013323l,186665,187000,335,EVM,mRNA,6000,224266,335,1.00
ptg013323l,223271,223591,320,EVM,mRNA,6000,224266,320,1.00
ptg013323l,662191,662504,313,EVM,mRNA,329813,712800,313,1.00
ptg013323l,689606,689903,297,EVM,mRNA,329813,712800,297,1.00
ptg013326l,822170,822460,290,EVM,mRNA,257090,1150963,290,1.00
ptg013326l,850364,850697,333,EVM,mRNA,257090,1150963,333,1.00
ptg013326l,865877,866166,289,EVM,mRNA,257090,1150963,289,1.00
ptg013332l,1753837,1754142,305,EVM,mRNA,754831,3344645,305,1.00
ptg013332l,1831828,1832103,275,EVM,mRNA,754831,3344645,275,1.00
ptg013332l,2340833,2341127,294,EVM,mRNA,754831,3344645,294,1.00
ptg013332l,2377213,2377505,292,EVM,mRNA,754831,3344645,292,1.00
ptg013343l,118252,118537,285,EVM,mRNA,47598,270502,285,1.00
ptg013346l,94147,94416,269,EVM,mRNA,55740,280800,269,1.00
ptg013347l,389245,389571,326,EVM,mRNA,85507,896451,326,1.00
ptg013347l,710037,710372,335,EVM,mRNA,85507,896451,335,1.00
ptg013353l,632670,632946,276,EVM,mRNA,608273,960624,276,1.00
ptg013362l,1134550,1134809,259,EVM,mRNA,535907,1229061,259,1.00
ptg013364l,306529,306842,313,EVM,mRNA,110507,405318,313,1.00
ptg013364l,392418,392706,288,EVM,mRNA,110507,405318,288,1.00
ptg013365l,274136,274402,266,EVM,mRNA,216,584465,266,1.00
ptg013366l,69506,69814,308,EVM,mRNA,52827,92152,308,1.00
ptg013369l,1058992,1059289,297,EVM,mRNA,953546,2300881,297,1.00
ptg013375l,2573006,2573322,316,EVM,mRNA,811197,2747461,316,1.00
ptg013382l,1952196,1952519,323,EVM,mRNA,545757,2445568,323,1.00
ptg013389l,417555,417860,305,EVM,mRNA,303449,547809,305,1.00
ptg013389l,463632,463918,286,EVM,mRNA,303449,547809,286,1.00
ptg013389l,877189,877488,299,EVM,mRNA,678973,1125569,299,1.00
ptg013389l,1065247,1065542,295,EVM,mRNA,678973,1125569,295,1.00
ptg013390l,97217,97505,288,EVM,mRNA,63274,100301,288,1.00
ptg013393l,1661281,1661580,299,EVM,mRNA,1648266,2209768,299,1.00
ptg013397l,615019,615342,323,EVM,mRNA,274215,955701,323,1.00
ptg013417l,846213,846490,277,EVM,mRNA,381790,959074,277,1.00
ptg013420l,96710,97001,291,EVM,mRNA,65626,195862,291,1.00
ptg013425l,749174,749468,294,EVM,mRNA,379036,841709,294,1.00
ptg013427l,1453815,1454117,302,EVM,mRNA,112348,1549481,302,1.00
ptg013431l,1297130,1297441,311,EVM,mRNA,493497,1386125,311,1.00
ptg013438l,1231780,1232094,314,EVM,mRNA,626073,1478667,314,1.00
ptg013438l,1290571,1290851,280,EVM,mRNA,626073,1478667,280,1.00
ptg013444l,409486,409784,298,EVM,mRNA,327854,788659,298,1.00
ptg013444l,738841,739127,286,EVM,mRNA,327854,788659,286,1.00
ptg013444l,1149552,1149857,305,EVM,mRNA,982185,1742465,305,1.00
ptg013448l,448151,448446,295,EVM,mRNA,378996,740223,295,1.00
ptg013451l,1460205,1460503,298,EVM,mRNA,231382,1755517,298,1.00
ptg013466l,36152,36446,294,EVM,mRNA,25895,971014,294,1.00
ptg013466l,775602,775890,288,EVM,mRNA,25895,971014,288,1.00
ptg013466l,901903,902201,298,EVM,mRNA,25895,971014,298,1.00
ptg013470l,412998,413293,295,EVM,mRNA,116427,680085,295,1.00
ptg013473l,3044589,3044886,297,EVM,mRNA,2887311,3610627,297,1.00
ptg013485l,757616,757932,316,EVM,mRNA,342842,786339,316,1.00
ptg013491l,200739,201026,287,EVM,mRNA,198036,4239427,287,1.00
ptg013491l,589468,589782,314,EVM,mRNA,198036,4239427,314,1.00
ptg013491l,656073,656378,305,EVM,mRNA,198036,4239427,305,1.00
ptg013491l,843825,844106,281,EVM,mRNA,198036,4239427,281,1.00
ptg013491l,1560823,1561151,328,EVM,mRNA,198036,4239427,328,1.00
ptg013491l,1601359,1601686,327,EVM,mRNA,198036,4239427,327,1.00
ptg013491l,3648675,3648992,317,EVM,mRNA,198036,4239427,317,1.00
ptg013491l,4104692,4104994,302,EVM,mRNA,198036,4239427,302,1.00
ptg013497l,832969,833246,277,EVM,mRNA,795985,837316,277,1.00
ptg013501l,348411,348712,301,EVM,mRNA,327479,742063,301,1.00
ptg013501l,1074986,1075254,268,EVM,mRNA,991733,1444974,268,1.00
ptg013502l,1391392,1391676,284,EVM,mRNA,1043034,2064707,284,1.00
ptg013502l,4354044,4354344,300,EVM,mRNA,4284862,4812516,300,1.00
ptg013502l,4696726,4697006,280,EVM,mRNA,4284862,4812516,280,1.00
ptg013505l,819845,820144,299,EVM,mRNA,153018,849415,299,1.00
ptg013506l,542223,542553,330,EVM,mRNA,287673,1183178,330,1.00
ptg013512l,192226,192522,296,EVM,mRNA,4988,830625,296,1.00
ptg013513l,1626276,1626570,294,EVM,mRNA,1304207,2548918,294,1.00
ptg013526l,2036493,2036811,318,EVM,mRNA,1511814,2551562,318,1.00
ptg013526l,2079747,2080063,316,EVM,mRNA,1511814,2551562,316,1.00
ptg013528l,54491,54791,300,EVM,mRNA,25108,1926472,300,1.00
ptg013528l,366594,366921,327,EVM,mRNA,25108,1926472,327,1.00
ptg013532l,55973,56289,316,EVM,mRNA,1854,1447741,316,1.00
ptg013537l,1930505,1930802,297,EVM,mRNA,1751570,1958381,297,1.00
ptg013541l,445622,445921,299,EVM,mRNA,321844,1367146,299,1.00
ptg013541l,942027,942327,300,EVM,mRNA,321844,1367146,300,1.00
ptg013541l,1070866,1071162,296,EVM,mRNA,321844,1367146,296,1.00
ptg013541l,1353822,1354131,309,EVM,mRNA,321844,1367146,309,1.00
ptg013541l,2230654,2230929,275,EVM,mRNA,1881285,2409915,275,1.00
ptg013545l,408391,408680,289,EVM,mRNA,919,412440,289,1.00
ptg013546l,711129,711434,305,EVM,mRNA,228436,1124159,305,1.00
ptg013546l,1010019,1010344,325,EVM,mRNA,228436,1124159,325,1.00
ptg013552l,1158867,1159144,277,EVM,mRNA,280558,1159878,277,1.00
ptg013571l,305293,305575,282,EVM,mRNA,195365,660106,282,1.00
ptg013576l,473534,473820,286,EVM,mRNA,243950,1110227,286,1.00
ptg013576l,625134,625433,299,EVM,mRNA,243950,1110227,299,1.00
ptg013576l,1093341,1093648,307,EVM,mRNA,243950,1110227,307,1.00
ptg013578l,1475621,1475936,315,EVM,mRNA,24474,1494095,315,1.00
ptg013582l,1191620,1191902,282,EVM,mRNA,1118631,1201587,282,1.00
ptg013583l,1884022,1884306,284,EVM,mRNA,1249308,2125959,284,1.00
ptg013591l,296024,296320,296,EVM,mRNA,204355,2525815,296,1.00
ptg013591l,653387,653691,304,EVM,mRNA,204355,2525815,304,1.00
ptg013591l,1260340,1260651,311,EVM,mRNA,204355,2525815,311,1.00
ptg013591l,1528529,1528804,275,EVM,mRNA,204355,2525815,275,1.00
ptg013591l,1778165,1778486,321,EVM,mRNA,204355,2525815,321,1.00
ptg013591l,2349317,2349637,320,EVM,mRNA,204355,2525815,320,1.00
ptg013597l,100682,100982,300,EVM,mRNA,86674,236824,300,1.00
ptg013599l,941873,942191,318,EVM,mRNA,454856,1009626,318,1.00
ptg013601l,295480,295793,313,EVM,mRNA,113405,1147952,313,1.00
ptg013601l,530425,530723,298,EVM,mRNA,113405,1147952,298,1.00
ptg013601l,760486,760816,330,EVM,mRNA,113405,1147952,330,1.00
ptg013602l,358543,358819,276,EVM,mRNA,238720,780719,276,1.00
ptg013602l,672559,672830,271,EVM,mRNA,238720,780719,271,1.00
ptg013604l,1130176,1130488,312,EVM,mRNA,214072,1730223,312,1.00
ptg013605l,594514,594799,285,EVM,mRNA,157747,871298,285,1.00
ptg013605l,730463,730759,296,EVM,mRNA,157747,871298,296,1.00
ptg013608l,299749,300067,318,EVM,mRNA,33686,853106,318,1.00
ptg013608l,695880,696179,299,EVM,mRNA,33686,853106,299,1.00
ptg013610l,227626,227925,299,EVM,mRNA,6350,330226,299,1.00
ptg013613l,859648,859927,279,EVM,mRNA,368172,1705590,279,1.00
ptg013613l,1900302,1900609,307,GeneWise,mRNA,1755766,1900319,17,0.06
ptg013614l,294411,294691,280,EVM,mRNA,243436,2549273,280,1.00
ptg013614l,1231207,1231509,302,EVM,mRNA,243436,2549273,302,1.00
ptg013614l,1797448,1797772,324,EVM,mRNA,243436,2549273,324,1.00
ptg013614l,3346959,3347251,292,EVM,mRNA,3331502,3426399,292,1.00
ptg013622l,40505,40822,317,EVM,mRNA,8401,207494,317,1.00
ptg013629l,802968,803267,299,EVM,mRNA,211219,1303307,299,1.00
ptg013629l,1069950,1070236,286,EVM,mRNA,211219,1303307,286,1.00
ptg013631l,88555,88869,314,EVM,mRNA,68321,147340,314,1.00
ptg013642l,845847,846136,289,EVM,mRNA,442727,1315379,289,1.00
ptg013652l,1953404,1953700,296,EVM,mRNA,1904105,2146861,296,1.00
ptg013653l,157265,157587,322,EVM,mRNA,14305,292278,322,1.00
ptg013656l,188643,188944,301,EVM,mRNA,24829,533107,301,1.00
ptg013656l,399046,399364,318,EVM,mRNA,24829,533107,318,1.00
ptg013660l,1503462,1503778,316,EVM,mRNA,1411667,1570830,316,1.00
ptg013661l,710593,710906,313,EVM,mRNA,392105,2863690,313,1.00
ptg013661l,1209844,1210130,286,EVM,mRNA,392105,2863690,286,1.00
ptg013661l,1956064,1956368,304,EVM,mRNA,392105,2863690,304,1.00
ptg013661l,2751754,2752074,320,EVM,mRNA,392105,2863690,320,1.00
ptg013663l,351871,352189,318,EVM,mRNA,104420,407085,318,1.00
ptg013668l,200865,201167,302,EVM,mRNA,20941,507685,302,1.00
ptg013670l,620104,620411,307,EVM,mRNA,552501,814866,307,1.00
ptg013670l,776048,776374,326,EVM,mRNA,552501,814866,326,1.00
ptg013671l,564707,564972,265,EVM,mRNA,496788,618889,265,1.00
ptg013674l,1049980,1050277,297,EVM,mRNA,1033906,1076709,297,1.00
ptg013678l,334464,334773,309,EVM,mRNA,8636,912035,309,1.00
ptg013682l,838308,838633,325,EVM,mRNA,360035,1153951,325,1.00
ptg013697l,445529,445838,309,EVM,mRNA,306234,494789,309,1.00
ptg013699l,534938,535210,272,EVM,mRNA,488281,1063560,272,1.00
ptg013708l,564401,564703,302,EVM,mRNA,7139,1209425,302,1.00
ptg013712l,125327,125641,314,EVM,mRNA,313,485618,314,1.00
ptg013712l,187100,187434,334,EVM,mRNA,313,485618,334,1.00
ptg013714l,239731,240011,280,EVM,mRNA,97092,326687,280,1.00
ptg013716l,449739,450049,310,EVM,mRNA,420727,457321,310,1.00
ptg013717l,400543,400834,291,EVM,mRNA,342343,602307,291,1.00
ptg013718l,390241,390574,333,EVM,mRNA,179909,394990,333,1.00
ptg013721l,539860,540159,299,EVM,mRNA,64841,1097062,299,1.00
ptg013731l,2489638,2489943,305,EVM,mRNA,1494287,2557937,305,1.00
ptg013731l,2522461,2522787,326,EVM,mRNA,1494287,2557937,326,1.00
ptg013736l,67033,67345,312,EVM,mRNA,28575,121464,312,1.00
ptg013736l,198812,199075,263,EVM,mRNA,141332,883350,263,1.00
ptg013739l,41131,41439,308,EVM,mRNA,3886,271445,308,1.00
ptg013739l,102247,102523,276,EVM,mRNA,3886,271445,276,1.00
ptg013747l,1100080,1100366,286,EVM,mRNA,340985,1352190,286,1.00
ptg013748l,1323163,1323451,288,EVM,mRNA,1314256,1738305,288,1.00
ptg013754l,497447,497761,314,EVM,mRNA,115542,514907,314,1.00
ptg013762l,877468,877777,309,EVM,mRNA,584497,1614304,309,1.00
ptg013770l,464341,464636,295,EVM,mRNA,84214,740953,295,1.00
ptg013778l,624170,624469,299,EVM,mRNA,101595,1029874,299,1.00
ptg013784l,734175,734486,311,EVM,mRNA,413810,1796502,311,1.00
ptg013787l,428548,428857,309,EVM,mRNA,391765,2060252,309,1.00
ptg013787l,1861600,1861903,303,EVM,mRNA,391765,2060252,303,1.00
ptg013791l,246913,247222,309,EVM,mRNA,164086,863612,309,1.00
ptg013800l,328610,328892,282,EVM,mRNA,310936,742981,282,1.00
ptg013800l,356674,356972,298,EVM,mRNA,310936,742981,298,1.00
ptg013810l,554104,554404,300,EVM,mRNA,354211,1495055,300,1.00
ptg013812l,997061,997358,297,EVM,mRNA,404111,1162248,297,1.00
ptg013817l,987403,987691,288,EVM,mRNA,21279,1220618,288,1.00
ptg013824l,375418,375713,295,EVM,mRNA,291815,660698,295,1.00
ptg013833l,142975,143291,316,EVM,mRNA,901,270668,316,1.00
ptg013833l,194756,195029,273,EVM,mRNA,901,270668,273,1.00
ptg013880l,532137,532452,315,EVM,mRNA,102081,620119,315,1.00
ptg013882l,207927,208202,275,EVM,mRNA,1084,552576,275,1.00
ptg013882l,1143325,1143633,308,EVM,mRNA,1007440,2177364,308,1.00
ptg013883l,312912,313214,302,EVM,mRNA,127232,596203,302,1.00
ptg013890l,2600582,2600904,322,EVM,mRNA,2186713,2605269,322,1.00
ptg013890l,2836420,2836697,277,EVM,mRNA,2799101,4405110,277,1.00
ptg013894l,3175755,3176036,281,EVM,mRNA,2577812,3237768,281,1.00
ptg013894l,3190024,3190322,298,EVM,mRNA,2577812,3237768,298,1.00
ptg013897l,694318,694605,287,EVM,mRNA,353187,1356644,287,1.00
ptg013897l,1061750,1062056,306,EVM,mRNA,353187,1356644,306,1.00
ptg013905l,835459,835757,298,EVM,mRNA,13026,3214366,298,1.00
ptg013909l,546586,546873,287,EVM,mRNA,542838,1038391,287,1.00
ptg013915l,702540,702858,318,EVM,mRNA,605976,857529,318,1.00
ptg013929l,423624,423937,313,EVM,mRNA,90117,489762,313,1.00
ptg013929l,489728,489976,248,EVM,mRNA,90117,489762,34,0.14
ptg013937l,346096,346395,299,EVM,mRNA,41535,470346,299,1.00
ptg013943l,484427,484742,315,EVM,mRNA,359467,619482,315,1.00
ptg013943l,703738,704065,327,EVM,mRNA,688336,1465108,327,1.00
ptg013943l,783085,783380,295,EVM,mRNA,688336,1465108,295,1.00
ptg013943l,976582,976906,324,EVM,mRNA,688336,1465108,324,1.00
ptg013943l,1246160,1246476,316,EVM,mRNA,688336,1465108,316,1.00
ptg013944l,1056910,1057209,299,EVM,mRNA,546675,1283310,299,1.00
ptg013944l,1274430,1274751,321,EVM,mRNA,546675,1283310,321,1.00
ptg013948l,1010184,1010490,306,EVM,mRNA,945203,1595208,306,1.00
ptg013951l,163318,163613,295,EVM,mRNA,25251,288305,295,1.00
ptg013953l,872124,872407,283,EVM,mRNA,522703,1075428,283,1.00
ptg013954l,185385,185657,272,EVM,mRNA,101893,374285,272,1.00
ptg013955l,1117315,1117619,304,EVM,mRNA,92023,1368828,304,1.00
ptg013956l,928695,928979,284,EVM,mRNA,837441,976851,284,1.00
ptg013960l,527885,528195,310,EVM,mRNA,462917,545651,310,1.00
ptg013964l,242972,243291,319,EVM,mRNA,4494,510742,319,1.00
ptg013968l,1129808,1130120,312,EVM,mRNA,870049,1403419,312,1.00
ptg013968l,1163666,1163975,309,EVM,mRNA,870049,1403419,309,1.00
ptg013968l,1207906,1208185,279,EVM,mRNA,870049,1403419,279,1.00
ptg013971l,221340,221645,305,EVM,mRNA,91412,547190,305,1.00
ptg013982l,1461406,1461708,302,EVM,mRNA,1454258,1612938,302,1.00
ptg013993l,1343467,1343792,325,EVM,mRNA,1290029,1578743,325,1.00
ptg013999l,536188,536504,316,EVM,mRNA,23208,604669,316,1.00
ptg014005l,487157,487435,278,EVM,mRNA,85814,489163,278,1.00
ptg014021l,388421,388728,307,EVM,mRNA,87486,961608,307,1.00
ptg014021l,686875,687169,294,EVM,mRNA,87486,961608,294,1.00
ptg014021l,1715188,1715491,303,EVM,mRNA,1313854,1892683,303,1.00
ptg014024l,446029,446361,332,EVM,mRNA,21993,942063,332,1.00
ptg014046l,1510342,1510617,275,EVM,mRNA,389330,2606830,275,1.00
ptg014048l,684157,684455,298,EVM,mRNA,33631,1106434,298,1.00
ptg014053l,92759,93084,325,EVM,mRNA,763,237897,325,1.00
ptg014053l,736113,736382,269,EVM,mRNA,373852,1456090,269,1.00
ptg014053l,809544,809837,293,EVM,mRNA,373852,1456090,293,1.00
ptg014054l,111293,111607,314,EVM,mRNA,7154,527598,314,1.00
ptg014054l,270987,271270,283,EVM,mRNA,7154,527598,283,1.00
ptg014055l,476270,476585,315,EVM,mRNA,453423,500710,315,1.00
ptg014061l,163401,163729,328,EVM,mRNA,51,308761,328,1.00
ptg014062l,835725,836007,282,EVM,mRNA,764437,1360800,282,1.00
ptg014065l,1330122,1330426,304,EVM,mRNA,264027,1898139,304,1.00
ptg014065l,1492397,1492737,340,EVM,mRNA,264027,1898139,340,1.00
ptg014068l,506289,506576,287,EVM,mRNA,45481,945665,287,1.00
ptg014068l,698680,698975,295,EVM,mRNA,45481,945665,295,1.00
ptg014069l,297243,297555,312,EVM,mRNA,81741,404054,312,1.00
ptg014072l,394254,394556,302,EVM,mRNA,381209,1993064,302,1.00
ptg014072l,694927,695260,333,EVM,mRNA,381209,1993064,333,1.00
ptg014072l,1412094,1412419,325,EVM,mRNA,381209,1993064,325,1.00
ptg014072l,1821101,1821414,313,EVM,mRNA,381209,1993064,313,1.00
ptg014074l,342796,343072,276,EVM,mRNA,54982,388038,276,1.00
ptg014076l,1379288,1379568,280,EVM,mRNA,150186,2649636,280,1.00
ptg014076l,1427207,1427508,301,EVM,mRNA,150186,2649636,301,1.00
ptg014076l,2081212,2081528,316,EVM,mRNA,150186,2649636,316,1.00
ptg014076l,2449450,2449739,289,EVM,mRNA,150186,2649636,289,1.00
ptg014078l,810484,810781,297,EVM,mRNA,128217,1107273,297,1.00
ptg014078l,1011831,1012152,321,EVM,mRNA,128217,1107273,321,1.00
ptg014081l,187772,188081,309,EVM,mRNA,40485,792996,309,1.00
ptg014095l,362628,362918,290,EVM,mRNA,10038,764209,290,1.00
ptg014101l,687451,687749,298,EVM,mRNA,26061,1748511,298,1.00
ptg014101l,1550210,1550502,292,EVM,mRNA,26061,1748511,292,1.00
ptg014102l,583653,583959,306,EVM,mRNA,143536,1218565,306,1.00
ptg014102l,1562647,1562937,290,EVM,mRNA,1372292,1650950,290,1.00
ptg014104l,248429,248718,289,EVM,mRNA,2843,778488,289,1.00
ptg014104l,616775,617103,328,EVM,mRNA,2843,778488,328,1.00
ptg014107l,206170,206470,300,EVM,mRNA,3904,870348,300,1.00
ptg014107l,613211,613512,301,EVM,mRNA,3904,870348,301,1.00
ptg014107l,839012,839335,323,EVM,mRNA,3904,870348,323,1.00
ptg014113l,123441,123765,324,EVM,mRNA,50564,277224,324,1.00
ptg014118l,265306,265600,294,EVM,mRNA,217050,600013,294,1.00
ptg014122l,324917,325206,289,EVM,mRNA,97171,379592,289,1.00
ptg014123l,419644,419924,280,EVM,mRNA,339436,573429,280,1.00
ptg014128l,511002,511328,326,EVM,mRNA,173871,786543,326,1.00
ptg014128l,1031720,1032005,285,EVM,mRNA,862862,1112426,285,1.00
ptg014128l,1174350,1174687,337,EVM,mRNA,1154697,1315243,337,1.00
ptg014128l,1849221,1849542,321,EVM,mRNA,1490774,1896113,321,1.00
ptg014128l,2130806,2131133,327,EVM,mRNA,2055197,2133629,327,1.00
ptg014133l,484630,484918,288,EVM,mRNA,137598,563824,288,1.00
ptg014141l,658357,658656,299,EVM,mRNA,453620,907655,299,1.00
ptg014141l,1041401,1041659,258,EVM,mRNA,946173,1204730,258,1.00
ptg014164l,439644,439959,315,EVM,mRNA,72074,918703,315,1.00
ptg014164l,440848,441122,274,EVM,mRNA,72074,918703,274,1.00
ptg014171l,290636,290957,321,EVM,mRNA,265627,906615,321,1.00
ptg014172l,1427404,1427732,328,EVM,mRNA,673610,3244746,328,1.00
ptg014172l,2113040,2113345,305,EVM,mRNA,673610,3244746,305,1.00
ptg014172l,2407125,2407404,279,EVM,mRNA,673610,3244746,279,1.00
ptg014172l,3148658,3148943,285,EVM,mRNA,673610,3244746,285,1.00
ptg014172l,3204162,3204442,280,EVM,mRNA,673610,3244746,280,1.00
ptg014172l,3209243,3209570,327,EVM,mRNA,673610,3244746,327,1.00
ptg014174l,147329,147651,322,EVM,mRNA,122002,195574,322,1.00
ptg014174l,2852528,2852861,333,EVM,mRNA,1171397,3638780,333,1.00
ptg014179l,164246,164581,335,EVM,mRNA,36418,2445916,335,1.00
ptg014179l,2352826,2353130,304,EVM,mRNA,36418,2445916,304,1.00
ptg014183l,417153,417460,307,EVM,mRNA,7248,1132679,307,1.00
ptg014194l,667139,667411,272,EVM,mRNA,551744,995531,272,1.00
ptg014194l,798628,798934,306,EVM,mRNA,551744,995531,306,1.00
ptg014209l,696487,696823,336,EVM,mRNA,34300,956116,336,1.00
ptg014213l,724699,724982,283,EVM,mRNA,665707,1562660,283,1.00
ptg014221l,193135,193433,298,EVM,mRNA,130714,341072,298,1.00
ptg014235l,305913,306193,280,EVM,mRNA,303601,596334,280,1.00
ptg014235l,397788,398102,314,EVM,mRNA,303601,596334,314,1.00
ptg014239l,762213,762491,278,EVM,mRNA,19114,839289,278,1.00
ptg014246l,500263,500573,310,EVM,mRNA,114540,1079167,310,1.00
ptg014248l,277647,277930,283,EVM,mRNA,220744,808945,283,1.00
ptg014250l,439315,439620,305,EVM,mRNA,187189,917167,305,1.00
ptg014251l,851008,851287,279,EVM,mRNA,62557,1719880,279,1.00
ptg014251l,1255337,1255648,311,EVM,mRNA,62557,1719880,311,1.00
ptg014263l,832953,833271,318,EVM,mRNA,605422,1389578,318,1.00
ptg014267l,830618,830923,305,EVM,mRNA,475298,1422848,305,1.00
ptg014269l,303914,304231,317,EVM,mRNA,147821,993193,317,1.00
ptg014309l,336807,337087,280,EVM,mRNA,55615,783918,280,1.00
ptg014309l,550449,550767,318,EVM,mRNA,55615,783918,318,1.00
ptg014321l,341420,341754,334,EVM,mRNA,10285,422961,334,1.00
ptg014325l,1169004,1169295,291,EVM,mRNA,395982,1184019,291,1.00
ptg014327l,313034,313296,262,EVM,mRNA,17281,592898,262,1.00
ptg014327l,391741,392043,302,EVM,mRNA,17281,592898,302,1.00
ptg014327l,1323445,1323758,313,EVM,mRNA,1281162,1346822,313,1.00
ptg014337l,463818,464122,304,EVM,mRNA,452088,481581,304,1.00
ptg014342l,645231,645544,313,EVM,mRNA,505281,1202233,313,1.00
ptg014342l,1196877,1197179,302,EVM,mRNA,505281,1202233,302,1.00
ptg014342l,2125852,2126152,300,EVM,mRNA,2125994,3135032,159,0.53
ptg014352l,2173557,2173866,309,EVM,mRNA,939244,3315313,309,1.00
ptg014352l,3795422,3795720,298,EVM,mRNA,3621743,3868587,298,1.00
ptg014353l,276242,276541,299,EVM,mRNA,11391,1181661,299,1.00
ptg014353l,700543,700853,310,EVM,mRNA,11391,1181661,310,1.00
ptg014355l,1137403,1137723,320,EVM,mRNA,1118209,1513747,320,1.00
ptg014355l,1155327,1155623,296,EVM,mRNA,1118209,1513747,296,1.00
ptg014358l,289415,289706,291,EVM,mRNA,131695,553060,291,1.00
ptg014367l,1118318,1118639,321,EVM,mRNA,1042708,1702670,321,1.00
ptg014367l,1245282,1245617,335,EVM,mRNA,1042708,1702670,335,1.00
ptg014367l,1306849,1307157,308,EVM,mRNA,1042708,1702670,308,1.00
ptg014367l,1445127,1445412,285,EVM,mRNA,1042708,1702670,285,1.00
ptg014372l,472760,473087,327,EVM,mRNA,399493,729756,327,1.00
ptg014376l,188470,188738,268,EVM,mRNA,48654,1271998,268,1.00
ptg014376l,242421,242689,268,EVM,mRNA,48654,1271998,268,1.00
ptg014376l,943462,943791,329,EVM,mRNA,48654,1271998,329,1.00
ptg014384l,480119,480415,296,EVM,mRNA,45139,983234,296,1.00
ptg014387l,1548432,1548745,313,EVM,mRNA,1526535,1578654,313,1.00
ptg014396l,321750,322039,289,EVM,mRNA,15900,786278,289,1.00
ptg014404l,25215,25516,301,EVM,mRNA,2497,307870,301,1.00
ptg014406l,1070255,1070589,334,EVM,mRNA,858413,2657881,334,1.00
ptg014406l,2462277,2462551,274,EVM,mRNA,858413,2657881,274,1.00
ptg014408l,437901,438216,315,EVM,mRNA,408872,728092,315,1.00
ptg014412l,383250,383541,291,EVM,mRNA,94421,433207,291,1.00
ptg014421l,1528624,1528910,286,EVM,mRNA,1188109,1925451,286,1.00
ptg014421l,1765909,1766249,340,EVM,mRNA,1188109,1925451,340,1.00
ptg014421l,1834495,1834793,298,EVM,mRNA,1188109,1925451,298,1.00
ptg014429l,400664,400985,321,EVM,mRNA,318924,695086,321,1.00
ptg014429l,694942,695283,341,EVM,mRNA,318924,695086,144,0.42
ptg014440l,338066,338365,299,EVM,mRNA,104473,455576,299,1.00
ptg014452l,2106795,2107103,308,EVM,mRNA,2057734,2112034,308,1.00
ptg014456l,473970,474257,287,EVM,mRNA,13359,1222538,287,1.00
ptg014458l,861098,861407,309,EVM,mRNA,841304,1646788,309,1.00
ptg014458l,928753,929051,298,EVM,mRNA,841304,1646788,298,1.00
ptg014458l,1080645,1080957,312,EVM,mRNA,841304,1646788,312,1.00
ptg014464l,244532,244842,310,EVM,mRNA,103561,682525,310,1.00
ptg014465l,112043,112334,291,EVM,mRNA,42286,269312,291,1.00
ptg014467l,1383005,1383309,304,EVM,mRNA,70089,3079893,304,1.00
ptg014467l,2606686,2606997,311,EVM,mRNA,70089,3079893,311,1.00
ptg014467l,2738055,2738347,292,EVM,mRNA,70089,3079893,292,1.00
ptg014470l,70436,70706,270,EVM,mRNA,22902,166996,270,1.00
ptg014476l,1718578,1718823,245,EVM,mRNA,88067,1900758,245,1.00
ptg014485l,399482,399788,306,EVM,mRNA,372662,736024,306,1.00
ptg014485l,425480,425796,316,EVM,mRNA,372662,736024,316,1.00
ptg014485l,2179546,2179841,295,EVM,mRNA,2007363,2270511,295,1.00
ptg014491l,107921,108248,327,EVM,mRNA,40589,888720,327,1.00
ptg014491l,173731,174042,311,EVM,mRNA,40589,888720,311,1.00
ptg014507l,534233,534552,319,EVM,mRNA,5968,1372984,319,1.00
ptg014507l,714110,714394,284,EVM,mRNA,5968,1372984,284,1.00
ptg014507l,1550798,1551106,308,EVM,mRNA,1503144,1595311,308,1.00
ptg014519l,1095802,1096066,264,EVM,mRNA,395482,1290931,264,1.00
ptg014519l,1220105,1220440,335,EVM,mRNA,395482,1290931,335,1.00
ptg014538l,61548,61873,325,EVM,mRNA,10402,1111656,325,1.00
ptg014538l,335045,335361,316,EVM,mRNA,10402,1111656,316,1.00
ptg014550l,196266,196570,304,EVM,mRNA,94118,555882,304,1.00
ptg014550l,509682,509996,314,EVM,mRNA,94118,555882,314,1.00
ptg014551l,18040,18332,292,EVM,mRNA,13124,121926,292,1.00
ptg014551l,856335,856660,325,EVM,mRNA,463956,1637058,325,1.00
ptg014551l,1907671,1907959,288,EVM,mRNA,1767106,2442058,288,1.00
ptg014559l,416060,416355,295,EVM,mRNA,45996,2195150,295,1.00
ptg014559l,729837,730136,299,EVM,mRNA,45996,2195150,299,1.00
ptg014575l,673368,673681,313,EVM,mRNA,511794,690430,313,1.00
ptg014583l,1273855,1274157,302,EVM,mRNA,1259570,1563643,302,1.00
ptg014592l,1042964,1043263,299,EVM,mRNA,566424,1369632,299,1.00
ptg014592l,1186934,1187215,281,EVM,mRNA,566424,1369632,281,1.00
ptg014594l,947357,947687,330,EVM,mRNA,627646,1098049,330,1.00
ptg014597l,110865,111138,273,EVM,mRNA,104453,356611,273,1.00
ptg014597l,845736,846005,269,EVM,mRNA,727979,1332944,269,1.00
ptg014599l,388798,389128,330,EVM,mRNA,270177,608004,330,1.00
ptg014599l,1887552,1887863,311,EVM,mRNA,1238298,2079585,311,1.00
ptg014602l,937153,937460,307,EVM,mRNA,704072,1103384,307,1.00
ptg014607l,262395,262660,265,EVM,mRNA,127279,314935,265,1.00
ptg014611l,245518,245824,306,EVM,mRNA,47707,334121,306,1.00
ptg014611l,605574,605877,303,EVM,mRNA,506115,644898,303,1.00
ptg014611l,1048102,1048426,324,EVM,mRNA,705813,1066473,324,1.00
ptg014613l,434675,434953,278,EVM,mRNA,23756,679404,278,1.00
ptg014623l,312447,312773,326,EVM,mRNA,824,340917,326,1.00
ptg014629l,151483,151798,315,EVM,mRNA,81903,163615,315,1.00
ptg014629l,152875,153185,310,EVM,mRNA,81903,163615,310,1.00
ptg014629l,156044,156317,273,EVM,mRNA,81903,163615,273,1.00
ptg014632l,1503124,1503419,295,EVM,mRNA,1274636,1573255,295,1.00
ptg014633l,1955409,1955738,329,EVM,mRNA,1625836,2077283,329,1.00
ptg014634l,817387,817690,303,EVM,mRNA,732167,1443850,303,1.00
ptg014638l,1042145,1042476,331,EVM,mRNA,722319,1269913,331,1.00
ptg014638l,1224472,1224781,309,EVM,mRNA,722319,1269913,309,1.00
ptg014638l,1231245,1231530,285,EVM,mRNA,722319,1269913,285,1.00
ptg014650l,1079903,1080185,282,EVM,mRNA,71161,1490508,282,1.00
ptg014650l,1125264,1125563,299,EVM,mRNA,71161,1490508,299,1.00
ptg014656l,368897,369161,264,EVM,mRNA,142568,502920,264,1.00
ptg014663l,395926,396225,299,EVM,mRNA,167972,589224,299,1.00
ptg014669l,534246,534545,299,EVM,mRNA,509819,559914,299,1.00
ptg014670l,594762,595085,323,EVM,mRNA,500490,598086,323,1.00
ptg014673l,54346,54661,315,EVM,mRNA,13116,503320,315,1.00
ptg014673l,258571,258875,304,EVM,mRNA,13116,503320,304,1.00
ptg014677l,615420,615701,281,EVM,mRNA,250162,904608,281,1.00
ptg014677l,640654,640930,276,EVM,mRNA,250162,904608,276,1.00
ptg014677l,2879495,2879744,249,EVM,mRNA,1076097,2960492,249,1.00
ptg014682l,1069680,1070003,323,EVM,mRNA,939862,1141134,323,1.00
ptg014685l,1238432,1238751,319,EVM,mRNA,1081766,1248231,319,1.00
ptg014688l,633828,634064,236,EVM,mRNA,521829,1024570,236,1.00
ptg014694l,406021,406348,327,EVM,mRNA,217832,653923,327,1.00
ptg014703l,530728,531040,312,EVM,mRNA,50223,1359806,312,1.00
ptg014703l,1219131,1219427,296,EVM,mRNA,50223,1359806,296,1.00
ptg014703l,2444662,2444986,324,EVM,mRNA,1817883,4494913,324,1.00
ptg014703l,2920683,2920964,281,EVM,mRNA,1817883,4494913,281,1.00
ptg014703l,3614074,3614360,286,EVM,mRNA,1817883,4494913,286,1.00
ptg014711l,493608,493918,310,EVM,mRNA,477988,694820,310,1.00
ptg014711l,578810,579117,307,EVM,mRNA,477988,694820,307,1.00
ptg014717l,2205132,2205461,329,EVM,mRNA,1907555,2312836,329,1.00
ptg014722l,247978,248263,285,EVM,mRNA,228436,1776058,285,1.00
ptg014723l,1733751,1734036,285,EVM,mRNA,1719023,1797906,285,1.00
ptg014728l,432905,433220,315,EVM,mRNA,25392,574922,315,1.00
ptg014735l,580543,580853,310,EVM,mRNA,360695,1331000,310,1.00
ptg014735l,1153958,1154258,300,EVM,mRNA,360695,1331000,300,1.00
ptg014748l,110828,111154,326,EVM,mRNA,8864,249869,326,1.00
ptg014750l,1933605,1933923,318,EVM,mRNA,1755482,3767945,318,1.00
ptg014750l,2504722,2505020,298,EVM,mRNA,1755482,3767945,298,1.00
ptg014750l,2538834,2539130,296,EVM,mRNA,1755482,3767945,296,1.00
ptg014750l,3737853,3738165,312,EVM,mRNA,1755482,3767945,312,1.00
ptg014760l,284776,285073,297,EVM,mRNA,110982,526058,297,1.00
ptg014764l,607160,607479,319,EVM,mRNA,5118,1092648,319,1.00
ptg014764l,2842107,2842402,295,EVM,mRNA,2839043,2918404,295,1.00
ptg014777l,57939,58257,318,EVM,mRNA,11703,349931,318,1.00
ptg014777l,278594,278873,279,EVM,mRNA,11703,349931,279,1.00
ptg014793l,221705,221979,274,EVM,mRNA,221906,261667,74,0.27
ptg014793l,3563314,3563573,259,EVM,mRNA,3484154,3764676,259,1.00
ptg014797l,2747076,2747353,277,EVM,mRNA,2725580,2754592,277,1.00
ptg014797l,3823454,3823711,257,EVM,mRNA,3732385,3881339,257,1.00
ptg014802l,1351968,1352290,322,EVM,mRNA,1284495,1364111,322,1.00
ptg014803l,271403,271722,319,EVM,mRNA,153358,974853,319,1.00
ptg014803l,722034,722330,296,EVM,mRNA,153358,974853,296,1.00
ptg014807l,109720,110041,321,EVM,mRNA,62886,143544,321,1.00
ptg014818l,1672620,1672910,290,EVM,mRNA,1438233,1953093,290,1.00
ptg014827l,677193,677508,315,EVM,mRNA,431241,795413,315,1.00
ptg014833l,897125,897411,286,EVM,mRNA,820417,1004326,286,1.00
ptg014842l,332158,332476,318,EVM,mRNA,114554,467382,318,1.00
ptg014844l,1208127,1208468,341,EVM,mRNA,1160045,1269135,341,1.00
ptg014845l,1707867,1708135,268,EVM,mRNA,1631938,1955376,268,1.00
ptg014845l,2682886,2683154,268,EVM,mRNA,2330519,3425106,268,1.00
ptg014845l,2754311,2754624,313,EVM,mRNA,2330519,3425106,313,1.00
ptg014846l,796299,796598,299,EVM,mRNA,617934,844769,299,1.00
ptg014849l,300592,300889,297,EVM,mRNA,47379,607607,297,1.00
ptg014854l,528790,529095,305,EVM,mRNA,54543,1182541,305,1.00
ptg014859l,2572003,2572300,297,EVM,mRNA,2310319,2751713,297,1.00
ptg014867l,263273,263588,315,EVM,mRNA,135739,1354093,315,1.00
ptg014871l,321137,321445,308,EVM,mRNA,166795,1401813,308,1.00
ptg014871l,844112,844399,287,EVM,mRNA,166795,1401813,287,1.00
ptg014871l,1097060,1097365,305,EVM,mRNA,166795,1401813,305,1.00
ptg014874l,335224,335523,299,EVM,mRNA,83587,616379,299,1.00
ptg014877l,81221,81530,309,EVM,mRNA,406,113518,309,1.00
ptg014878l,783389,783654,265,EVM,mRNA,18985,1212311,265,1.00
ptg014880l,283394,283685,291,EVM,mRNA,148605,457580,291,1.00
ptg014880l,349214,349532,318,EVM,mRNA,148605,457580,318,1.00
ptg014883l,573105,573385,280,EVM,mRNA,274997,689336,280,1.00
ptg014885l,349579,349875,296,EVM,mRNA,330106,367085,296,1.00
ptg014892l,137671,137960,289,EVM,mRNA,13263,773318,289,1.00
ptg014902l,483885,484152,267,EVM,mRNA,239238,584955,267,1.00
ptg014903l,980127,980421,294,EVM,mRNA,256832,998026,294,1.00
ptg014904l,1243020,1243284,264,EVM,mRNA,10327,1348159,264,1.00
ptg014912l,609793,610072,279,EVM,mRNA,240136,709478,279,1.00
ptg014913l,530490,530773,283,EVM,mRNA,23870,1578942,283,1.00
ptg014913l,855608,855901,293,EVM,mRNA,23870,1578942,293,1.00
ptg014913l,940981,941252,271,EVM,mRNA,23870,1578942,271,1.00
ptg014913l,1522876,1523154,278,EVM,mRNA,23870,1578942,278,1.00
ptg014914l,1030548,1030849,301,EVM,mRNA,588618,1144935,301,1.00
ptg014914l,1543419,1543739,320,EVM,mRNA,1182970,1815009,320,1.00
ptg014922l,22323,22648,325,EVM,mRNA,22270,450056,325,1.00
ptg014923l,516262,516571,309,EVM,mRNA,258488,539575,309,1.00
ptg014924l,1704309,1704600,291,EVM,mRNA,1572835,2475933,291,1.00
ptg014924l,2324752,2325030,278,EVM,mRNA,1572835,2475933,278,1.00
ptg014927l,139012,139328,316,EVM,mRNA,6943,194073,316,1.00
ptg014947l,516544,516836,292,EVM,mRNA,111727,745734,292,1.00
ptg014966l,705427,705727,300,EVM,mRNA,270219,894949,300,1.00
ptg014970l,681927,682229,302,EVM,mRNA,650431,1076084,302,1.00
ptg014970l,1005246,1005563,317,EVM,mRNA,650431,1076084,317,1.00
ptg014971l,1245741,1246034,293,EVM,mRNA,1229501,1265981,293,1.00
ptg014973l,108381,108678,297,EVM,mRNA,83286,697105,297,1.00
ptg014973l,264980,265275,295,EVM,mRNA,83286,697105,295,1.00
ptg014973l,546660,546959,299,EVM,mRNA,83286,697105,299,1.00
ptg014975l,121614,121902,288,EVM,mRNA,115280,832812,288,1.00
ptg014993l,815523,815803,280,EVM,mRNA,803856,1276319,280,1.00
ptg014993l,937024,937309,285,EVM,mRNA,803856,1276319,285,1.00
ptg014995l,707823,708141,318,EVM,mRNA,652783,1242256,318,1.00
ptg014996l,682075,682395,320,EVM,mRNA,71418,757652,320,1.00
ptg015004l,455547,455840,293,EVM,mRNA,2259,1718758,293,1.00
ptg015004l,885675,885988,313,EVM,mRNA,2259,1718758,313,1.00
ptg015015l,440130,440420,290,EVM,mRNA,262095,1064271,290,1.00
ptg015020l,1225044,1225335,291,EVM,mRNA,4362,1574397,291,1.00
ptg015035l,1042541,1042820,279,EVM,mRNA,170548,1472586,279,1.00
ptg015038l,137446,137757,311,EVM,mRNA,822,200283,311,1.00
ptg015041l,828393,828671,278,EVM,mRNA,169534,1887788,278,1.00
ptg015041l,1200870,1201159,289,EVM,mRNA,169534,1887788,289,1.00
ptg015041l,1797010,1797304,294,EVM,mRNA,169534,1887788,294,1.00
ptg015048l,597735,598053,318,EVM,mRNA,479113,932662,318,1.00
ptg015051l,721120,721415,295,EVM,mRNA,596937,1973522,295,1.00
ptg015051l,1656623,1656922,299,EVM,mRNA,596937,1973522,299,1.00
ptg015061l,1090768,1091051,283,EVM,mRNA,1090752,1325381,283,1.00
ptg015062l,536979,537285,306,EVM,mRNA,61305,982299,306,1.00
ptg015063l,1066848,1067149,301,EVM,mRNA,1063430,1075144,301,1.00
ptg015072l,437402,437667,265,EVM,mRNA,207281,1098224,265,1.00
ptg015073l,401481,401764,283,EVM,mRNA,284118,1897405,283,1.00
ptg015073l,592290,592582,292,EVM,mRNA,284118,1897405,292,1.00
ptg015073l,599149,599441,292,EVM,mRNA,284118,1897405,292,1.00
ptg015073l,680390,680688,298,EVM,mRNA,284118,1897405,298,1.00
ptg015073l,1788704,1788999,295,EVM,mRNA,284118,1897405,295,1.00
ptg015079l,2044488,2044766,278,EVM,mRNA,1900482,2065340,278,1.00
ptg015080l,1146342,1146636,294,EVM,mRNA,212062,1283953,294,1.00
ptg015084l,829229,829539,310,EVM,mRNA,110840,1226499,310,1.00
ptg015084l,1091150,1091467,317,EVM,mRNA,110840,1226499,317,1.00
ptg015086l,195475,195764,289,EVM,mRNA,159838,783258,289,1.00
ptg015090l,1282912,1283200,288,EVM,mRNA,471595,2461289,288,1.00
ptg015092l,484708,485026,318,EVM,mRNA,477276,631689,318,1.00
ptg015092l,550960,551252,292,EVM,mRNA,477276,631689,292,1.00
ptg015093l,249438,249709,271,EVM,mRNA,3134,301468,271,1.00
ptg015102l,200250,200558,308,EVM,mRNA,25581,610041,308,1.00
ptg015102l,309381,309662,281,EVM,mRNA,25581,610041,281,1.00
ptg015116l,24056,24345,289,EVM,mRNA,14649,207696,289,1.00
ptg015116l,110647,110944,297,EVM,mRNA,14649,207696,297,1.00
ptg015125l,788490,788801,311,EVM,mRNA,78725,1189545,311,1.00
ptg015130l,495768,496081,313,EVM,mRNA,438540,1250961,313,1.00
ptg015130l,575753,576034,281,EVM,mRNA,438540,1250961,281,1.00
ptg015130l,913702,914036,334,EVM,mRNA,438540,1250961,334,1.00
ptg015131l,257536,257861,325,EVM,mRNA,25596,387746,325,1.00
ptg015131l,2452498,2452780,282,EVM,mRNA,2355518,2504753,282,1.00
ptg015141l,107816,108125,309,EVM,mRNA,42501,158537,309,1.00
ptg015150l,224190,224488,298,EVM,mRNA,121675,299175,298,1.00
ptg015150l,252972,253259,287,EVM,mRNA,121675,299175,287,1.00
ptg015158l,401770,402053,283,EVM,mRNA,393673,845255,283,1.00
ptg015158l,656843,657119,276,EVM,mRNA,393673,845255,276,1.00
ptg015159l,336664,336956,292,EVM,mRNA,21644,701312,292,1.00
ptg015159l,366729,367059,330,EVM,mRNA,21644,701312,330,1.00
ptg015159l,622513,622807,294,EVM,mRNA,21644,701312,294,1.00
ptg015168l,501746,502080,334,EVM,mRNA,491436,659984,334,1.00
ptg015170l,1045854,1046162,308,EVM,mRNA,350008,1694793,308,1.00
ptg015173l,214471,214770,299,EVM,mRNA,121075,228163,299,1.00
ptg015179l,826539,826849,310,EVM,mRNA,303960,1518471,310,1.00
ptg015179l,1005732,1006045,313,EVM,mRNA,303960,1518471,313,1.00
ptg015179l,1205491,1205784,293,EVM,mRNA,303960,1518471,293,1.00
ptg015180l,166867,167204,337,EVM,mRNA,7031,171963,337,1.00
ptg015185l,1027165,1027484,319,EVM,mRNA,685459,1515488,319,1.00
ptg015185l,1286252,1286526,274,EVM,mRNA,685459,1515488,274,1.00
ptg015185l,1385458,1385784,326,EVM,mRNA,685459,1515488,326,1.00
ptg015185l,1440523,1440815,292,EVM,mRNA,685459,1515488,292,1.00
ptg015186l,286963,287251,288,EVM,mRNA,249160,680826,288,1.00
ptg015186l,514787,515082,295,EVM,mRNA,249160,680826,295,1.00
ptg015191l,966351,966647,296,EVM,mRNA,441722,1364187,296,1.00
ptg015191l,1250458,1250790,332,EVM,mRNA,441722,1364187,332,1.00
ptg015205l,206900,207182,282,EVM,mRNA,36201,744499,282,1.00
ptg015205l,730060,730367,307,EVM,mRNA,36201,744499,307,1.00
ptg015215l,477420,477743,323,EVM,mRNA,4038,1191175,323,1.00
ptg015215l,535020,535351,331,EVM,mRNA,4038,1191175,331,1.00
ptg015215l,1981431,1981700,269,EVM,mRNA,1469808,2026043,269,1.00
ptg015225l,2265458,2265755,297,EVM,mRNA,1021558,2292205,297,1.00
ptg015228l,55941,56225,284,EVM,mRNA,51217,360728,284,1.00
ptg015229l,225116,225399,283,EVM,mRNA,16699,380528,283,1.00
ptg015229l,319196,319473,277,EVM,mRNA,16699,380528,277,1.00
ptg015231l,1054799,1055110,311,EVM,mRNA,590666,1143881,311,1.00
ptg015235l,523682,523983,301,EVM,mRNA,104755,1112508,301,1.00
ptg015236l,352825,353106,281,EVM,mRNA,334173,1006895,281,1.00
ptg015248l,301393,301713,320,EVM,mRNA,253319,678197,320,1.00
ptg015248l,530750,531035,285,EVM,mRNA,253319,678197,285,1.00
ptg015250l,426576,426895,319,EVM,mRNA,4753,765395,319,1.00
ptg015250l,651032,651352,320,EVM,mRNA,4753,765395,320,1.00
ptg015252l,359553,359867,314,EVM,mRNA,110465,670922,314,1.00
ptg015252l,918342,918637,295,EVM,mRNA,852999,952850,295,1.00
ptg015253l,148617,148911,294,EVM,mRNA,11848,725777,294,1.00
ptg015253l,1133093,1133408,315,EVM,mRNA,777690,1504069,315,1.00
ptg015260l,205837,206126,289,EVM,mRNA,70559,490837,289,1.00
ptg015260l,212097,212400,303,EVM,mRNA,70559,490837,303,1.00
ptg015260l,286675,286982,307,EVM,mRNA,70559,490837,307,1.00
ptg015263l,939770,940076,306,EVM,mRNA,601912,1100474,306,1.00
ptg015268l,932150,932423,273,EVM,mRNA,851641,985601,273,1.00
ptg015271l,1482785,1483075,290,EVM,mRNA,1438020,1578922,290,1.00
ptg015279l,624180,624491,311,EVM,mRNA,308369,1539205,311,1.00
ptg015293l,1780069,1780366,297,EVM,mRNA,1330860,1907595,297,1.00
ptg015300l,133781,134060,279,EVM,mRNA,132091,651943,279,1.00
ptg015300l,244551,244809,258,EVM,mRNA,132091,651943,258,1.00
ptg015313l,634252,634546,294,EVM,mRNA,138131,667189,294,1.00
ptg015318l,609063,609360,297,EVM,mRNA,468383,659460,297,1.00
ptg015324l,986213,986525,312,EVM,mRNA,878790,1011951,312,1.00
ptg015335l,501305,501589,284,EVM,mRNA,433418,673010,284,1.00
ptg015335l,641973,642270,297,EVM,mRNA,433418,673010,297,1.00
ptg015339l,1135970,1136304,334,EVM,mRNA,1015591,1256522,334,1.00
ptg015349l,332403,332729,326,EVM,mRNA,72485,478849,326,1.00
ptg015350l,1858057,1858333,276,EVM,mRNA,1730176,1992212,276,1.00
ptg015350l,1985907,1986215,308,EVM,mRNA,1730176,1992212,308,1.00
ptg015352l,855698,855978,280,EVM,mRNA,180941,1670779,280,1.00
ptg015352l,1291567,1291873,306,EVM,mRNA,180941,1670779,306,1.00
ptg015352l,1312180,1312490,310,EVM,mRNA,180941,1670779,310,1.00
ptg015355l,152828,153157,329,EVM,mRNA,119821,253502,329,1.00
ptg015357l,1443375,1443706,331,EVM,mRNA,1273012,2080889,331,1.00
ptg015357l,1743158,1743452,294,EVM,mRNA,1273012,2080889,294,1.00
ptg015377l,761528,761840,312,EVM,mRNA,85621,812587,312,1.00
ptg015380l,203513,203805,292,EVM,mRNA,49067,265553,292,1.00
ptg015395l,808539,808818,279,EVM,mRNA,802490,1060783,279,1.00
ptg015395l,920793,921097,304,EVM,mRNA,802490,1060783,304,1.00
ptg015396l,600674,600963,289,EVM,mRNA,478812,718531,289,1.00
ptg015403l,2870939,2871230,291,EVM,mRNA,1622770,3289339,291,1.00
ptg015416l,147951,148252,301,EVM,mRNA,116107,307142,301,1.00
ptg015416l,205225,205523,298,EVM,mRNA,116107,307142,298,1.00
ptg015416l,223066,223398,332,EVM,mRNA,116107,307142,332,1.00
ptg015417l,1182738,1183023,285,EVM,mRNA,765909,1596216,285,1.00
ptg015420l,1510605,1510912,307,EVM,mRNA,1471868,1779019,307,1.00
ptg015434l,1151662,1151974,312,EVM,mRNA,1129066,1309683,312,1.00
ptg015442l,175079,175404,325,EVM,mRNA,94754,477265,325,1.00
ptg015442l,342695,342972,277,EVM,mRNA,94754,477265,277,1.00
ptg015454l,177810,178109,299,EVM,mRNA,135830,888655,299,1.00
ptg015460l,347196,347509,313,EVM,mRNA,326556,555249,313,1.00
ptg015464l,569262,569561,299,EVM,mRNA,268707,1020172,299,1.00
ptg015468l,1436153,1436442,289,EVM,mRNA,668396,1557626,289,1.00
ptg015468l,1494474,1494761,287,EVM,mRNA,668396,1557626,287,1.00
ptg015470l,1949627,1949923,296,EVM,mRNA,1919454,2744576,296,1.00
ptg015472l,1367903,1368204,301,EVM,mRNA,602676,1827778,301,1.00
ptg015480l,295229,295555,326,EVM,mRNA,272156,476675,326,1.00
ptg015481l,310043,310326,283,EVM,mRNA,287846,858197,283,1.00
ptg015490l,750997,751322,325,EVM,mRNA,535132,1073679,325,1.00
ptg015490l,1024194,1024508,314,EVM,mRNA,535132,1073679,314,1.00
ptg015494l,841339,841631,292,EVM,mRNA,161328,1691854,292,1.00
ptg015500l,674224,674507,283,EVM,mRNA,550182,992449,283,1.00
ptg015502l,691837,692125,288,EVM,mRNA,667889,856465,288,1.00
ptg015504l,1291308,1291603,295,EVM,mRNA,12009,2216193,295,1.00
ptg015505l,319937,320241,304,EVM,mRNA,282,405184,304,1.00
ptg015506l,1846075,1846359,284,EVM,mRNA,1011287,2119533,284,1.00
ptg015506l,3005854,3006185,331,EVM,mRNA,2844122,3426604,331,1.00
ptg015506l,3249632,3249968,336,EVM,mRNA,2844122,3426604,336,1.00
ptg015506l,3353904,3354183,279,EVM,mRNA,2844122,3426604,279,1.00
ptg015514l,190785,191123,338,EVM,mRNA,188508,191177,338,1.00
ptg015514l,718263,718557,294,EVM,mRNA,421667,950745,294,1.00
ptg015522l,808157,808440,283,EVM,mRNA,808040,2053926,283,1.00
ptg015522l,841267,841582,315,EVM,mRNA,808040,2053926,315,1.00
ptg015522l,944212,944520,308,EVM,mRNA,808040,2053926,308,1.00
ptg015522l,1726189,1726521,332,EVM,mRNA,808040,2053926,332,1.00
ptg015528l,989933,990258,325,EVM,mRNA,977357,1157700,325,1.00
ptg015528l,1103727,1104025,298,EVM,mRNA,977357,1157700,298,1.00
ptg015532l,1235606,1235912,306,EVM,mRNA,238318,1918790,306,1.00
ptg015532l,1279659,1279933,274,EVM,mRNA,238318,1918790,274,1.00
ptg015532l,1506197,1506506,309,EVM,mRNA,238318,1918790,309,1.00
ptg015534l,611515,611826,311,EVM,mRNA,181102,778116,311,1.00
ptg015534l,1078433,1078736,303,EVM,mRNA,1020523,1269565,303,1.00
ptg015535l,168282,168558,276,EVM,mRNA,120291,1115174,276,1.00
ptg015556l,2614982,2615280,298,EVM,mRNA,2476254,2986610,298,1.00
ptg015556l,2855726,2856016,290,EVM,mRNA,2476254,2986610,290,1.00
ptg015576l,220699,220984,285,EVM,mRNA,107488,353329,285,1.00
ptg015579l,474245,474549,304,EVM,mRNA,397806,972504,304,1.00
ptg015585l,269868,270188,320,EVM,mRNA,221556,570419,320,1.00
ptg015585l,313173,313440,267,EVM,mRNA,221556,570419,267,1.00
ptg015588l,1188650,1188961,311,EVM,mRNA,1036451,1963745,311,1.00
ptg015588l,1204061,1204369,308,EVM,mRNA,1036451,1963745,308,1.00
ptg015588l,1821791,1822105,314,EVM,mRNA,1036451,1963745,314,1.00
ptg015590l,167269,167572,303,EVM,mRNA,1017,418446,303,1.00
ptg015592l,44690,44985,295,EVM,mRNA,14475,141313,295,1.00
ptg015595l,171581,171869,288,EVM,mRNA,149126,181303,288,1.00
ptg015595l,608081,608329,248,EVM,mRNA,460345,822558,248,1.00
ptg015596l,36620,36931,311,EVM,mRNA,24803,57385,311,1.00
ptg015605l,86142,86433,291,EVM,mRNA,18375,192033,291,1.00
ptg015606l,141154,141457,303,EVM,mRNA,86962,266454,303,1.00
ptg015620l,584386,584678,292,EVM,mRNA,421396,830994,292,1.00
ptg015624l,562307,562600,293,EVM,mRNA,252995,645573,293,1.00
ptg015630l,413666,413982,316,EVM,mRNA,91816,642108,316,1.00
ptg015636l,208472,208757,285,EVM,mRNA,208396,934366,285,1.00
ptg015659l,850334,850617,283,EVM,mRNA,477988,1406643,283,1.00
ptg015659l,1739302,1739591,289,EVM,mRNA,1690218,2169707,289,1.00
ptg015659l,1886449,1886732,283,EVM,mRNA,1690218,2169707,283,1.00
ptg015659l,2162628,2162904,276,EVM,mRNA,1690218,2169707,276,1.00
ptg015660l,178380,178616,236,EVM,mRNA,48558,360181,236,1.00
ptg015664l,34591,34916,325,EVM,mRNA,215,404817,325,1.00
ptg015679l,298899,299209,310,EVM,mRNA,14807,1208280,310,1.00
ptg015691l,751793,752079,286,EVM,mRNA,510816,1369392,286,1.00
ptg015696l,461835,462116,281,EVM,mRNA,371604,465513,281,1.00
ptg015701l,498256,498533,277,EVM,mRNA,604,604464,277,1.00
ptg015704l,331827,332128,301,EVM,mRNA,280526,430739,301,1.00
ptg015710l,789440,789709,269,EVM,mRNA,783215,1109636,269,1.00
ptg015710l,967546,967855,309,EVM,mRNA,783215,1109636,309,1.00
ptg015714l,591992,592284,292,EVM,mRNA,382014,728925,292,1.00
ptg015714l,1159645,1159926,281,EVM,mRNA,1000151,1428588,281,1.00
ptg015715l,200902,201226,324,EVM,mRNA,199,268691,324,1.00
ptg015718l,565457,565741,284,EVM,mRNA,320609,601056,284,1.00
ptg015720l,723029,723325,296,EVM,mRNA,624665,765091,296,1.00
ptg015729l,156876,157172,296,EVM,mRNA,1418,299640,296,1.00
ptg015748l,1070863,1071178,315,EVM,mRNA,896816,1180260,315,1.00
ptg015748l,2109063,2109372,309,EVM,mRNA,1676627,2542589,309,1.00
ptg015748l,2491078,2491355,277,EVM,mRNA,1676627,2542589,277,1.00
ptg015749l,408950,409266,316,EVM,mRNA,38986,1030050,316,1.00
ptg015749l,455428,455694,266,EVM,mRNA,38986,1030050,266,1.00
ptg015749l,584802,585081,279,EVM,mRNA,38986,1030050,279,1.00
ptg015749l,870447,870763,316,EVM,mRNA,38986,1030050,316,1.00
ptg015751l,949309,949597,288,EVM,mRNA,818034,1314667,288,1.00
ptg015751l,1006205,1006472,267,EVM,mRNA,818034,1314667,267,1.00
ptg015752l,319784,320069,285,EVM,mRNA,40695,368518,285,1.00
ptg015754l,516881,517188,307,EVM,mRNA,300179,682636,307,1.00
ptg015756l,67354,67662,308,EVM,mRNA,43,271536,308,1.00
ptg015759l,1289222,1289548,326,EVM,mRNA,1276534,1425111,326,1.00
ptg015760l,1240388,1240712,324,EVM,mRNA,1128313,1625977,324,1.00
ptg015760l,1433427,1433707,280,EVM,mRNA,1128313,1625977,280,1.00
ptg015760l,1483660,1483962,302,EVM,mRNA,1128313,1625977,302,1.00
ptg015766l,498330,498648,318,EVM,mRNA,191625,1190959,318,1.00
ptg015766l,726101,726382,281,EVM,mRNA,191625,1190959,281,1.00
ptg015766l,1092234,1092521,287,EVM,mRNA,191625,1190959,287,1.00
ptg015768l,552925,553232,307,EVM,mRNA,360807,555221,307,1.00
ptg015768l,865919,866240,321,EVM,mRNA,736584,911039,321,1.00
ptg015768l,1299491,1299783,292,EVM,mRNA,1276915,1514138,292,1.00
ptg015768l,2461171,2461486,315,EVM,mRNA,1756324,2502052,315,1.00
ptg015768l,4145812,4146131,319,EVM,mRNA,4059354,4467476,319,1.00
ptg015768l,6140350,6140649,299,EVM,mRNA,5775631,7316770,299,1.00
ptg015768l,6219618,6219908,290,EVM,mRNA,5775631,7316770,290,1.00
ptg015768l,6232015,6232325,310,EVM,mRNA,5775631,7316770,310,1.00
ptg015768l,7070574,7070885,311,EVM,mRNA,5775631,7316770,311,1.00
ptg015768l,7099520,7099815,295,EVM,mRNA,5775631,7316770,295,1.00
ptg015768l,7119240,7119520,280,EVM,mRNA,5775631,7316770,280,1.00
ptg015778l,109467,109792,325,EVM,mRNA,19346,631827,325,1.00
ptg015778l,300135,300442,307,EVM,mRNA,19346,631827,307,1.00
ptg015778l,300661,300943,282,EVM,mRNA,19346,631827,282,1.00
ptg015778l,630009,630290,281,EVM,mRNA,19346,631827,281,1.00
ptg015782l,1463598,1463891,293,EVM,mRNA,1297137,1775924,293,1.00
ptg015782l,2259988,2260298,310,EVM,mRNA,2097410,2275482,310,1.00
ptg015787l,2328048,2328379,331,EVM,mRNA,142559,2530899,331,1.00
ptg015806l,1093866,1094168,302,EVM,mRNA,463571,1218064,302,1.00
ptg015810l,275658,275972,314,EVM,mRNA,21924,838071,314,1.00
ptg015811l,258965,259244,279,EVM,mRNA,1621,418250,279,1.00
ptg015814l,159161,159492,331,EVM,mRNA,13925,236833,331,1.00
ptg015819l,458090,458391,301,EVM,mRNA,36890,1188308,301,1.00
ptg015819l,836303,836616,313,EVM,mRNA,36890,1188308,313,1.00
ptg015822l,563640,563949,309,EVM,mRNA,362086,763183,309,1.00
ptg015829l,1683696,1684004,308,EVM,mRNA,1583932,1686289,308,1.00
ptg015831l,640634,640970,336,EVM,mRNA,447130,1097094,336,1.00
ptg015835l,130702,130989,287,EVM,mRNA,108111,650041,287,1.00
ptg015835l,2197315,2197579,264,EVM,mRNA,1147746,2226847,264,1.00
ptg015840l,873394,873696,302,EVM,mRNA,854028,1184450,302,1.00
ptg015840l,1074222,1074514,292,EVM,mRNA,854028,1184450,292,1.00
ptg015840l,1118584,1118868,284,EVM,mRNA,854028,1184450,284,1.00
ptg015841l,920776,921043,267,EVM,mRNA,816033,1004298,267,1.00
ptg015843l,1394687,1394958,271,EVM,mRNA,24194,1990995,271,1.00
ptg015845l,553344,553644,300,EVM,mRNA,203647,564428,300,1.00
ptg015846l,182117,182412,295,EVM,mRNA,19701,388808,295,1.00
ptg015873l,404332,404621,289,EVM,mRNA,332431,717846,289,1.00
ptg015880l,713999,714301,302,EVM,mRNA,90618,1042687,302,1.00
ptg015880l,1478979,1479287,308,EVM,mRNA,1416343,1497449,308,1.00
ptg015883l,465452,465747,295,EVM,mRNA,315463,1498555,295,1.00
ptg015884l,1850642,1850958,316,EVM,mRNA,1363996,2074936,316,1.00
ptg015909l,234451,234739,288,EVM,mRNA,74205,252458,288,1.00
ptg015910l,305888,306202,314,EVM,mRNA,231876,756658,314,1.00
ptg015913l,255964,256279,315,EVM,mRNA,20818,1579379,315,1.00
ptg015913l,374950,375265,315,EVM,mRNA,20818,1579379,315,1.00
ptg015913l,1350985,1351291,306,EVM,mRNA,20818,1579379,306,1.00
ptg015919l,2317466,2317761,295,EVM,mRNA,1851319,2468457,295,1.00
ptg015919l,2356518,2356796,278,EVM,mRNA,1851319,2468457,278,1.00
ptg015923l,1025895,1026186,291,EVM,mRNA,95304,1250164,291,1.00
ptg015924l,648614,648930,316,EVM,mRNA,639402,652551,316,1.00
ptg015938l,1295911,1296219,308,EVM,mRNA,311947,1625152,308,1.00
ptg015946l,2973821,2974100,279,EVM,mRNA,2921293,3173581,279,1.00
ptg015946l,3017801,3018125,324,EVM,mRNA,2921293,3173581,324,1.00
ptg015947l,523292,523588,296,EVM,mRNA,384025,873583,296,1.00
ptg015952l,414605,414889,284,EVM,mRNA,338977,831892,284,1.00
ptg015952l,681553,681844,291,EVM,mRNA,338977,831892,291,1.00
ptg015952l,703778,704088,310,EVM,mRNA,338977,831892,310,1.00
ptg015953l,1648984,1649293,309,EVM,mRNA,720018,1722821,309,1.00
ptg015955l,418568,418848,280,EVM,mRNA,344306,513571,280,1.00
ptg015955l,481903,482199,296,EVM,mRNA,344306,513571,296,1.00
ptg015968l,106286,106602,316,EVM,mRNA,73905,207728,316,1.00
ptg015974l,99686,99992,306,EVM,mRNA,6036,289438,306,1.00
ptg015982l,387299,387604,305,EVM,mRNA,77647,532552,305,1.00
ptg015993l,375662,375956,294,EVM,mRNA,349870,445726,294,1.00
ptg015998l,253547,253852,305,EVM,mRNA,1673,277328,305,1.00
ptg015999l,874212,874516,304,EVM,mRNA,26271,1482684,304,1.00
ptg015999l,1109749,1110039,290,EVM,mRNA,26271,1482684,290,1.00
ptg016009l,49013,49333,320,EVM,mRNA,27852,481419,320,1.00
ptg016026l,158268,158566,298,EVM,mRNA,39217,932368,298,1.00
ptg016028l,126880,127174,294,EVM,mRNA,1794,373899,294,1.00
ptg016031l,1607844,1608116,272,EVM,mRNA,781203,1775754,272,1.00
ptg016036l,79145,79454,309,EVM,mRNA,47267,643491,309,1.00
ptg016036l,415796,416127,331,EVM,mRNA,47267,643491,331,1.00
ptg016041l,253916,254178,262,EVM,mRNA,236485,258429,262,1.00
ptg016046l,369443,369743,300,EVM,mRNA,161444,390426,300,1.00
ptg016062l,79119,79401,282,EVM,mRNA,126,173978,282,1.00
ptg016072l,170857,171140,283,EVM,mRNA,20814,783776,283,1.00
ptg016077l,300866,301141,275,EVM,mRNA,237136,612553,275,1.00
ptg016077l,879092,879419,327,EVM,mRNA,842003,1100741,327,1.00
ptg016080l,1386060,1386360,300,EVM,mRNA,791301,1580093,300,1.00
ptg016080l,1572197,1572519,322,EVM,mRNA,791301,1580093,322,1.00
ptg016080l,1837230,1837545,315,EVM,mRNA,1692227,2019539,315,1.00
ptg016084l,450002,450290,288,EVM,mRNA,399744,924929,288,1.00
ptg016091l,242599,242911,312,EVM,mRNA,151893,244683,312,1.00
ptg016091l,2233511,2233794,283,EVM,mRNA,2152169,2250119,283,1.00
ptg016095l,323443,323762,319,EVM,mRNA,229175,800970,319,1.00
ptg016095l,370162,370431,269,EVM,mRNA,229175,800970,269,1.00
ptg016102l,958609,958940,331,EVM,mRNA,479486,1451602,331,1.00
ptg016102l,1444231,1444517,286,EVM,mRNA,479486,1451602,286,1.00
ptg016103l,302375,302668,293,EVM,mRNA,180478,428729,293,1.00
ptg016112l,1283289,1283604,315,EVM,mRNA,970362,1510976,315,1.00
ptg016114l,161390,161687,297,EVM,mRNA,36568,332633,297,1.00
ptg016140l,1375269,1375543,274,EVM,mRNA,1239995,1463663,274,1.00
ptg016176l,776065,776377,312,EVM,mRNA,318878,1260456,312,1.00
ptg016188l,562966,563254,288,EVM,mRNA,426206,689227,288,1.00
ptg016193l,410458,410785,327,EVM,mRNA,163661,950283,327,1.00
ptg016200l,247132,247451,319,EVM,mRNA,7402,338030,319,1.00
ptg016202l,251226,251543,317,EVM,mRNA,207284,260326,317,1.00
ptg016205l,458354,458676,322,EVM,mRNA,332491,500265,322,1.00
ptg016209l,232149,232443,294,EVM,mRNA,3037,322802,294,1.00
ptg016209l,283424,283712,288,EVM,mRNA,3037,322802,288,1.00
ptg016224l,329125,329451,326,EVM,mRNA,23540,481035,326,1.00
ptg016224l,407065,407350,285,EVM,mRNA,23540,481035,285,1.00
ptg016227l,1236706,1237007,301,EVM,mRNA,1117874,1244414,301,1.00
ptg016238l,337224,337495,271,EVM,mRNA,163560,1235690,271,1.00
ptg016238l,956603,956890,287,EVM,mRNA,163560,1235690,287,1.00
ptg016238l,1025942,1026255,313,EVM,mRNA,163560,1235690,313,1.00
ptg016239l,565231,565528,297,EVM,mRNA,518927,588089,297,1.00
ptg016239l,585374,585714,340,EVM,mRNA,518927,588089,340,1.00
ptg016240l,268968,269274,306,EVM,mRNA,28216,424877,306,1.00
ptg016242l,355175,355495,320,EVM,mRNA,231664,561507,320,1.00
ptg016242l,390115,390414,299,EVM,mRNA,231664,561507,299,1.00
ptg016250l,464373,464662,289,EVM,mRNA,253954,630079,289,1.00
ptg016263l,280779,281111,332,EVM,mRNA,193201,619944,332,1.00
ptg016278l,111779,112098,319,EVM,mRNA,22501,680083,319,1.00
ptg016292l,2395680,2395990,310,EVM,mRNA,2078394,3007523,310,1.00
ptg016295l,218773,219087,314,EVM,mRNA,116573,316973,314,1.00
ptg016296l,645072,645398,326,EVM,mRNA,213069,1306719,326,1.00
ptg016302l,914480,914768,288,EVM,mRNA,765062,1637806,288,1.00
ptg016302l,938149,938432,283,EVM,mRNA,765062,1637806,283,1.00
ptg016302l,1071879,1072188,309,EVM,mRNA,765062,1637806,309,1.00
ptg016302l,2354126,2354454,328,EVM,mRNA,2353426,3122668,328,1.00
ptg016302l,2655254,2655582,328,EVM,mRNA,2353426,3122668,328,1.00
ptg016302l,2899093,2899397,304,EVM,mRNA,2353426,3122668,304,1.00
ptg016306l,549789,550106,317,EVM,mRNA,134522,1781718,317,1.00
ptg016306l,1342398,1342692,294,EVM,mRNA,134522,1781718,294,1.00
ptg016313l,273996,274302,306,EVM,mRNA,240027,576282,306,1.00
ptg016320l,1720919,1721205,286,EVM,mRNA,1688214,2112898,286,1.00
ptg016320l,1834207,1834519,312,EVM,mRNA,1688214,2112898,312,1.00
ptg016324l,814066,814391,325,EVM,mRNA,725097,851610,325,1.00
ptg016324l,846515,846801,286,EVM,mRNA,725097,851610,286,1.00
ptg016330l,416056,416345,289,EVM,mRNA,356492,434145,289,1.00
ptg016342l,82818,83134,316,EVM,mRNA,60102,265179,316,1.00
ptg016343l,645839,646154,315,EVM,mRNA,626836,924767,315,1.00
ptg016345l,2150821,2151133,312,EVM,mRNA,2150426,2503050,312,1.00
ptg016345l,2277016,2277326,310,EVM,mRNA,2150426,2503050,310,1.00
ptg016358l,122196,122522,326,EVM,mRNA,21103,281240,326,1.00
ptg016358l,312138,312380,242,EVM,mRNA,301722,641661,242,1.00
ptg016363l,373467,373761,294,EVM,mRNA,276123,1392357,294,1.00
ptg016363l,1041215,1041502,287,EVM,mRNA,276123,1392357,287,1.00
ptg016365l,358280,358588,308,EVM,mRNA,19696,379887,308,1.00
ptg016369l,469588,469872,284,EVM,mRNA,410280,529574,284,1.00
ptg016378l,256658,256979,321,EVM,mRNA,29120,1401119,321,1.00
ptg016378l,532076,532375,299,EVM,mRNA,29120,1401119,299,1.00
ptg016379l,564256,564588,332,EVM,mRNA,124560,1906753,332,1.00
ptg016379l,1360717,1361035,318,EVM,mRNA,124560,1906753,318,1.00
ptg016379l,1505091,1505368,277,EVM,mRNA,124560,1906753,277,1.00
ptg016382l,467139,467468,329,EVM,mRNA,160108,472459,329,1.00
ptg016392l,158653,158975,322,EVM,mRNA,153197,652972,322,1.00
ptg016392l,461769,462084,315,EVM,mRNA,153197,652972,315,1.00
ptg016392l,487943,488258,315,EVM,mRNA,153197,652972,315,1.00
ptg016424l,205765,206047,282,EVM,mRNA,8496,552677,282,1.00
ptg016437l,311294,311599,305,EVM,mRNA,145297,387886,305,1.00
ptg016442l,694764,695026,262,EVM,mRNA,62191,1281579,262,1.00
ptg016442l,1730635,1730933,298,EVM,mRNA,1595736,2154226,298,1.00
ptg016442l,1825297,1825626,329,EVM,mRNA,1595736,2154226,329,1.00
ptg016442l,1894873,1895149,276,EVM,mRNA,1595736,2154226,276,1.00
ptg016445l,407890,408187,297,EVM,mRNA,258394,491744,297,1.00
ptg016445l,580032,580326,294,EVM,mRNA,496093,619108,294,1.00
ptg016449l,338143,338460,317,EVM,mRNA,292100,479969,317,1.00
ptg016450l,692217,692544,327,EVM,mRNA,1369,721372,327,1.00
ptg016451l,1071631,1071931,300,EVM,mRNA,701512,1176501,300,1.00
ptg016454l,454449,454749,300,EVM,mRNA,410183,631914,300,1.00
ptg016462l,1197195,1197490,295,EVM,mRNA,1150740,1393060,295,1.00
ptg016462l,2340324,2340619,295,EVM,mRNA,2062418,2415013,295,1.00
ptg016466l,558679,558983,304,EVM,mRNA,151830,1594289,304,1.00
ptg016466l,1562108,1562401,293,EVM,mRNA,151830,1594289,293,1.00
ptg016466l,3156280,3156595,315,EVM,mRNA,3122485,4000195,315,1.00
ptg016466l,3593020,3593292,272,EVM,mRNA,3122485,4000195,272,1.00
ptg016466l,4304379,4304678,299,EVM,mRNA,4271401,4387665,299,1.00
ptg016482l,380876,381166,290,EVM,mRNA,120412,508124,290,1.00
ptg016482l,389712,390007,295,EVM,mRNA,120412,508124,295,1.00
ptg016486l,318827,319123,296,EVM,mRNA,80637,371023,296,1.00
ptg016491l,911216,911515,299,EVM,mRNA,644981,1283223,299,1.00
ptg016492l,176582,176877,295,EVM,mRNA,3736,375309,295,1.00
ptg016496l,301927,302215,288,EVM,mRNA,36931,479689,288,1.00
ptg016497l,657140,657418,278,EVM,mRNA,417383,795089,278,1.00
ptg016519l,71058,71361,303,EVM,mRNA,2485,461077,303,1.00
ptg016526l,727472,727789,317,EVM,mRNA,76159,2944134,317,1.00
ptg016526l,749326,749614,288,EVM,mRNA,76159,2944134,288,1.00
ptg016526l,1733569,1733867,298,EVM,mRNA,76159,2944134,298,1.00
ptg016526l,2329654,2329955,301,EVM,mRNA,76159,2944134,301,1.00
ptg016532l,199054,199333,279,EVM,mRNA,138887,386406,279,1.00
ptg016545l,235222,235521,299,EVM,mRNA,88767,2101135,299,1.00
ptg016545l,783423,783707,284,EVM,mRNA,88767,2101135,284,1.00
ptg016558l,266589,266888,299,EVM,mRNA,550,376330,299,1.00
ptg016561l,445755,446065,310,EVM,mRNA,138947,823210,310,1.00
ptg016576c,562191,562523,332,EVM,mRNA,359935,828144,332,1.00
ptg016577l,181701,182018,317,EVM,mRNA,145445,491582,317,1.00
ptg016577l,664315,664605,290,EVM,mRNA,513021,1466785,290,1.00
ptg016577l,1708946,1709279,333,EVM,mRNA,1610002,1816021,333,1.00
ptg016587l,440980,441309,329,EVM,mRNA,320937,657882,329,1.00
ptg016589l,859663,859955,292,EVM,mRNA,5991,877291,292,1.00
ptg016598l,188920,189219,299,EVM,mRNA,54273,1680406,299,1.00
ptg016598l,2378048,2378375,327,EVM,mRNA,2319076,2803028,327,1.00
ptg016609l,453492,453776,284,EVM,mRNA,110976,604285,284,1.00
ptg016611l,15164,15444,280,EVM,mRNA,268,2701957,280,1.00
ptg016611l,117935,118219,284,EVM,mRNA,268,2701957,284,1.00
ptg016611l,517945,518261,316,EVM,mRNA,268,2701957,316,1.00
ptg016617l,445019,445309,290,EVM,mRNA,98732,453454,290,1.00
ptg016621l,875574,875869,295,EVM,mRNA,688124,1008054,295,1.00
ptg016625l,1750807,1751116,309,EVM,mRNA,1728016,1913083,309,1.00
ptg016631l,2015867,2016154,287,EVM,mRNA,795548,2133372,287,1.00
ptg016632l,251725,252027,302,EVM,mRNA,224215,427712,302,1.00
ptg016639l,191999,192325,326,EVM,mRNA,91178,836700,326,1.00
ptg016648l,387716,387996,280,EVM,mRNA,214854,498002,280,1.00
ptg016651l,810652,810965,313,EVM,mRNA,659477,1093072,313,1.00
ptg016662l,20117,20414,297,EVM,mRNA,1424,878304,297,1.00
ptg016701l,953466,953763,297,EVM,mRNA,933355,983979,297,1.00
ptg016704l,201378,201663,285,EVM,mRNA,141552,206520,285,1.00
ptg016712l,80907,81222,315,EVM,mRNA,46834,431845,315,1.00
ptg016723l,348463,348742,279,EVM,mRNA,132925,649056,279,1.00
ptg016723l,595078,595409,331,EVM,mRNA,132925,649056,331,1.00
ptg016724l,460672,460989,317,EVM,mRNA,181019,976503,317,1.00
ptg016728l,698265,698601,336,EVM,mRNA,289815,1234268,336,1.00
ptg016735l,218273,218579,306,EVM,mRNA,68118,420473,306,1.00
ptg016737l,1451324,1451636,312,EVM,mRNA,1068402,1461402,312,1.00
ptg016744l,1536374,1536680,306,EVM,mRNA,963892,2029012,306,1.00
ptg016748l,652552,652826,274,EVM,mRNA,430294,1196331,274,1.00
ptg016751l,882387,882700,313,EVM,mRNA,772209,922903,313,1.00
ptg016765l,393494,393793,299,EVM,mRNA,385236,1045860,299,1.00
ptg016765l,627787,628092,305,EVM,mRNA,385236,1045860,305,1.00
ptg016765l,802158,802455,297,EVM,mRNA,385236,1045860,297,1.00
ptg016774l,584000,584291,291,EVM,mRNA,960,782491,291,1.00
ptg016774l,2418584,2418914,330,EVM,mRNA,2123504,3704528,330,1.00
ptg016774l,2889203,2889542,339,EVM,mRNA,2123504,3704528,339,1.00
ptg016774l,3306394,3306695,301,EVM,mRNA,2123504,3704528,301,1.00
ptg016779l,646008,646345,337,EVM,mRNA,107268,790029,337,1.00
ptg016795l,607485,607740,255,EVM,mRNA,440334,769581,255,1.00
ptg016795l,746927,747244,317,EVM,mRNA,440334,769581,317,1.00
ptg016801l,219702,220016,314,EVM,mRNA,2057,366356,314,1.00
ptg016801l,338685,338995,310,EVM,mRNA,2057,366356,310,1.00
ptg016816l,1013344,1013644,300,EVM,mRNA,974268,1371659,300,1.00
ptg016816l,1370806,1371095,289,EVM,mRNA,974268,1371659,289,1.00
ptg016827l,449442,449741,299,EVM,mRNA,419501,1033350,299,1.00
ptg016827l,559450,559760,310,EVM,mRNA,419501,1033350,310,1.00
ptg016827l,609237,609565,328,EVM,mRNA,419501,1033350,328,1.00
ptg016845l,457349,457623,274,EVM,mRNA,456425,806134,274,1.00
ptg016845l,791954,792280,326,EVM,mRNA,456425,806134,326,1.00
ptg016846l,236854,237147,293,EVM,mRNA,164959,751077,293,1.00
ptg016849l,118690,118985,295,EVM,mRNA,14241,483831,295,1.00
ptg016850l,409764,410102,338,EVM,mRNA,311411,427830,338,1.00
ptg016855l,143491,143803,312,EVM,mRNA,97263,343656,312,1.00
ptg016871l,187455,187735,280,EVM,mRNA,184982,190025,280,1.00
ptg016884l,487880,488189,309,EVM,mRNA,1063,744140,309,1.00
ptg016884l,668123,668425,302,EVM,mRNA,1063,744140,302,1.00
ptg016888l,694865,695191,326,EVM,mRNA,68971,733236,326,1.00
ptg016890l,457342,457642,300,EVM,mRNA,378284,508853,300,1.00
ptg016890l,2019542,2019862,320,EVM,mRNA,1942562,2075582,320,1.00
ptg016901l,115202,115515,313,EVM,mRNA,113564,189620,313,1.00
ptg016905l,1142955,1143253,298,EVM,mRNA,426940,2179275,298,1.00
ptg016905l,1570022,1570351,329,EVM,mRNA,426940,2179275,329,1.00
ptg016905l,1920989,1921288,299,EVM,mRNA,426940,2179275,299,1.00
ptg016930l,698438,698718,280,EVM,mRNA,689791,818763,280,1.00
ptg016930l,760645,760972,327,EVM,mRNA,689791,818763,327,1.00
ptg016934l,1540617,1540928,311,EVM,mRNA,1406329,1920345,311,1.00
ptg016934l,1565130,1565458,328,EVM,mRNA,1406329,1920345,328,1.00
ptg016943l,311159,311439,280,EVM,mRNA,26958,568550,280,1.00
ptg016945l,222171,222493,322,EVM,mRNA,199,232252,322,1.00
ptg016948l,286153,286446,293,EVM,mRNA,199212,550857,293,1.00
ptg016959l,152921,153219,298,EVM,mRNA,6610,160349,298,1.00
ptg016979l,664024,664337,313,EVM,mRNA,427044,792462,313,1.00
ptg016989l,354778,355017,239,EVM,mRNA,116817,442374,239,1.00
ptg016991l,171006,171321,315,EVM,mRNA,126673,280456,315,1.00
ptg017017l,252508,252807,299,EVM,mRNA,148735,534692,299,1.00
ptg017017l,485850,486177,327,EVM,mRNA,148735,534692,327,1.00
ptg017018l,499838,500155,317,EVM,mRNA,474031,543806,317,1.00
ptg017018l,1337672,1337815,143,EVM,mRNA,1286693,1430557,143,1.00
ptg017021l,731389,731667,278,EVM,mRNA,10756,770337,278,1.00
ptg017021l,936623,936943,320,EVM,mRNA,888595,1127002,320,1.00
ptg017037l,2240690,2240962,272,EVM,mRNA,1533756,2248037,272,1.00
ptg017040l,180957,181278,321,EVM,mRNA,71441,323165,321,1.00
ptg017045l,861500,861790,290,EVM,mRNA,682707,911689,290,1.00
ptg017045l,903742,904041,299,EVM,mRNA,682707,911689,299,1.00
ptg017049l,422782,423086,304,EVM,mRNA,338284,538733,304,1.00
ptg017065l,1047585,1047901,316,EVM,mRNA,536559,1639938,316,1.00
ptg017072l,41806,42142,336,EVM,mRNA,11282,457656,336,1.00
ptg017073l,1441232,1441567,335,EVM,mRNA,1425281,1568711,335,1.00
ptg017073l,1515983,1516274,291,EVM,mRNA,1425281,1568711,291,1.00
ptg017073l,1534204,1534475,271,EVM,mRNA,1425281,1568711,271,1.00
ptg017075l,577200,577488,288,EVM,mRNA,3971,582087,288,1.00
ptg017078l,560885,561189,304,EVM,mRNA,509436,659587,304,1.00
ptg017087l,480251,480529,278,EVM,mRNA,15356,522818,278,1.00
ptg017088l,313833,314096,263,EVM,mRNA,70757,967059,263,1.00
ptg017093l,386711,387015,304,EVM,mRNA,338626,570031,304,1.00
ptg017093l,396850,397108,258,EVM,mRNA,338626,570031,258,1.00
ptg017093l,1136769,1137061,292,EVM,mRNA,1055877,1163161,292,1.00
ptg017093l,1896729,1897044,315,EVM,mRNA,1547730,2012459,315,1.00
ptg017100l,1689799,1690094,295,EVM,mRNA,1526826,2417589,295,1.00
ptg017100l,1807178,1807455,277,EVM,mRNA,1526826,2417589,277,1.00
ptg017102l,19267,19564,297,EVM,mRNA,8270,742332,297,1.00
ptg017102l,146613,146908,295,EVM,mRNA,8270,742332,295,1.00
ptg017102l,305492,305789,297,EVM,mRNA,8270,742332,297,1.00
ptg017102l,310782,311077,295,EVM,mRNA,8270,742332,295,1.00
ptg017102l,506313,506633,320,EVM,mRNA,8270,742332,320,1.00
ptg017104l,1339353,1339634,281,EVM,mRNA,904302,1340427,281,1.00
ptg017108l,2702237,2702517,280,EVM,mRNA,2582667,2732760,280,1.00
ptg017123l,642869,643202,333,EVM,mRNA,323393,829855,333,1.00
ptg017130l,98460,98769,309,EVM,mRNA,82448,624821,309,1.00
ptg017156l,602076,602373,297,EVM,mRNA,566651,1221919,297,1.00
ptg017164l,1727954,1728281,327,EVM,mRNA,225658,2100396,327,1.00
ptg017164l,1856828,1857125,297,EVM,mRNA,225658,2100396,297,1.00
ptg017165l,898114,898413,299,EVM,mRNA,157733,1237620,299,1.00
ptg017165l,971952,972252,300,EVM,mRNA,157733,1237620,300,1.00
ptg017172l,168013,168331,318,EVM,mRNA,67001,255417,318,1.00
ptg017191l,858275,858590,315,EVM,mRNA,780770,1021014,315,1.00
ptg017193l,938552,938831,279,EVM,mRNA,793667,2055088,279,1.00
ptg017193l,1461377,1461693,316,EVM,mRNA,793667,2055088,316,1.00
ptg017200l,469355,469652,297,EVM,mRNA,469294,469467,112,0.38
ptg017221l,882391,882691,300,EVM,mRNA,132288,981114,300,1.00
ptg017223l,447306,447618,312,EVM,mRNA,326757,567664,312,1.00
ptg017226l,413874,414189,315,EVM,mRNA,289501,469259,315,1.00
ptg017228l,683484,683805,321,EVM,mRNA,1466,707434,321,1.00
ptg017230l,927867,928152,285,EVM,mRNA,509144,1104451,285,1.00
ptg017230l,960605,960869,264,EVM,mRNA,509144,1104451,264,1.00
ptg017234l,923000,923327,327,EVM,mRNA,839652,1668069,327,1.00
ptg017234l,1226848,1227137,289,EVM,mRNA,839652,1668069,289,1.00
ptg017234l,1334162,1334465,303,EVM,mRNA,839652,1668069,303,1.00
ptg017234l,1412342,1412668,326,EVM,mRNA,839652,1668069,326,1.00
ptg017236l,171013,171301,288,EVM,mRNA,171026,176066,276,0.96
ptg017238l,177513,177810,297,EVM,mRNA,44153,390474,297,1.00
ptg017241l,310479,310778,299,EVM,mRNA,291230,440088,299,1.00
ptg017244l,524824,525094,270,EVM,mRNA,264569,1763090,270,1.00
ptg017244l,692509,692815,306,EVM,mRNA,264569,1763090,306,1.00
ptg017244l,929115,929413,298,EVM,mRNA,264569,1763090,298,1.00
ptg017248l,322261,322572,311,EVM,mRNA,163056,914251,311,1.00
ptg017248l,568050,568377,327,EVM,mRNA,163056,914251,327,1.00
ptg017267l,1621403,1621706,303,EVM,mRNA,1239910,2057020,303,1.00
ptg017270l,1161138,1161433,295,EVM,mRNA,678043,1955523,295,1.00
ptg017270l,1219020,1219310,290,EVM,mRNA,678043,1955523,290,1.00
ptg017270l,1264269,1264562,293,EVM,mRNA,678043,1955523,293,1.00
ptg017270l,1809784,1810069,285,EVM,mRNA,678043,1955523,285,1.00
ptg017277l,277402,277697,295,EVM,mRNA,89996,702122,295,1.00
ptg017277l,1575720,1576043,323,EVM,mRNA,852670,2012240,323,1.00
ptg017283l,415414,415730,316,EVM,mRNA,313854,525965,316,1.00
ptg017289l,227989,228301,312,EVM,mRNA,152159,644740,312,1.00
ptg017301l,656502,656805,303,EVM,mRNA,587164,814894,303,1.00
ptg017307l,488539,488864,325,EVM,mRNA,482950,745586,325,1.00
ptg017311l,1282957,1283249,292,EVM,mRNA,1282324,1665362,292,1.00
ptg017312l,818259,818588,329,EVM,mRNA,712933,853541,329,1.00
ptg017319l,190385,190678,293,EVM,mRNA,59663,557127,293,1.00
ptg017322l,137531,137842,311,EVM,mRNA,106644,141972,311,1.00
ptg017325l,1384563,1384883,320,EVM,mRNA,520794,1959100,320,1.00
ptg017325l,3782432,3782768,336,EVM,mRNA,3185545,4059875,336,1.00
ptg017325l,3851158,3851457,299,EVM,mRNA,3185545,4059875,299,1.00
ptg017330l,347209,347524,315,EVM,mRNA,310534,527877,315,1.00
ptg017333l,59122,59414,292,EVM,mRNA,44550,387956,292,1.00
ptg017334l,700646,700949,303,EVM,mRNA,1708,764470,303,1.00
ptg017350l,125573,125863,290,EVM,mRNA,119532,138387,290,1.00
ptg017358l,232696,233006,310,EVM,mRNA,10123,443158,310,1.00
ptg017358l,269039,269364,325,EVM,mRNA,10123,443158,325,1.00
ptg017358l,575638,575929,291,EVM,mRNA,510923,948911,291,1.00
ptg017359l,196652,196965,313,EVM,mRNA,71057,364794,313,1.00
ptg017359l,265917,266238,321,EVM,mRNA,71057,364794,321,1.00
ptg017364l,412882,413175,293,EVM,mRNA,329553,1786146,293,1.00
ptg017364l,691086,691393,307,EVM,mRNA,329553,1786146,307,1.00
ptg017364l,1492577,1492894,317,EVM,mRNA,329553,1786146,317,1.00
ptg017369l,989752,990047,295,EVM,mRNA,971717,1177690,295,1.00
ptg017377l,211287,211587,300,EVM,mRNA,71583,356863,300,1.00
ptg017377l,237320,237631,311,EVM,mRNA,71583,356863,311,1.00
ptg017377l,617979,618261,282,EVM,mRNA,569340,1316422,282,1.00
ptg017384l,1112319,1112567,248,EVM,mRNA,750174,1365997,248,1.00
ptg017387l,401237,401541,304,EVM,mRNA,6440,971481,304,1.00
ptg017387l,881663,881957,294,EVM,mRNA,6440,971481,294,1.00
ptg017388l,422837,423129,292,EVM,mRNA,94810,2181867,292,1.00
ptg017412l,139856,140155,299,EVM,mRNA,23615,506770,299,1.00
ptg017424l,392071,392385,314,EVM,mRNA,52956,754693,314,1.00
ptg017428l,198480,198748,268,EVM,mRNA,40028,259627,268,1.00
ptg017431l,397652,397973,321,EVM,mRNA,180581,1308199,321,1.00
ptg017431l,722590,722910,320,EVM,mRNA,180581,1308199,320,1.00
ptg017433l,677356,677665,309,EVM,mRNA,421706,688130,309,1.00
ptg017441l,707540,707827,287,EVM,mRNA,75398,789487,287,1.00
ptg017442l,811457,811756,299,EVM,mRNA,561238,828315,299,1.00
ptg017452l,309826,310152,326,EVM,mRNA,176645,525355,326,1.00
ptg017454l,2343218,2343536,318,EVM,mRNA,3889,2716413,318,1.00
ptg017457l,195421,195707,286,EVM,mRNA,3110,198071,286,1.00
ptg017457l,1032626,1032943,317,EVM,mRNA,953506,1048010,317,1.00
ptg017457l,2123039,2123348,309,EVM,mRNA,1421505,2350083,309,1.00
ptg017457l,2271532,2271835,303,EVM,mRNA,1421505,2350083,303,1.00
ptg017464l,609804,610135,331,EVM,mRNA,132247,773690,331,1.00
ptg017464l,645090,645425,335,EVM,mRNA,132247,773690,335,1.00
ptg017464l,756760,757061,301,EVM,mRNA,132247,773690,301,1.00
ptg017465l,204463,204738,275,EVM,mRNA,152712,264613,275,1.00
ptg017465l,206892,207204,312,EVM,mRNA,152712,264613,312,1.00
ptg017469l,218922,219235,313,EVM,mRNA,81593,416857,313,1.00
ptg017471l,155151,155410,259,EVM,mRNA,84772,1803636,259,1.00
ptg017471l,597898,598178,280,EVM,mRNA,84772,1803636,280,1.00
ptg017473l,319850,320171,321,EVM,mRNA,136958,415567,321,1.00
ptg017474l,1004134,1004439,305,EVM,mRNA,343405,2640880,305,1.00
ptg017474l,1985928,1986172,244,EVM,mRNA,343405,2640880,244,1.00
ptg017474l,2763798,2764113,315,EVM,mRNA,2678666,2766809,315,1.00
ptg017490l,565038,565287,249,EVM,mRNA,14849,595659,249,1.00
ptg017519l,864130,864435,305,EVM,mRNA,857093,867394,305,1.00
ptg017521l,112873,113164,291,EVM,mRNA,54847,213498,291,1.00
ptg017523l,124228,124532,304,EVM,mRNA,121519,1211347,304,1.00
ptg017523l,655427,655759,332,EVM,mRNA,121519,1211347,332,1.00
ptg017525l,187592,187888,296,EVM,mRNA,101782,726839,296,1.00
ptg017525l,571546,571828,282,EVM,mRNA,101782,726839,282,1.00
ptg017525l,603146,603432,286,EVM,mRNA,101782,726839,286,1.00
ptg017525l,636654,636925,271,EVM,mRNA,101782,726839,271,1.00
ptg017526l,204016,204340,324,EVM,mRNA,326,542993,324,1.00
ptg017526l,404271,404585,314,EVM,mRNA,326,542993,314,1.00
ptg017542l,1771950,1772267,317,EVM,mRNA,1708433,2395683,317,1.00
ptg017544l,33233,33549,316,EVM,mRNA,2520,227613,316,1.00
ptg017569l,1321495,1321785,290,EVM,mRNA,96895,4104967,290,1.00
ptg017575l,272489,272798,309,EVM,mRNA,66553,525353,309,1.00
ptg017576l,1380040,1380338,298,EVM,mRNA,167665,1885532,298,1.00
ptg017585l,820142,820438,296,EVM,mRNA,363325,965785,296,1.00
ptg017587l,960599,960896,297,EVM,mRNA,831567,976984,297,1.00
ptg017588l,122439,122716,277,EVM,mRNA,115755,344050,277,1.00
ptg017589l,405126,405426,300,EVM,mRNA,15093,487110,300,1.00
ptg017603l,203061,203372,311,EVM,mRNA,99344,793622,311,1.00
ptg017603l,497133,497436,303,EVM,mRNA,99344,793622,303,1.00
ptg017613l,1351419,1351703,284,EVM,mRNA,1170108,1458228,284,1.00
ptg017620l,523086,523380,294,EVM,mRNA,7356,697395,294,1.00
ptg017628l,543737,544020,283,EVM,mRNA,237211,894319,283,1.00
ptg017628l,2831574,2831850,276,EVM,mRNA,930820,2832581,276,1.00
ptg017629l,828021,828302,281,EVM,mRNA,806726,1000264,281,1.00
ptg017632l,386907,387203,296,EVM,mRNA,107641,700954,296,1.00
ptg017632l,439116,439412,296,EVM,mRNA,107641,700954,296,1.00
ptg017632l,954357,954642,285,EVM,mRNA,841136,1157936,285,1.00
ptg017634l,387922,388217,295,EVM,mRNA,28270,743639,295,1.00
ptg017635l,52283,52594,311,EVM,mRNA,5450,256004,311,1.00
ptg017640l,447975,448280,305,EVM,mRNA,108783,750402,305,1.00
ptg017640l,481940,482205,265,EVM,mRNA,108783,750402,265,1.00
ptg017640l,656306,656625,319,EVM,mRNA,108783,750402,319,1.00
ptg017641l,710323,710600,277,EVM,mRNA,649213,721641,277,1.00
ptg017656l,75705,76012,307,EVM,mRNA,488,911812,307,1.00
ptg017656l,842214,842524,310,EVM,mRNA,488,911812,310,1.00
ptg017658l,1046319,1046599,280,EVM,mRNA,748193,1227410,280,1.00
ptg017661l,169904,170189,285,EVM,mRNA,99472,198277,285,1.00
ptg017661l,170243,170529,286,EVM,mRNA,99472,198277,286,1.00
ptg017671l,499890,500175,285,EVM,mRNA,379238,586272,285,1.00
ptg017687l,736114,736403,289,EVM,mRNA,578972,856321,289,1.00
ptg017690l,42640,42944,304,EVM,mRNA,42935,618727,10,0.03
ptg017699l,125073,125364,291,EVM,mRNA,113044,335951,291,1.00
ptg017699l,297231,297511,280,EVM,mRNA,113044,335951,280,1.00
ptg017703l,308827,309132,305,EVM,mRNA,25679,1389644,305,1.00
ptg017703l,323019,323292,273,EVM,mRNA,25679,1389644,273,1.00
ptg017704l,716322,716637,315,EVM,mRNA,233,1017486,315,1.00
ptg017708l,290880,291180,300,EVM,mRNA,271294,436535,300,1.00
ptg017713l,610593,610902,309,EVM,mRNA,187292,943013,309,1.00
ptg017727l,29181,29468,287,EVM,mRNA,403,280587,287,1.00
ptg017736l,323782,324061,279,EVM,mRNA,250619,402462,279,1.00
ptg017770l,215620,215955,335,EVM,mRNA,108511,276714,335,1.00
ptg017773l,125677,125968,291,EVM,mRNA,76043,368539,291,1.00
ptg017783l,3086220,3086539,319,EVM,mRNA,2423156,3617547,319,1.00
ptg017784l,982750,983041,291,EVM,mRNA,332013,1320698,291,1.00
ptg017794l,663910,664234,324,EVM,mRNA,134994,749522,324,1.00
ptg017794l,730725,731037,312,EVM,mRNA,134994,749522,312,1.00
ptg017804l,361142,361448,306,EVM,mRNA,2795,1495721,306,1.00
ptg017815l,312832,313141,309,EVM,mRNA,293300,1009147,309,1.00
ptg017815l,607206,607513,307,EVM,mRNA,293300,1009147,307,1.00
ptg017815l,990279,990575,296,EVM,mRNA,293300,1009147,296,1.00
ptg017820l,260907,261230,323,EVM,mRNA,255953,419763,323,1.00
ptg017826l,1313740,1314029,289,EVM,mRNA,1212577,1348960,289,1.00
ptg017828l,548063,548372,309,EVM,mRNA,304094,674506,309,1.00
ptg017828l,1109157,1109470,313,EVM,mRNA,922987,1312328,313,1.00
ptg017852l,1312621,1312936,315,EVM,mRNA,545857,1448368,315,1.00
ptg017859l,109797,110109,312,EVM,mRNA,62168,131925,312,1.00
ptg017865l,3095921,3096220,299,EVM,mRNA,2560364,3239359,299,1.00
ptg017889l,1151755,1152090,335,EVM,mRNA,400892,1354359,335,1.00
ptg017889l,1772110,1772428,318,EVM,mRNA,1733542,2334879,318,1.00
ptg017889l,4373967,4374260,293,EVM,mRNA,4342544,4756041,293,1.00
ptg017889l,6566327,6566610,283,EVM,mRNA,6566145,6580970,283,1.00
ptg017889l,6824982,6825274,292,EVM,mRNA,6776034,7062466,292,1.00
ptg017898l,7694,7985,291,EVM,mRNA,1599,1297218,291,1.00
ptg017898l,1003352,1003651,299,EVM,mRNA,1599,1297218,299,1.00
ptg017898l,5545615,5545898,283,EVM,mRNA,5089674,7581606,283,1.00
ptg017898l,5984731,5985032,301,EVM,mRNA,5089674,7581606,301,1.00
ptg017898l,6750863,6751170,307,EVM,mRNA,5089674,7581606,307,1.00
ptg017898l,7066302,7066609,307,EVM,mRNA,5089674,7581606,307,1.00
ptg017908l,361314,361610,296,EVM,mRNA,72870,607747,296,1.00
ptg017908l,557871,558166,295,EVM,mRNA,72870,607747,295,1.00
ptg017912l,172136,172465,329,EVM,mRNA,47393,372686,329,1.00
ptg017917l,25974,26267,293,EVM,mRNA,2075,1269708,293,1.00
ptg017923l,773516,773792,276,EVM,mRNA,733176,1024409,276,1.00
ptg017923l,871329,871630,301,EVM,mRNA,733176,1024409,301,1.00
ptg017923l,942111,942400,289,EVM,mRNA,733176,1024409,289,1.00
ptg017925l,211266,211570,304,EVM,mRNA,187347,423325,304,1.00
ptg017925l,292558,292891,333,EVM,mRNA,187347,423325,333,1.00
ptg017925l,293233,293512,279,EVM,mRNA,187347,423325,279,1.00
ptg017925l,319140,319440,300,EVM,mRNA,187347,423325,300,1.00
ptg017925l,366231,366516,285,EVM,mRNA,187347,423325,285,1.00
ptg017933l,183323,183633,310,EVM,mRNA,93701,203106,310,1.00
ptg017935l,561688,561969,281,EVM,mRNA,186452,576291,281,1.00
ptg017935l,569216,569510,294,EVM,mRNA,186452,576291,294,1.00
ptg017939l,2866324,2866662,338,EVM,mRNA,2861094,2956666,338,1.00
ptg017939l,2870729,2871032,303,EVM,mRNA,2861094,2956666,303,1.00
ptg017948l,564383,564680,297,EVM,mRNA,87,678151,297,1.00
ptg017959l,27774,28073,299,EVM,mRNA,16838,274374,299,1.00
ptg017990l,398974,399269,295,EVM,mRNA,315013,488822,295,1.00
ptg017995l,1044310,1044625,315,EVM,mRNA,721748,1260079,315,1.00
ptg017995l,1173978,1174249,271,EVM,mRNA,721748,1260079,271,1.00
ptg018018l,14298,14602,304,EVM,mRNA,13069,446881,304,1.00
ptg018018l,25719,26007,288,EVM,mRNA,13069,446881,288,1.00
ptg018037l,449352,449675,323,EVM,mRNA,94426,674282,323,1.00
ptg018037l,644743,645021,278,EVM,mRNA,94426,674282,278,1.00
ptg018060l,890872,891150,278,EVM,mRNA,317808,1370269,278,1.00
ptg018060l,1115355,1115694,339,EVM,mRNA,317808,1370269,339,1.00
ptg018060l,1203029,1203340,311,EVM,mRNA,317808,1370269,311,1.00
ptg018066l,174137,174425,288,EVM,mRNA,31,613153,288,1.00
ptg018066l,1698636,1698937,301,EVM,mRNA,1605118,1808140,301,1.00
ptg018076l,461297,461614,317,EVM,mRNA,169354,1206987,317,1.00
ptg018079l,1644631,1644877,246,EVM,mRNA,1643532,1897783,246,1.00
ptg018088l,596540,596845,305,EVM,mRNA,24383,980330,305,1.00
ptg018088l,810620,810952,332,EVM,mRNA,24383,980330,332,1.00
ptg018096l,869891,870186,295,EVM,mRNA,721023,1189663,295,1.00
ptg018109l,279467,279769,302,EVM,mRNA,17043,629518,302,1.00
ptg018122l,712682,713000,318,EVM,mRNA,221,752144,318,1.00
ptg018124l,583006,583319,313,EVM,mRNA,49759,700889,313,1.00
ptg018128l,472536,472825,289,EVM,mRNA,909,992050,289,1.00
ptg018129l,683313,683611,298,EVM,mRNA,585312,688085,298,1.00
ptg018129l,759560,759858,298,EVM,mRNA,758719,947592,298,1.00
ptg018153l,3841447,3841735,288,EVM,mRNA,3818849,4043436,288,1.00
ptg018155l,144781,145108,327,EVM,mRNA,66387,235828,327,1.00
ptg018174l,220186,220473,287,EVM,mRNA,18023,246313,287,1.00
ptg018180l,145541,145823,282,EVM,mRNA,126902,412615,282,1.00
ptg018180l,249787,250091,304,EVM,mRNA,126902,412615,304,1.00
ptg018181l,1067124,1067397,273,EVM,mRNA,512297,1765982,273,1.00
ptg018181l,1222477,1222778,301,EVM,mRNA,512297,1765982,301,1.00
ptg018187l,803811,804121,310,EVM,mRNA,778238,1290393,310,1.00
ptg018188l,607384,607684,300,EVM,mRNA,601,677770,300,1.00
ptg018191l,1532808,1533085,277,EVM,mRNA,737680,1755343,277,1.00
ptg018201l,452025,452322,297,EVM,mRNA,351048,503659,297,1.00
ptg018218l,1416764,1417078,314,EVM,mRNA,693505,2098044,314,1.00
ptg018219l,248773,249087,314,EVM,mRNA,189855,378064,314,1.00
ptg018219l,340899,341252,353,EVM,mRNA,189855,378064,353,1.00
ptg018223l,345742,346053,311,EVM,mRNA,215398,346720,311,1.00
ptg018225l,248035,248320,285,EVM,mRNA,275,351749,285,1.00
ptg018227l,444195,444495,300,EVM,mRNA,1532,845158,300,1.00
ptg018243l,804706,805006,300,EVM,mRNA,522508,837553,300,1.00
ptg018258l,166736,167016,280,EVM,mRNA,21076,1134603,280,1.00
ptg018266l,350022,350314,292,EVM,mRNA,248777,404903,292,1.00
ptg018270l,1308052,1308368,316,EVM,mRNA,1141783,1534742,316,1.00
ptg018270l,3902451,3902731,280,EVM,mRNA,3372632,4302649,280,1.00
ptg018270l,3945167,3945432,265,EVM,mRNA,3372632,4302649,265,1.00
ptg018270l,4053941,4054220,279,EVM,mRNA,3372632,4302649,279,1.00
ptg018270l,6369471,6369791,320,EVM,mRNA,6166560,6421816,320,1.00
ptg018285l,366545,366851,306,EVM,mRNA,361325,787809,306,1.00
ptg018285l,519981,520270,289,EVM,mRNA,361325,787809,289,1.00
ptg018292l,111118,111433,315,EVM,mRNA,43418,157169,315,1.00
ptg018295l,187304,187589,285,EVM,mRNA,9710,617362,285,1.00
ptg018309l,1028831,1029126,295,EVM,mRNA,67960,1947816,295,1.00
ptg018313l,784312,784615,303,EVM,mRNA,759606,1828607,303,1.00
ptg018313l,1303425,1303732,307,EVM,mRNA,759606,1828607,307,1.00
ptg018324l,385293,385603,310,EVM,mRNA,106459,447590,310,1.00
ptg018324l,422320,422604,284,EVM,mRNA,106459,447590,284,1.00
ptg018324l,1545052,1545333,281,EVM,mRNA,554019,1694048,281,1.00
ptg018331l,179933,180248,315,EVM,mRNA,38363,328609,315,1.00
ptg018350l,388469,388696,227,EVM,mRNA,330296,389053,227,1.00
ptg018362l,317121,317418,297,EVM,mRNA,102778,342410,297,1.00
ptg018363l,319954,320282,328,EVM,mRNA,95618,1871607,328,1.00
ptg018363l,1599830,1600160,330,EVM,mRNA,95618,1871607,330,1.00
ptg018381l,117388,117669,281,EVM,mRNA,103128,1228115,281,1.00
ptg018389l,978300,978599,299,EVM,mRNA,854974,989285,299,1.00
ptg018407l,204835,205135,300,EVM,mRNA,23841,1005819,300,1.00
ptg018411l,130611,130906,295,EVM,mRNA,34695,319674,295,1.00
ptg018416l,242545,242831,286,EVM,mRNA,67367,544991,286,1.00
ptg018418l,1202625,1202926,301,EVM,mRNA,527891,1751584,301,1.00
ptg018418l,1456631,1456960,329,EVM,mRNA,527891,1751584,329,1.00
ptg018423l,382056,382365,309,EVM,mRNA,284820,651341,309,1.00
ptg018427l,234184,234453,269,EVM,mRNA,916,820233,269,1.00
ptg018427l,468986,469267,281,EVM,mRNA,916,820233,281,1.00
ptg018427l,493918,494198,280,EVM,mRNA,916,820233,280,1.00
ptg018427l,539172,539474,302,EVM,mRNA,916,820233,302,1.00
ptg018427l,677397,677725,328,EVM,mRNA,916,820233,328,1.00
ptg018431l,837751,838043,292,EVM,mRNA,60090,1174547,292,1.00
ptg018449l,371109,371410,301,EVM,mRNA,41358,615105,301,1.00
ptg018475l,66865,67159,294,EVM,mRNA,20483,105105,294,1.00
ptg018475l,98016,98300,284,EVM,mRNA,20483,105105,284,1.00
ptg018488l,454453,454751,298,EVM,mRNA,416068,474049,298,1.00
ptg018488l,658257,658564,307,EVM,mRNA,598440,786032,307,1.00
ptg018504l,220042,220343,301,EVM,mRNA,45420,482446,301,1.00
ptg018506l,600131,600430,299,EVM,mRNA,17604,723649,299,1.00
ptg018516l,134816,135109,293,EVM,mRNA,125710,208713,293,1.00
ptg018520l,869746,870054,308,EVM,mRNA,193,2351310,308,1.00
ptg018520l,3404231,3404547,316,EVM,mRNA,2912760,3437002,316,1.00
ptg018520l,3726357,3726679,322,EVM,mRNA,3633716,4032613,322,1.00
ptg018522l,12970,13291,321,EVM,mRNA,365,66011,321,1.00
ptg018523l,3023591,3023896,305,EVM,mRNA,1287996,4493657,305,1.00
ptg018523l,3852464,3852759,295,EVM,mRNA,1287996,4493657,295,1.00
ptg018523l,4150743,4151023,280,EVM,mRNA,1287996,4493657,280,1.00
ptg018525l,696775,697081,306,EVM,mRNA,89237,1066470,306,1.00
ptg018525l,716170,716497,327,EVM,mRNA,89237,1066470,327,1.00
ptg018525l,867616,867928,312,EVM,mRNA,89237,1066470,312,1.00
ptg018527l,205249,205548,299,EVM,mRNA,325,952754,299,1.00
ptg018527l,375126,375425,299,EVM,mRNA,325,952754,299,1.00
ptg018527l,426637,426921,284,EVM,mRNA,325,952754,284,1.00
ptg018527l,497746,498046,300,EVM,mRNA,325,952754,300,1.00
ptg018527l,654826,655104,278,EVM,mRNA,325,952754,278,1.00
ptg018536l,393944,394258,314,EVM,mRNA,100005,588367,314,1.00
ptg018559l,1124368,1124673,305,EVM,mRNA,1063052,1305155,305,1.00
ptg018559l,1248489,1248779,290,EVM,mRNA,1063052,1305155,290,1.00
ptg018565l,806235,806512,277,EVM,mRNA,657315,816582,277,1.00
ptg018571l,705832,706154,322,EVM,mRNA,239425,954079,322,1.00
ptg018571l,1278272,1278591,319,EVM,mRNA,1277683,1940962,319,1.00
ptg018571l,1326473,1326766,293,EVM,mRNA,1277683,1940962,293,1.00
ptg018576l,824686,824955,269,EVM,mRNA,32744,1381819,269,1.00
ptg018578l,1051088,1051411,323,EVM,mRNA,786147,1224143,323,1.00
ptg018580l,408638,408933,295,EVM,mRNA,89568,1634575,295,1.00
ptg018580l,2716960,2717254,294,EVM,mRNA,2666953,2985033,294,1.00
ptg018586l,109563,109856,293,EVM,mRNA,57581,207476,293,1.00
ptg018590l,931511,931852,341,EVM,mRNA,117,1016409,341,1.00
ptg018595l,320842,321131,289,EVM,mRNA,104585,346532,289,1.00
ptg018602l,1191886,1192201,315,EVM,mRNA,334349,1588273,315,1.00
ptg018602l,1288682,1288986,304,EVM,mRNA,334349,1588273,304,1.00
ptg018620l,271410,271726,316,EVM,mRNA,187580,287947,316,1.00
ptg018623l,839251,839575,324,EVM,mRNA,746519,911176,324,1.00
ptg018631l,787437,787711,274,EVM,mRNA,623440,932532,274,1.00
ptg018632l,962295,962611,316,EVM,mRNA,90070,1651511,316,1.00
ptg018632l,1149675,1149989,314,EVM,mRNA,90070,1651511,314,1.00
ptg018632l,1632445,1632761,316,EVM,mRNA,90070,1651511,316,1.00
ptg018648l,1033832,1034125,293,EVM,mRNA,922673,1070148,293,1.00
ptg018652l,265470,265785,315,EVM,mRNA,147617,738738,315,1.00
ptg018665l,534194,534481,287,EVM,mRNA,402103,2235467,287,1.00
ptg018665l,1037538,1037872,334,EVM,mRNA,402103,2235467,334,1.00
ptg018665l,1079931,1080222,291,EVM,mRNA,402103,2235467,291,1.00
ptg018665l,1159525,1159804,279,EVM,mRNA,402103,2235467,279,1.00
ptg018665l,1466947,1467211,264,EVM,mRNA,402103,2235467,264,1.00
ptg018665l,1558185,1558512,327,EVM,mRNA,402103,2235467,327,1.00
ptg018670l,470151,470448,297,EVM,mRNA,430394,790070,297,1.00
ptg018670l,595414,595714,300,EVM,mRNA,430394,790070,300,1.00
ptg018674l,1820401,1820726,325,EVM,mRNA,1752095,1918384,325,1.00
ptg018676l,1764213,1764515,302,EVM,mRNA,1151109,1776858,302,1.00
ptg018686l,184705,185012,307,EVM,mRNA,18566,878967,307,1.00
ptg018689l,207925,208209,284,EVM,mRNA,126868,248926,284,1.00
ptg018696l,429812,430102,290,EVM,mRNA,196268,539933,290,1.00
ptg018705l,275840,276141,301,EVM,mRNA,20703,357812,301,1.00
ptg018711l,474475,474763,288,EVM,mRNA,10792,797589,288,1.00
ptg018726l,183036,183348,312,EVM,mRNA,57107,183787,312,1.00
ptg018730l,279548,279858,310,EVM,mRNA,279171,467271,310,1.00
ptg018736l,832011,832309,298,EVM,mRNA,528493,1013771,298,1.00
ptg018759l,730171,730463,292,EVM,mRNA,683895,764717,292,1.00
ptg018769l,173388,173668,280,EVM,mRNA,168514,695155,280,1.00
ptg018786l,1258443,1258721,278,EVM,mRNA,872915,1283298,278,1.00
ptg018792l,480612,480936,324,EVM,mRNA,118610,485828,324,1.00
ptg018809l,850937,851215,278,EVM,mRNA,668933,923164,278,1.00
ptg018826l,476419,476716,297,EVM,mRNA,309724,528358,297,1.00
ptg018826l,525980,526304,324,EVM,mRNA,309724,528358,324,1.00
ptg018828l,604512,604809,297,EVM,mRNA,1116,733818,297,1.00
ptg018847l,328013,328311,298,EVM,mRNA,39449,671092,298,1.00
ptg018850l,557865,558159,294,EVM,mRNA,269202,1070237,294,1.00
ptg018857l,383394,383648,254,EVM,mRNA,155936,1667434,254,1.00
ptg018857l,827012,827325,313,EVM,mRNA,155936,1667434,313,1.00
ptg018857l,927431,927734,303,EVM,mRNA,155936,1667434,303,1.00
ptg018857l,2078228,2078519,291,EVM,mRNA,1786780,2638338,291,1.00
ptg018858l,1234881,1235181,300,EVM,mRNA,1233246,1402105,300,1.00
ptg018865l,177196,177481,285,EVM,mRNA,143397,514165,285,1.00
ptg018870l,239339,239623,284,EVM,mRNA,235059,269054,284,1.00
ptg018870l,890968,891264,296,EVM,mRNA,373106,1195366,296,1.00
ptg018870l,1086868,1087160,292,EVM,mRNA,373106,1195366,292,1.00
ptg018872l,1346513,1346804,291,EVM,mRNA,1200424,1688729,291,1.00
ptg018872l,2155160,2155446,286,EVM,mRNA,1879965,2206073,286,1.00
ptg018873l,759335,759635,300,EVM,mRNA,693655,986036,300,1.00
ptg018876l,206278,206569,291,EVM,mRNA,850,265429,291,1.00
ptg018878l,442888,443195,307,EVM,mRNA,301776,484092,307,1.00
ptg018881l,316825,317107,282,EVM,mRNA,257931,439675,282,1.00
ptg018887l,1531764,1532061,297,EVM,mRNA,1053467,1573417,297,1.00
ptg018891l,1725264,1725529,265,EVM,mRNA,1053880,1934654,265,1.00
ptg018891l,4184751,4185050,299,EVM,mRNA,4183401,4687359,299,1.00
ptg018891l,4625748,4626058,310,EVM,mRNA,4183401,4687359,310,1.00
ptg018891l,4758852,4759136,284,EVM,mRNA,4757063,5695077,284,1.00
ptg018904l,1231274,1231577,303,EVM,mRNA,791938,2385843,303,1.00
ptg018904l,1977355,1977648,293,EVM,mRNA,791938,2385843,293,1.00
ptg018910l,384057,384337,280,EVM,mRNA,168387,394294,280,1.00
ptg018913l,620682,620978,296,EVM,mRNA,368617,760891,296,1.00
ptg018920l,192129,192436,307,EVM,mRNA,123841,220887,307,1.00
ptg018931l,928209,928526,317,EVM,mRNA,860569,1007651,317,1.00
ptg018939l,282783,283067,284,EVM,mRNA,190172,442855,284,1.00
ptg018941l,560804,561120,316,EVM,mRNA,422191,562448,316,1.00
ptg018941l,965272,965568,296,EVM,mRNA,955243,988627,296,1.00
ptg018957l,3097766,3098059,293,EVM,mRNA,2279350,3138200,293,1.00
ptg018962l,619874,620172,298,EVM,mRNA,546807,690982,298,1.00
ptg018989l,148896,149214,318,EVM,mRNA,89203,158039,318,1.00
ptg018991l,1477145,1477421,276,EVM,mRNA,1383389,1569079,276,1.00
ptg018995l,1421276,1421588,312,EVM,mRNA,1003661,2011118,312,1.00
ptg019006l,62505,62817,312,EVM,mRNA,14916,265350,312,1.00
ptg019006l,85170,85490,320,EVM,mRNA,14916,265350,320,1.00
ptg019027l,370774,371068,294,EVM,mRNA,352298,541779,294,1.00
ptg019042l,36837,37136,299,EVM,mRNA,13220,81433,299,1.00
ptg019042l,781784,782085,301,EVM,mRNA,236802,792956,301,1.00
ptg019043l,140605,140905,300,EVM,mRNA,68113,238968,300,1.00
ptg019063l,476636,476930,294,EVM,mRNA,470583,533673,294,1.00
ptg019066l,251257,251552,295,EVM,mRNA,126512,1582394,295,1.00
ptg019082l,600113,600419,306,EVM,mRNA,454248,863531,306,1.00
ptg019120l,219497,219820,323,EVM,mRNA,142627,379541,323,1.00
ptg019120l,321176,321508,332,EVM,mRNA,142627,379541,332,1.00
ptg019125l,112986,113288,302,EVM,mRNA,36210,563631,302,1.00
ptg019139l,53063,53362,299,EVM,mRNA,14554,418602,299,1.00
ptg019146l,358937,359269,332,EVM,mRNA,89378,747890,332,1.00
ptg019161l,280890,281170,280,EVM,mRNA,193029,640457,280,1.00
ptg019161l,311672,311968,296,EVM,mRNA,193029,640457,296,1.00
ptg019180l,1460591,1460904,313,EVM,mRNA,1347554,2532936,313,1.00
ptg019190l,1801710,1801975,265,EVM,mRNA,1722202,1833774,265,1.00
ptg019197l,174758,175034,276,EVM,mRNA,173259,1528316,276,1.00
ptg019197l,407395,407659,264,EVM,mRNA,173259,1528316,264,1.00
ptg019199l,719506,719792,286,EVM,mRNA,384236,846363,286,1.00
ptg019199l,784605,784900,295,EVM,mRNA,384236,846363,295,1.00
ptg019211l,1684910,1685221,311,EVM,mRNA,1212915,2171749,311,1.00
ptg019211l,1750055,1750334,279,EVM,mRNA,1212915,2171749,279,1.00
ptg019216l,1051161,1051492,331,EVM,mRNA,1045186,1061551,331,1.00
ptg019231l,986680,986981,301,EVM,mRNA,977663,1558226,301,1.00
ptg019238l,525756,526034,278,EVM,mRNA,495160,635440,278,1.00
ptg019244l,136352,136629,277,EVM,mRNA,2147,338284,277,1.00
ptg019244l,257551,257798,247,EVM,mRNA,2147,338284,247,1.00
ptg019251l,247038,247337,299,EVM,mRNA,168925,549806,299,1.00
ptg019251l,252708,253006,298,EVM,mRNA,168925,549806,298,1.00
ptg019257l,997556,997840,284,EVM,mRNA,922508,1187038,284,1.00
ptg019258l,301244,301531,287,EVM,mRNA,122915,353278,287,1.00
ptg019263l,1332780,1333068,288,EVM,mRNA,701619,1558744,288,1.00
ptg019271l,302568,302878,310,EVM,mRNA,187844,1308858,310,1.00
ptg019271l,829857,830153,296,EVM,mRNA,187844,1308858,296,1.00
ptg019272l,193308,193615,307,EVM,mRNA,112346,208486,307,1.00
ptg019273l,868827,869157,330,EVM,mRNA,738177,885699,330,1.00
ptg019275l,446030,446295,265,EVM,mRNA,230471,1080340,265,1.00
ptg019275l,542223,542562,339,EVM,mRNA,230471,1080340,339,1.00
ptg019275l,644618,644909,291,EVM,mRNA,230471,1080340,291,1.00
ptg019286l,170041,170330,289,EVM,mRNA,118471,689161,289,1.00
ptg019288l,1692667,1692966,299,EVM,mRNA,1524727,2317597,299,1.00
ptg019290l,842975,843301,326,EVM,mRNA,762040,917267,326,1.00
ptg019290l,910659,910956,297,EVM,mRNA,762040,917267,297,1.00
ptg019294l,685265,685544,279,EVM,mRNA,346078,1015346,279,1.00
ptg019294l,848429,848707,278,EVM,mRNA,346078,1015346,278,1.00
ptg019303l,561762,562087,325,EVM,mRNA,436653,578290,325,1.00
ptg019303l,1042669,1042939,270,EVM,mRNA,1030087,1113353,270,1.00
ptg019305l,90346,90626,280,EVM,mRNA,54812,99474,280,1.00
ptg019330l,229953,230257,304,EVM,mRNA,140505,618175,304,1.00
ptg019333l,143290,143562,272,EVM,mRNA,37963,960774,272,1.00
ptg019347l,365119,365426,307,EVM,mRNA,6744,554540,307,1.00
ptg019354l,763676,763961,285,EVM,mRNA,1427,1191855,285,1.00
ptg019354l,853965,854243,278,EVM,mRNA,1427,1191855,278,1.00
ptg019356l,159410,159698,288,EVM,mRNA,2818,264940,288,1.00
ptg019366l,518370,518665,295,EVM,mRNA,518122,1135188,295,1.00
ptg019388l,415789,416086,297,EVM,mRNA,472,608496,297,1.00
ptg019423l,301641,301927,286,EVM,mRNA,46667,521305,286,1.00
ptg019429l,800115,800417,302,EVM,mRNA,775573,863080,302,1.00
ptg019430l,1962356,1962636,280,EVM,mRNA,1673386,1971732,280,1.00
ptg019434l,577460,577758,298,EVM,mRNA,179977,661953,298,1.00
ptg019444l,340060,340374,314,EVM,mRNA,297605,3533115,314,1.00
ptg019444l,2819690,2819985,295,EVM,mRNA,297605,3533115,295,1.00
ptg019444l,3530264,3530549,285,EVM,mRNA,297605,3533115,285,1.00
ptg019454l,215603,215934,331,EVM,mRNA,14888,656010,331,1.00
ptg019459l,1088512,1088812,300,EVM,mRNA,407842,1095918,300,1.00
ptg019465l,2512014,2512317,303,EVM,mRNA,2295822,3776326,303,1.00
ptg019465l,2890760,2891072,312,EVM,mRNA,2295822,3776326,312,1.00
ptg019474l,21148,21460,312,EVM,mRNA,688,164942,312,1.00
ptg019482l,295391,295693,302,EVM,mRNA,285641,349337,302,1.00
ptg019482l,571420,571712,292,EVM,mRNA,556649,656655,292,1.00
ptg019483l,1438528,1438812,284,EVM,mRNA,1349243,1874011,284,1.00
ptg019484l,140672,140969,297,EVM,mRNA,41336,460496,297,1.00
ptg019491l,222475,222779,304,EVM,mRNA,213813,337399,304,1.00
ptg019493l,894138,894449,311,EVM,mRNA,496121,978400,311,1.00
ptg019503l,301768,302081,313,EVM,mRNA,299739,330186,313,1.00
ptg019533l,49190,49505,315,EVM,mRNA,8436,248847,315,1.00
ptg019546l,182814,183111,297,EVM,mRNA,105813,296891,297,1.00
ptg019551l,575185,575466,281,EVM,mRNA,446966,1198100,281,1.00
ptg019562l,405977,406267,290,EVM,mRNA,340954,434922,290,1.00
ptg019574l,135722,136038,316,EVM,mRNA,135224,521599,316,1.00
ptg019574l,497830,498163,333,EVM,mRNA,135224,521599,333,1.00
ptg019581l,763881,764161,280,EVM,mRNA,603245,859930,280,1.00
ptg019581l,2290362,2290671,309,EVM,mRNA,1191312,2562907,309,1.00
ptg019621l,1432491,1432773,282,EVM,mRNA,1432280,1914397,282,1.00
ptg019647l,344980,345272,292,EVM,mRNA,3586,514099,292,1.00
ptg019649l,817703,817999,296,EVM,mRNA,696279,818287,296,1.00
ptg019654l,345545,345841,296,EVM,mRNA,55649,386446,296,1.00
ptg019665l,335028,335327,299,EVM,mRNA,313568,457725,299,1.00
ptg019670l,851344,851639,295,EVM,mRNA,198138,1030991,295,1.00
ptg019672l,346590,346879,289,EVM,mRNA,130291,500484,289,1.00
ptg019680l,384943,385225,282,EVM,mRNA,239435,767060,282,1.00
ptg019683l,635510,635801,291,EVM,mRNA,315419,733239,291,1.00
ptg019685l,999131,999450,319,EVM,mRNA,650336,1591659,319,1.00
ptg019691l,829748,830061,313,EVM,mRNA,98290,1238292,313,1.00
ptg019691l,1161740,1162068,328,EVM,mRNA,98290,1238292,328,1.00
ptg019692l,733643,733950,307,EVM,mRNA,732406,871261,307,1.00
ptg019696l,1796484,1796749,265,EVM,mRNA,1406468,2210577,265,1.00
ptg019699l,212415,212734,319,EVM,mRNA,166144,487674,319,1.00
ptg019702l,1359391,1359687,296,EVM,mRNA,652608,1682187,296,1.00
ptg019702l,1618927,1619215,288,EVM,mRNA,652608,1682187,288,1.00
ptg019738l,320582,320895,313,EVM,mRNA,312610,409250,313,1.00
ptg019742l,341728,342051,323,EVM,mRNA,21592,580754,323,1.00
ptg019755l,873767,874070,303,EVM,mRNA,704942,981140,303,1.00
ptg019757l,229434,229717,283,EVM,mRNA,229467,504759,251,0.89
ptg019765l,406125,406423,298,EVM,mRNA,91582,441549,298,1.00
ptg019791l,235250,235492,242,EVM,mRNA,128114,363068,242,1.00
ptg019794l,142651,142945,294,EVM,mRNA,100428,173706,294,1.00
ptg019800l,184673,185005,332,EVM,mRNA,64063,238709,332,1.00
ptg019809l,263001,263288,287,EVM,mRNA,246189,782925,287,1.00
ptg019809l,443078,443395,317,EVM,mRNA,246189,782925,317,1.00
ptg019810l,2168816,2169128,312,EVM,mRNA,1990444,2847825,312,1.00
ptg019852l,862011,862330,319,EVM,mRNA,214525,878802,319,1.00
ptg019854l,341077,341358,281,EVM,mRNA,314152,791616,281,1.00
ptg019854l,729923,730243,320,EVM,mRNA,314152,791616,320,1.00
ptg019859l,43013,43333,320,EVM,mRNA,7630,429892,320,1.00
ptg019879l,181036,181340,304,EVM,mRNA,91128,1218682,304,1.00
ptg019879l,360000,360317,317,EVM,mRNA,91128,1218682,317,1.00
ptg019879l,400180,400478,298,EVM,mRNA,91128,1218682,298,1.00
ptg019879l,1173448,1173761,313,EVM,mRNA,91128,1218682,313,1.00
ptg019885l,323090,323374,284,EVM,mRNA,59268,641683,284,1.00
ptg019885l,514772,515042,270,EVM,mRNA,59268,641683,270,1.00
ptg019897l,234872,235157,285,EVM,mRNA,84477,424752,285,1.00
ptg019897l,269552,269844,292,EVM,mRNA,84477,424752,292,1.00
ptg019900l,684770,685057,287,EVM,mRNA,63814,1087821,287,1.00
ptg019900l,757146,757288,142,EVM,mRNA,63814,1087821,142,1.00
ptg019911l,65682,65990,308,EVM,mRNA,47386,262819,308,1.00
ptg019920l,303434,303703,269,EVM,mRNA,131262,311227,269,1.00
ptg019929l,666257,666581,324,EVM,mRNA,544753,791668,324,1.00
ptg019930l,532199,532496,297,EVM,mRNA,261707,585650,297,1.00
ptg019936l,301418,301717,299,EVM,mRNA,288041,1231740,299,1.00
ptg019956l,2398389,2398689,300,EVM,mRNA,2074874,2646089,300,1.00
ptg019962l,1549918,1550231,313,EVM,mRNA,1486495,1694479,313,1.00
ptg019962l,1556810,1557107,297,EVM,mRNA,1486495,1694479,297,1.00
ptg019962l,4983336,4983638,302,EVM,mRNA,4730455,5112112,302,1.00
ptg019973l,246931,247238,307,EVM,mRNA,44599,401351,307,1.00
ptg020010l,187730,188005,275,EVM,mRNA,34824,271316,275,1.00
ptg020024l,328255,328568,313,EVM,mRNA,290139,443242,313,1.00
ptg020024l,435681,435954,273,EVM,mRNA,290139,443242,273,1.00
ptg020024l,1109617,1109941,324,EVM,mRNA,1109384,1109764,147,0.45
ptg020027l,7213,7535,322,EVM,mRNA,7003,372827,322,1.00
ptg020047l,328467,328744,277,EVM,mRNA,282674,329769,277,1.00
ptg020049l,448943,449178,235,EVM,mRNA,57001,1461363,235,1.00
ptg020049l,979387,979685,298,EVM,mRNA,57001,1461363,298,1.00
ptg020049l,1092895,1093195,300,EVM,mRNA,57001,1461363,300,1.00
ptg020053l,96258,96595,337,EVM,mRNA,9603,443675,337,1.00
ptg020064l,1187783,1188099,316,EVM,mRNA,1068289,1336878,316,1.00
ptg020067l,400290,400577,287,EVM,mRNA,166455,434994,287,1.00
ptg020075l,148512,148807,295,EVM,mRNA,25778,514699,295,1.00
ptg020077l,84670,84971,301,EVM,mRNA,27861,280814,301,1.00
ptg020089l,192879,193201,322,EVM,mRNA,61140,223994,322,1.00
ptg020092l,2133500,2133804,304,EVM,mRNA,2075792,2479563,304,1.00
ptg020098l,58982,59298,316,EVM,mRNA,58405,76723,316,1.00
ptg020102l,653580,653874,294,EVM,mRNA,640495,683038,294,1.00
ptg020110l,61379,61702,323,EVM,mRNA,35791,147494,323,1.00
ptg020117l,302038,302353,315,EVM,mRNA,262691,339330,315,1.00
ptg020117l,364449,364752,303,EVM,mRNA,341198,387071,303,1.00
ptg020126l,445916,446214,298,EVM,mRNA,364710,629823,298,1.00
ptg020141l,1761831,1762162,331,EVM,mRNA,1712492,2067059,331,1.00
ptg020141l,1784761,1785058,297,EVM,mRNA,1712492,2067059,297,1.00
ptg020141l,1794386,1794685,299,EVM,mRNA,1712492,2067059,299,1.00
ptg020148l,426859,427188,329,EVM,mRNA,46824,491809,329,1.00
ptg020160l,441664,441972,308,EVM,mRNA,7181,644730,308,1.00
ptg020169l,488275,488591,316,EVM,mRNA,183884,982578,316,1.00
ptg020171l,487847,488152,305,EVM,mRNA,2862,919406,305,1.00
ptg020172l,428645,428943,298,EVM,mRNA,191869,1077496,298,1.00
ptg020172l,751016,751314,298,EVM,mRNA,191869,1077496,298,1.00
ptg020185l,315867,316179,312,EVM,mRNA,306635,331957,312,1.00
ptg020198l,859980,860311,331,EVM,mRNA,766770,870618,331,1.00
ptg020207l,587083,587349,266,EVM,mRNA,459391,1762356,266,1.00
ptg020207l,1403711,1404016,305,EVM,mRNA,459391,1762356,305,1.00
ptg020207l,1427553,1427850,297,EVM,mRNA,459391,1762356,297,1.00
ptg020207l,1694205,1694492,287,EVM,mRNA,459391,1762356,287,1.00
ptg020208l,192535,192804,269,EVM,mRNA,26124,283376,269,1.00
ptg020218l,1011997,1012313,316,EVM,mRNA,982889,1057030,316,1.00
ptg020224l,618597,618877,280,EVM,mRNA,544179,658753,280,1.00
ptg020226l,469069,469365,296,EVM,mRNA,442443,562325,296,1.00
ptg020227l,431653,431961,308,EVM,mRNA,402494,553583,308,1.00
ptg020243l,87684,87988,304,EVM,mRNA,1873,730836,304,1.00
ptg020252l,248474,248747,273,EVM,mRNA,151452,293581,273,1.00
ptg020254l,464733,465027,294,EVM,mRNA,310534,832511,294,1.00
ptg020254l,599492,599785,293,EVM,mRNA,310534,832511,293,1.00
ptg020256l,82281,82570,289,EVM,mRNA,51363,323051,289,1.00
ptg020256l,144735,145010,275,EVM,mRNA,51363,323051,275,1.00
ptg020261l,292412,292690,278,EVM,mRNA,202437,339379,278,1.00
ptg020275l,69680,69960,280,EVM,mRNA,58980,220978,280,1.00
ptg020278l,761613,761896,283,EVM,mRNA,592475,854721,283,1.00
ptg020286l,614123,614435,312,EVM,mRNA,505270,2140930,312,1.00
ptg020286l,1115405,1115713,308,EVM,mRNA,505270,2140930,308,1.00
ptg020286l,1388349,1388678,329,EVM,mRNA,505270,2140930,329,1.00
ptg020289l,180117,180395,278,EVM,mRNA,69666,754068,278,1.00
ptg020320l,326635,326941,306,EVM,mRNA,188145,356980,306,1.00
ptg020322l,468687,469021,334,EVM,mRNA,337334,640219,334,1.00
ptg020335l,222218,222515,297,EVM,mRNA,46066,1257010,297,1.00
ptg020335l,566213,566504,291,EVM,mRNA,46066,1257010,291,1.00
ptg020350l,58572,58894,322,EVM,mRNA,40517,836964,322,1.00
ptg020350l,149223,149504,281,EVM,mRNA,40517,836964,281,1.00
ptg020350l,297862,298185,323,EVM,mRNA,40517,836964,323,1.00
ptg020350l,766733,767021,288,EVM,mRNA,40517,836964,288,1.00
ptg020351l,438369,438687,318,EVM,mRNA,154741,473321,318,1.00
ptg020365l,312974,313282,308,EVM,mRNA,312171,316755,308,1.00
ptg020378l,501726,502006,280,EVM,mRNA,419545,1043902,280,1.00
ptg020390l,15538,15804,266,EVM,mRNA,2622,25643,266,1.00
ptg020403l,559802,560106,304,EVM,mRNA,78507,716502,304,1.00
ptg020435l,1760813,1761109,296,EVM,mRNA,966272,3131752,296,1.00
ptg020435l,2042788,2043120,332,EVM,mRNA,966272,3131752,332,1.00
ptg020447l,154536,154842,306,EVM,mRNA,10137,649243,306,1.00
ptg020452l,359785,360101,316,EVM,mRNA,359437,810127,316,1.00
ptg020463l,133414,133754,340,EVM,mRNA,115107,310561,340,1.00
ptg020471l,2485400,2485705,305,EVM,mRNA,1851757,2756622,305,1.00
ptg020471l,2493650,2493935,285,EVM,mRNA,1851757,2756622,285,1.00
ptg020471l,5146620,5146909,289,EVM,mRNA,4176934,5168086,289,1.00
ptg020486l,392119,392399,280,EVM,mRNA,274537,505040,280,1.00
ptg020488l,190289,190570,281,EVM,mRNA,116589,199338,281,1.00
ptg020490l,431811,432137,326,EVM,mRNA,288310,497022,326,1.00
ptg020512l,788381,788680,299,EVM,mRNA,7543,890945,299,1.00
ptg020516l,694980,695293,313,EVM,mRNA,672498,1347745,313,1.00
ptg020535l,429317,429626,309,EVM,mRNA,269602,1440368,309,1.00
ptg020543l,233057,233349,292,EVM,mRNA,21369,583384,292,1.00
ptg020543l,1333896,1334224,328,EVM,mRNA,1114001,2071691,328,1.00
ptg020568l,145410,145721,311,EVM,mRNA,117935,186750,311,1.00
ptg020569l,484455,484735,280,EVM,mRNA,19239,745076,280,1.00
ptg020569l,937430,937713,283,EVM,mRNA,819715,1116270,283,1.00
ptg020570l,793973,794280,307,EVM,mRNA,403861,908944,307,1.00
ptg020576l,373570,373897,327,EVM,mRNA,21753,702339,327,1.00
ptg020576l,383009,383313,304,EVM,mRNA,21753,702339,304,1.00
ptg020576l,653908,654194,286,EVM,mRNA,21753,702339,286,1.00
ptg020579l,3646151,3646439,288,EVM,mRNA,3176556,5951408,288,1.00
ptg020579l,4625726,4626039,313,EVM,mRNA,3176556,5951408,313,1.00
ptg020579l,5874368,5874680,312,EVM,mRNA,3176556,5951408,312,1.00
ptg020580l,395279,395583,304,EVM,mRNA,110953,439706,304,1.00
ptg020582l,1106636,1106907,271,EVM,mRNA,898873,1176697,271,1.00
ptg020582l,1142465,1142790,325,EVM,mRNA,898873,1176697,325,1.00
ptg020602l,898823,899110,287,EVM,mRNA,854564,954759,287,1.00
ptg020618l,151082,151381,299,EVM,mRNA,4396,1005467,299,1.00
ptg020618l,230430,230729,299,EVM,mRNA,4396,1005467,299,1.00
ptg020618l,990094,990390,296,EVM,mRNA,4396,1005467,296,1.00
ptg020627l,22197,22479,282,EVM,mRNA,60,704897,282,1.00
ptg020652l,746570,746877,307,EVM,mRNA,111709,830875,307,1.00
ptg020661l,27418,27718,300,EVM,mRNA,3903,224449,300,1.00
ptg020715l,174380,174683,303,EVM,mRNA,111446,658534,303,1.00
ptg020730l,522902,523180,278,EVM,mRNA,433215,729408,278,1.00
ptg020730l,602453,602769,316,EVM,mRNA,433215,729408,316,1.00
ptg020742l,583783,584079,296,EVM,mRNA,18021,601955,296,1.00
ptg020752l,458793,459085,292,EVM,mRNA,453648,500185,292,1.00
ptg020773l,925997,926361,364,EVM,mRNA,893709,1034135,364,1.00
ptg020817l,338925,339253,328,EVM,mRNA,311760,536092,328,1.00
ptg020820l,107167,107451,284,EVM,mRNA,26055,159077,284,1.00
ptg020842l,523165,523464,299,EVM,mRNA,186982,902907,299,1.00
ptg020846l,1213844,1214133,289,EVM,mRNA,449263,1535207,289,1.00
ptg020852l,526203,526533,330,EVM,mRNA,523469,824148,330,1.00
ptg020853l,372143,372439,296,EVM,mRNA,349497,769727,296,1.00
ptg020853l,522090,522389,299,EVM,mRNA,349497,769727,299,1.00
ptg020863l,84795,85076,281,EVM,mRNA,84262,638303,281,1.00
ptg020864l,345818,346115,297,EVM,mRNA,194094,429597,297,1.00
ptg020874l,423893,424206,313,EVM,mRNA,95285,636039,313,1.00
ptg020879l,130205,130500,295,EVM,mRNA,923,324173,295,1.00
ptg020879l,132812,133145,333,EVM,mRNA,923,324173,333,1.00
ptg020899l,332326,332618,292,EVM,mRNA,144412,558663,292,1.00
ptg020915l,692443,692771,328,EVM,mRNA,267319,1205541,328,1.00
ptg020915l,1114966,1115282,316,EVM,mRNA,267319,1205541,316,1.00
ptg020925l,334861,335142,281,EVM,mRNA,164093,558427,281,1.00
ptg020929l,203626,203912,286,EVM,mRNA,97289,410531,286,1.00
ptg020929l,360278,360604,326,EVM,mRNA,97289,410531,326,1.00
ptg020960l,550783,551070,287,EVM,mRNA,531940,675329,287,1.00
ptg020966l,62957,63239,282,EVM,mRNA,6560,101732,282,1.00
ptg020967l,435581,435874,293,EVM,mRNA,313250,536805,293,1.00
ptg020972l,2027637,2027929,292,EVM,mRNA,1936879,2793181,292,1.00
ptg020991l,459221,459518,297,EVM,mRNA,16280,513690,297,1.00
ptg020997l,705647,705966,319,EVM,mRNA,278424,930381,319,1.00
ptg021038l,1838686,1838829,143,EVM,mRNA,1722362,1990615,143,1.00
ptg021038l,1953467,1953776,309,EVM,mRNA,1722362,1990615,309,1.00
ptg021049l,145530,145810,280,EVM,mRNA,33658,187600,280,1.00
ptg021052l,42411,42708,297,EVM,mRNA,36022,74263,297,1.00
ptg021064l,862139,862435,296,EVM,mRNA,402557,1332107,296,1.00
ptg021064l,968518,968804,286,EVM,mRNA,402557,1332107,286,1.00
ptg021064l,1142878,1143201,323,EVM,mRNA,402557,1332107,323,1.00
ptg021074l,502471,502728,257,EVM,mRNA,431939,628807,257,1.00
ptg021077l,53034,53331,297,EVM,mRNA,9947,136374,297,1.00
ptg021078l,272383,272683,300,EVM,mRNA,76226,646746,300,1.00
ptg021082l,315224,315515,291,EVM,mRNA,1478,321679,291,1.00
ptg021083l,246542,246826,284,EVM,mRNA,217835,445512,284,1.00
ptg021091l,1085155,1085455,300,EVM,mRNA,1059435,1155437,300,1.00
ptg021091l,2246860,2247174,314,EVM,mRNA,2162906,2366070,314,1.00
ptg021097l,519640,519913,273,EVM,mRNA,437403,1032454,273,1.00
ptg021101l,31691,32007,316,EVM,mRNA,1869,106371,316,1.00
ptg021124l,33601,33896,295,EVM,mRNA,2708,159385,295,1.00
ptg021124l,116477,116770,293,EVM,mRNA,2708,159385,293,1.00
ptg021124l,287123,287422,299,EVM,mRNA,241618,479808,299,1.00
ptg021163l,487708,487997,289,EVM,mRNA,477808,609484,289,1.00
ptg021167l,382921,383234,313,EVM,mRNA,269363,884536,313,1.00
ptg021170l,576006,576314,308,EVM,mRNA,446453,623929,308,1.00
ptg021174l,265787,266089,302,EVM,mRNA,2659,609620,302,1.00
ptg021182l,454676,454980,304,EVM,mRNA,34685,745406,304,1.00
ptg021197l,581604,581886,282,EVM,mRNA,440131,812398,282,1.00
ptg021198l,80163,80478,315,EVM,mRNA,68,925989,315,1.00
ptg021198l,266838,267137,299,EVM,mRNA,68,925989,299,1.00
ptg021198l,581413,581709,296,EVM,mRNA,68,925989,296,1.00
ptg021202l,756777,757063,286,EVM,mRNA,394412,1292204,286,1.00
ptg021229l,679494,679815,321,EVM,mRNA,653067,1430325,321,1.00
ptg021229l,780923,781225,302,EVM,mRNA,653067,1430325,302,1.00
ptg021229l,960880,961164,284,EVM,mRNA,653067,1430325,284,1.00
ptg021230l,461177,461491,314,EVM,mRNA,145274,761833,314,1.00
ptg021230l,678607,678867,260,EVM,mRNA,145274,761833,260,1.00
ptg021238l,448882,449196,314,EVM,mRNA,10005,579615,314,1.00
ptg021287l,378924,379232,308,EVM,mRNA,33462,491070,308,1.00
ptg021287l,743853,744146,293,EVM,mRNA,514220,1326067,293,1.00
ptg021287l,1107236,1107545,309,EVM,mRNA,514220,1326067,309,1.00
ptg021296l,1311190,1311454,264,EVM,mRNA,860921,1366704,264,1.00
ptg021303l,459961,460270,309,EVM,mRNA,127490,676945,309,1.00
ptg021311l,447430,447717,287,EVM,mRNA,296603,1105462,287,1.00
ptg021327l,123185,123488,303,EVM,mRNA,5470,229812,303,1.00
ptg021334l,83508,83836,328,EVM,mRNA,1825,90064,328,1.00
ptg021337l,758246,758539,293,EVM,mRNA,7657,1150955,293,1.00
ptg021337l,765071,765342,271,EVM,mRNA,7657,1150955,271,1.00
ptg021345l,662262,662557,295,EVM,mRNA,579477,695915,295,1.00
ptg021348l,27833,28114,281,EVM,mRNA,23623,868115,281,1.00
ptg021348l,99728,100026,298,EVM,mRNA,23623,868115,298,1.00
ptg021359l,699701,699988,287,EVM,mRNA,590977,783596,287,1.00
ptg021359l,768828,769120,292,EVM,mRNA,590977,783596,292,1.00
ptg021359l,1167980,1168287,307,EVM,mRNA,948686,1174973,307,1.00
ptg021360l,311865,312164,299,EVM,mRNA,99164,541088,299,1.00
ptg021366l,147376,147624,248,EVM,mRNA,46036,310322,248,1.00
ptg021385l,502996,503314,318,EVM,mRNA,252506,619725,318,1.00
ptg021412l,388310,388642,332,EVM,mRNA,344879,419207,332,1.00
ptg021417l,213807,214121,314,EVM,mRNA,209940,613999,314,1.00
ptg021422l,575338,575613,275,EVM,mRNA,87564,722021,275,1.00
ptg021442l,1330253,1330563,310,EVM,mRNA,1192093,1651998,310,1.00
ptg021450l,338741,339006,265,EVM,mRNA,17852,780363,265,1.00
ptg021450l,372409,372719,310,EVM,mRNA,17852,780363,310,1.00
ptg021462l,321849,322172,323,EVM,mRNA,196790,391131,323,1.00
ptg021465l,606201,606498,297,EVM,mRNA,332547,668187,297,1.00
ptg021465l,622853,623151,298,EVM,mRNA,332547,668187,298,1.00
ptg021483l,66808,67118,310,EVM,mRNA,6439,438576,310,1.00
ptg021483l,82088,82370,282,EVM,mRNA,6439,438576,282,1.00
ptg021488l,228504,228815,311,EVM,mRNA,8439,315666,311,1.00
ptg021492l,890807,891095,288,EVM,mRNA,827079,893235,288,1.00
ptg021499l,426169,426451,282,EVM,mRNA,363218,487011,282,1.00
ptg021517l,549011,549291,280,EVM,mRNA,46641,563524,280,1.00
ptg021518l,446818,447103,285,EVM,mRNA,322805,621470,285,1.00
ptg021527l,647089,647399,310,EVM,mRNA,294056,822989,310,1.00
ptg021527l,820719,821033,314,EVM,mRNA,294056,822989,314,1.00
ptg021530l,173258,173566,308,EVM,mRNA,77213,630971,308,1.00
ptg021534l,496102,496392,290,EVM,mRNA,424366,905498,290,1.00
ptg021550l,530045,530334,289,EVM,mRNA,275090,890344,289,1.00
ptg021574l,378896,379201,305,EVM,mRNA,151262,779140,305,1.00
ptg021577l,96907,97210,303,EVM,mRNA,14637,101012,303,1.00
ptg021631l,191010,191337,327,EVM,mRNA,50454,527877,327,1.00
ptg021637l,626371,626683,312,EVM,mRNA,172994,1097762,312,1.00
ptg021637l,796505,796802,297,EVM,mRNA,172994,1097762,297,1.00
ptg021644l,39818,40111,293,EVM,mRNA,20007,130755,293,1.00
ptg021653l,110658,110964,306,EVM,mRNA,12601,787343,306,1.00
ptg021668l,138083,138377,294,EVM,mRNA,92881,155067,294,1.00
ptg021668l,529170,529462,292,EVM,mRNA,505814,557800,292,1.00
ptg021669l,210119,210449,330,EVM,mRNA,110078,555281,330,1.00
ptg021679l,574185,574484,299,EVM,mRNA,459523,970112,299,1.00
ptg021697l,1682966,1683273,307,EVM,mRNA,1608263,1805997,307,1.00
ptg021703l,263839,264165,326,EVM,mRNA,127820,529360,326,1.00
ptg021703l,692629,692942,313,EVM,mRNA,656451,771557,313,1.00
ptg021704l,616634,616963,329,EVM,mRNA,23649,654854,329,1.00
ptg021721l,138536,138827,291,EVM,mRNA,76271,1391757,291,1.00
ptg021724l,313495,313776,281,EVM,mRNA,8438,556935,281,1.00
ptg021730l,500446,500769,323,EVM,mRNA,39083,507071,323,1.00
ptg021734l,1457149,1457448,299,EVM,mRNA,1002941,1504016,299,1.00
ptg021752l,56928,57246,318,EVM,mRNA,5347,576915,318,1.00
ptg021764l,211511,211830,319,EVM,mRNA,156190,385188,319,1.00
ptg021773l,615109,615435,326,EVM,mRNA,536288,665345,326,1.00
ptg021796l,132109,132423,314,EVM,mRNA,113,739522,314,1.00
ptg021796l,396917,397231,314,EVM,mRNA,113,739522,314,1.00
ptg021799l,2789993,2790321,328,EVM,mRNA,2549033,3013954,328,1.00
ptg021809l,360137,360427,290,EVM,mRNA,300000,497995,290,1.00
ptg021839l,368377,368693,316,EVM,mRNA,3056,630498,316,1.00
ptg021839l,422145,422428,283,EVM,mRNA,3056,630498,283,1.00
ptg021846l,839136,839459,323,EVM,mRNA,601017,878117,323,1.00
ptg021847l,151575,151867,292,EVM,mRNA,48409,1818172,292,1.00
ptg021847l,1164361,1164691,330,EVM,mRNA,48409,1818172,330,1.00
ptg021847l,1511867,1512181,314,EVM,mRNA,48409,1818172,314,1.00
ptg021878l,1275890,1276237,347,EVM,mRNA,618699,1673986,347,1.00
ptg021885l,879681,880009,328,EVM,mRNA,699782,1221572,328,1.00
ptg021903l,518211,518527,316,EVM,mRNA,53791,819471,316,1.00
ptg021915l,273352,273656,304,EVM,mRNA,109512,630875,304,1.00
ptg021919l,260595,260911,316,EVM,mRNA,75672,302936,316,1.00
ptg021923l,507230,507553,323,EVM,mRNA,28277,722588,323,1.00
ptg021941l,208048,208366,318,EVM,mRNA,1542,740560,318,1.00
ptg021941l,298106,298419,313,EVM,mRNA,1542,740560,313,1.00
ptg021941l,432704,433006,302,EVM,mRNA,1542,740560,302,1.00
ptg021959l,118472,118788,316,EVM,mRNA,68806,505159,316,1.00
ptg021960l,515995,516320,325,EVM,mRNA,437800,562424,325,1.00
ptg021984l,461799,462075,276,EVM,mRNA,458926,554669,276,1.00
ptg021986l,412131,412423,292,EVM,mRNA,186313,439174,292,1.00
ptg022000l,222714,222998,284,EVM,mRNA,62914,275892,284,1.00
ptg022000l,1025634,1025952,318,EVM,mRNA,533405,1026799,318,1.00
ptg022007l,370525,370800,275,EVM,mRNA,10556,372650,275,1.00
ptg022012l,226068,226340,272,EVM,mRNA,170640,923103,272,1.00
ptg022026l,52554,52874,320,EVM,mRNA,6511,258809,320,1.00
ptg022051l,673746,674040,294,EVM,mRNA,342877,1407260,294,1.00
ptg022051l,873045,873335,290,EVM,mRNA,342877,1407260,290,1.00
ptg022051l,1154511,1154818,307,EVM,mRNA,342877,1407260,307,1.00
ptg022051l,1304372,1304670,298,EVM,mRNA,342877,1407260,298,1.00
ptg022051l,1393522,1393796,274,EVM,mRNA,342877,1407260,274,1.00
ptg022061l,581965,582290,325,EVM,mRNA,539879,1734023,325,1.00
ptg022061l,1688670,1688969,299,EVM,mRNA,539879,1734023,299,1.00
ptg022062l,271209,271503,294,EVM,mRNA,54524,875353,294,1.00
ptg022062l,373810,374113,303,EVM,mRNA,54524,875353,303,1.00
ptg022088l,324292,324578,286,EVM,mRNA,94796,497318,286,1.00
ptg022088l,674183,674472,289,EVM,mRNA,646604,834781,289,1.00
ptg022090l,304895,305205,310,EVM,mRNA,6558,867960,310,1.00
ptg022119l,342986,343286,300,EVM,mRNA,131425,626006,300,1.00
ptg022154l,49478,49802,324,EVM,mRNA,11171,199012,324,1.00
ptg022158l,32276,32610,334,EVM,mRNA,5982,895734,334,1.00
ptg022158l,255186,255483,297,EVM,mRNA,5982,895734,297,1.00
ptg022158l,286923,287210,287,EVM,mRNA,5982,895734,287,1.00
ptg022158l,482816,483113,297,EVM,mRNA,5982,895734,297,1.00
ptg022158l,810732,811031,299,EVM,mRNA,5982,895734,299,1.00
ptg022158l,890750,891043,293,EVM,mRNA,5982,895734,293,1.00
ptg022164l,693359,693676,317,EVM,mRNA,692498,736438,317,1.00
ptg022183l,180383,180690,307,EVM,mRNA,168696,555081,307,1.00
ptg022183l,208820,209127,307,EVM,mRNA,168696,555081,307,1.00
ptg022197l,256833,257114,281,EVM,mRNA,28839,580349,281,1.00
ptg022201l,442583,442861,278,EVM,mRNA,271635,712316,278,1.00
ptg022201l,449743,450026,283,EVM,mRNA,271635,712316,283,1.00
ptg022206l,196324,196603,279,EVM,mRNA,39227,437032,279,1.00
ptg022234l,256924,257230,306,EVM,mRNA,208107,587871,306,1.00
ptg022268l,286355,286662,307,EVM,mRNA,23083,365455,307,1.00
ptg022278l,1987383,1987683,300,EVM,mRNA,1899854,2656746,300,1.00
ptg022278l,2592107,2592405,298,EVM,mRNA,1899854,2656746,298,1.00
ptg022307l,400617,400928,311,EVM,mRNA,3397,875529,311,1.00
ptg022323l,79611,79908,297,EVM,mRNA,13093,281474,297,1.00
ptg022323l,688104,688412,308,EVM,mRNA,311298,817809,308,1.00
ptg022327l,228315,228644,329,EVM,mRNA,1050,370474,329,1.00
ptg022327l,649351,649661,310,EVM,mRNA,476400,761528,310,1.00
ptg022340l,3110,3402,292,EVM,mRNA,653,34058,292,1.00
ptg022358l,377941,378226,285,EVM,mRNA,373179,618084,285,1.00
ptg022372l,512936,513217,281,EVM,mRNA,379717,578475,281,1.00
ptg022412l,428131,428408,277,EVM,mRNA,357560,620729,277,1.00
ptg022420l,249263,249569,306,EVM,mRNA,227538,1184450,306,1.00
ptg022420l,491647,491977,330,EVM,mRNA,227538,1184450,330,1.00
ptg022450l,433967,434272,305,EVM,mRNA,43016,491600,305,1.00
ptg022474l,152568,152872,304,EVM,mRNA,406,443350,304,1.00
ptg022480l,1281006,1281292,286,EVM,mRNA,1001050,1907273,286,1.00
ptg022480l,1698510,1698828,318,EVM,mRNA,1001050,1907273,318,1.00
ptg022485l,1193464,1193799,335,EVM,mRNA,1188157,1378126,335,1.00
ptg022485l,1217025,1217323,298,EVM,mRNA,1188157,1378126,298,1.00
ptg022512l,848179,848469,290,EVM,mRNA,761039,865988,290,1.00
ptg022523l,665840,666163,323,EVM,mRNA,297423,712390,323,1.00
ptg022529l,1127164,1127479,315,EVM,mRNA,365297,1190923,315,1.00
ptg022544l,113245,113570,325,EVM,mRNA,21389,184103,325,1.00
ptg022551l,140369,140655,286,EVM,mRNA,24042,192672,286,1.00
ptg022560l,466885,467201,316,EVM,mRNA,279198,501170,316,1.00
ptg022571l,636499,636792,293,EVM,mRNA,537216,649602,293,1.00
ptg022581l,512505,512765,260,EVM,mRNA,142305,719033,260,1.00
ptg022592l,74714,75040,326,EVM,mRNA,58252,251971,326,1.00
ptg022592l,147209,147489,280,EVM,mRNA,58252,251971,280,1.00
ptg022597l,903997,904272,275,EVM,mRNA,806889,961886,275,1.00
ptg022607l,387282,387601,319,EVM,mRNA,198602,394200,319,1.00
ptg022620l,294790,295092,302,EVM,mRNA,145741,615951,302,1.00
ptg022620l,439656,439961,305,EVM,mRNA,145741,615951,305,1.00
ptg022621l,754450,754757,307,EVM,mRNA,505524,822667,307,1.00
ptg022646l,890285,890539,254,EVM,mRNA,85068,1043247,254,1.00
ptg022655l,64834,65120,286,EVM,mRNA,33554,161241,286,1.00
ptg022678l,109362,109638,276,EVM,mRNA,97688,114652,276,1.00
ptg022686l,661481,661767,286,EVM,mRNA,660430,768702,286,1.00
ptg022693l,499510,499800,290,EVM,mRNA,482360,614631,290,1.00
ptg022711l,211708,211991,283,EVM,mRNA,108237,350252,283,1.00
ptg022717l,274045,274354,309,EVM,mRNA,49763,295495,309,1.00
ptg022717l,701959,702251,292,EVM,mRNA,563210,1260550,292,1.00
ptg022718l,581029,581335,306,EVM,mRNA,428187,1121867,306,1.00
ptg022724l,412484,412790,306,EVM,mRNA,60776,497821,306,1.00
ptg022739l,246133,246425,292,EVM,mRNA,59205,303342,292,1.00
ptg022753l,294482,294781,299,EVM,mRNA,156707,533513,299,1.00
ptg022780l,178092,178380,288,EVM,mRNA,78931,199117,288,1.00
ptg022780l,651620,651904,284,EVM,mRNA,633281,657431,284,1.00
ptg022784l,145018,145351,333,EVM,mRNA,134539,276060,333,1.00
ptg022786l,365697,365986,289,EVM,mRNA,19279,655031,289,1.00
ptg022786l,386969,387266,297,EVM,mRNA,19279,655031,297,1.00
ptg022786l,1304597,1304915,318,EVM,mRNA,1260038,1458653,318,1.00
ptg022801l,118607,118922,315,EVM,mRNA,285,198120,315,1.00
ptg022805l,11527,11844,317,EVM,mRNA,4680,166607,317,1.00
ptg022829l,788187,788465,278,EVM,mRNA,421314,1932394,278,1.00
ptg022841l,58685,58986,301,EVM,mRNA,50640,232828,301,1.00
ptg022858l,514671,514966,295,EVM,mRNA,473573,550108,295,1.00
ptg022873l,771325,771610,285,EVM,mRNA,720378,1564531,285,1.00
ptg022873l,901674,901993,319,EVM,mRNA,720378,1564531,319,1.00
ptg022885l,544046,544326,280,EVM,mRNA,311627,718457,280,1.00
ptg022981l,173212,173512,300,EVM,mRNA,447,520696,300,1.00
ptg023012l,86918,87206,288,EVM,mRNA,35571,482246,288,1.00
ptg023012l,122363,122629,266,EVM,mRNA,35571,482246,266,1.00
ptg023019l,506806,507105,299,EVM,mRNA,345802,629119,299,1.00
ptg023062l,135424,135714,290,EVM,mRNA,23921,378870,290,1.00
ptg023113l,71539,71807,268,EVM,mRNA,40754,176240,268,1.00
ptg023137l,136877,137186,309,EVM,mRNA,126816,252159,309,1.00
ptg023152l,560918,561226,308,EVM,mRNA,447914,766439,308,1.00
ptg023174l,1600881,1601192,311,EVM,mRNA,1397163,2105122,311,1.00
ptg023184l,514190,514498,308,EVM,mRNA,235326,961460,308,1.00
ptg023188l,59578,59890,312,EVM,mRNA,41488,217190,312,1.00
ptg023189l,1165206,1165504,298,EVM,mRNA,99859,1230506,298,1.00
ptg023195l,811180,811488,308,EVM,mRNA,808218,1199309,308,1.00
ptg023195l,977321,977601,280,EVM,mRNA,808218,1199309,280,1.00
ptg023195l,1533737,1534040,303,EVM,mRNA,1310702,2164072,303,1.00
ptg023210l,308229,308502,273,EVM,mRNA,207934,425244,273,1.00
ptg023224l,130400,130702,302,EVM,mRNA,105872,419963,302,1.00
ptg023225l,129173,129465,292,EVM,mRNA,37888,368825,292,1.00
ptg023272l,526605,526895,290,EVM,mRNA,298977,583170,290,1.00
ptg023288l,255864,256143,279,EVM,mRNA,147618,807870,279,1.00
ptg023288l,263028,263327,299,EVM,mRNA,147618,807870,299,1.00
ptg023290l,629193,629514,321,EVM,mRNA,201581,800944,321,1.00
ptg023304l,284458,284768,310,EVM,mRNA,117977,571882,310,1.00
ptg023312l,245418,245711,293,EVM,mRNA,133770,504941,293,1.00
ptg023313l,257383,257710,327,EVM,mRNA,126310,487059,327,1.00
ptg023318l,1054163,1054443,280,EVM,mRNA,1001501,1067200,280,1.00
ptg023340l,247679,247990,311,EVM,mRNA,1359,260540,311,1.00
ptg023375l,45725,46050,325,EVM,mRNA,31633,145002,325,1.00
ptg023376l,78254,78543,289,EVM,mRNA,9341,651789,289,1.00
ptg023403l,91927,92207,280,EVM,mRNA,20666,138841,280,1.00
ptg023419l,60550,60836,286,EVM,mRNA,34710,132729,286,1.00
ptg023454l,250313,250614,301,EVM,mRNA,167475,684620,301,1.00
ptg023457l,151129,151410,281,EVM,mRNA,120437,311076,281,1.00
ptg023462l,63937,64256,319,EVM,mRNA,25027,615093,319,1.00
ptg023470l,766241,766557,316,EVM,mRNA,47322,1615569,316,1.00
ptg023502l,241237,241567,330,EVM,mRNA,134878,241532,295,0.89
ptg023523l,142612,142897,285,EVM,mRNA,129994,483399,285,1.00
ptg023544l,220120,220428,308,EVM,mRNA,64008,240130,308,1.00
ptg023548l,479980,480286,306,EVM,mRNA,379754,492572,306,1.00
ptg023550l,187476,187762,286,EVM,mRNA,63171,420403,286,1.00
ptg023550l,612527,612850,323,EVM,mRNA,434094,693758,323,1.00
ptg023567l,731436,731755,319,EVM,mRNA,703129,1074543,319,1.00
ptg023602l,176365,176665,300,EVM,mRNA,113277,201601,300,1.00
ptg023607l,553879,554186,307,EVM,mRNA,454462,558759,307,1.00
ptg023613l,299145,299467,322,EVM,mRNA,1737,488227,322,1.00
ptg023616l,80825,81130,305,EVM,mRNA,65330,210120,305,1.00
ptg023650l,544421,544736,315,EVM,mRNA,147775,779787,315,1.00
ptg023657l,228845,229144,299,EVM,mRNA,222095,408324,299,1.00
ptg023657l,277161,277459,298,EVM,mRNA,222095,408324,298,1.00
ptg023685l,168851,169158,307,EVM,mRNA,67970,766971,307,1.00
ptg023685l,629366,629675,309,EVM,mRNA,67970,766971,309,1.00
ptg023685l,700057,700367,310,EVM,mRNA,67970,766971,310,1.00
ptg023755l,274384,274656,272,EVM,mRNA,254698,277180,272,1.00
ptg023763l,146036,146329,293,EVM,mRNA,13307,381102,293,1.00
ptg023771l,119653,119975,322,EVM,mRNA,4537,693827,322,1.00
ptg023771l,374336,374625,289,EVM,mRNA,4537,693827,289,1.00
ptg023775l,3382568,3382877,309,EVM,mRNA,1736084,3481310,309,1.00
ptg023778l,460404,460720,316,EVM,mRNA,360423,817578,316,1.00
ptg023779l,86715,86995,280,EVM,mRNA,61501,1112417,280,1.00
ptg023779l,565416,565748,332,EVM,mRNA,61501,1112417,332,1.00
ptg023804l,117714,118004,290,EVM,mRNA,97554,364809,290,1.00
ptg023815l,1992406,1992720,314,EVM,mRNA,1880480,2222439,314,1.00
ptg023815l,2014175,2014468,293,EVM,mRNA,1880480,2222439,293,1.00
ptg023815l,2120393,2120700,307,EVM,mRNA,1880480,2222439,307,1.00
ptg023882l,529004,529303,299,EVM,mRNA,46195,710969,299,1.00
ptg023898l,103148,103457,309,EVM,mRNA,84302,163339,309,1.00
ptg023898l,348407,348736,329,EVM,mRNA,219233,348469,62,0.19
ptg023903l,107136,107460,324,EVM,mRNA,1057,272349,324,1.00
ptg023903l,158948,159201,253,EVM,mRNA,1057,272349,253,1.00
ptg023904l,258618,258890,272,EVM,mRNA,193883,1036116,272,1.00
ptg023904l,913902,914188,286,EVM,mRNA,193883,1036116,286,1.00
ptg023920l,660942,661245,303,EVM,mRNA,153374,779651,303,1.00
ptg023952l,925376,925649,273,EVM,mRNA,484641,1210345,273,1.00
ptg023952l,1091542,1091805,263,EVM,mRNA,484641,1210345,263,1.00
ptg023968l,69017,69341,324,EVM,mRNA,52877,144997,324,1.00
ptg023973l,395743,396044,301,EVM,mRNA,171822,514263,301,1.00
ptg023973l,459029,459341,312,EVM,mRNA,171822,514263,312,1.00
ptg023995l,1136870,1137192,322,EVM,mRNA,206324,1184670,322,1.00
ptg024045l,329939,330261,322,EVM,mRNA,113218,339908,322,1.00
ptg024064l,259171,259438,267,EVM,mRNA,55077,670900,267,1.00
ptg024065l,208251,208565,314,EVM,mRNA,83694,584548,314,1.00
ptg024066l,322673,322987,314,EVM,mRNA,10719,349619,314,1.00
ptg024071l,845356,845662,306,EVM,mRNA,842587,861820,306,1.00
ptg024080l,37329,37619,290,EVM,mRNA,3803,392910,290,1.00
ptg024080l,41352,41642,290,EVM,mRNA,3803,392910,290,1.00
ptg024080l,140367,140665,298,EVM,mRNA,3803,392910,298,1.00
ptg024091l,262385,262679,294,EVM,mRNA,83104,631811,294,1.00
ptg024125l,167350,167637,287,EVM,mRNA,10985,309960,287,1.00
ptg024133l,581054,581375,321,EVM,mRNA,562497,581504,321,1.00
ptg024148l,460528,460839,311,EVM,mRNA,178098,689118,311,1.00
ptg024165l,14600,14903,303,EVM,mRNA,6585,35291,303,1.00
ptg024208l,167138,167438,300,EVM,mRNA,23419,230394,300,1.00
ptg024211l,183685,183980,295,EVM,mRNA,58749,371001,295,1.00
ptg024215l,236959,237296,337,EVM,mRNA,223817,584255,337,1.00
ptg024230l,445785,446113,328,EVM,mRNA,336842,448351,328,1.00
ptg024232l,226962,227260,298,EVM,mRNA,130633,284352,298,1.00
ptg024232l,412097,412392,295,EVM,mRNA,409394,494682,295,1.00
ptg024234l,145292,145585,293,EVM,mRNA,110961,321982,293,1.00
ptg024269l,1022996,1023280,284,EVM,mRNA,902287,1193977,284,1.00
ptg024288l,169833,170120,287,EVM,mRNA,159456,296084,287,1.00
ptg024289l,89171,89455,284,EVM,mRNA,34404,236124,284,1.00
ptg024309l,664105,664403,298,EVM,mRNA,566606,667600,298,1.00
ptg024338l,381187,381524,337,EVM,mRNA,269505,887522,337,1.00
ptg024338l,759650,759962,312,EVM,mRNA,269505,887522,312,1.00
ptg024400l,126480,126778,298,EVM,mRNA,105307,269975,298,1.00
ptg024400l,402393,402667,274,EVM,mRNA,293858,420375,274,1.00
ptg024404l,531563,531890,327,EVM,mRNA,483249,533343,327,1.00
ptg024415l,205593,205897,304,EVM,mRNA,7272,231652,304,1.00
ptg024437l,327771,328052,281,EVM,mRNA,62171,405803,281,1.00
ptg024437l,334958,335248,290,EVM,mRNA,62171,405803,290,1.00
ptg024486l,474528,474822,294,EVM,mRNA,406323,479416,294,1.00
ptg024508l,442431,442773,342,EVM,mRNA,308927,517578,342,1.00
ptg024554l,362551,362850,299,EVM,mRNA,184734,693415,299,1.00
ptg024554l,551371,551650,279,EVM,mRNA,184734,693415,279,1.00
ptg024554l,621114,621418,304,EVM,mRNA,184734,693415,304,1.00
ptg024566l,135039,135312,273,EVM,mRNA,1804,214389,273,1.00
ptg024577l,755877,756167,290,EVM,mRNA,75180,1772260,290,1.00
ptg024577l,826784,827080,296,EVM,mRNA,75180,1772260,296,1.00
ptg024585l,648800,649117,317,EVM,mRNA,488918,1352750,317,1.00
ptg024585l,668532,668835,303,EVM,mRNA,488918,1352750,303,1.00
ptg024604l,812691,813004,313,EVM,mRNA,464477,2051588,313,1.00
ptg024604l,892475,892770,295,EVM,mRNA,464477,2051588,295,1.00
ptg024604l,1163037,1163325,288,EVM,mRNA,464477,2051588,288,1.00
ptg024604l,1534972,1535273,301,EVM,mRNA,464477,2051588,301,1.00
ptg024612l,297895,298164,269,EVM,mRNA,8849,330513,269,1.00
ptg024612l,329217,329532,315,EVM,mRNA,8849,330513,315,1.00
ptg024627l,357519,357815,296,EVM,mRNA,356831,357733,214,0.72
ptg024657l,93552,93876,324,EVM,mRNA,59922,304585,324,1.00
ptg024673l,449909,450207,298,EVM,mRNA,353295,980163,298,1.00
ptg024673l,934206,934525,319,EVM,mRNA,353295,980163,319,1.00
ptg024686l,94837,95125,288,EVM,mRNA,26448,635170,288,1.00
ptg024699l,432385,432680,295,EVM,mRNA,2667,553204,295,1.00
ptg024706l,2004400,2004685,285,EVM,mRNA,643528,2289897,285,1.00
ptg024706l,2242772,2243074,302,EVM,mRNA,643528,2289897,302,1.00
ptg024718l,1017035,1017349,314,EVM,mRNA,744964,1306367,314,1.00
ptg024761l,65996,66282,286,EVM,mRNA,55525,191245,286,1.00
ptg024764l,542608,542893,285,EVM,mRNA,378334,634445,285,1.00
ptg024764l,915787,916068,281,EVM,mRNA,691074,948075,281,1.00
ptg024843l,541320,541648,328,EVM,mRNA,536084,558429,328,1.00
ptg024902l,2307105,2307420,315,EVM,mRNA,546216,2437112,315,1.00
ptg024932l,231917,232198,281,EVM,mRNA,192508,321456,281,1.00
ptg024932l,311231,311536,305,EVM,mRNA,192508,321456,305,1.00
ptg024981l,106785,107104,319,EVM,mRNA,78871,160893,319,1.00
ptg024988l,127563,127851,288,EVM,mRNA,92582,278255,288,1.00
ptg025002l,269372,269655,283,EVM,mRNA,185371,329492,283,1.00
ptg025015l,145611,145928,317,EVM,mRNA,64522,201484,317,1.00
ptg025019l,169995,170303,308,EVM,mRNA,81489,284907,308,1.00
ptg025053l,158342,158599,257,EVM,mRNA,48283,403936,257,1.00
ptg025062l,274086,274358,272,EVM,mRNA,216608,337167,272,1.00
ptg025074l,695535,695822,287,EVM,mRNA,336642,724923,287,1.00
ptg025083l,540063,540343,280,EVM,mRNA,540243,579801,101,0.36
ptg025087l,132239,132552,313,EVM,mRNA,45252,190402,313,1.00
ptg025087l,138124,138437,313,EVM,mRNA,45252,190402,313,1.00
ptg025093l,510038,510338,300,EVM,mRNA,298375,990462,300,1.00
ptg025093l,569615,569900,285,EVM,mRNA,298375,990462,285,1.00
ptg025093l,590572,590899,327,EVM,mRNA,298375,990462,327,1.00
ptg025093l,956874,957162,288,EVM,mRNA,298375,990462,288,1.00
ptg025093l,1476505,1476802,297,EVM,mRNA,1346864,1529746,297,1.00
ptg025103l,46169,46478,309,EVM,mRNA,10716,392217,309,1.00
ptg025108l,641741,642046,305,EVM,mRNA,641386,646858,305,1.00
ptg025109l,506402,506701,299,EVM,mRNA,161349,1285927,299,1.00
ptg025109l,725428,725711,283,EVM,mRNA,161349,1285927,283,1.00
ptg025110l,331316,331631,315,EVM,mRNA,188275,484191,315,1.00
ptg025231l,318765,319081,316,EVM,mRNA,225660,573869,316,1.00
ptg025285l,614326,614600,274,EVM,mRNA,201912,1526961,274,1.00
ptg025285l,1518540,1518834,294,EVM,mRNA,201912,1526961,294,1.00
ptg025311l,675165,675464,299,EVM,mRNA,413129,683126,299,1.00
ptg025328l,150326,150602,276,EVM,mRNA,87935,290599,276,1.00
ptg025366l,247617,247935,318,EVM,mRNA,153456,431737,318,1.00
ptg025376l,1626895,1627168,273,EVM,mRNA,1506174,2132297,273,1.00
ptg025376l,3126619,3126945,326,EVM,mRNA,2739667,3215812,326,1.00
ptg025422l,586382,586692,310,EVM,mRNA,225805,630218,310,1.00
ptg025516l,1313485,1313813,328,EVM,mRNA,1182799,1337698,328,1.00
ptg025547l,11597,11874,277,EVM,mRNA,11148,12089,277,1.00
ptg025551l,619542,619833,291,EVM,mRNA,619767,620546,67,0.23
ptg025568l,39738,40063,325,EVM,mRNA,27225,689099,325,1.00
ptg025568l,268186,268493,307,EVM,mRNA,27225,689099,307,1.00
ptg025573l,804804,805107,303,EVM,mRNA,711616,1235155,303,1.00
ptg025575l,231892,232217,325,EVM,mRNA,138598,258271,325,1.00
ptg025582l,267020,267340,320,EVM,mRNA,229997,316911,320,1.00
ptg025585l,87875,88175,300,EVM,mRNA,79284,250300,300,1.00
ptg025599l,337043,337360,317,EVM,mRNA,205723,859925,317,1.00
ptg025615l,118255,118541,286,EVM,mRNA,75905,146534,286,1.00
ptg025631l,706572,706864,292,EVM,mRNA,561482,811962,292,1.00
ptg025631l,712263,712555,292,EVM,mRNA,561482,811962,292,1.00
ptg025631l,1041726,1042038,312,EVM,mRNA,1008385,1267553,312,1.00
ptg025657l,392819,393134,315,EVM,mRNA,284680,1151633,315,1.00
ptg025693l,115017,115317,300,EVM,mRNA,59762,248442,300,1.00
ptg025704l,345147,345474,327,EVM,mRNA,310060,465825,327,1.00
ptg025737l,378081,378387,306,EVM,mRNA,301191,379893,306,1.00
ptg025819l,759797,760131,334,EVM,mRNA,672927,810244,334,1.00
ptg025853l,96064,96376,312,EVM,mRNA,5717,292625,312,1.00
ptg025862l,2050734,2051028,294,EVM,mRNA,7209,2573245,294,1.00
ptg025898l,102122,102438,316,EVM,mRNA,54070,278391,316,1.00
ptg025903l,913605,913898,293,EVM,mRNA,899454,993828,293,1.00
ptg025903l,920000,920262,262,EVM,mRNA,899454,993828,262,1.00
ptg025909l,453372,453662,290,EVM,mRNA,43828,623476,290,1.00
ptg025909l,488302,488615,313,EVM,mRNA,43828,623476,313,1.00
ptg025936l,80192,80516,324,EVM,mRNA,413,145618,324,1.00
ptg025936l,139160,139432,272,EVM,mRNA,413,145618,272,1.00
ptg025952l,143569,143847,278,EVM,mRNA,45364,385537,278,1.00
ptg025956l,511245,511543,298,EVM,mRNA,170705,626797,298,1.00
ptg025976l,163457,163738,281,EVM,mRNA,4172,222309,281,1.00
ptg025998l,311161,311478,317,EVM,mRNA,13840,331511,317,1.00
ptg026059l,1009285,1009548,263,EVM,mRNA,997128,1076738,263,1.00
ptg026090l,152932,153211,279,EVM,mRNA,109535,240026,279,1.00
ptg026100l,41017,41316,299,EVM,mRNA,26334,594859,299,1.00
ptg026100l,351523,351840,317,EVM,mRNA,26334,594859,317,1.00
ptg026100l,568965,569280,315,EVM,mRNA,26334,594859,315,1.00
ptg026118l,1149828,1150129,301,EVM,mRNA,919896,1230915,301,1.00
ptg026121l,38097,38416,319,EVM,mRNA,4786,235364,319,1.00
ptg026125l,442171,442469,298,EVM,mRNA,122787,445468,298,1.00
ptg026149l,261607,261909,302,EVM,mRNA,58246,328475,302,1.00
ptg026166l,72322,72626,304,EVM,mRNA,26897,133892,304,1.00
ptg026198l,374355,374656,301,EVM,mRNA,1295,450943,301,1.00
ptg026198l,438057,438369,312,EVM,mRNA,1295,450943,312,1.00
ptg026204l,218228,218526,298,EVM,mRNA,1417,993617,298,1.00
ptg026204l,450099,450407,308,EVM,mRNA,1417,993617,308,1.00
ptg026219l,207114,207437,323,EVM,mRNA,111205,455216,323,1.00
ptg026294l,1670003,1670315,312,EVM,mRNA,707795,1961561,312,1.00
ptg026341l,113736,114029,293,EVM,mRNA,10799,358081,293,1.00
ptg026348l,558885,559195,310,EVM,mRNA,114856,1064558,310,1.00
ptg026348l,568596,568904,308,EVM,mRNA,114856,1064558,308,1.00
ptg026348l,984699,984956,257,EVM,mRNA,114856,1064558,257,1.00
ptg026390l,356258,356569,311,EVM,mRNA,103207,514502,311,1.00
ptg026397l,57976,58298,322,EVM,mRNA,34351,161952,322,1.00
ptg026397l,159461,159765,304,EVM,mRNA,34351,161952,304,1.00
ptg026482l,298366,298681,315,EVM,mRNA,231986,358123,315,1.00
ptg026482l,341195,341504,309,EVM,mRNA,231986,358123,309,1.00
ptg026494l,553973,554278,305,EVM,mRNA,129037,593994,305,1.00
ptg026537l,898898,899185,287,EVM,mRNA,453249,904042,287,1.00
ptg026632l,417655,417949,294,EVM,mRNA,393606,604305,294,1.00
ptg026645l,451936,452227,291,EVM,mRNA,387376,460299,291,1.00
ptg026686l,876584,876918,334,EVM,mRNA,766420,1013041,334,1.00
ptg026733l,612948,613274,326,EVM,mRNA,536351,757613,326,1.00
ptg026769l,296796,297084,288,EVM,mRNA,10362,338374,288,1.00
ptg026775l,564337,564651,314,EVM,mRNA,497777,764417,314,1.00
ptg026799l,211578,211871,293,EVM,mRNA,289,836730,293,1.00
ptg026826l,428669,428971,302,EVM,mRNA,235990,501913,302,1.00
ptg026848l,48423,48703,280,EVM,mRNA,3322,482008,280,1.00
ptg026848l,391591,391876,285,EVM,mRNA,3322,482008,285,1.00
ptg026848l,451108,451406,298,EVM,mRNA,3322,482008,298,1.00
ptg026855l,3142140,3142422,282,EVM,mRNA,1058514,3146954,282,1.00
ptg026855l,3450406,3450707,301,EVM,mRNA,3256729,3504895,301,1.00
ptg026855l,3986496,3986791,295,EVM,mRNA,3702257,4850914,295,1.00
ptg026855l,4134302,4134624,322,EVM,mRNA,3702257,4850914,322,1.00
ptg026855l,4780295,4780609,314,EVM,mRNA,3702257,4850914,314,1.00
ptg026899l,470391,470711,320,EVM,mRNA,3232,574988,320,1.00
ptg026936l,151530,151836,306,EVM,mRNA,80157,198468,306,1.00
ptg026966l,1074913,1075246,333,EVM,mRNA,256790,1658529,333,1.00
ptg027027l,296030,296357,327,EVM,mRNA,209327,379423,327,1.00
ptg027027l,321403,321687,284,EVM,mRNA,209327,379423,284,1.00
ptg027040l,55482,55778,296,EVM,mRNA,55331,289297,296,1.00
ptg027052l,76156,76458,302,EVM,mRNA,7350,134840,302,1.00
ptg027052l,543955,544230,275,EVM,mRNA,471330,833262,275,1.00
ptg027089l,609590,609901,311,EVM,mRNA,114002,776781,311,1.00
ptg027143l,627436,627725,289,EVM,mRNA,572944,818408,289,1.00
ptg027154l,187206,187492,286,EVM,mRNA,2360,340905,286,1.00
ptg027154l,270566,270861,295,EVM,mRNA,2360,340905,295,1.00
ptg027166l,262861,263162,301,EVM,mRNA,245326,347449,301,1.00
ptg027166l,307434,307698,264,EVM,mRNA,245326,347449,264,1.00
ptg027188l,931564,931869,305,EVM,mRNA,795036,1027916,305,1.00
ptg027224l,1505490,1505801,311,EVM,mRNA,682855,2369865,311,1.00
ptg027224l,1519258,1519569,311,EVM,mRNA,682855,2369865,311,1.00
ptg027224l,1856629,1856926,297,EVM,mRNA,682855,2369865,297,1.00
ptg027224l,2013126,2013425,299,EVM,mRNA,682855,2369865,299,1.00
ptg027227l,286750,287055,305,EVM,mRNA,270513,413926,305,1.00
ptg027228l,420013,420324,311,EVM,mRNA,22195,469704,311,1.00
ptg027237l,32226,32506,280,EVM,mRNA,12267,43131,280,1.00
ptg027238l,307168,307498,330,EVM,mRNA,442,1016923,330,1.00
ptg027260l,495725,496038,313,EVM,mRNA,182565,582959,313,1.00
ptg027289l,555669,555991,322,EVM,mRNA,231650,753538,322,1.00
ptg027289l,706713,707007,294,EVM,mRNA,231650,753538,294,1.00
ptg027306l,105969,106235,266,EVM,mRNA,53827,193786,266,1.00
ptg027307l,219865,220146,281,EVM,mRNA,22006,320689,281,1.00
ptg027347l,1528436,1528738,302,EVM,mRNA,1447545,1533137,302,1.00
ptg027354l,319812,320117,305,EVM,mRNA,118614,444499,305,1.00
ptg027355l,217003,217306,303,EVM,mRNA,34206,584345,303,1.00
ptg027369l,307122,307429,307,EVM,mRNA,3508,314185,307,1.00
ptg027395l,97478,97791,313,EVM,mRNA,88062,289807,313,1.00
ptg027426l,203509,203787,278,EVM,mRNA,114386,344737,278,1.00
ptg027429l,2569299,2569597,298,EVM,mRNA,2457725,2811830,298,1.00
ptg027439l,1078811,1079141,330,EVM,mRNA,3982,1296842,330,1.00
ptg027439l,1080331,1080633,302,EVM,mRNA,3982,1296842,302,1.00
ptg027439l,1773439,1773744,305,EVM,mRNA,1416617,2222605,305,1.00
ptg027443l,85503,85802,299,EVM,mRNA,75328,294427,299,1.00
ptg027460l,544877,545199,322,EVM,mRNA,424573,802210,322,1.00
ptg027460l,707682,708004,322,EVM,mRNA,424573,802210,322,1.00
ptg027466l,2664198,2664510,312,EVM,mRNA,1025643,2703622,312,1.00
ptg027472l,340404,340715,311,EVM,mRNA,2240,458302,311,1.00
ptg027472l,387183,387472,289,EVM,mRNA,2240,458302,289,1.00
ptg027487l,242653,242925,272,EVM,mRNA,145413,255333,272,1.00
ptg027539l,49600,49918,318,EVM,mRNA,799,118704,318,1.00
ptg027579l,93961,94222,261,EVM,mRNA,44615,145443,261,1.00
ptg027620l,346817,347113,296,EVM,mRNA,330837,366966,296,1.00
ptg027620l,347844,348163,319,EVM,mRNA,330837,366966,319,1.00
ptg027667l,94897,95183,286,EVM,mRNA,56682,171977,286,1.00
ptg027669l,1752987,1753303,316,EVM,mRNA,1197143,1866077,316,1.00
ptg027669l,1769954,1770235,281,EVM,mRNA,1197143,1866077,281,1.00
ptg027678l,167918,168232,314,EVM,mRNA,1146,270546,314,1.00
ptg027687l,22107,22385,278,EVM,mRNA,810,102193,278,1.00
ptg027705l,139669,139982,313,EVM,mRNA,21232,248963,313,1.00
ptg027730l,389347,389650,303,EVM,mRNA,252256,398757,303,1.00
ptg027740l,74652,74971,319,EVM,mRNA,1514,642472,319,1.00
ptg027749l,2638805,2639109,304,EVM,mRNA,2033641,5005374,304,1.00
ptg027749l,3160437,3160750,313,EVM,mRNA,2033641,5005374,313,1.00
ptg027777l,680655,680979,324,EVM,mRNA,637305,767298,324,1.00
ptg027793l,312427,312726,299,EVM,mRNA,281439,600601,299,1.00
ptg027909l,330942,331230,288,EVM,mRNA,192365,441221,288,1.00
ptg027936l,273293,273576,283,EVM,mRNA,194322,489460,283,1.00
ptg027938l,389300,389621,321,EVM,mRNA,153017,437863,321,1.00
ptg027954l,793733,794025,292,EVM,mRNA,606744,1069854,292,1.00
ptg027971l,608249,608548,299,EVM,mRNA,136279,618591,299,1.00
ptg027980l,133870,134191,321,EVM,mRNA,572,345424,321,1.00
ptg028014l,392031,392328,297,EVM,mRNA,102698,406383,297,1.00
ptg028058l,939532,939806,274,EVM,mRNA,716816,1108564,274,1.00
ptg028102l,309056,309375,319,EVM,mRNA,145766,336109,319,1.00
ptg028236l,720686,720972,286,EVM,mRNA,60099,769039,286,1.00
ptg028263l,215471,215782,311,EVM,mRNA,215297,306445,311,1.00
ptg028324l,235201,235486,285,EVM,mRNA,88123,251071,285,1.00
ptg028362l,309200,309526,326,EVM,mRNA,34932,386795,326,1.00
ptg028378l,210238,210547,309,EVM,mRNA,50492,346679,309,1.00
ptg028392l,112174,112471,297,EVM,mRNA,35713,171441,297,1.00
ptg028394l,145866,146155,289,EVM,mRNA,32285,184195,289,1.00
ptg028405l,129650,129972,322,EVM,mRNA,75167,148504,322,1.00
ptg028411l,256380,256684,304,EVM,mRNA,185196,333697,304,1.00
ptg028432l,85003,85325,322,EVM,mRNA,76745,252798,322,1.00
ptg028477l,66527,66802,275,EVM,mRNA,53357,84669,275,1.00
ptg028499l,86044,86347,303,EVM,mRNA,79584,516706,303,1.00
ptg028502l,64350,64650,300,EVM,mRNA,15718,123798,300,1.00
ptg028502l,120596,120916,320,EVM,mRNA,15718,123798,320,1.00
ptg028533l,300084,300378,294,EVM,mRNA,187253,307580,294,1.00
ptg028539l,151947,152226,279,EVM,mRNA,79672,152202,255,0.91
ptg028550l,591949,592240,291,EVM,mRNA,416322,683221,291,1.00
ptg028577l,808426,808742,316,EVM,mRNA,721820,1225929,316,1.00
ptg028596l,134213,134511,298,EVM,mRNA,9568,456397,298,1.00
ptg028624l,293733,294042,309,EVM,mRNA,240,410654,309,1.00
ptg028635l,183932,184249,317,EVM,mRNA,32515,309849,317,1.00
ptg028652l,682505,682826,321,EVM,mRNA,638738,785771,321,1.00
ptg028652l,1267685,1268004,319,EVM,mRNA,815503,1313262,319,1.00
ptg028755l,886932,887206,274,EVM,mRNA,867644,978163,274,1.00
ptg028768l,299202,299519,317,EVM,mRNA,234301,1485447,317,1.00
ptg028768l,1069729,1070046,317,EVM,mRNA,234301,1485447,317,1.00
ptg028768l,1155281,1155589,308,EVM,mRNA,234301,1485447,308,1.00
ptg028879l,328652,328963,311,EVM,mRNA,361,448569,311,1.00
ptg028879l,682877,683186,309,EVM,mRNA,672982,692611,309,1.00
ptg028936l,733859,734158,299,EVM,mRNA,371256,990053,299,1.00
ptg028936l,984760,985059,299,EVM,mRNA,371256,990053,299,1.00
ptg028975l,224783,225082,299,EVM,mRNA,220885,359792,299,1.00
ptg028989l,350575,350873,298,EVM,mRNA,22895,441831,298,1.00
ptg028999l,170708,171025,317,EVM,mRNA,58831,227353,317,1.00
ptg029057l,74611,74911,300,EVM,mRNA,16996,102027,300,1.00
ptg029063l,148694,148978,284,EVM,mRNA,128106,481344,284,1.00
ptg029100l,2222824,2223145,321,EVM,mRNA,2165162,2251708,321,1.00
ptg029112l,152141,152472,331,EVM,mRNA,60143,337403,331,1.00
ptg029145l,118627,118916,289,EVM,mRNA,118267,242156,289,1.00
ptg029151l,333027,333340,313,EVM,mRNA,3168,410579,313,1.00
ptg029151l,377784,378075,291,EVM,mRNA,3168,410579,291,1.00
ptg029181l,25808,26072,264,EVM,mRNA,5723,171444,264,1.00
ptg029186l,120539,120859,320,EVM,mRNA,15430,120616,77,0.24
ptg029194l,255171,255465,294,EVM,mRNA,56319,303063,294,1.00
ptg029205l,1240786,1241108,322,EVM,mRNA,630971,1242533,322,1.00
ptg029223l,341439,341739,300,EVM,mRNA,320750,504734,300,1.00
ptg029224l,154165,154489,324,EVM,mRNA,62966,2412446,324,1.00
ptg029224l,1825531,1825857,326,EVM,mRNA,62966,2412446,326,1.00
ptg029224l,2351951,2352265,314,EVM,mRNA,62966,2412446,314,1.00
ptg029224l,4466763,4467080,317,EVM,mRNA,4006775,5088733,317,1.00
ptg029224l,4824221,4824525,304,EVM,mRNA,4006775,5088733,304,1.00
ptg029243l,121944,122233,289,EVM,mRNA,122167,122500,67,0.23
ptg029245l,673992,674287,295,EVM,mRNA,76636,893467,295,1.00
ptg029260l,138835,139134,299,EVM,mRNA,138004,517356,299,1.00
ptg029270l,191166,191435,269,EVM,mRNA,190089,191217,51,0.19
ptg029275l,379373,379686,313,EVM,mRNA,213787,387844,313,1.00
ptg029373l,16255,16542,287,EVM,mRNA,8378,240477,287,1.00
ptg029373l,46553,46855,302,EVM,mRNA,8378,240477,302,1.00
ptg029406l,351676,351954,278,EVM,mRNA,9808,481977,278,1.00
ptg029440l,758334,758583,249,EVM,mRNA,399162,911717,249,1.00
ptg029440l,1508080,1508377,297,EVM,mRNA,1235949,2669253,297,1.00
ptg029440l,2035467,2035756,289,EVM,mRNA,1235949,2669253,289,1.00
ptg029459l,1180572,1180901,329,EVM,mRNA,761369,1204348,329,1.00
ptg029570l,1440604,1440917,313,EVM,mRNA,92301,1461716,313,1.00
ptg029600l,18467,18778,311,EVM,mRNA,2620,62546,311,1.00
ptg029655l,88950,89224,274,EVM,mRNA,6898,329445,274,1.00
ptg029732l,142836,143133,297,EVM,mRNA,44109,452564,297,1.00
ptg029735l,47926,48254,328,EVM,mRNA,14396,131651,328,1.00
ptg029817l,261407,261687,280,EVM,mRNA,48258,331364,280,1.00
ptg029839l,213088,213399,311,EVM,mRNA,187704,233055,311,1.00
ptg029849l,14925,15254,329,EVM,mRNA,4083,162015,329,1.00
ptg029849l,81736,82051,315,EVM,mRNA,4083,162015,315,1.00
ptg029917l,151252,151552,300,EVM,mRNA,2686,596348,300,1.00
ptg029917l,596234,596542,308,EVM,mRNA,2686,596348,114,0.37
ptg029932l,223842,224155,313,EVM,mRNA,201698,238332,313,1.00
ptg029972l,98322,98464,142,EVM,mRNA,53235,181541,142,1.00
ptg030001l,96176,96466,290,EVM,mRNA,38400,152675,290,1.00
ptg030163l,272888,273184,296,EVM,mRNA,157541,405880,296,1.00
ptg030164l,16498,16828,330,EVM,mRNA,14817,351702,330,1.00
ptg030215l,168789,169087,298,EVM,mRNA,254,229431,298,1.00
ptg030216l,1945799,1946118,319,EVM,mRNA,1626557,2127869,319,1.00
ptg030249l,728305,728634,329,EVM,mRNA,223942,1527638,329,1.00
ptg030249l,973509,973804,295,EVM,mRNA,223942,1527638,295,1.00
ptg030249l,1483715,1484009,294,EVM,mRNA,223942,1527638,294,1.00
ptg030249l,1899844,1900109,265,EVM,mRNA,1897281,5682586,265,1.00
ptg030249l,2670873,2671188,315,EVM,mRNA,1897281,5682586,315,1.00
ptg030249l,3191447,3191777,330,EVM,mRNA,1897281,5682586,330,1.00
ptg030321l,60492,60774,282,EVM,mRNA,7988,242919,282,1.00
ptg030378l,256380,256692,312,EVM,mRNA,45799,288143,312,1.00
ptg030382l,2887891,2888211,320,EVM,mRNA,2574117,2937187,320,1.00
ptg030456l,400149,400419,270,EVM,mRNA,333347,490016,270,1.00
ptg030466l,287322,287608,286,EVM,mRNA,17267,2315949,286,1.00
ptg030466l,414089,414385,296,EVM,mRNA,17267,2315949,296,1.00
ptg030466l,638789,639072,283,EVM,mRNA,17267,2315949,283,1.00
ptg030466l,1312481,1312795,314,EVM,mRNA,17267,2315949,314,1.00
ptg030466l,1504564,1504876,312,EVM,mRNA,17267,2315949,312,1.00
ptg030466l,2093742,2094035,293,EVM,mRNA,17267,2315949,293,1.00
ptg030515l,108535,108813,278,EVM,mRNA,101587,113958,278,1.00
ptg030569l,367836,368136,300,EVM,mRNA,362476,586832,300,1.00
ptg030569l,1685387,1685697,310,EVM,mRNA,1635346,1746349,310,1.00
ptg030569l,2981535,2981842,307,EVM,mRNA,2853733,3778030,307,1.00
ptg030569l,3381358,3381684,326,EVM,mRNA,2853733,3778030,326,1.00
ptg030597l,94434,94725,291,EVM,mRNA,62420,355790,291,1.00
ptg030604l,8128,8299,171,EVM,mRNA,2054,209751,171,1.00
ptg030605l,120665,120962,297,EVM,mRNA,116494,137741,297,1.00
ptg030605l,120665,120962,297,GeneWise,mRNA,116497,146215,297,1.00
ptg030606l,503440,503756,316,EVM,mRNA,251211,852035,316,1.00
ptg030716l,104215,104544,329,EVM,mRNA,44105,197105,329,1.00
ptg030718l,95271,95561,290,EVM,mRNA,58963,201448,290,1.00
ptg030760l,66008,66308,300,EVM,mRNA,12986,471477,300,1.00
ptg030760l,304645,304940,295,EVM,mRNA,12986,471477,295,1.00
ptg030855l,190758,191034,276,EVM,mRNA,112505,394655,276,1.00
ptg030855l,259724,260027,303,EVM,mRNA,112505,394655,303,1.00
ptg030888l,293365,293662,297,EVM,mRNA,189954,307912,297,1.00
ptg030898l,243111,243427,316,EVM,mRNA,4543,295085,316,1.00
ptg030925l,288235,288534,299,EVM,mRNA,227842,383165,299,1.00
ptg030979l,80857,81156,299,EVM,mRNA,47875,197889,299,1.00
ptg031007l,56664,56944,280,EVM,mRNA,20167,69267,280,1.00
ptg031071l,549063,549363,300,EVM,mRNA,472218,641995,300,1.00
ptg031131l,511209,511540,331,EVM,mRNA,401418,814391,331,1.00
ptg031200l,24329,24607,278,EVM,mRNA,838,368719,278,1.00
ptg031205l,300388,300677,289,EVM,mRNA,140312,649808,289,1.00
ptg031210l,130091,130410,319,EVM,mRNA,105827,385474,319,1.00
ptg031210l,729352,729688,336,EVM,mRNA,665077,916490,336,1.00
ptg031210l,1225691,1225990,299,EVM,mRNA,1175194,1400803,299,1.00
ptg031210l,1329660,1329997,337,EVM,mRNA,1175194,1400803,337,1.00
ptg031217l,194310,194628,318,EVM,mRNA,191022,349777,318,1.00
ptg031233l,249980,250296,316,EVM,mRNA,113072,343674,316,1.00
ptg031271l,119283,119618,335,EVM,mRNA,12881,210616,335,1.00
ptg031566l,13135,13417,282,EVM,mRNA,13172,90900,246,0.87
ptg031567l,238902,239191,289,EVM,mRNA,170373,287085,289,1.00
ptg031571l,337782,338064,282,EVM,mRNA,237788,383253,282,1.00
ptg031571l,350677,350969,292,EVM,mRNA,237788,383253,292,1.00
ptg031734l,703655,703955,300,EVM,mRNA,129660,1093868,300,1.00
ptg031739l,202462,202760,298,EVM,mRNA,21106,522582,298,1.00
ptg031867l,119238,119564,326,EVM,mRNA,37866,196170,326,1.00
ptg031965l,43213,43511,298,EVM,mRNA,34335,237490,298,1.00
ptg031965l,82661,82926,265,EVM,mRNA,34335,237490,265,1.00
ptg032080l,122231,122518,287,EVM,mRNA,32604,216966,287,1.00
ptg032131l,147882,148166,284,EVM,mRNA,133897,199134,284,1.00
ptg032251l,46790,47089,299,EVM,mRNA,12038,57071,299,1.00
ptg032256l,221829,222109,280,EVM,mRNA,170025,454502,280,1.00
ptg032256l,433373,433671,298,EVM,mRNA,170025,454502,298,1.00
ptg032292l,313077,313374,297,EVM,mRNA,245336,322004,297,1.00
ptg032398l,29415,29731,316,EVM,mRNA,28798,79562,316,1.00
ptg032538l,419614,419925,311,EVM,mRNA,92308,786696,311,1.00
ptg032562l,1551321,1551614,293,EVM,mRNA,810561,1780523,293,1.00
ptg032570l,175462,175773,311,EVM,mRNA,115495,220050,311,1.00
ptg032588l,64320,64585,265,EVM,mRNA,33391,169196,265,1.00
ptg032742l,349028,349333,305,EVM,mRNA,167805,736040,305,1.00
ptg032742l,465650,465958,308,EVM,mRNA,167805,736040,308,1.00
ptg032742l,696142,696463,321,EVM,mRNA,167805,736040,321,1.00
ptg032816l,1147781,1148076,295,EVM,mRNA,538131,1372234,295,1.00
ptg032921l,188545,188864,319,EVM,mRNA,48612,483369,319,1.00
ptg032921l,386853,387152,299,EVM,mRNA,48612,483369,299,1.00
ptg032936l,197088,197386,298,EVM,mRNA,2210,483950,298,1.00
ptg033090l,387451,387748,297,EVM,mRNA,208030,511919,297,1.00
ptg033151l,88645,88923,278,EVM,mRNA,42211,140494,278,1.00
ptg033207l,10942,11249,307,EVM,mRNA,1121,157484,307,1.00
ptg033208l,749501,749794,293,EVM,mRNA,746146,1094527,293,1.00
ptg033244l,354605,354879,274,EVM,mRNA,106484,387073,274,1.00
ptg033324l,1355356,1355659,303,EVM,mRNA,1062851,1425348,303,1.00
ptg033324l,1383585,1383885,300,EVM,mRNA,1062851,1425348,300,1.00
ptg033417l,573394,573706,312,EVM,mRNA,272731,576898,312,1.00
ptg033419l,210619,210950,331,EVM,mRNA,34269,387122,331,1.00
ptg033440l,1131738,1132059,321,EVM,mRNA,1028442,1153246,321,1.00
ptg033487l,241042,241324,282,EVM,mRNA,34919,546261,282,1.00
ptg033487l,480111,480415,304,EVM,mRNA,34919,546261,304,1.00
ptg033551l,885093,885398,305,EVM,mRNA,177023,1294368,305,1.00
ptg033610l,95477,95793,316,EVM,mRNA,31947,106657,316,1.00
ptg033624l,125120,125418,298,EVM,mRNA,29522,138823,298,1.00
ptg033629l,222020,222320,300,EVM,mRNA,57184,307950,300,1.00
ptg033648l,653608,653888,280,EVM,mRNA,578391,669364,280,1.00
ptg033703l,139308,139612,304,EVM,mRNA,104937,167097,304,1.00
ptg033849l,16113,16414,301,EVM,mRNA,43,286182,301,1.00
ptg033953l,733180,733477,297,EVM,mRNA,732785,756978,297,1.00
ptg034041l,11286,11598,312,EVM,mRNA,2344,21795,312,1.00
ptg034092l,224042,224356,314,EVM,mRNA,61678,283055,314,1.00
ptg034180l,123826,124163,337,EVM,mRNA,34829,211307,337,1.00
ptg034190l,273106,273390,284,EVM,mRNA,233438,693653,284,1.00
ptg034190l,523163,523479,316,EVM,mRNA,233438,693653,316,1.00
ptg034190l,1146161,1146471,310,EVM,mRNA,1001604,1175171,310,1.00
ptg034359l,260249,260572,323,EVM,mRNA,258270,402346,323,1.00
ptg034361l,32087,32404,317,EVM,mRNA,30752,121566,317,1.00
ptg034627l,95626,95943,317,EVM,mRNA,7202,257903,317,1.00
ptg034627l,436844,437131,287,EVM,mRNA,408106,548276,287,1.00
ptg034649l,301648,301946,298,EVM,mRNA,9399,302705,298,1.00
ptg034927l,220474,220735,261,EVM,mRNA,212116,245350,261,1.00
ptg034991l,60464,60773,309,EVM,mRNA,41782,175351,309,1.00
ptg035132l,94955,95273,318,EVM,mRNA,92761,102871,318,1.00
ptg035191l,186771,187077,306,EVM,mRNA,182864,231591,306,1.00
ptg035669l,544180,544494,314,EVM,mRNA,517506,717738,314,1.00
ptg035694l,20686,20968,282,EVM,mRNA,6605,789599,282,1.00
ptg035694l,472707,473000,293,EVM,mRNA,6605,789599,293,1.00
ptg035734l,102875,103184,309,EVM,mRNA,21764,808553,309,1.00
ptg035734l,398127,398419,292,EVM,mRNA,21764,808553,292,1.00
ptg035734l,778640,778923,283,EVM,mRNA,21764,808553,283,1.00
ptg035777l,114315,114646,331,EVM,mRNA,91078,150494,331,1.00
ptg036034l,188492,188784,292,EVM,mRNA,9512,325919,292,1.00
ptg036048l,112612,112911,299,EVM,mRNA,89151,184884,299,1.00
ptg036074l,42697,42972,275,EVM,mRNA,18177,68602,275,1.00
ptg036193l,215206,215494,288,EVM,mRNA,18054,240191,288,1.00
ptg036193l,220801,221084,283,EVM,mRNA,18054,240191,283,1.00
ptg036366l,113961,114235,274,EVM,mRNA,70733,140366,274,1.00
ptg036480l,195486,195821,335,EVM,mRNA,103212,566334,335,1.00
ptg036585l,81944,82213,269,EVM,mRNA,77722,379524,269,1.00
ptg036611l,435053,435366,313,EVM,mRNA,413631,542542,313,1.00
ptg036661l,219196,219501,305,EVM,mRNA,152578,230095,305,1.00
ptg036980l,123331,123648,317,EVM,mRNA,23979,443688,317,1.00
ptg037213l,147366,147670,304,EVM,mRNA,46430,175459,304,1.00
ptg037566l,318524,318850,326,EVM,mRNA,266751,374304,326,1.00
ptg037615l,3412505,3412820,315,EVM,mRNA,3134386,5768312,315,1.00
ptg037615l,3842698,3843012,314,EVM,mRNA,3134386,5768312,314,1.00
ptg037615l,4062875,4063182,307,EVM,mRNA,3134386,5768312,307,1.00
ptg037615l,4175141,4175450,309,EVM,mRNA,3134386,5768312,309,1.00
ptg037615l,4335179,4335465,286,EVM,mRNA,3134386,5768312,286,1.00
ptg037615l,5478258,5478533,275,EVM,mRNA,3134386,5768312,275,1.00
ptg037939l,599995,600307,312,EVM,mRNA,38575,789296,312,1.00
ptg038043l,92450,92774,324,EVM,mRNA,18801,191401,324,1.00
ptg038073l,104478,104771,293,EVM,mRNA,103000,173013,293,1.00
ptg038084l,971179,971506,327,EVM,mRNA,852471,992081,327,1.00
ptg038109l,200033,200332,299,EVM,mRNA,75512,218918,299,1.00
ptg038227l,791361,791659,298,EVM,mRNA,670492,923352,298,1.00
ptg038237l,1393509,1393801,292,EVM,mRNA,157592,1897548,292,1.00
ptg038252l,268537,268860,323,EVM,mRNA,128734,338525,323,1.00
ptg038252l,272528,272827,299,EVM,mRNA,128734,338525,299,1.00
ptg038272l,234715,235005,290,EVM,mRNA,116706,328151,290,1.00
ptg038324l,135378,135678,300,EVM,mRNA,50752,167384,300,1.00
ptg038357l,245292,245603,311,EVM,mRNA,2983,421530,311,1.00
ptg038357l,805502,805774,272,EVM,mRNA,641436,1305092,272,1.00
ptg038400l,34188,34476,288,EVM,mRNA,4417,132024,288,1.00
ptg038589l,121662,121942,280,EVM,mRNA,106579,159858,280,1.00
ptg038589l,516033,516322,289,EVM,mRNA,501494,524497,289,1.00
ptg039132l,216021,216329,308,EVM,mRNA,157126,240317,308,1.00
ptg039170l,123447,123760,313,EVM,mRNA,62410,212765,313,1.00
ptg039294l,216484,216777,293,EVM,mRNA,165327,229195,293,1.00
ptg039452l,1904410,1904720,310,EVM,mRNA,18915,2336543,310,1.00
ptg039452l,3478028,3478341,313,EVM,mRNA,2473924,3597669,313,1.00
ptg039549l,2934497,2934812,315,EVM,mRNA,2665869,3117568,315,1.00
ptg039561l,32196,32477,281,EVM,mRNA,12725,33509,281,1.00
ptg039663l,1123150,1123431,281,EVM,mRNA,206261,1218084,281,1.00
ptg039663l,1847532,1847823,291,EVM,mRNA,1608747,1926428,291,1.00
ptg039789l,980889,981200,311,EVM,mRNA,528003,2097300,311,1.00
ptg039789l,1554705,1554980,275,EVM,mRNA,528003,2097300,275,1.00
ptg039953l,83182,83438,256,EVM,mRNA,52665,167156,256,1.00
ptg040065l,1407267,1407566,299,EVM,mRNA,253983,1755154,299,1.00
ptg040065l,1754756,1755042,286,EVM,mRNA,253983,1755154,286,1.00
ptg040204l,2304749,2305037,288,EVM,mRNA,2299683,5557079,288,1.00
ptg040204l,3605261,3605553,292,EVM,mRNA,2299683,5557079,292,1.00
ptg040204l,4283406,4283684,278,EVM,mRNA,2299683,5557079,278,1.00
ptg040204l,5500487,5500806,319,EVM,mRNA,2299683,5557079,319,1.00
ptg040230l,85768,86075,307,EVM,mRNA,63772,96217,307,1.00
ptg040333l,82339,82640,301,EVM,mRNA,82159,82467,128,0.43
ptg040863l,130436,130748,312,EVM,mRNA,124885,390426,312,1.00
ptg040911l,100150,100488,338,EVM,mRNA,57932,203136,338,1.00
ptg041091l,252640,252934,294,EVM,mRNA,175149,457996,294,1.00
ptg041564l,214650,214953,303,EVM,mRNA,115673,2614828,303,1.00
ptg041564l,342670,342970,300,EVM,mRNA,115673,2614828,300,1.00
ptg041564l,642463,642770,307,EVM,mRNA,115673,2614828,307,1.00
ptg041564l,935705,936001,296,EVM,mRNA,115673,2614828,296,1.00
ptg041564l,2134963,2135271,308,EVM,mRNA,115673,2614828,308,1.00
ptg041606l,255865,256193,328,EVM,mRNA,236193,258603,328,1.00
ptg041647l,263039,263353,314,EVM,mRNA,232370,280142,314,1.00
ptg041801l,413833,414135,302,EVM,mRNA,364873,503194,302,1.00
ptg041813l,289334,289644,310,EVM,mRNA,203185,746122,310,1.00
ptg041822l,62810,63103,293,EVM,mRNA,17929,81285,293,1.00
ptg042415l,244190,244466,276,EVM,mRNA,243784,606240,276,1.00
ptg042487l,35587,35868,281,EVM,mRNA,28279,97968,281,1.00
ptg042487l,42755,43036,281,EVM,mRNA,28279,97968,281,1.00
ptg043615l,1088671,1088981,310,EVM,mRNA,4619,1668313,310,1.00
ptg043615l,1567222,1567531,309,EVM,mRNA,4619,1668313,309,1.00
ptg043856l,131740,132036,296,EVM,mRNA,109766,168812,296,1.00
ptg043856l,162483,162803,320,EVM,mRNA,109766,168812,320,1.00
ptg044076l,64450,64743,293,EVM,mRNA,2507,96326,293,1.00
ptg044162l,382968,383298,330,EVM,mRNA,272630,421053,330,1.00
ptg044162l,896616,896882,266,EVM,mRNA,755128,999777,266,1.00
ptg044481l,164025,164326,301,EVM,mRNA,148249,247051,301,1.00
ptg044481l,2118112,2118424,312,EVM,mRNA,1092460,2947902,312,1.00
ptg045200l,254449,254731,282,EVM,mRNA,182603,703060,282,1.00
ptg045200l,456836,457154,318,EVM,mRNA,182603,703060,318,1.00
ptg045273l,648476,648802,326,EVM,mRNA,218127,1529033,326,1.00
ptg045273l,778195,778474,279,EVM,mRNA,218127,1529033,279,1.00
ptg045273l,862691,863001,310,EVM,mRNA,218127,1529033,310,1.00
ptg045273l,1277991,1278307,316,EVM,mRNA,218127,1529033,316,1.00
ptg046269l,126217,126535,318,EVM,mRNA,15780,1193229,318,1.00
ptg046269l,1038971,1039265,294,EVM,mRNA,15780,1193229,294,1.00
ptg046538l,1074731,1075063,332,EVM,mRNA,380521,1436687,332,1.00
ptg046659l,1389828,1390133,305,EVM,mRNA,873930,1496827,305,1.00
ptg049572l,75308,75625,317,EVM,mRNA,25815,86338,317,1.00
ptg050038l,481897,482210,313,EVM,mRNA,127306,586949,313,1.00
ptg050256l,113384,113719,335,EVM,mRNA,937,1034281,335,1.00
ptg050742l,459356,459665,309,EVM,mRNA,415772,938953,309,1.00
ptg051242l,18596,18906,310,EVM,mRNA,18068,655649,310,1.00
ptg052056l,44423,44752,329,EVM,mRNA,18733,83300,329,1.00
ptg052562l,106806,107098,292,EVM,mRNA,102837,290568,292,1.00
ptg053699l,591969,592288,319,EVM,mRNA,10365,679275,319,1.00
ptg058450l,24971,25287,316,EVM,mRNA,3367,29278,316,1.00
ptg000016l,623563,623801,238,RepeatMasker,SINE,623515,623602,39,0.16
ptg000020l,3757668,3757947,279,RepeatMasker,SINE,3757891,3758002,57,0.20
ptg000020l,3757668,3757947,279,RepeatMasker,SINE,3757891,3758043,57,0.20
ptg000048l,16488625,16488935,310,RepeatMasker,SINE,16488595,16488802,177,0.57
ptg000078l,1197186,1197487,301,RepeatMasker,SINE,1197155,1197376,190,0.63
ptg000104l,10182860,10183166,306,RepeatMasker,SINE,10182995,10183145,151,0.49
ptg000109l,344555,344841,286,RepeatMasker,SINE,344362,344589,34,0.12
ptg000122l,3442741,3443072,331,RepeatMasker,SINE,3442722,3442774,33,0.10
ptg000124l,2167779,2168074,295,RepeatMasker,SINE,2168031,2168262,44,0.15
ptg000142l,4277294,4277566,272,RepeatMasker,SINE,4277532,4277697,35,0.13
ptg000145l,88167,88454,287,RepeatMasker,SINE,88133,88371,204,0.71
ptg000195l,405129,405446,317,RepeatMasker,SINE,405124,405202,73,0.23
ptg000218l,2968131,2968403,272,RepeatMasker,SINE,2968360,2968499,44,0.16
ptg000221l,2497942,2498249,307,RepeatMasker,SINE,2497748,2497974,32,0.10
ptg000221l,2541189,2541488,299,RepeatMasker,SINE,2541151,2541399,210,0.70
ptg000248l,4822982,4823291,309,RepeatMasker,SINE,4823290,4823452,2,0.01
ptg000250l,4617460,4617748,288,RepeatMasker,SINE,4617337,4617496,36,0.13
ptg000267l,834578,834845,267,RepeatMasker,SINE,834699,834750,52,0.19
ptg000267l,834578,834845,267,RepeatMasker,SINE,834699,834759,61,0.23
ptg000267l,834578,834845,267,RepeatMasker,SINE,834756,834841,86,0.32
ptg000267l,4840661,4840966,305,RepeatMasker,SINE,4840464,4840698,37,0.12
ptg000271l,4203955,4204284,329,RepeatMasker,SINE,4204013,4204097,85,0.26
ptg000271l,4203955,4204284,329,RepeatMasker,SINE,4204113,4204190,78,0.24
ptg000283l,501225,501509,284,RepeatMasker,SINE,501276,501339,64,0.23
ptg000304l,5441803,5442082,279,RepeatMasker,SINE,5441829,5441960,132,0.47
ptg000321l,955457,955743,286,RepeatMasker,SINE,955260,955497,40,0.14
ptg000367l,3261345,3261639,294,RepeatMasker,SINE,3261336,3261429,84,0.29
ptg000383l,1171593,1171921,328,RepeatMasker,SINE,1171631,1171754,124,0.38
ptg000413l,795681,795989,308,RepeatMasker,SINE,795953,796180,37,0.12
ptg000416l,394956,395238,282,RepeatMasker,SINE,395118,395178,61,0.22
ptg000428l,953755,954079,324,RepeatMasker,SINE,954001,954122,79,0.24
ptg000435l,507850,508154,304,RepeatMasker,SINE,507640,507886,36,0.12
ptg000452l,2185789,2186075,286,RepeatMasker,SINE,2185988,2186056,69,0.24
ptg000460l,523227,523510,283,RepeatMasker,SINE,523041,523228,1,0.00
ptg000480l,2657931,2658240,309,RepeatMasker,SINE,2658092,2658281,149,0.48
ptg000480l,2657931,2658240,309,RepeatMasker,SINE,2658153,2658282,88,0.28
ptg000505l,2299967,2300279,312,RepeatMasker,SINE,2300088,2300317,192,0.62
ptg000506l,5167796,5168061,265,RepeatMasker,SINE,5167762,5167847,51,0.19
ptg000508l,3719528,3719809,281,RepeatMasker,SINE,3719497,3719725,197,0.70
ptg000511l,5258251,5258543,292,RepeatMasker,SINE,5258363,5258414,52,0.18
ptg000511l,5258251,5258543,292,RepeatMasker,SINE,5258372,5258425,54,0.18
ptg000522l,1971063,1971346,283,RepeatMasker,SINE,1970869,1971097,34,0.12
ptg000523l,6485794,6486102,308,RepeatMasker,SINE,6485712,6485871,77,0.25
ptg000523l,6485794,6486102,308,RepeatMasker,SINE,6485718,6485841,47,0.15
ptg000555l,437759,438057,298,RepeatMasker,SINE,438033,438144,25,0.08
ptg000585l,1676603,1676930,327,RepeatMasker,SINE,1676701,1676785,85,0.26
ptg000602l,1362086,1362397,311,RepeatMasker,SINE,1361886,1362123,37,0.12
ptg000607l,2457725,2458017,292,RepeatMasker,SINE,2457986,2458195,32,0.11
ptg000613l,2737540,2737832,292,RepeatMasker,SINE,2737690,2737769,80,0.27
ptg000620l,2669306,2669621,315,RepeatMasker,SINE,2669253,2669341,35,0.11
ptg000627l,5478283,5478588,305,RepeatMasker,SINE,5478563,5478723,26,0.09
ptg000631l,797213,797501,288,RepeatMasker,SINE,797129,797260,47,0.16
ptg000631l,1430239,1430565,326,RepeatMasker,SINE,1430198,1430426,187,0.57
ptg000631l,1430239,1430565,326,RepeatMasker,SINE,1430209,1430373,134,0.41
ptg000633l,1121892,1122215,323,RepeatMasker,SINE,1122112,1122263,104,0.32
ptg000653l,5356404,5356719,315,RepeatMasker,SINE,5356542,5356756,178,0.57
ptg000664l,60069,60359,290,RepeatMasker,SINE,60025,60155,86,0.30
ptg000689l,1268727,1269003,276,RepeatMasker,SINE,1268968,1269184,36,0.13
ptg000707l,1202418,1202701,283,RepeatMasker,SINE,1202665,1202871,37,0.13
ptg000716l,4268074,4268336,262,RepeatMasker,SINE,4268159,4268378,178,0.68
ptg000724l,7305902,7306194,292,RepeatMasker,SINE,7305707,7305933,31,0.11
ptg000738l,1685642,1685951,309,RepeatMasker,SINE,1685558,1685689,47,0.15
ptg000738l,1685642,1685951,309,RepeatMasker,SINE,1685560,1685740,98,0.32
ptg000748l,2141223,2141506,283,RepeatMasker,SINE,2141139,2141247,24,0.08
ptg000748l,2141223,2141506,283,RepeatMasker,SINE,2141481,2141607,26,0.09
ptg000751l,188568,188894,326,RepeatMasker,SINE,188723,188800,78,0.24
ptg000751l,3485500,3485780,280,RepeatMasker,SINE,3485735,3485826,46,0.16
ptg000751l,3485500,3485780,280,RepeatMasker,SINE,3485750,3485840,31,0.11
ptg000766l,175091,175369,278,RepeatMasker,SINE,175052,175095,4,0.01
ptg000795l,2072833,2073151,318,RepeatMasker,SINE,2072926,2073053,128,0.40
ptg000805l,3869482,3869770,288,RepeatMasker,SINE,3869452,3869672,190,0.66
ptg000818l,1268295,1268614,319,RepeatMasker,SINE,1268261,1268488,193,0.61
ptg000820l,2113977,2114266,289,RepeatMasker,SINE,2113940,2114073,96,0.33
ptg000821l,1569443,1569758,315,RepeatMasker,SINE,1569622,1569798,137,0.43
ptg000821l,1569443,1569758,315,RepeatMasker,SINE,1569631,1569779,128,0.41
ptg000824l,2268349,2268603,254,RepeatMasker,SINE,2268431,2268639,173,0.68
ptg000830l,2141497,2141819,322,RepeatMasker,SINE,2141786,2141998,34,0.11
ptg000842l,2010965,2011264,299,RepeatMasker,SINE,2010860,2011010,45,0.15
ptg000842l,2010965,2011264,299,RepeatMasker,SINE,2010861,2011041,76,0.25
ptg000869l,2825545,2825865,320,RepeatMasker,SINE,2825497,2825628,83,0.26
ptg000873l,1690715,1691012,297,RepeatMasker,SINE,1690991,1691035,22,0.07
ptg000873l,2367278,2367544,266,RepeatMasker,SINE,2367389,2367569,156,0.59
ptg000875l,7060226,7060547,321,RepeatMasker,SINE,7060369,7060583,179,0.56
ptg000881l,2625653,2625944,291,RepeatMasker,SINE,2625627,2625851,198,0.68
ptg000885l,6984957,6985277,320,RepeatMasker,SINE,6985108,6985235,128,0.40
ptg000893l,7300392,7300691,299,RepeatMasker,SINE,7300358,7300590,198,0.66
ptg000920l,2389432,2389727,295,RepeatMasker,SINE,2389324,2389468,36,0.12
ptg000956l,4295787,4296103,316,RepeatMasker,SINE,4295849,4295959,111,0.35
ptg000956l,4295787,4296103,316,RepeatMasker,SINE,4295849,4295991,143,0.45
ptg000965l,961393,961669,276,RepeatMasker,SINE,961641,961790,29,0.11
ptg000966l,3926843,3927116,273,RepeatMasker,SINE,3926937,3927151,180,0.66
ptg000967l,3239836,3240162,326,RepeatMasker,SINE,3240080,3240185,83,0.25
ptg000976l,1401990,1402259,269,RepeatMasker,SINE,1402218,1402445,42,0.16
ptg001000l,317713,317999,286,RepeatMasker,SINE,317689,317745,32,0.11
ptg001064l,2946552,2946863,311,RepeatMasker,SINE,2946668,2946902,196,0.63
ptg001076l,391205,391518,313,RepeatMasker,SINE,391342,391553,177,0.57
ptg001076l,2171559,2171858,299,RepeatMasker,SINE,2171363,2171590,31,0.10
ptg001095l,616436,616737,301,RepeatMasker,SINE,616372,616522,86,0.29
ptg001095l,1763833,1764158,325,RepeatMasker,SINE,1763986,1764081,96,0.30
ptg001101l,2964738,2965028,290,RepeatMasker,SINE,2964901,2964968,68,0.23
ptg001131l,2051364,2051649,285,RepeatMasker,SINE,2051270,2051450,86,0.30
ptg001131l,2051364,2051649,285,RepeatMasker,SINE,2051320,2051451,87,0.31
ptg001131l,2051364,2051649,285,RepeatMasker,SINE,2051597,2051828,53,0.19
ptg001131l,2682361,2682664,303,RepeatMasker,SINE,2682469,2682704,196,0.65
ptg001131l,5986570,5986849,279,RepeatMasker,SINE,5986699,5986924,151,0.54
ptg001138l,1071379,1071659,280,RepeatMasker,SINE,1071573,1071627,55,0.20
ptg001154l,74149,74419,270,RepeatMasker,SINE,74231,74452,189,0.70
ptg001158l,438223,438514,291,RepeatMasker,SINE,438035,438257,34,0.12
ptg001177l,401016,401304,288,RepeatMasker,SINE,400928,401055,39,0.14
ptg001239l,2013897,2014222,325,RepeatMasker,SINE,2013865,2013967,70,0.22
ptg001244l,2262875,2263168,293,RepeatMasker,SINE,2263138,2263286,31,0.11
ptg001251l,1011884,1012176,292,RepeatMasker,SINE,1011960,1012140,181,0.62
ptg001251l,1011884,1012176,292,RepeatMasker,SINE,1012012,1012144,133,0.46
ptg001266l,293324,293610,286,RepeatMasker,SINE,293435,293647,176,0.62
ptg001270l,2592877,2593164,287,RepeatMasker,SINE,2593023,2593145,123,0.43
ptg001272l,1249,1528,279,RepeatMasker,SINE,1369,1440,72,0.26
ptg001279l,4039873,4040159,286,RepeatMasker,SINE,4040117,4040328,43,0.15
ptg001299l,162724,163001,277,RepeatMasker,SINE,162732,162807,76,0.27
ptg001299l,162724,163001,277,RepeatMasker,SINE,162732,162863,132,0.48
ptg001302l,1836042,1836381,339,RepeatMasker,SINE,1836116,1836335,220,0.65
ptg001302l,1836042,1836381,339,RepeatMasker,SINE,1836380,1836465,2,0.01
ptg001317l,2181550,2181817,267,RepeatMasker,SINE,2181504,2181624,74,0.28
ptg001317l,2181550,2181817,267,RepeatMasker,SINE,2181530,2181627,77,0.29
ptg001339l,666722,667037,315,RepeatMasker,SINE,666845,666976,132,0.42
ptg001339l,666722,667037,315,RepeatMasker,SINE,666998,667211,40,0.13
ptg001341l,958475,958770,295,RepeatMasker,SINE,958729,958958,42,0.14
ptg001341l,1610820,1611103,283,RepeatMasker,SINE,1610740,1610871,51,0.18
ptg001348l,1583236,1583535,299,RepeatMasker,SINE,1583202,1583285,49,0.16
ptg001348l,1583236,1583535,299,RepeatMasker,SINE,1583407,1583571,129,0.43
ptg001351l,2640630,2640921,291,RepeatMasker,SINE,2640598,2640663,33,0.11
ptg001352l,2543067,2543342,275,RepeatMasker,SINE,2542991,2543104,37,0.13
ptg001361l,1009579,1009894,315,RepeatMasker,SINE,1009724,1009941,171,0.54
ptg001369l,1579479,1579804,325,RepeatMasker,SINE,1579760,1579996,45,0.14
ptg001400l,1237452,1237764,312,RepeatMasker,SINE,1237253,1237489,37,0.12
ptg001407l,456988,457309,321,RepeatMasker,SINE,457135,457250,116,0.36
ptg001424l,3830563,3830890,327,RepeatMasker,SINE,3830851,3830985,40,0.12
ptg001424l,3830563,3830890,327,RepeatMasker,SINE,3830873,3830985,18,0.06
ptg001428l,488299,488618,319,RepeatMasker,SINE,488593,488709,26,0.08
ptg001428l,488299,488618,319,RepeatMasker,SINE,488598,488692,21,0.07
ptg001448l,112499,112803,304,RepeatMasker,SINE,112771,112977,33,0.11
ptg001451l,2168588,2168904,316,RepeatMasker,SINE,2168826,2168983,79,0.25
ptg001483l,1845152,1845492,340,RepeatMasker,SINE,1845124,1845335,183,0.54
ptg001524l,335028,335313,285,RepeatMasker,SINE,335284,335473,30,0.11
ptg001536l,90125,90441,316,RepeatMasker,SINE,90092,90296,171,0.54
ptg001541l,189993,190271,278,RepeatMasker,SINE,189959,190062,69,0.25
ptg001560l,738345,738628,283,RepeatMasker,SINE,738532,738664,97,0.34
ptg001563l,376647,376956,309,RepeatMasker,SINE,376686,376827,142,0.46
ptg001567l,1141156,1141462,306,RepeatMasker,SINE,1141094,1141192,36,0.12
ptg001579l,3667160,3667455,295,RepeatMasker,SINE,3667089,3667193,33,0.11
ptg001586l,891417,891725,308,RepeatMasker,SINE,891221,891454,37,0.12
ptg001611l,663060,663353,293,RepeatMasker,SINE,663314,663461,40,0.14
ptg001617l,1375383,1375685,302,RepeatMasker,SINE,1375183,1375420,37,0.12
ptg001628l,685708,685999,291,RepeatMasker,SINE,685925,686099,75,0.26
ptg001641l,2229070,2229389,319,RepeatMasker,SINE,2229301,2229434,89,0.28
ptg001643l,2288778,2289072,294,RepeatMasker,SINE,2289030,2289170,43,0.15
ptg001648l,238772,239069,297,RepeatMasker,SINE,238985,239100,85,0.29
ptg001649l,479357,479665,308,RepeatMasker,SINE,479425,479549,125,0.41
ptg001649l,479357,479665,308,RepeatMasker,SINE,479473,479549,77,0.25
ptg001666l,687250,687557,307,RepeatMasker,SINE,687282,687437,156,0.51
ptg001666l,687250,687557,307,RepeatMasker,SINE,687304,687436,133,0.43
ptg001681l,3425393,3425728,335,RepeatMasker,SINE,3425514,3425626,113,0.34
ptg001687l,4173384,4173702,318,RepeatMasker,SINE,4173646,4173774,57,0.18
ptg001716l,520397,520708,311,RepeatMasker,SINE,520708,520832,1,0.00
ptg001752l,1385490,1385816,326,RepeatMasker,SINE,1385713,1385856,104,0.32
ptg001773l,707774,708066,292,RepeatMasker,SINE,707872,708103,195,0.67
ptg001780l,2095965,2096274,309,RepeatMasker,SINE,2095935,2096104,139,0.45
ptg001814l,4528511,4528816,305,RepeatMasker,SINE,4528479,4528719,208,0.68
ptg001830l,425174,425482,308,RepeatMasker,SINE,425043,425211,37,0.12
ptg001835l,1062173,1062504,331,RepeatMasker,SINE,1062121,1062204,31,0.09
ptg001836l,53333,53629,296,RepeatMasker,SINE,53173,53339,6,0.02
ptg001851l,4861374,4861684,310,RepeatMasker,SINE,4861180,4861406,32,0.10
ptg001863l,9958499,9958790,291,RepeatMasker,SINE,9958750,9958911,41,0.14
ptg001866l,104461,104793,332,RepeatMasker,SINE,104700,104779,80,0.24
ptg001867l,1240229,1240531,302,RepeatMasker,SINE,1240050,1240260,31,0.10
ptg001872l,1166629,1166954,325,RepeatMasker,SINE,1166581,1166694,65,0.20
ptg001899l,4278062,4278340,278,RepeatMasker,SINE,4278028,4278256,194,0.70
ptg001912l,2138859,2139161,302,RepeatMasker,SINE,2139152,2139309,10,0.03
ptg001916l,296808,297095,287,RepeatMasker,SINE,297058,297214,38,0.13
ptg001921l,1283076,1283348,272,RepeatMasker,SINE,1283056,1283156,80,0.29
ptg001936l,5255222,5255519,297,RepeatMasker,SINE,5255138,5255298,76,0.26
ptg001936l,5255222,5255519,297,RepeatMasker,SINE,5255180,5255284,62,0.21
ptg001936l,5719942,5720202,260,RepeatMasker,SINE,5720152,5720281,51,0.20
ptg001959l,2940938,2941243,305,RepeatMasker,SINE,2940995,2941130,136,0.45
ptg001993l,1620565,1620846,281,RepeatMasker,SINE,1620370,1620598,33,0.12
ptg002022l,4285662,4285981,319,RepeatMasker,SINE,4285628,4285736,74,0.23
ptg002043l,4740889,4741174,285,RepeatMasker,SINE,4741085,4741136,52,0.18
ptg002051l,1763387,1763707,320,RepeatMasker,SINE,1763513,1763740,195,0.61
ptg002085l,7158892,7159172,280,RepeatMasker,SINE,7158710,7158922,30,0.11
ptg002118l,1480505,1480795,290,RepeatMasker,SINE,1480509,1480660,152,0.52
ptg002118l,1480505,1480795,290,RepeatMasker,SINE,1480532,1480663,132,0.46
ptg002163l,1551389,1551689,300,RepeatMasker,SINE,1551191,1551421,32,0.11
ptg002173l,2960829,2961126,297,RepeatMasker,SINE,2960801,2960981,152,0.51
ptg002173l,5174434,5174714,280,RepeatMasker,SINE,5174354,5174485,51,0.18
ptg002187l,210519,210815,296,RepeatMasker,SINE,210370,210559,40,0.14
ptg002193l,2640858,2641144,286,RepeatMasker,SINE,2641112,2641318,33,0.12
ptg002249l,2068019,2068344,325,RepeatMasker,SINE,2067987,2068158,139,0.43
ptg002274l,345186,345510,324,RepeatMasker,SINE,345310,345459,150,0.46
ptg002315l,1276950,1277268,318,RepeatMasker,SINE,1277226,1277460,43,0.14
ptg002315l,1608138,1608439,301,RepeatMasker,SINE,1608094,1608220,82,0.27
ptg002347l,3341066,3341359,293,RepeatMasker,SINE,3341042,3341269,203,0.69
ptg002363l,291073,291375,302,RepeatMasker,SINE,291180,291425,196,0.65
ptg002409l,1825596,1825883,287,RepeatMasker,SINE,1825698,1825836,139,0.48
ptg002456l,1628004,1628306,302,RepeatMasker,SINE,1628162,1628349,145,0.48
ptg002476l,102329,102587,258,RepeatMasker,SINE,102557,102748,31,0.12
ptg002499l,2676563,2676870,307,RepeatMasker,SINE,2676832,2677038,39,0.13
ptg002512l,737893,738206,313,RepeatMasker,SINE,737861,737995,102,0.33
ptg002565l,1536675,1536940,265,RepeatMasker,SINE,1536620,1536725,50,0.19
ptg002565l,1536675,1536940,265,RepeatMasker,SINE,1536635,1536740,65,0.25
ptg002572l,187192,187488,296,RepeatMasker,SINE,187160,187389,197,0.67
ptg002583l,798929,799207,278,RepeatMasker,SINE,799028,799108,81,0.29
ptg002594l,2555543,2555846,303,RepeatMasker,SINE,2555375,2555571,28,0.09
ptg002598l,885120,885450,330,RepeatMasker,SINE,885231,885336,106,0.32
ptg002621l,2296610,2296924,314,RepeatMasker,SINE,2296758,2296961,167,0.53
ptg002621l,3172286,3172589,303,RepeatMasker,SINE,3172446,3172615,144,0.48
ptg002621l,3172286,3172589,303,RepeatMasker,SINE,3172501,3172615,89,0.29
ptg002682l,271990,272289,299,RepeatMasker,SINE,271915,272185,195,0.65
ptg002682l,271990,272289,299,RepeatMasker,SINE,271963,272192,202,0.68
ptg002697l,1018226,1018554,328,RepeatMasker,SINE,1018554,1018595,1,0.00
ptg002721l,1962475,1962807,332,RepeatMasker,SINE,1962453,1962673,198,0.60
ptg002732l,5652249,5652585,336,RepeatMasker,SINE,5652544,5652625,42,0.13
ptg002741l,2850856,2851150,294,RepeatMasker,SINE,2850837,2850886,30,0.10
ptg002749l,253473,253781,308,RepeatMasker,SINE,253445,253665,192,0.62
ptg002809l,1294789,1295090,301,RepeatMasker,SINE,1294738,1294822,33,0.11
ptg002825l,554567,554888,321,RepeatMasker,SINE,554594,554769,176,0.55
ptg002825l,554567,554888,321,RepeatMasker,SINE,554642,554769,128,0.40
ptg002825l,554567,554888,321,RepeatMasker,SINE,554853,555019,36,0.11
ptg002842l,457441,457766,325,RepeatMasker,SINE,457733,457902,34,0.10
ptg002854l,105359,105686,327,RepeatMasker,SINE,105171,105396,37,0.11
ptg002864l,999926,1000218,292,RepeatMasker,SINE,999895,1000111,185,0.63
ptg002874l,516327,516603,276,RepeatMasker,SINE,516294,516357,30,0.11
ptg002891l,1893488,1893809,321,RepeatMasker,SINE,1893698,1893847,112,0.35
ptg002894l,601089,601373,284,RepeatMasker,SINE,601289,601400,85,0.30
ptg002895l,466324,466643,319,RepeatMasker,SINE,466451,466684,193,0.61
ptg002911l,463019,463328,309,RepeatMasker,SINE,463250,463324,75,0.24
ptg002963l,500153,500439,286,RepeatMasker,SINE,500123,500176,23,0.08
ptg002976l,2377550,2377846,296,RepeatMasker,SINE,2377481,2377571,21,0.07
ptg002983l,2108036,2108361,325,RepeatMasker,SINE,2108003,2108084,48,0.15
ptg002983l,2108036,2108361,325,RepeatMasker,SINE,2108094,2108177,84,0.26
ptg002983l,2108036,2108361,325,RepeatMasker,SINE,2108097,2108235,139,0.43
ptg003025l,1008842,1009096,254,RepeatMasker,SINE,1008928,1009119,169,0.67
ptg003027l,62080,62372,292,RepeatMasker,SINE,62093,62323,231,0.79
ptg003030l,1133820,1134117,297,RepeatMasker,SINE,1133789,1133854,34,0.11
ptg003045l,390405,390733,328,RepeatMasker,SINE,390217,390432,27,0.08
ptg003081l,5082999,5083289,290,RepeatMasker,SINE,5082969,5083192,193,0.67
ptg003137l,655744,656024,280,RepeatMasker,SINE,655659,655791,47,0.17
ptg003138l,1452782,1453114,332,RepeatMasker,SINE,1452938,1453146,177,0.53
ptg003139l,86953,87245,292,RepeatMasker,SINE,87211,87441,35,0.12
ptg003145l,2567812,2568096,284,RepeatMasker,SINE,2567620,2567849,37,0.13
ptg003171l,511074,511362,288,RepeatMasker,SINE,511040,511151,77,0.27
ptg003176l,2220200,2220498,298,RepeatMasker,SINE,2220190,2220230,30,0.10
ptg003204l,1580151,1580458,307,RepeatMasker,SINE,1580168,1580326,159,0.52
ptg003204l,1580151,1580458,307,RepeatMasker,SINE,1580198,1580328,131,0.43
ptg003209l,286068,286386,318,RepeatMasker,SINE,285890,286084,16,0.05
ptg003217l,410444,410730,286,RepeatMasker,SINE,410602,410763,129,0.45
ptg003224l,1453377,1453661,284,RepeatMasker,SINE,1453585,1453675,77,0.27
ptg003268l,394690,395018,328,RepeatMasker,SINE,394867,395046,152,0.46
ptg003276l,959563,959851,288,RepeatMasker,SINE,959674,959886,178,0.62
ptg003286l,1271614,1271918,304,RepeatMasker,SINE,1271765,1271896,132,0.43
ptg003311l,713655,713961,306,RepeatMasker,SINE,713839,713998,123,0.40
ptg003348l,50467,50774,307,RepeatMasker,SINE,50663,50815,112,0.36
ptg003348l,50467,50774,307,RepeatMasker,SINE,50686,50818,89,0.29
ptg003355l,942257,942585,328,RepeatMasker,SINE,942059,942289,32,0.10
ptg003364l,2419869,2420153,284,RepeatMasker,SINE,2419941,2419994,54,0.19
ptg003367l,1810629,1810897,268,RepeatMasker,SINE,1810800,1810929,98,0.37
ptg003379l,30966,31271,305,RepeatMasker,SINE,31203,31258,56,0.18
ptg003381l,800370,800692,322,RepeatMasker,SINE,800516,800733,177,0.55
ptg003383l,522238,522530,292,RepeatMasker,SINE,522067,522275,37,0.13
ptg003410l,1075651,1075986,335,RepeatMasker,SINE,1075957,1076076,30,0.09
ptg003410l,1075651,1075986,335,RepeatMasker,SINE,1075957,1076091,30,0.09
ptg003441l,797892,798176,284,RepeatMasker,SINE,797998,798209,179,0.63
ptg003445l,178045,178341,296,RepeatMasker,SINE,178304,178513,38,0.13
ptg003472l,2595476,2595752,276,RepeatMasker,SINE,2595401,2595512,36,0.13
ptg003474l,2993960,2994263,303,RepeatMasker,SINE,2994067,2994137,71,0.23
ptg003482l,1386424,1386722,298,RepeatMasker,SINE,1386390,1386455,31,0.10
ptg003486l,1801165,1801480,315,RepeatMasker,SINE,1801453,1801581,28,0.09
ptg003504l,347335,347616,281,RepeatMasker,SINE,347394,347531,138,0.49
ptg003517l,2081105,2081391,286,RepeatMasker,SINE,2080965,2081143,38,0.13
ptg003524l,2682196,2682537,341,RepeatMasker,SINE,2682239,2682404,166,0.49
ptg003524l,2682196,2682537,341,RepeatMasker,SINE,2682276,2682407,132,0.39
ptg003537l,579437,579757,320,RepeatMasker,SINE,579236,579470,33,0.10
ptg003561l,1607958,1608274,316,RepeatMasker,SINE,1607917,1608159,201,0.64
ptg003569l,400744,401020,276,RepeatMasker,SINE,400675,400781,37,0.13
ptg003634l,4011862,4012178,316,RepeatMasker,SINE,4012127,4012230,52,0.16
ptg003634l,9724469,9724810,341,RepeatMasker,SINE,9724561,9724689,129,0.38
ptg003652l,2334578,2334860,282,RepeatMasker,SINE,2334555,2334781,203,0.72
ptg003683l,322712,322996,284,RepeatMasker,SINE,322893,323023,104,0.37
ptg003719l,746181,746471,290,RepeatMasker,SINE,746161,746360,179,0.62
ptg003720l,2701818,2702105,287,RepeatMasker,SINE,2701786,2701836,18,0.06
ptg003720l,5754641,5754948,307,RepeatMasker,SINE,5754757,5754979,192,0.63
ptg003721l,1040998,1041337,339,RepeatMasker,SINE,1041016,1041148,133,0.39
ptg003722l,3826135,3826470,335,RepeatMasker,SINE,3826172,3826332,161,0.48
ptg003722l,3826135,3826470,335,RepeatMasker,SINE,3826202,3826336,135,0.40
ptg003722l,4485760,4486053,293,RepeatMasker,SINE,4485727,4485838,78,0.27
ptg003767l,1154971,1155297,326,RepeatMasker,SINE,1154937,1155040,69,0.21
ptg003795l,706154,706454,300,RepeatMasker,SINE,706078,706191,37,0.12
ptg003829l,305756,306081,325,RepeatMasker,SINE,305810,306023,214,0.66
ptg003830l,2199684,2199978,294,RepeatMasker,SINE,2199781,2200014,198,0.67
ptg003841l,1516196,1516491,295,RepeatMasker,SINE,1515990,1516229,33,0.11
ptg003853l,2287513,2287822,309,RepeatMasker,SINE,2287484,2287710,197,0.64
ptg003873l,2354141,2354459,318,RepeatMasker,SINE,2353948,2354178,37,0.12
ptg003887l,1190950,1191281,331,RepeatMasker,SINE,1191246,1191355,36,0.11
ptg003894l,1895893,1896175,282,RepeatMasker,SINE,1895916,1896119,204,0.72
ptg003895l,2855338,2855663,325,RepeatMasker,SINE,2855157,2855375,37,0.11
ptg003897l,2965139,2965461,322,RepeatMasker,SINE,2965407,2965511,55,0.17
ptg003897l,2965139,2965461,322,RepeatMasker,SINE,2965426,2965581,36,0.11
ptg003901l,27774,28084,310,RepeatMasker,SINE,27744,27827,53,0.17
ptg003923l,398389,398660,271,RepeatMasker,SINE,398643,398778,18,0.07
ptg003935l,55503,55800,297,RepeatMasker,SINE,55316,55534,31,0.10
ptg003941l,532458,532767,309,RepeatMasker,SINE,532595,532778,173,0.56
ptg003941l,532458,532767,309,RepeatMasker,SINE,532767,532839,1,0.00
ptg003945l,287438,287759,321,RepeatMasker,SINE,287736,287793,24,0.07
ptg003954l,316171,316495,324,RepeatMasker,SINE,315976,316206,35,0.11
ptg003975l,1853355,1853684,329,RepeatMasker,SINE,1853385,1853571,187,0.57
ptg003975l,1853355,1853684,329,RepeatMasker,SINE,1853438,1853570,133,0.40
ptg004008l,413193,413509,316,RepeatMasker,SINE,413377,413535,133,0.42
ptg004023l,2604898,2605178,280,RepeatMasker,SINE,2604719,2604930,32,0.11
ptg004026l,328986,329288,302,RepeatMasker,SINE,328913,329010,24,0.08
ptg004038l,4442187,4442514,327,RepeatMasker,SINE,4442465,4442598,50,0.15
ptg004071l,24382,24660,278,RepeatMasker,SINE,24584,24801,77,0.28
ptg004109l,3558616,3558923,307,RepeatMasker,SINE,3558624,3558670,47,0.15
ptg004119l,1072870,1073171,301,RepeatMasker,SINE,1073131,1073353,41,0.14
ptg004120l,1368396,1368683,287,RepeatMasker,SINE,1368411,1368600,190,0.66
ptg004120l,1368396,1368683,287,RepeatMasker,SINE,1368472,1368599,128,0.45
ptg004133l,2602306,2602621,315,RepeatMasker,SINE,2602506,2602653,116,0.37
ptg004162l,1672362,1672637,275,RepeatMasker,SINE,1672338,1672434,72,0.26
ptg004162l,1672362,1672637,275,RepeatMasker,SINE,1672436,1672674,202,0.73
ptg004162l,3682861,3683147,286,RepeatMasker,SINE,3683100,3683299,48,0.17
ptg004199l,2145005,2145334,329,RepeatMasker,SINE,2145050,2145184,135,0.41
ptg004199l,2145005,2145334,329,RepeatMasker,SINE,2145060,2145208,149,0.45
ptg004200l,1420152,1420487,335,RepeatMasker,SINE,1420343,1420560,145,0.43
ptg004233l,25952,26235,283,RepeatMasker,SINE,26124,26255,112,0.40
ptg004233l,3349661,3349973,312,RepeatMasker,SINE,3349477,3349694,33,0.11
ptg004271l,2015879,2016215,336,RepeatMasker,SINE,2016037,2016245,179,0.53
ptg004277l,2864452,2864764,312,RepeatMasker,SINE,2864524,2864648,125,0.40
ptg004277l,2864452,2864764,312,RepeatMasker,SINE,2864572,2864648,77,0.25
ptg004303l,2030259,2030547,288,RepeatMasker,SINE,2030264,2030395,132,0.46
ptg004303l,3103290,3103619,329,RepeatMasker,SINE,3103575,3103677,45,0.14
ptg004311l,813184,813477,293,RepeatMasker,SINE,813320,813442,123,0.42
ptg004379l,768704,769019,315,RepeatMasker,SINE,768969,769096,51,0.16
ptg004387l,165567,165847,280,RepeatMasker,SINE,165365,165604,37,0.13
ptg004399l,1470406,1470700,294,RepeatMasker,SINE,1470354,1470435,29,0.10
ptg004425l,660700,660993,293,RepeatMasker,SINE,660898,661025,96,0.33
ptg004428l,2736751,2737033,282,RepeatMasker,SINE,2736854,2737071,180,0.64
ptg004449l,83376,83689,313,RepeatMasker,SINE,83515,83670,156,0.50
ptg004449l,86356,86658,302,RepeatMasker,SINE,86482,86697,177,0.59
ptg004454l,181898,182210,312,RepeatMasker,SINE,182018,182075,58,0.19
ptg004472l,716369,716670,301,RepeatMasker,SINE,716631,716863,40,0.13
ptg004490l,1008265,1008593,328,RepeatMasker,SINE,1008063,1008300,35,0.11
ptg004495l,3623137,3623419,282,RepeatMasker,SINE,3623203,3623259,57,0.20
ptg004495l,3623137,3623419,282,RepeatMasker,SINE,3623275,3623383,109,0.39
ptg004495l,3623137,3623419,282,RepeatMasker,SINE,3623397,3623478,23,0.08
ptg004501l,1089401,1089686,285,RepeatMasker,SINE,1089646,1089872,41,0.14
ptg004501l,1089401,1089686,285,RepeatMasker,SINE,1089651,1089943,36,0.13
ptg004535l,1260866,1261142,276,RepeatMasker,SINE,1261108,1261313,35,0.13
ptg004544l,4946387,4946693,306,RepeatMasker,SINE,4946360,4946587,200,0.65
ptg004554l,1217834,1218114,280,RepeatMasker,SINE,1217690,1217841,7,0.03
ptg004567l,4638471,4638803,332,RepeatMasker,SINE,4638268,4638508,37,0.11
ptg004567l,4638471,4638803,332,RepeatMasker,SINE,4638547,4638665,119,0.36
ptg004627l,167138,167401,263,RepeatMasker,SINE,167104,167338,200,0.76
ptg004639l,2193828,2194137,309,RepeatMasker,SINE,2194103,2194330,35,0.11
ptg004661l,2338103,2338396,293,RepeatMasker,SINE,2337911,2338138,35,0.12
ptg004661l,2338103,2338396,293,RepeatMasker,SINE,2337919,2338191,88,0.30
ptg004723l,1621635,1621957,322,RepeatMasker,SINE,1621925,1622115,33,0.10
ptg004752l,3920672,3920972,300,RepeatMasker,SINE,3920933,3920998,40,0.13
ptg004763l,3579535,3579849,314,RepeatMasker,SINE,3579656,3579880,194,0.62
ptg004782l,6614926,6615260,334,RepeatMasker,SINE,6615009,6615224,216,0.65
ptg004830l,1055404,1055691,287,RepeatMasker,SINE,1055511,1055614,104,0.36
ptg004873l,1870734,1871060,326,RepeatMasker,SINE,1870858,1870994,137,0.42
ptg004873l,1870734,1871060,326,RepeatMasker,SINE,1870903,1871007,105,0.32
ptg004923l,3452852,3453133,281,RepeatMasker,SINE,3452807,3452940,88,0.31
ptg004933l,1008863,1009194,331,RepeatMasker,SINE,1008667,1008896,33,0.10
ptg004971l,230649,230943,294,RepeatMasker,SINE,230753,230884,132,0.45
ptg004984l,248116,248441,325,RepeatMasker,SINE,248266,248483,176,0.54
ptg004984l,464506,464817,311,RepeatMasker,SINE,464627,464852,191,0.61
ptg005032l,76526,76849,323,RepeatMasker,SINE,76329,76561,35,0.11
ptg005048l,434321,434640,319,RepeatMasker,SINE,434289,434458,137,0.43
ptg005061l,1966009,1966288,279,RepeatMasker,SINE,1966287,1966353,2,0.01
ptg005085l,657372,657675,303,RepeatMasker,SINE,657287,657419,47,0.16
ptg005144l,682096,682397,301,RepeatMasker,SINE,682017,682147,51,0.17
ptg005144l,682096,682397,301,RepeatMasker,SINE,682017,682176,80,0.27
ptg005152l,50472,50758,286,RepeatMasker,SINE,50303,50502,30,0.10
ptg005152l,50472,50758,286,RepeatMasker,SINE,50303,50539,67,0.23
ptg005187l,1039668,1039967,299,RepeatMasker,SINE,1039480,1039710,42,0.14
ptg005199l,38303,38590,287,RepeatMasker,SINE,38118,38338,35,0.12
ptg005245l,395900,396176,276,RepeatMasker,SINE,395866,395984,84,0.30
ptg005245l,395900,396176,276,RepeatMasker,SINE,396067,396221,110,0.40
ptg005250l,1629897,1630195,298,RepeatMasker,SINE,1629870,1630100,203,0.68
ptg005257l,1792125,1792412,287,RepeatMasker,SINE,1792172,1792208,37,0.13
ptg005296l,208050,208364,314,RepeatMasker,SINE,207853,208090,40,0.13
ptg005354l,1986541,1986870,329,RepeatMasker,SINE,1986508,1986612,71,0.22
ptg005356l,2671832,2672106,274,RepeatMasker,SINE,2671682,2671870,38,0.14
ptg005361l,439397,439682,285,RepeatMasker,SINE,439550,439708,133,0.47
ptg005361l,439397,439682,285,RepeatMasker,SINE,439594,439713,89,0.31
ptg005364l,666959,667280,321,RepeatMasker,SINE,666944,667138,179,0.56
ptg005371l,3019023,3019352,329,RepeatMasker,SINE,3018990,3019060,37,0.11
ptg005403l,2727790,2728074,284,RepeatMasker,SINE,2727830,2727946,117,0.41
ptg005403l,2727790,2728074,284,RepeatMasker,SINE,2728002,2728128,73,0.26
ptg005403l,2727790,2728074,284,RepeatMasker,SINE,2728034,2728164,41,0.14
ptg005404l,708326,708648,322,RepeatMasker,SINE,708474,708688,175,0.54
ptg005421l,396959,397266,307,RepeatMasker,SINE,396997,397138,142,0.46
ptg005421l,396959,397266,307,RepeatMasker,SINE,397048,397135,88,0.29
ptg005422l,1768763,1769065,302,RepeatMasker,SINE,1768745,1768791,28,0.09
ptg005441l,367823,368116,293,RepeatMasker,SINE,367625,367858,35,0.12
ptg005441l,367823,368116,293,RepeatMasker,SINE,367948,368108,161,0.55
ptg005441l,367823,368116,293,RepeatMasker,SINE,367998,368113,116,0.40
ptg005446l,1892051,1892334,283,RepeatMasker,SINE,1892080,1892246,167,0.59
ptg005446l,1892051,1892334,283,RepeatMasker,SINE,1892132,1892248,117,0.41
ptg005471l,3698157,3698480,323,RepeatMasker,SINE,3698328,3698454,127,0.39
ptg005471l,3698157,3698480,323,RepeatMasker,SINE,3698373,3698454,82,0.25
ptg005476l,2589978,2590268,290,RepeatMasker,SINE,2589782,2590012,34,0.12
ptg005483l,1334198,1334513,315,RepeatMasker,SINE,1334251,1334382,132,0.42
ptg005498l,636895,637177,282,RepeatMasker,SINE,636980,637213,198,0.70
ptg005508l,5560547,5560860,313,RepeatMasker,SINE,5560651,5560782,132,0.42
ptg005522l,797069,797349,280,RepeatMasker,SINE,797176,797372,174,0.62
ptg005522l,797069,797349,280,RepeatMasker,SINE,797225,797386,125,0.45
ptg005532l,2506089,2506401,312,RepeatMasker,SINE,2506162,2506285,124,0.40
ptg005532l,2506089,2506401,312,RepeatMasker,SINE,2506209,2506285,77,0.25
ptg005552l,1854297,1854586,289,RepeatMasker,SINE,1854265,1854354,57,0.20
ptg005554l,1775884,1776176,292,RepeatMasker,SINE,1775807,1775961,77,0.26
ptg005554l,1775884,1776176,292,RepeatMasker,SINE,1775836,1775961,77,0.26
ptg005558l,959367,959658,291,RepeatMasker,SINE,959171,959402,35,0.12
ptg005564l,269622,269948,326,RepeatMasker,SINE,269740,269831,92,0.28
ptg005564l,269622,269948,326,RepeatMasker,SINE,269760,269846,87,0.27
ptg005564l,269622,269948,326,RepeatMasker,SINE,269771,269850,80,0.25
ptg005629l,2263976,2264278,302,RepeatMasker,SINE,2263943,2264174,198,0.66
ptg005629l,2263976,2264284,308,RepeatMasker,SINE,2263943,2264174,198,0.64
ptg005695l,1528326,1528626,300,RepeatMasker,SINE,1528437,1528665,190,0.63
ptg005714l,1451216,1451549,333,RepeatMasker,SINE,1451518,1451636,32,0.10
ptg005714l,1451216,1451549,333,RepeatMasker,SINE,1451521,1451673,29,0.09
ptg005722l,1138234,1138532,298,RepeatMasker,SINE,1138486,1138681,47,0.16
ptg005741l,422106,422440,334,RepeatMasker,SINE,422077,422112,6,0.02
ptg005769l,648793,649092,299,RepeatMasker,SINE,648759,648989,196,0.66
ptg005772l,1488718,1489019,301,RepeatMasker,SINE,1488811,1488959,149,0.50
ptg005772l,1488718,1489019,301,RepeatMasker,SINE,1488830,1488961,132,0.44
ptg005777l,193481,193812,331,RepeatMasker,SINE,193708,193758,51,0.15
ptg005816l,1270979,1271271,292,RepeatMasker,SINE,1270949,1271164,185,0.63
ptg005822l,3625359,3625619,260,RepeatMasker,SINE,3625312,3625396,37,0.14
ptg005834l,68909,69208,299,RepeatMasker,SINE,68870,68994,85,0.28
ptg005842l,2758720,2759056,336,RepeatMasker,SINE,2758676,2758809,89,0.26
ptg005876l,1244089,1244374,285,RepeatMasker,SINE,1244044,1244176,87,0.31
ptg005893l,725396,725709,313,RepeatMasker,SINE,725203,725433,37,0.12
ptg005904l,664010,664340,330,RepeatMasker,SINE,664307,664521,34,0.10
ptg005904l,2231722,2231987,265,RepeatMasker,SINE,2231695,2231755,33,0.12
ptg005928l,202396,202699,303,RepeatMasker,SINE,202418,202606,189,0.62
ptg005928l,202396,202699,303,RepeatMasker,SINE,202472,202595,124,0.41
ptg005950l,1261273,1261584,311,RepeatMasker,SINE,1261540,1261763,45,0.14
ptg005954l,1878466,1878764,298,RepeatMasker,SINE,1878514,1878625,112,0.38
ptg005954l,1878466,1878764,298,RepeatMasker,SINE,1878514,1878678,165,0.55
ptg005978l,1868219,1868512,293,RepeatMasker,SINE,1868381,1868493,113,0.39
ptg006015l,1970313,1970612,299,RepeatMasker,SINE,1970531,1970613,82,0.27
ptg006027l,2705342,2705625,283,RepeatMasker,SINE,2705389,2705436,48,0.17
ptg006051l,638373,638702,329,RepeatMasker,SINE,638169,638392,19,0.06
ptg006061l,314075,314349,274,RepeatMasker,SINE,313882,314112,37,0.14
ptg006090l,2003024,2003328,304,RepeatMasker,SINE,2003096,2003149,54,0.18
ptg006090l,2003024,2003328,304,RepeatMasker,SINE,2003258,2003334,71,0.23
ptg006110l,1329011,1329292,281,RepeatMasker,SINE,1329252,1329330,41,0.15
ptg006116l,1578545,1578853,308,RepeatMasker,SINE,1578515,1578733,188,0.61
ptg006197l,3608890,3609158,268,RepeatMasker,SINE,3609135,3609256,24,0.09
ptg006220l,199717,200021,304,RepeatMasker,SINE,199520,199747,30,0.10
ptg006220l,199717,200021,304,RepeatMasker,SINE,200015,200067,7,0.02
ptg006223l,31297,31583,286,RepeatMasker,SINE,31544,31760,40,0.14
ptg006242l,630641,630955,314,RepeatMasker,SINE,630818,630903,86,0.27
ptg006248l,132158,132468,310,RepeatMasker,SINE,132256,132365,110,0.35
ptg006248l,132158,132468,310,RepeatMasker,SINE,132404,132515,65,0.21
ptg006248l,183198,183480,282,RepeatMasker,SINE,183026,183228,30,0.11
ptg006277l,2013074,2013351,277,RepeatMasker,SINE,2013182,2013388,170,0.61
ptg006330l,603708,603970,262,RepeatMasker,SINE,603530,603745,37,0.14
ptg006334l,539583,539855,272,RepeatMasker,SINE,539829,540041,27,0.10
ptg006334l,592417,592740,323,RepeatMasker,SINE,592641,592786,100,0.31
ptg006335l,1135326,1135602,276,RepeatMasker,SINE,1135292,1135519,193,0.70
ptg006354l,612844,613132,288,RepeatMasker,SINE,612810,613049,205,0.71
ptg006354l,612844,613132,288,RepeatMasker,SINE,613042,613173,91,0.32
ptg006379l,948772,949058,286,RepeatMasker,SINE,948578,948802,30,0.10
ptg006405l,479490,479785,295,RepeatMasker,SINE,479293,479521,31,0.11
ptg006408l,2162290,2162578,288,RepeatMasker,SINE,2162484,2162624,95,0.33
ptg006412l,77586,77860,274,RepeatMasker,SINE,77654,77806,153,0.56
ptg006442l,1891491,1891807,316,RepeatMasker,SINE,1891463,1891526,35,0.11
ptg006454l,961299,961596,297,RepeatMasker,SINE,961426,961483,58,0.20
ptg006454l,961299,961596,297,RepeatMasker,SINE,961569,961655,28,0.09
ptg006455l,3039792,3040097,305,RepeatMasker,SINE,3039885,3040017,133,0.44
ptg006455l,3129911,3130201,290,RepeatMasker,SINE,3130105,3130238,97,0.33
ptg006465l,2251431,2251742,311,RepeatMasker,SINE,2251403,2251574,143,0.46
ptg006482l,2202260,2202573,313,RepeatMasker,SINE,2202060,2202296,36,0.12
ptg006488l,1331372,1331640,268,RepeatMasker,SINE,1331371,1331568,196,0.73
ptg006488l,2230574,2230887,313,RepeatMasker,SINE,2230499,2230611,37,0.12
ptg006488l,2230574,2230887,313,RepeatMasker,SINE,2230511,2230626,52,0.17
ptg006493l,1449997,1450249,252,RepeatMasker,SINE,1450163,1450275,87,0.35
ptg006494l,36455,36706,251,RepeatMasker,SINE,36532,36601,70,0.28
ptg006494l,440596,440890,294,RepeatMasker,SINE,440850,441076,41,0.14
ptg006513l,1132090,1132621,531,RepeatMasker,SINE,1132342,1132473,132,0.25
ptg006524l,2441800,2442092,292,RepeatMasker,SINE,2441919,2442051,133,0.46
ptg006524l,2651036,2651303,267,RepeatMasker,SINE,2651280,2651423,24,0.09
ptg006536l,1200506,1200794,288,RepeatMasker,SINE,1200354,1200541,35,0.12
ptg006541l,716768,717094,326,RepeatMasker,SINE,716912,717125,183,0.56
ptg006560l,173255,173550,295,RepeatMasker,SINE,173225,173278,23,0.08
ptg006567l,240215,240522,307,RepeatMasker,SINE,240397,240557,126,0.41
ptg006571l,278980,279296,316,RepeatMasker,SINE,279017,279100,84,0.27
ptg006588l,1532501,1532818,317,RepeatMasker,SINE,1532638,1532855,181,0.57
ptg006589l,1529572,1529872,300,RepeatMasker,SINE,1529377,1529607,35,0.12
ptg006615l,993321,993627,306,RepeatMasker,SINE,993287,993522,201,0.66
ptg006623l,4800962,4801242,280,RepeatMasker,SINE,4801183,4801276,60,0.21
ptg006634l,554841,555135,294,RepeatMasker,SINE,554745,554874,33,0.11
ptg006639l,3944119,3944404,285,RepeatMasker,SINE,3944150,3944337,188,0.66
ptg006639l,3944119,3944404,285,RepeatMasker,SINE,3944205,3944336,132,0.46
ptg006660l,3225164,3225466,302,RepeatMasker,SINE,3225343,3225490,124,0.41
ptg006703l,3935011,3935322,311,RepeatMasker,SINE,3935311,3935456,12,0.04
ptg006734l,815885,816178,293,RepeatMasker,SINE,816057,816179,122,0.42
ptg006745l,833049,833375,326,RepeatMasker,SINE,833346,833416,30,0.09
ptg006748l,344104,344405,301,RepeatMasker,SINE,344256,344483,150,0.50
ptg006773l,173066,173389,323,RepeatMasker,SINE,173164,173225,62,0.19
ptg006788l,491868,492172,304,RepeatMasker,SINE,492049,492198,124,0.41
ptg006788l,5554309,5554592,283,RepeatMasker,SINE,5554562,5554736,31,0.11
ptg006809l,357605,357893,288,RepeatMasker,SINE,357770,357930,124,0.43
ptg006809l,357605,357893,288,RepeatMasker,SINE,357801,357930,93,0.32
ptg006817l,1774221,1774520,299,RepeatMasker,SINE,1774186,1774251,30,0.10
ptg006838l,1860298,1860564,266,RepeatMasker,SINE,1860322,1860545,224,0.84
ptg006858l,2406215,2406494,279,RepeatMasker,SINE,2406064,2406248,33,0.12
ptg006860l,724965,725255,290,RepeatMasker,SINE,724941,725045,80,0.28
ptg006909l,145072,145389,317,RepeatMasker,SINE,144996,145122,50,0.16
ptg006909l,145072,145389,317,RepeatMasker,SINE,144996,145155,83,0.26
ptg006921l,1872464,1872794,330,RepeatMasker,SINE,1872497,1872730,234,0.71
ptg006939l,1013938,1014238,300,RepeatMasker,SINE,1014157,1014227,71,0.24
ptg006949l,4201687,4201979,292,RepeatMasker,SINE,4201653,4201740,53,0.18
ptg006956l,531617,531941,324,RepeatMasker,SINE,531619,531705,87,0.27
ptg006979l,662304,662596,292,RepeatMasker,SINE,662555,662612,42,0.14
ptg006981l,822025,822342,317,RepeatMasker,SINE,822034,822166,133,0.42
ptg007003l,58295,58635,340,RepeatMasker,SINE,58544,58678,92,0.27
ptg007007l,1947924,1948221,297,RepeatMasker,SINE,1947729,1947957,33,0.11
ptg007015l,68230,68521,291,RepeatMasker,SINE,68179,68267,37,0.13
ptg007017l,6473937,6474235,298,RepeatMasker,SINE,6473741,6473971,34,0.11
ptg007049l,1870331,1870650,319,RepeatMasker,SINE,1870138,1870368,37,0.12
ptg007065l,436610,436930,320,RepeatMasker,SINE,436808,436967,123,0.38
ptg007076l,605790,606100,310,RepeatMasker,SINE,606061,606285,40,0.13
ptg007099l,93938,94236,298,RepeatMasker,SINE,94193,94398,44,0.15
ptg007099l,639521,639776,255,RepeatMasker,SINE,639576,639726,151,0.59
ptg007136l,78072,78405,333,RepeatMasker,SINE,78038,78235,163,0.49
ptg007136l,78072,78405,333,RepeatMasker,SINE,78366,78577,40,0.12
ptg007143l,6276947,6277241,294,RepeatMasker,SINE,6277174,6277290,68,0.23
ptg007149l,558753,559051,298,RepeatMasker,SINE,558677,558794,41,0.14
ptg007160l,250730,251011,281,RepeatMasker,SINE,250659,250763,33,0.12
ptg007197l,251993,252275,282,RepeatMasker,SINE,252114,252234,121,0.43
ptg007216l,2512606,2512932,326,RepeatMasker,SINE,2512577,2512751,145,0.44
ptg007250l,1510504,1510789,285,RepeatMasker,SINE,1510742,1510873,48,0.17
ptg007250l,1510504,1510789,285,RepeatMasker,SINE,1510745,1510895,45,0.16
ptg007261l,498821,499139,318,RepeatMasker,SINE,498787,498876,55,0.17
ptg007276l,3002199,3002478,279,RepeatMasker,SINE,3002288,3002526,191,0.68
ptg007277l,2229777,2230074,297,RepeatMasker,SINE,2229582,2229811,34,0.11
ptg007337l,78777,79082,305,RepeatMasker,SINE,78743,78971,194,0.64
ptg007341l,1147681,1147976,295,RepeatMasker,SINE,1147872,1148009,105,0.36
ptg007349l,2109183,2109437,254,RepeatMasker,SINE,2109398,2109613,40,0.16
ptg007376l,3907562,3907865,303,RepeatMasker,SINE,3907738,3907888,128,0.42
ptg007380l,1304027,1304302,275,RepeatMasker,SINE,1304141,1304331,162,0.59
ptg007509l,2276449,2276772,323,RepeatMasker,SINE,2276309,2276487,38,0.12
ptg007529l,3674010,3674295,285,RepeatMasker,SINE,3674017,3674169,153,0.54
ptg007529l,3674010,3674295,285,RepeatMasker,SINE,3674061,3674178,118,0.41
ptg007552l,1798103,1798385,282,RepeatMasker,SINE,1798171,1798217,47,0.17
ptg007562l,243427,243730,303,RepeatMasker,SINE,243474,243530,57,0.19
ptg007566l,1930452,1930740,288,RepeatMasker,SINE,1930549,1930680,132,0.46
ptg007572l,427142,427458,316,RepeatMasker,SINE,427094,427225,83,0.26
ptg007602l,18438,18734,296,RepeatMasker,SINE,18670,18830,65,0.22
ptg007602l,18438,18734,296,RepeatMasker,SINE,18689,18880,46,0.16
ptg007633l,1671952,1672276,324,RepeatMasker,SINE,1672109,1672248,140,0.43
ptg007633l,1671952,1672276,324,RepeatMasker,SINE,1672124,1672251,128,0.40
ptg007668l,4206124,4206438,314,RepeatMasker,SINE,4206285,4206416,132,0.42
ptg007674l,256474,256754,280,RepeatMasker,SINE,256711,256942,44,0.16
ptg007732l,238127,238419,292,RepeatMasker,SINE,238097,238270,143,0.49
ptg007763l,3851229,3851540,311,RepeatMasker,SINE,3851516,3851630,25,0.08
ptg007763l,4722099,4722414,315,RepeatMasker,SINE,4722094,4722324,225,0.71
ptg007823l,1419415,1419701,286,RepeatMasker,SINE,1419570,1419738,132,0.46
ptg007930l,1406981,1407290,309,RepeatMasker,SINE,1407275,1407348,16,0.05
ptg007930l,1406981,1407290,309,RepeatMasker,SINE,1407275,1407374,16,0.05
ptg007930l,1406981,1407290,309,RepeatMasker,SINE,1407289,1407374,2,0.01
ptg007944l,431200,431502,302,RepeatMasker,SINE,431226,431357,132,0.44
ptg007953l,2303407,2303713,306,RepeatMasker,SINE,2303522,2303682,161,0.53
ptg007953l,2303407,2303713,306,RepeatMasker,SINE,2303567,2303682,116,0.38
ptg008010l,1800084,1800386,302,RepeatMasker,SINE,1799889,1800117,33,0.11
ptg008071l,765977,766265,288,RepeatMasker,SINE,766005,766122,118,0.41
ptg008112l,2663362,2663658,296,RepeatMasker,SINE,2663583,2663712,76,0.26
ptg008112l,2663362,2663658,296,RepeatMasker,SINE,2663586,2663784,73,0.25
ptg008119l,941938,942240,302,RepeatMasker,SINE,942206,942435,35,0.12
ptg008157l,750641,750926,285,RepeatMasker,SINE,750437,750680,39,0.14
ptg008157l,750641,750926,285,RepeatMasker,SINE,750463,750681,40,0.14
ptg008179l,989554,989845,291,RepeatMasker,SINE,989675,989881,171,0.59
ptg008216l,1306372,1306655,283,RepeatMasker,SINE,1306291,1306408,36,0.13
ptg008217l,363113,363435,322,RepeatMasker,SINE,363189,363311,123,0.38
ptg008217l,363113,363435,322,RepeatMasker,SINE,363235,363311,77,0.24
ptg008220l,1330061,1330350,289,RepeatMasker,SINE,1330082,1330133,52,0.18
ptg008233l,845189,845454,265,RepeatMasker,SINE,845301,845494,154,0.58
ptg008239l,1796449,1796734,285,RepeatMasker,SINE,1796440,1796593,144,0.51
ptg008240l,1209235,1209541,306,RepeatMasker,SINE,1209503,1209715,39,0.13
ptg008312l,549187,549482,295,RepeatMasker,SINE,549398,549499,85,0.29
ptg008337l,1342809,1343100,291,RepeatMasker,SINE,1342781,1342862,53,0.18
ptg008342l,616389,616693,304,RepeatMasker,SINE,616364,616410,21,0.07
ptg008378l,1253800,1254092,292,RepeatMasker,SINE,1253609,1253834,34,0.12
ptg008378l,1362475,1362801,326,RepeatMasker,SINE,1362290,1362509,34,0.10
ptg008411l,1001271,1001546,275,RepeatMasker,SINE,1001452,1001602,95,0.35
ptg008418l,422644,422947,303,RepeatMasker,SINE,422475,422679,35,0.12
ptg008455l,649115,649394,279,RepeatMasker,SINE,649157,649285,129,0.46
ptg008455l,649115,649394,279,RepeatMasker,SINE,649190,649302,113,0.41
ptg008472l,992209,992526,317,RepeatMasker,SINE,992502,992547,25,0.08
ptg008482l,176929,177237,308,RepeatMasker,SINE,176766,176964,35,0.11
ptg008484l,1198034,1198309,275,RepeatMasker,SINE,1198282,1198501,28,0.10
ptg008491l,651197,651509,312,RepeatMasker,SINE,651155,651234,37,0.12
ptg008494l,104665,104946,281,RepeatMasker,SINE,104470,104696,31,0.11
ptg008502l,1292010,1292305,295,RepeatMasker,SINE,1292212,1292317,94,0.32
ptg008512l,245397,245713,316,RepeatMasker,SINE,245202,245430,33,0.10
ptg008526l,750048,750372,324,RepeatMasker,SINE,750013,750071,23,0.07
ptg008526l,750048,750372,324,RepeatMasker,SINE,750014,750078,30,0.09
ptg008535l,985247,985534,287,RepeatMasker,SINE,985489,985583,46,0.16
ptg008557l,1189691,1190014,323,RepeatMasker,SINE,1189655,1189714,23,0.07
ptg008557l,1189691,1190014,323,RepeatMasker,SINE,1189871,1190051,144,0.45
ptg008561l,564853,565137,284,RepeatMasker,SINE,564944,565181,194,0.68
ptg008579l,1121391,1121684,293,RepeatMasker,SINE,1121358,1121573,182,0.62
ptg008645l,1366920,1367193,273,RepeatMasker,SINE,1367146,1367380,48,0.18
ptg008665l,762581,762887,306,RepeatMasker,SINE,762547,762780,199,0.65
ptg008666l,521393,521708,315,RepeatMasker,SINE,521539,521670,132,0.42
ptg008688l,2266748,2267083,335,RepeatMasker,SINE,2267029,2267099,55,0.16
ptg008688l,2266748,2267083,335,RepeatMasker,SINE,2267029,2267110,55,0.16
ptg008700l,4539332,4539614,282,RepeatMasker,SINE,4539513,4539610,98,0.35
ptg008723l,1070410,1070723,313,RepeatMasker,SINE,1070215,1070447,37,0.12
ptg008741l,1487646,1487924,278,RepeatMasker,SINE,1487538,1487693,47,0.17
ptg008741l,2835252,2835552,300,RepeatMasker,SINE,2835505,2835613,48,0.16
ptg008749l,3410685,3410967,282,RepeatMasker,SINE,3410926,3411012,42,0.15
ptg008759l,1426395,1426649,254,RepeatMasker,SINE,1426611,1426818,39,0.15
ptg008776l,126328,126647,319,RepeatMasker,SINE,126526,126701,122,0.38
ptg008795l,1243170,1243479,309,RepeatMasker,SINE,1243090,1243221,51,0.17
ptg008795l,1961245,1961564,319,RepeatMasker,SINE,1961052,1961277,32,0.10
ptg008822l,484437,484759,322,RepeatMasker,SINE,484683,484822,77,0.24
ptg008845l,3895368,3895668,300,RepeatMasker,SINE,3895588,3895665,78,0.26
ptg008856l,2125738,2126028,290,RepeatMasker,SINE,2125704,2125851,113,0.39
ptg008919l,402711,403035,324,RepeatMasker,SINE,402813,402944,132,0.41
ptg008990l,688444,688737,293,RepeatMasker,SINE,688412,688643,199,0.68
ptg008999l,992574,992717,143,RepeatMasker,SINE,992521,992652,78,0.55
ptg009078l,1025519,1025786,267,RepeatMasker,SINE,1025577,1025652,76,0.28
ptg009143l,637421,637729,308,RepeatMasker,SINE,637488,637613,126,0.41
ptg009143l,637421,637729,308,RepeatMasker,SINE,637537,637613,77,0.25
ptg009175l,1654179,1654500,321,RepeatMasker,SINE,1654146,1654218,39,0.12
ptg009175l,1654179,1654500,321,RepeatMasker,SINE,1654485,1654598,16,0.05
ptg009175l,1654179,1654500,321,RepeatMasker,SINE,1654485,1654656,16,0.05
ptg009201l,1359138,1359411,273,RepeatMasker,SINE,1359371,1359451,41,0.15
ptg009201l,1359138,1359411,273,RepeatMasker,SINE,1359376,1359497,36,0.13
ptg009206l,1514416,1514692,276,RepeatMasker,SINE,1514362,1514447,31,0.11
ptg009222l,896282,896566,284,RepeatMasker,SINE,896351,896420,70,0.25
ptg009262l,2842326,2842637,311,RepeatMasker,SINE,2842566,2842675,72,0.23
ptg009276l,865928,866220,292,RepeatMasker,SINE,866104,866170,67,0.23
ptg009316l,763899,764182,283,RepeatMasker,SINE,764137,764373,46,0.16
ptg009336l,1443317,1443607,290,RepeatMasker,SINE,1443563,1443661,45,0.16
ptg009342l,100861,101167,306,RepeatMasker,SINE,101011,101143,133,0.43
ptg009353l,23381,23685,304,RepeatMasker,SINE,23185,23417,36,0.12
ptg009357l,347963,348256,293,RepeatMasker,SINE,347932,348163,200,0.68
ptg009361l,517645,517966,321,RepeatMasker,SINE,517695,517826,132,0.41
ptg009446l,1696876,1697171,295,RepeatMasker,SINE,1696784,1696961,85,0.29
ptg009446l,1696876,1697171,295,RepeatMasker,SINE,1696832,1696960,84,0.28
ptg009447l,1664130,1664414,284,RepeatMasker,SINE,1664367,1664498,48,0.17
ptg009447l,1664130,1664414,284,RepeatMasker,SINE,1664371,1664520,44,0.15
ptg009523l,676830,677103,273,RepeatMasker,SINE,676927,677140,177,0.65
ptg009535l,3302282,3302564,282,RepeatMasker,SINE,3302332,3302465,134,0.48
ptg009540l,1441801,1442124,323,RepeatMasker,SINE,1441716,1441813,12,0.04
ptg009540l,1441801,1442124,323,RepeatMasker,SINE,1441720,1441832,31,0.10
ptg009548l,816139,816424,285,RepeatMasker,SINE,815945,816177,38,0.13
ptg009592l,365055,365388,333,RepeatMasker,SINE,365225,365425,164,0.49
ptg009660l,1116768,1117050,282,RepeatMasker,SINE,1116738,1116817,49,0.17
ptg009705l,983743,984016,273,RepeatMasker,SINE,983989,984207,28,0.10
ptg009719l,968100,968391,291,RepeatMasker,SINE,968070,968140,40,0.14
ptg009719l,968100,968391,291,RepeatMasker,SINE,968267,968436,125,0.43
ptg009759l,440352,440677,325,RepeatMasker,SINE,440487,440590,104,0.32
ptg009775l,2499762,2500027,265,RepeatMasker,SINE,2499958,2500026,69,0.26
ptg009777l,586896,587181,285,RepeatMasker,SINE,586785,586932,36,0.13
ptg009808l,186313,186640,327,RepeatMasker,SINE,186437,186519,83,0.25
ptg009831l,755127,755426,299,RepeatMasker,SINE,754925,755164,37,0.12
ptg009864l,1126890,1127217,327,RepeatMasker,SINE,1126724,1126922,32,0.10
ptg009866l,649998,650310,312,RepeatMasker,SINE,649969,650202,204,0.65
ptg009887l,1966828,1967157,329,RepeatMasker,SINE,1967036,1967143,108,0.33
ptg009929l,411069,411396,327,RepeatMasker,SINE,411294,411423,103,0.31
ptg009933l,822637,822944,307,RepeatMasker,SINE,822542,822714,77,0.25
ptg009933l,822637,822944,307,RepeatMasker,SINE,822593,822725,88,0.29
ptg009933l,872100,872398,298,RepeatMasker,SINE,872286,872442,113,0.38
ptg009933l,1146057,1146383,326,RepeatMasker,SINE,1146189,1146412,195,0.60
ptg009984l,564314,564626,312,RepeatMasker,SINE,564117,564351,37,0.12
ptg010006l,1204795,1205056,261,RepeatMasker,SINE,1204879,1205063,178,0.68
ptg010016l,229119,229413,294,RepeatMasker,SINE,229034,229166,47,0.16
ptg010024l,557868,558159,291,RepeatMasker,SINE,557985,558119,135,0.46
ptg010024l,1168478,1168799,321,RepeatMasker,SINE,1168282,1168513,35,0.11
ptg010038l,517762,518095,333,RepeatMasker,SINE,517667,517847,85,0.26
ptg010038l,517762,518095,333,RepeatMasker,SINE,517718,517851,89,0.27
ptg010040l,410566,410823,257,RepeatMasker,SINE,410660,410780,121,0.47
ptg010102l,1085814,1086115,301,RepeatMasker,SINE,1085975,1086085,111,0.37
ptg010125l,1450592,1450885,293,RepeatMasker,SINE,1450398,1450625,33,0.11
ptg010165l,353053,353360,307,RepeatMasker,SINE,353068,353111,44,0.14
ptg010179l,596183,596495,312,RepeatMasker,SINE,596241,596350,110,0.35
ptg010179l,596183,596495,312,RepeatMasker,SINE,596241,596395,155,0.50
ptg010179l,596183,596495,312,RepeatMasker,SINE,596456,596671,40,0.13
ptg010191l,86346,86634,288,RepeatMasker,SINE,86152,86380,34,0.12
ptg010231l,2564525,2564843,318,RepeatMasker,SINE,2564631,2564681,51,0.16
ptg010231l,2564525,2564843,318,RepeatMasker,SINE,2564641,2564691,51,0.16
ptg010336l,2311578,2311865,287,RepeatMasker,SINE,2311512,2311763,185,0.64
ptg010336l,2311578,2311865,287,RepeatMasker,SINE,2311544,2311768,190,0.66
ptg010411l,1068995,1069285,290,RepeatMasker,SINE,1068961,1069174,179,0.62
ptg010446l,70500,70811,311,RepeatMasker,SINE,70771,70973,41,0.13
ptg010464l,1995652,1995958,306,RepeatMasker,SINE,1995828,1995902,75,0.25
ptg010472l,2140762,2141079,317,RepeatMasker,SINE,2140637,2140766,4,0.01
ptg010548l,4190516,4190838,322,RepeatMasker,SINE,4190545,4190779,235,0.73
ptg010548l,4190516,4190838,322,RepeatMasker,SINE,4190809,4190923,30,0.09
ptg010605l,1661595,1661911,316,RepeatMasker,SINE,1661567,1661644,49,0.16
ptg010648l,597734,598035,301,RepeatMasker,SINE,597679,597770,36,0.12
ptg010656l,2064021,2064345,324,RepeatMasker,SINE,2063846,2064058,37,0.11
ptg010773l,3107525,3107827,302,RepeatMasker,SINE,3107502,3107534,9,0.03
ptg010786l,619093,619409,316,RepeatMasker,SINE,619152,619332,181,0.57
ptg010786l,619093,619409,316,RepeatMasker,SINE,619204,619336,133,0.42
ptg010792l,149719,150029,310,RepeatMasker,SINE,149686,149810,91,0.29
ptg010809l,806851,807141,290,RepeatMasker,SINE,807009,807180,133,0.46
ptg010817l,712428,712679,251,RepeatMasker,SINE,712556,712715,124,0.49
ptg010850l,1527885,1528175,290,RepeatMasker,SINE,1527689,1527920,35,0.12
ptg010890l,461456,461790,334,RepeatMasker,SINE,461408,461489,33,0.10
ptg010890l,461456,461790,334,RepeatMasker,SINE,461414,461498,42,0.13
ptg010943l,180129,180438,309,RepeatMasker,SINE,180252,180475,187,0.61
ptg010959l,498808,499131,323,RepeatMasker,SINE,499101,499318,31,0.10
ptg010960l,759878,760157,279,RepeatMasker,SINE,759848,759931,53,0.19
ptg010968l,104062,104382,320,RepeatMasker,SINE,103984,104098,36,0.11
ptg010984l,250685,250998,313,RepeatMasker,SINE,250801,251034,198,0.63
ptg011068l,1105852,1106139,287,RepeatMasker,SINE,1105914,1106041,128,0.45
ptg011082l,729086,729402,316,RepeatMasker,SINE,728891,729116,30,0.09
ptg011082l,1299898,1300206,308,RepeatMasker,SINE,1299893,1299936,38,0.12
ptg011084l,1645486,1645774,288,RepeatMasker,SINE,1645727,1645816,48,0.17
ptg011091l,473892,474216,324,RepeatMasker,SINE,473972,474210,239,0.74
ptg011098l,929139,929477,338,RepeatMasker,SINE,928969,929174,35,0.10
ptg011108l,1844412,1844688,276,RepeatMasker,SINE,1844216,1844449,37,0.13
ptg011144l,22501,22815,314,RepeatMasker,SINE,22781,22842,35,0.11
ptg011164l,218590,218865,275,RepeatMasker,SINE,218684,218906,182,0.66
ptg011166l,507658,507968,310,RepeatMasker,SINE,507961,508010,8,0.03
ptg011263l,2217551,2217798,247,RepeatMasker,SINE,2217624,2217834,175,0.71
ptg011277l,113980,114270,290,RepeatMasker,SINE,113950,114010,30,0.10
ptg011296l,147024,147307,283,RepeatMasker,SINE,147264,147499,44,0.16
ptg011296l,147024,147307,283,RepeatMasker,SINE,147272,147534,36,0.13
ptg011297l,553680,554005,325,RepeatMasker,SINE,553812,553936,125,0.38
ptg011332l,576268,576533,265,RepeatMasker,SINE,576337,576571,197,0.74
ptg011406l,1030380,1030661,281,RepeatMasker,SINE,1030304,1030417,37,0.13
ptg011451l,1253030,1253337,307,RepeatMasker,SINE,1253011,1253060,30,0.10
ptg011515l,1145765,1146091,326,RepeatMasker,SINE,1145663,1145769,4,0.01
ptg011515l,1145765,1146091,326,RepeatMasker,SINE,1145717,1145777,12,0.04
ptg011515l,1145765,1146091,326,RepeatMasker,SINE,1145721,1145790,25,0.08
ptg011543l,2502539,2502837,298,RepeatMasker,SINE,2502700,2502831,132,0.44
ptg011602l,644159,644460,301,RepeatMasker,SINE,644285,644497,176,0.58
ptg011608l,132449,132730,281,RepeatMasker,SINE,132267,132481,32,0.11
ptg011642l,1657089,1657392,303,RepeatMasker,SINE,1657055,1657289,200,0.66
ptg011659l,122623,122897,274,RepeatMasker,SINE,122714,122845,132,0.48
ptg011719l,381565,381845,280,RepeatMasker,SINE,381369,381602,37,0.13
ptg011722l,144305,144566,261,RepeatMasker,SINE,144483,144575,84,0.32
ptg011736l,478838,479115,277,RepeatMasker,SINE,478739,478892,54,0.19
ptg011736l,478838,479115,277,RepeatMasker,SINE,478757,478885,47,0.17
ptg011736l,1835019,1835335,316,RepeatMasker,SINE,1835175,1835355,161,0.51
ptg011736l,1835019,1835335,316,RepeatMasker,SINE,1835203,1835331,129,0.41
ptg011773l,118543,118844,301,RepeatMasker,SINE,118807,119028,38,0.13
ptg011773l,118543,118844,301,RepeatMasker,SINE,118809,119061,36,0.12
ptg011894l,260669,260979,310,RepeatMasker,SINE,260802,260881,80,0.26
ptg011894l,260669,260979,310,RepeatMasker,SINE,260802,260895,94,0.30
ptg011931l,756964,757289,325,RepeatMasker,SINE,757097,757326,193,0.59
ptg011978l,6027563,6027863,300,RepeatMasker,SINE,6027383,6027591,28,0.09
ptg011986l,1778481,1778793,312,RepeatMasker,SINE,1778286,1778511,30,0.10
ptg012047l,181973,182280,307,RepeatMasker,SINE,181942,182185,212,0.69
ptg012058l,1521713,1522050,337,RepeatMasker,SINE,1522018,1522091,33,0.10
ptg012058l,2044588,2044885,297,RepeatMasker,SINE,2044556,2044786,198,0.67
ptg012101l,911429,911744,315,RepeatMasker,SINE,911637,911772,108,0.34
ptg012106l,849812,850143,331,RepeatMasker,SINE,849649,849845,33,0.10
ptg012149l,386389,386696,307,RepeatMasker,SINE,386598,386729,99,0.32
ptg012157l,170953,171263,310,RepeatMasker,SINE,171066,171304,198,0.64
ptg012173l,1652503,1652761,258,RepeatMasker,SINE,1652312,1652540,37,0.14
ptg012181l,37916,38230,314,RepeatMasker,SINE,38047,38267,184,0.59
ptg012249l,1375519,1375847,328,RepeatMasker,SINE,1375456,1375537,18,0.05
ptg012372l,352077,352375,298,RepeatMasker,SINE,352046,352119,42,0.14
ptg012372l,352077,352375,298,RepeatMasker,SINE,352054,352113,36,0.12
ptg012375l,3317484,3317812,328,RepeatMasker,SINE,3317451,3317681,197,0.60
ptg012376l,1244624,1244938,314,RepeatMasker,SINE,1244526,1244709,85,0.27
ptg012376l,1244624,1244938,314,RepeatMasker,SINE,1244585,1244712,88,0.28
ptg012470l,356998,357309,311,RepeatMasker,SINE,356802,357035,37,0.12
ptg012555l,183502,183819,317,RepeatMasker,SINE,183474,183700,198,0.62
ptg012625l,1201176,1201501,325,RepeatMasker,SINE,1200958,1201210,34,0.10
ptg012630l,741972,742288,316,RepeatMasker,SINE,741776,742005,33,0.10
ptg012636l,34625,34877,252,RepeatMasker,SINE,34844,35033,34,0.13
ptg012682l,463527,463789,262,RepeatMasker,SINE,463666,463826,124,0.47
ptg012692l,306006,306327,321,RepeatMasker,SINE,305813,306043,37,0.12
ptg012700l,203105,203396,291,RepeatMasker,SINE,203150,203382,233,0.80
ptg012743l,1073936,1074205,269,RepeatMasker,SINE,1073761,1073966,30,0.11
ptg012767l,821942,822230,288,RepeatMasker,SINE,821960,822083,124,0.43
ptg012785l,531719,532000,281,RepeatMasker,SINE,531615,531800,81,0.29
ptg012785l,531719,532000,281,RepeatMasker,SINE,531672,531800,81,0.29
ptg012789l,100812,101117,305,RepeatMasker,SINE,100995,101186,123,0.40
ptg012789l,100812,101117,305,RepeatMasker,SINE,101057,101185,61,0.20
ptg012792l,474496,474792,296,RepeatMasker,SINE,474471,474517,21,0.07
ptg012824l,5588747,5589032,285,RepeatMasker,SINE,5588841,5589064,192,0.67
ptg012854l,1063294,1063602,308,RepeatMasker,SINE,1063539,1063631,64,0.21
ptg012866l,199292,199597,305,RepeatMasker,SINE,199139,199357,65,0.21
ptg012951l,252767,253059,292,RepeatMasker,SINE,252724,252805,38,0.13
ptg012982l,1946057,1946370,313,RepeatMasker,SINE,1946330,1946558,41,0.13
ptg013016l,729179,729470,291,RepeatMasker,SINE,729201,729383,183,0.63
ptg013016l,729179,729470,291,RepeatMasker,SINE,729254,729386,133,0.46
ptg013024l,1342208,1342479,271,RepeatMasker,SINE,1342181,1342252,44,0.16
ptg013024l,1342208,1342479,271,RepeatMasker,SINE,1342311,1342397,87,0.32
ptg013024l,1342208,1342479,271,RepeatMasker,SINE,1342394,1342518,86,0.32
ptg013087l,1905319,1905629,310,RepeatMasker,SINE,1905247,1905356,37,0.12
ptg013170l,423805,424122,317,RepeatMasker,SINE,423892,424023,132,0.42
ptg013221l,399078,399332,254,RepeatMasker,SINE,399167,399364,166,0.65
ptg013221l,399078,399332,254,RepeatMasker,SINE,399216,399377,117,0.46
ptg013279l,609772,610100,328,RepeatMasker,SINE,610058,610146,43,0.13
ptg013282l,2123139,2123443,304,RepeatMasker,SINE,2122943,2123176,37,0.12
ptg013311l,1684030,1684308,278,RepeatMasker,SINE,1684272,1684428,37,0.13
ptg013353l,878618,878919,301,RepeatMasker,SINE,878837,878986,83,0.28
ptg013368l,14751,15054,303,RepeatMasker,SINE,14967,15129,88,0.29
ptg013368l,193650,193955,305,RepeatMasker,SINE,193762,193986,194,0.64
ptg013382l,204695,204989,294,RepeatMasker,SINE,204704,204834,131,0.45
ptg013434l,168140,168398,258,RepeatMasker,SINE,168220,168448,179,0.69
ptg013449l,1006677,1006964,287,RepeatMasker,SINE,1006922,1007178,43,0.15
ptg013468l,280695,281011,316,RepeatMasker,SINE,280661,280895,200,0.63
ptg013468l,429426,429738,312,RepeatMasker,SINE,429686,429753,53,0.17
ptg013477l,242548,242860,312,RepeatMasker,SINE,242447,242561,13,0.04
ptg013582l,430899,431198,299,RepeatMasker,SINE,430992,431115,124,0.41
ptg013632l,258525,258831,306,RepeatMasker,SINE,258676,258865,156,0.51
ptg013642l,218877,219182,305,RepeatMasker,SINE,218948,219065,118,0.39
ptg013642l,872076,872384,308,RepeatMasker,SINE,872083,872292,210,0.68
ptg013642l,872076,872384,308,RepeatMasker,SINE,872145,872277,133,0.43
ptg013682l,378828,379137,309,RepeatMasker,SINE,379088,379243,50,0.16
ptg013701l,679980,680245,265,RepeatMasker,SINE,680094,680277,152,0.57
ptg013902l,401493,401789,296,RepeatMasker,SINE,401749,401979,41,0.14
ptg014076l,2081525,2081809,284,RepeatMasker,SINE,2081747,2081838,63,0.22
ptg014093l,826279,826609,330,RepeatMasker,SINE,826296,826421,126,0.38
ptg014161l,29919,30228,309,RepeatMasker,SINE,29991,30114,124,0.40
ptg014161l,29919,30228,309,RepeatMasker,SINE,30038,30114,77,0.25
ptg014166l,231038,231339,301,RepeatMasker,SINE,230842,231075,37,0.12
ptg014171l,180710,180997,287,RepeatMasker,SINE,180657,180748,38,0.13
ptg014268l,195191,195472,281,RepeatMasker,SINE,195183,195399,208,0.74
ptg014296l,672810,673111,301,RepeatMasker,SINE,672775,672833,23,0.08
ptg014452l,349280,349569,289,RepeatMasker,SINE,349252,349480,200,0.69
ptg014458l,1414509,1414821,312,RepeatMasker,SINE,1414426,1414556,47,0.15
ptg014466l,479454,479761,307,RepeatMasker,SINE,479564,479600,37,0.12
ptg014582l,675839,676150,311,RepeatMasker,SINE,675978,676086,109,0.35
ptg014582l,675839,676150,311,RepeatMasker,SINE,675998,676086,89,0.29
ptg014594l,924412,924697,285,RepeatMasker,SINE,924601,924723,97,0.34
ptg014602l,1083335,1083639,304,RepeatMasker,SINE,1083304,1083529,194,0.64
ptg014638l,1131615,1131948,333,RepeatMasker,SINE,1131658,1131694,37,0.11
ptg014638l,1131615,1131948,333,RepeatMasker,SINE,1131702,1131803,102,0.31
ptg014638l,1131615,1131948,333,RepeatMasker,SINE,1131712,1131798,87,0.26
ptg014638l,1131615,1131948,333,RepeatMasker,SINE,1131819,1131904,86,0.26
ptg014638l,1131615,1131948,333,RepeatMasker,SINE,1131926,1132138,23,0.07
ptg014656l,293825,294146,321,RepeatMasker,SINE,294094,294193,53,0.17
ptg014663l,591046,591330,284,RepeatMasker,SINE,591238,591314,77,0.27
ptg014749l,1260928,1261225,297,RepeatMasker,SINE,1260895,1261113,185,0.62
ptg014837l,1249795,1250088,293,RepeatMasker,SINE,1249761,1249977,182,0.62
ptg014947l,1233998,1234307,309,RepeatMasker,SINE,1233964,1234198,200,0.65
ptg014970l,503408,503724,316,RepeatMasker,SINE,503439,503570,132,0.42
ptg014995l,281046,281335,289,RepeatMasker,SINE,281014,281100,54,0.19
ptg015044l,58606,58929,323,RepeatMasker,SINE,58574,58801,195,0.60
ptg015086l,778060,778334,274,RepeatMasker,SINE,778172,778366,163,0.59
ptg015143l,1223850,1224161,311,RepeatMasker,SINE,1223963,1224021,59,0.19
ptg015143l,1223850,1224161,311,RepeatMasker,SINE,1223963,1224058,96,0.31
ptg015153l,139861,140145,284,RepeatMasker,SINE,140115,140276,31,0.11
ptg015166l,471765,472100,335,RepeatMasker,SINE,471801,471932,132,0.39
ptg015180l,166572,166870,298,RepeatMasker,SINE,166474,166654,82,0.28
ptg015180l,166572,166870,298,RepeatMasker,SINE,166526,166662,90,0.30
ptg015185l,628033,628341,308,RepeatMasker,SINE,627984,628113,80,0.26
ptg015255l,2641577,2641860,283,RepeatMasker,SINE,2641550,2641773,196,0.69
ptg015293l,604238,604545,307,RepeatMasker,SINE,604205,604292,54,0.18
ptg015344l,1665398,1665710,312,RepeatMasker,SINE,1665202,1665435,37,0.12
ptg015352l,446031,446331,300,RepeatMasker,SINE,445958,446088,57,0.19
ptg015352l,446031,446331,300,RepeatMasker,SINE,446034,446093,60,0.20
ptg015385l,370219,370544,325,RepeatMasker,SINE,370489,370644,56,0.17
ptg015403l,464246,464575,329,RepeatMasker,SINE,464231,464277,31,0.09
ptg015420l,45631,45921,290,RepeatMasker,SINE,45425,45664,33,0.11
ptg015425l,1266783,1267074,291,RepeatMasker,SINE,1266751,1266974,191,0.66
ptg015454l,2059016,2059301,285,RepeatMasker,SINE,2058820,2059053,37,0.13
ptg015476l,296921,297205,284,RepeatMasker,SINE,297008,297170,163,0.57
ptg015476l,296921,297205,284,RepeatMasker,SINE,297011,297142,132,0.46
ptg015493l,507494,507777,283,RepeatMasker,SINE,507737,507881,41,0.14
ptg015509l,731305,731587,282,RepeatMasker,SINE,731391,731623,197,0.70
ptg015548l,293379,293678,299,RepeatMasker,SINE,293292,293431,52,0.17
ptg015562l,61794,62116,322,RepeatMasker,SINE,62063,62300,54,0.17
ptg015664l,2259636,2259939,303,RepeatMasker,SINE,2259886,2260130,54,0.18
ptg015710l,1040843,1041153,310,RepeatMasker,SINE,1041011,1041122,112,0.36
ptg015731l,999085,999351,266,RepeatMasker,SINE,999249,999303,55,0.21
ptg015760l,400494,400778,284,RepeatMasker,SINE,400299,400530,36,0.13
ptg015768l,5096200,5096513,313,RepeatMasker,SINE,5096478,5096664,36,0.12
ptg015835l,179165,179447,282,RepeatMasker,SINE,179194,179359,166,0.59
ptg015835l,179165,179447,282,RepeatMasker,SINE,179241,179358,118,0.42
ptg015845l,553641,553931,290,RepeatMasker,SINE,553607,553843,202,0.70
ptg015845l,1771229,1771520,291,RepeatMasker,SINE,1771192,1771427,198,0.68
ptg015858l,202598,202876,278,RepeatMasker,SINE,202563,202649,51,0.18
ptg015946l,3043380,3043658,278,RepeatMasker,SINE,3043479,3043688,180,0.65
ptg015946l,3982289,3982581,292,RepeatMasker,SINE,3982090,3982325,36,0.12
ptg015997l,130144,130424,280,RepeatMasker,SINE,130386,130575,39,0.14
ptg016018l,406127,406402,275,RepeatMasker,SINE,406317,406372,56,0.20
ptg016026l,375356,375642,286,RepeatMasker,SINE,375398,375529,132,0.46
ptg016070l,691152,691436,284,RepeatMasker,SINE,691318,691399,82,0.29
ptg016070l,691152,691436,284,RepeatMasker,SINE,691394,691620,43,0.15
ptg016316l,422674,422978,304,RepeatMasker,SINE,422944,423138,35,0.12
ptg016459l,610626,610907,281,RepeatMasker,SINE,610433,610661,35,0.12
ptg016463l,320808,321090,282,RepeatMasker,SINE,320780,321011,203,0.72
ptg016463l,997914,998217,303,RepeatMasker,SINE,997909,998013,99,0.33
ptg016501l,74987,75271,284,RepeatMasker,SINE,75093,75224,132,0.46
ptg016502l,556915,557230,315,RepeatMasker,SINE,556881,557085,170,0.54
ptg016582l,482660,482963,303,RepeatMasker,SINE,482463,482691,31,0.10
ptg016584l,112287,112614,327,RepeatMasker,SINE,112511,112634,104,0.32
ptg016611l,1320604,1320891,287,RepeatMasker,SINE,1320507,1320689,85,0.30
ptg016611l,1320604,1320891,287,RepeatMasker,SINE,1320571,1320689,85,0.30
ptg016628l,1001565,1001849,284,RepeatMasker,SINE,1001485,1001616,51,0.18
ptg016646l,264218,264532,314,RepeatMasker,SINE,264418,264605,115,0.37
ptg016702l,375539,375847,308,RepeatMasker,SINE,375511,375572,33,0.11
ptg016816l,876252,876584,332,RepeatMasker,SINE,876350,876442,93,0.28
ptg016837l,813332,813639,307,RepeatMasker,SINE,813298,813523,191,0.62
ptg016837l,813332,813639,307,RepeatMasker,SINE,813523,813566,44,0.14
ptg016884l,864707,864998,291,RepeatMasker,SINE,864725,864766,42,0.14
ptg016910l,5075,5398,323,RepeatMasker,SINE,5150,5274,125,0.39
ptg016910l,5075,5398,323,RepeatMasker,SINE,5196,5274,79,0.24
ptg016974l,1003942,1004239,297,RepeatMasker,SINE,1003967,1004049,83,0.28
ptg016981l,193472,193794,322,RepeatMasker,SINE,193421,193501,29,0.09
ptg017151l,506498,506794,296,RepeatMasker,SINE,506744,506970,51,0.17
ptg017330l,996874,997165,291,RepeatMasker,SINE,997077,997303,89,0.31
ptg017359l,366459,366710,251,RepeatMasker,SINE,366377,366490,31,0.12
ptg017365l,122032,122348,316,RepeatMasker,SINE,122105,122232,128,0.41
ptg017365l,122032,122348,316,RepeatMasker,SINE,122156,122232,77,0.24
ptg017392l,188891,189202,311,RepeatMasker,SINE,189050,189173,124,0.40
ptg017392l,214794,215097,303,RepeatMasker,SINE,214598,214830,36,0.12
ptg017462l,998144,998435,291,RepeatMasker,SINE,998113,998197,53,0.18
ptg017505l,118167,118464,297,RepeatMasker,SINE,118114,118201,34,0.11
ptg017509l,227072,227384,312,RepeatMasker,SINE,227348,227577,37,0.12
ptg017680l,69984,70287,303,RepeatMasker,SINE,69867,70004,20,0.07
ptg017680l,69984,70287,303,RepeatMasker,SINE,70004,70135,132,0.44
ptg017680l,69984,70287,303,RepeatMasker,SINE,70237,70314,51,0.17
ptg017740l,243533,243829,296,RepeatMasker,SINE,243502,243733,200,0.68
ptg017764l,693742,694060,318,RepeatMasker,SINE,694022,694184,39,0.12
ptg017812l,426371,426635,264,RepeatMasker,SINE,426424,426570,147,0.56
ptg017812l,426371,426635,264,RepeatMasker,SINE,426456,426581,126,0.48
ptg017848l,300216,300538,322,RepeatMasker,SINE,300186,300416,200,0.62
ptg017865l,2604771,2605077,306,RepeatMasker,SINE,2605017,2605109,61,0.20
ptg017865l,2604771,2605077,306,RepeatMasker,SINE,2605030,2605108,48,0.16
ptg017898l,693209,693520,311,RepeatMasker,SINE,693326,693556,195,0.63
ptg017912l,171848,172139,291,RepeatMasker,SINE,171813,172047,199,0.68
ptg018037l,644424,644746,322,RepeatMasker,SINE,644390,644616,192,0.60
ptg018133l,909512,909789,277,RepeatMasker,SINE,909503,909710,198,0.71
ptg018270l,1577617,1577886,269,RepeatMasker,SINE,1577730,1577917,157,0.58
ptg018475l,223646,223953,307,RepeatMasker,SINE,223449,223680,34,0.11
ptg018520l,3726056,3726360,304,RepeatMasker,SINE,3726325,3726536,36,0.12
ptg018541l,449432,449751,319,RepeatMasker,SINE,449399,449627,195,0.61
ptg018581l,382948,383218,270,RepeatMasker,SINE,382900,382975,27,0.10
ptg018586l,53116,53437,321,RepeatMasker,SINE,53382,53526,56,0.17
ptg018601l,84517,84847,330,RepeatMasker,SINE,84708,84835,128,0.39
ptg018616l,129482,129792,310,RepeatMasker,SINE,129640,129771,132,0.43
ptg018689l,489601,489900,299,RepeatMasker,SINE,489532,489638,37,0.12
ptg018720l,791125,791417,292,RepeatMasker,SINE,791077,791207,82,0.28
ptg018850l,585657,585966,309,RepeatMasker,SINE,585773,585841,69,0.22
ptg018850l,585657,585966,309,RepeatMasker,SINE,585845,585918,74,0.24
ptg018893l,824562,824883,321,RepeatMasker,SINE,824482,824613,51,0.16
ptg018913l,95851,96179,328,RepeatMasker,SINE,95911,96034,124,0.38
ptg018982l,540910,541228,318,RepeatMasker,SINE,541039,541264,190,0.60
ptg019009l,131230,131502,272,RepeatMasker,SINE,131408,131571,95,0.35
ptg019062l,842555,842864,309,RepeatMasker,SINE,842508,842592,37,0.12
ptg019081l,134999,135290,291,RepeatMasker,SINE,135092,135339,199,0.68
ptg019133l,89452,89767,315,RepeatMasker,SINE,89642,89754,113,0.36
ptg019133l,308785,309064,279,RepeatMasker,SINE,309037,309101,28,0.10
ptg019136l,767531,767829,298,RepeatMasker,SINE,767498,767590,59,0.20
ptg019137l,347529,347795,266,RepeatMasker,SINE,347696,347766,71,0.27
ptg019158l,127549,127781,232,RepeatMasker,SINE,127510,127635,86,0.37
ptg019216l,1220918,1221223,305,RepeatMasker,SINE,1220725,1220955,37,0.12
ptg019303l,430699,430992,293,RepeatMasker,SINE,430959,431113,34,0.12
ptg019459l,540913,541232,319,RepeatMasker,SINE,540870,540946,33,0.10
ptg019577l,179572,179858,286,RepeatMasker,SINE,179538,179772,200,0.70
ptg019581l,1186309,1186636,327,RepeatMasker,SINE,1186325,1186467,143,0.44
ptg019625l,733792,734097,305,RepeatMasker,SINE,733911,734003,93,0.30
ptg019625l,733792,734097,305,RepeatMasker,SINE,734009,734141,89,0.29
ptg019651l,407743,408037,294,RepeatMasker,SINE,407879,407925,47,0.16
ptg019672l,199249,199551,302,RepeatMasker,SINE,199517,199745,35,0.12
ptg019705l,472218,472521,303,RepeatMasker,SINE,472038,472250,32,0.11
ptg019747l,412601,412920,319,RepeatMasker,SINE,412688,412819,132,0.41
ptg019900l,1016653,1016974,321,RepeatMasker,SINE,1016620,1016691,38,0.12
ptg019907l,439431,439709,278,RepeatMasker,SINE,439232,439464,33,0.12
ptg019974l,617498,617820,322,RepeatMasker,SINE,617635,617862,186,0.58
ptg020100l,137206,137528,322,RepeatMasker,SINE,137131,137244,38,0.12
ptg020245l,1125879,1126207,328,RepeatMasker,SINE,1125883,1126078,196,0.60
ptg020245l,1125879,1126207,328,RepeatMasker,SINE,1125944,1126069,126,0.38
ptg020320l,45074,45357,283,RepeatMasker,SINE,45046,45129,55,0.19
ptg020358l,257348,257644,296,RepeatMasker,SINE,257312,257478,130,0.44
ptg020454l,18892,19182,290,RepeatMasker,SINE,18694,18907,15,0.05
ptg020454l,18892,19182,290,RepeatMasker,SINE,19139,19371,44,0.15
ptg020466l,211411,211736,325,RepeatMasker,SINE,211696,211928,41,0.13
ptg020504l,83424,83730,306,RepeatMasker,SINE,83679,83747,52,0.17
ptg020513l,194380,194706,326,RepeatMasker,SINE,194183,194419,39,0.12
ptg020526l,1351250,1351584,334,RepeatMasker,SINE,1351491,1351628,94,0.28
ptg020579l,4701943,4702241,298,RepeatMasker,SINE,4701743,4701980,37,0.12
ptg020641l,300816,301130,314,RepeatMasker,SINE,300926,301057,132,0.42
ptg021017l,498386,498710,324,RepeatMasker,SINE,498517,498623,107,0.33
ptg021026l,1217157,1217452,295,RepeatMasker,SINE,1217413,1217626,40,0.14
ptg021087l,307288,307555,267,RepeatMasker,SINE,307393,307585,163,0.61
ptg021110l,393000,393305,305,RepeatMasker,SINE,392978,393039,39,0.13
ptg021235l,1164806,1165139,333,RepeatMasker,SINE,1164790,1164976,170,0.51
ptg021442l,1356940,1357229,289,RepeatMasker,SINE,1356907,1357138,198,0.69
ptg021470l,42207,42526,319,RepeatMasker,SINE,42446,42531,81,0.25
ptg021614l,3578837,3579113,276,RepeatMasker,SINE,3578694,3578882,45,0.16
ptg021668l,460942,461238,296,RepeatMasker,SINE,461047,461153,107,0.36
ptg021668l,460942,461238,296,RepeatMasker,SINE,461063,461186,124,0.42
ptg021730l,500736,501052,316,RepeatMasker,SINE,501016,501240,37,0.12
ptg021755l,614873,615177,304,RepeatMasker,SINE,614666,614910,37,0.12
ptg021765l,881474,881756,282,RepeatMasker,SINE,881566,881792,191,0.68
ptg021931l,55889,56206,317,RepeatMasker,SINE,55692,55926,37,0.12
ptg021933l,19527,19842,315,RepeatMasker,SINE,19751,19869,92,0.29
ptg021933l,19527,19842,315,RepeatMasker,SINE,19764,19879,79,0.25
ptg022061l,984250,984561,311,RepeatMasker,SINE,984394,984525,132,0.42
ptg022078l,8348,8643,295,RepeatMasker,SINE,8369,8532,164,0.56
ptg022078l,8348,8643,295,RepeatMasker,SINE,8419,8595,177,0.60
ptg022090l,1241362,1241661,299,RepeatMasker,SINE,1241169,1241381,19,0.06
ptg022247l,565940,566226,286,RepeatMasker,SINE,565906,566134,194,0.68
ptg022760l,222012,222285,273,RepeatMasker,SINE,222104,222237,134,0.49
ptg022981l,723022,723301,279,RepeatMasker,SINE,722826,723057,35,0.13
ptg023008l,289365,289665,300,RepeatMasker,SINE,289175,289397,32,0.11
ptg023140l,38854,39184,330,RepeatMasker,SINE,38925,39056,132,0.40
ptg023273l,391518,391829,311,RepeatMasker,SINE,391491,391538,20,0.06
ptg023457l,520222,520541,319,RepeatMasker,SINE,520368,520578,174,0.55
ptg023583l,728712,729009,297,RepeatMasker,SINE,728968,729031,42,0.14
ptg023895l,139026,139310,284,RepeatMasker,SINE,139262,139410,49,0.17
ptg023980l,724944,725235,291,RepeatMasker,SINE,724870,724981,37,0.13
ptg024212l,659778,660036,258,RepeatMasker,SINE,659909,660037,128,0.50
ptg024361l,383469,383754,285,RepeatMasker,SINE,383725,383845,30,0.11
ptg024377l,237773,238094,321,RepeatMasker,SINE,237735,237806,33,0.10
ptg024454l,7704,7992,288,RepeatMasker,SINE,7522,7738,34,0.12
ptg024542l,392821,393131,310,RepeatMasker,SINE,392800,392865,44,0.14
ptg024636l,442262,442573,311,RepeatMasker,SINE,442064,442299,37,0.12
ptg024720l,138359,138638,279,RepeatMasker,SINE,138164,138396,37,0.13
ptg024927l,66639,66915,276,RepeatMasker,SINE,66607,66712,73,0.26
ptg024992l,297775,298102,327,RepeatMasker,SINE,297755,297916,141,0.43
ptg025376l,3308849,3309165,316,RepeatMasker,SINE,3308805,3308937,88,0.28
ptg025446l,529629,529966,337,RepeatMasker,SINE,529436,529665,36,0.11
ptg025466l,657461,657766,305,RepeatMasker,SINE,657702,657834,65,0.21
ptg025574l,326083,326386,303,RepeatMasker,SINE,326192,326417,195,0.64
ptg025849l,386976,387285,309,RepeatMasker,SINE,387175,387227,53,0.17
ptg025949l,52828,53122,294,RepeatMasker,SINE,53111,53230,12,0.04
ptg025949l,52828,53122,294,RepeatMasker,SINE,53111,53256,12,0.04
ptg026007l,276767,277069,302,RepeatMasker,SINE,276735,276955,188,0.62
ptg026534l,265425,265699,274,RepeatMasker,SINE,265500,265735,200,0.73
ptg026562l,941734,942023,289,RepeatMasker,SINE,941918,942069,106,0.37
ptg026562l,941734,942023,289,RepeatMasker,SINE,941959,942069,65,0.22
ptg026643l,251945,252275,330,RepeatMasker,SINE,251766,251984,39,0.12
ptg026661l,121630,121915,285,RepeatMasker,SINE,121765,121950,151,0.53
ptg026855l,3338691,3338982,291,RepeatMasker,SINE,3338773,3338886,114,0.39
ptg026855l,3338691,3338982,291,RepeatMasker,SINE,3338773,3338907,135,0.46
ptg026920l,13389,13693,304,RepeatMasker,SINE,13459,13620,162,0.53
ptg027355l,20086,20415,329,RepeatMasker,SINE,19890,20107,21,0.06
ptg027460l,943331,943621,290,RepeatMasker,SINE,943514,943649,108,0.37
ptg027466l,557525,557847,322,RepeatMasker,SINE,557641,557883,207,0.64
ptg027633l,804769,805047,278,RepeatMasker,SINE,804747,804799,30,0.11
ptg027633l,804769,805047,278,RepeatMasker,SINE,804917,805088,131,0.47
ptg027936l,309457,309759,302,RepeatMasker,SINE,309268,309487,30,0.10
ptg027936l,531945,532220,275,RepeatMasker,SINE,531747,531979,34,0.12
ptg027936l,531945,532220,275,RepeatMasker,SINE,532025,532129,105,0.38
ptg028263l,76862,77134,272,RepeatMasker,SINE,76670,76888,26,0.10
ptg028301l,501293,501570,277,RepeatMasker,SINE,501129,501306,13,0.05
ptg028497l,156194,156494,300,RepeatMasker,SINE,156159,156394,200,0.67
ptg028497l,156194,156494,300,RepeatMasker,SINE,156169,156394,200,0.67
ptg028499l,86344,86658,314,RepeatMasker,SINE,86405,86555,151,0.48
ptg028627l,100981,101278,297,RepeatMasker,SINE,101144,101350,135,0.45
ptg028959l,309379,309670,291,RepeatMasker,SINE,309600,309717,71,0.24
ptg029100l,1692865,1693181,316,RepeatMasker,SINE,1693150,1693366,32,0.10
ptg029155l,727957,728260,303,RepeatMasker,SINE,727923,728166,209,0.69
ptg029224l,5936583,5936887,304,RepeatMasker,SINE,5936695,5936923,193,0.63
ptg029286l,66738,67047,309,RepeatMasker,SINE,66752,66883,132,0.43
ptg029303l,225587,225898,311,RepeatMasker,SINE,225393,225618,31,0.10
ptg029449l,304207,304535,328,RepeatMasker,SINE,304019,304236,29,0.09
ptg029873l,312416,312729,313,RepeatMasker,SINE,312383,312489,73,0.23
ptg030732l,227258,227580,322,RepeatMasker,SINE,227394,227615,187,0.58
ptg030927l,947671,947987,316,RepeatMasker,SINE,947476,947705,34,0.11
ptg031542l,28602,28904,302,RepeatMasker,SINE,28843,28935,62,0.21
ptg031584l,1255275,1255606,331,RepeatMasker,SINE,1255413,1255501,89,0.27
ptg031584l,1255275,1255606,331,RepeatMasker,SINE,1255429,1255520,92,0.28
ptg031898l,331357,331654,297,RepeatMasker,SINE,331400,331582,183,0.62
ptg031898l,331357,331654,297,RepeatMasker,SINE,331453,331585,133,0.45
ptg032252l,162552,162850,298,RepeatMasker,SINE,162518,162607,55,0.18
ptg032638l,354084,354400,316,RepeatMasker,SINE,354319,354450,82,0.26
ptg032638l,354084,354400,316,RepeatMasker,SINE,354347,354464,54,0.17
ptg033551l,1417601,1417892,291,RepeatMasker,SINE,1417436,1417607,6,0.02
ptg033723l,321080,321371,291,RepeatMasker,SINE,320883,321116,36,0.12
ptg033912l,295948,296238,290,RepeatMasker,SINE,295918,295984,36,0.12
ptg034284l,93698,94032,334,RepeatMasker,SINE,93752,93872,121,0.36
ptg034293l,607878,608167,289,RepeatMasker,SINE,607844,608077,199,0.69
ptg034460l,39517,39844,327,RepeatMasker,SINE,39469,39555,38,0.12
ptg035535l,119000,119308,308,RepeatMasker,SINE,118970,119133,133,0.43
ptg035823l,177476,177774,298,RepeatMasker,SINE,177599,177647,49,0.16
ptg037569l,196146,196436,290,RepeatMasker,SINE,196319,196483,118,0.41
ptg037615l,2408477,2408734,257,RepeatMasker,SINE,2408623,2408763,112,0.44
ptg037615l,5608029,5608327,298,RepeatMasker,SINE,5607839,5608048,19,0.06
ptg037933l,158798,159098,300,RepeatMasker,SINE,158719,158849,51,0.17
ptg038109l,200329,200639,310,RepeatMasker,SINE,200304,200473,144,0.46
ptg038109l,200329,200639,310,RepeatMasker,SINE,200618,200665,22,0.07
ptg038822l,358146,358439,293,RepeatMasker,SINE,358261,358467,179,0.61
ptg038964l,49094,49369,275,RepeatMasker,SINE,49283,49432,87,0.32
ptg040497l,54716,54996,280,RepeatMasker,SINE,54807,54931,125,0.45
ptg041778l,1043948,1044237,289,RepeatMasker,SINE,1043899,1043985,37,0.13
ptg043603l,119744,120026,282,RepeatMasker,SINE,119893,120006,114,0.40
ptg044963l,18125,18408,283,RepeatMasker,SINE,17925,18157,32,0.11
ptg052241l,1018898,1019233,335,RepeatMasker,SINE,1018813,1018979,81,0.24
ptg052241l,1018898,1019233,335,RepeatMasker,SINE,1018854,1018985,87,0.26
ptg054646l,31944,32223,279,RepeatMasker,SINE,32185,32405,39,0.14
ptg054795l,410824,411127,303,RepeatMasker,SINE,410780,410912,88,0.29
ptg056506l,15268,15598,330,RepeatMasker,SINE,15477,15630,122,0.37
ptg000026l,256548,256836,288,RepeatMasker,SINE,256650,256866,187,0.65
ptg000026l,256548,256836,288,RepeatMasker,SINE,256650,256892,187,0.65
ptg000037l,3218254,3218582,328,RepeatMasker,SINE,3218554,3218751,29,0.09
ptg000043l,285148,285464,316,RepeatMasker,SINE,285263,285339,77,0.24
ptg000044l,451840,452165,325,RepeatMasker,SINE,451902,452028,127,0.39
ptg000048l,6630010,6630310,300,RepeatMasker,SINE,6630116,6630283,168,0.56
ptg000048l,6630010,6630310,300,RepeatMasker,SINE,6630128,6630251,124,0.41
ptg000048l,15017701,15018008,307,RepeatMasker,SINE,15017957,15018031,52,0.17
ptg000069l,4190504,4190777,273,RepeatMasker,SINE,4190316,4190544,40,0.15
ptg000074l,2512735,2513036,301,RepeatMasker,SINE,2512693,2512802,67,0.22
ptg000074l,2512735,2513036,301,RepeatMasker,SINE,2512801,2512870,70,0.23
ptg000074l,2512735,2513036,301,RepeatMasker,SINE,2512875,2513061,162,0.54
ptg000078l,4464208,4464526,318,RepeatMasker,SINE,4464268,4464396,129,0.41
ptg000084l,3051632,3051955,323,RepeatMasker,SINE,3051764,3051978,192,0.59
ptg000089l,75888,76221,333,RepeatMasker,SINE,76079,76169,91,0.27
ptg000104l,6629850,6630168,318,RepeatMasker,SINE,6630131,6630364,38,0.12
ptg000104l,9549707,9550018,311,RepeatMasker,SINE,9549721,9549926,206,0.66
ptg000107l,5926241,5926566,325,RepeatMasker,SINE,5926519,5926651,48,0.15
ptg000122l,4743285,4743555,270,RepeatMasker,SINE,4743471,4743592,85,0.31
ptg000122l,4743285,4743555,270,RepeatMasker,SINE,4743475,4743661,81,0.30
ptg000123l,5411967,5412289,322,RepeatMasker,SINE,5412058,5412265,208,0.65
ptg000125l,66427,66717,290,RepeatMasker,SINE,66471,66693,223,0.77
ptg000130l,1189904,1190210,306,RepeatMasker,SINE,1189867,1189949,45,0.15
ptg000130l,2666449,2666782,333,RepeatMasker,SINE,2666542,2666684,143,0.43
ptg000169l,497508,497829,321,RepeatMasker,SINE,497824,497944,6,0.02
ptg000180l,6686602,6686921,319,RepeatMasker,SINE,6686524,6686652,50,0.16
ptg000215l,2825293,2825572,279,RepeatMasker,SINE,2825257,2825366,73,0.26
ptg000215l,2825293,2825572,279,RepeatMasker,SINE,2825480,2825600,93,0.33
ptg000231l,1558559,1558860,301,RepeatMasker,SINE,1558823,1558890,38,0.13
ptg000234l,2900689,2900999,310,RepeatMasker,SINE,2900800,2900853,54,0.17
ptg000235l,1402501,1402803,302,RepeatMasker,SINE,1402320,1402545,44,0.15
ptg000239l,364508,364814,306,RepeatMasker,SINE,364479,364690,182,0.59
ptg000246l,400396,400686,290,RepeatMasker,SINE,400270,400398,2,0.01
ptg000256l,126010,126348,338,RepeatMasker,SINE,126192,126282,91,0.27
ptg000267l,11909145,11909477,332,RepeatMasker,SINE,11908953,11909182,37,0.11
ptg000268l,521678,521961,283,RepeatMasker,SINE,521652,521694,16,0.06
ptg000286l,3692774,3693072,298,RepeatMasker,SINE,3693015,3693060,46,0.15
ptg000313l,3206982,3207278,296,RepeatMasker,SINE,3206947,3207174,192,0.65
ptg000315l,285192,285482,290,RepeatMasker,SINE,285450,285516,33,0.11
ptg000325l,4005287,4005570,283,RepeatMasker,SINE,4005373,4005596,198,0.70
ptg000337l,3680732,3681042,310,RepeatMasker,SINE,3681005,3681241,38,0.12
ptg000337l,13038797,13039102,305,RepeatMasker,SINE,13038623,13038840,43,0.14
ptg000359l,3249903,3250216,313,RepeatMasker,SINE,3249953,3250019,67,0.21
ptg000359l,3249903,3250216,313,RepeatMasker,SINE,3250068,3250194,127,0.41
ptg000359l,3249903,3250216,313,RepeatMasker,SINE,3250068,3250243,149,0.48
ptg000367l,1313126,1313423,297,RepeatMasker,SINE,1313140,1313189,50,0.17
ptg000373l,2837679,2837963,284,RepeatMasker,SINE,2837594,2837706,27,0.10
ptg000383l,136559,136860,301,RepeatMasker,SINE,136637,136734,98,0.33
ptg000393l,2134997,2135314,317,RepeatMasker,SINE,2135225,2135448,90,0.28
ptg000395l,728697,728969,272,RepeatMasker,SINE,728657,728788,91,0.33
ptg000395l,728697,728969,272,RepeatMasker,SINE,728882,729004,88,0.32
ptg000407l,3550951,3551276,325,RepeatMasker,SINE,3551242,3551412,35,0.11
ptg000412l,1261548,1261864,316,RepeatMasker,SINE,1261683,1261814,132,0.42
ptg000434l,605022,605336,314,RepeatMasker,SINE,605303,605525,34,0.11
ptg000472l,3819918,3820211,293,RepeatMasker,SINE,3820065,3820194,130,0.44
ptg000475l,578554,578873,319,RepeatMasker,SINE,578679,578810,132,0.41
ptg000476l,466566,466892,326,RepeatMasker,SINE,466391,466605,39,0.12
ptg000522l,2252518,2252824,306,RepeatMasker,SINE,2252790,2252839,35,0.11
ptg000523l,573267,573574,307,RepeatMasker,SINE,573541,573765,34,0.11
ptg000523l,5758194,5758517,323,RepeatMasker,SINE,5758438,5758556,80,0.25
ptg000523l,5758194,5758517,323,RepeatMasker,SINE,5758438,5758601,80,0.25
ptg000523l,5758194,5758517,323,RepeatMasker,SINE,5758451,5758556,67,0.21
ptg000532l,1106082,1106408,326,RepeatMasker,SINE,1106210,1106440,199,0.61
ptg000558l,3503073,3503384,311,RepeatMasker,SINE,3503350,3503582,35,0.11
ptg000558l,4072376,4072710,334,RepeatMasker,SINE,4072465,4072593,129,0.39
ptg000573l,2169130,2169416,286,RepeatMasker,SINE,2169040,2169177,47,0.16
ptg000592l,3197885,3198201,316,RepeatMasker,SINE,3197856,3197929,44,0.14
ptg000635l,352553,352879,326,RepeatMasker,SINE,352624,352747,124,0.38
ptg000636l,250929,251226,297,RepeatMasker,SINE,251189,251426,38,0.13
ptg000653l,2550530,2550834,304,RepeatMasker,SINE,2550489,2550726,196,0.64
ptg000662l,1271765,1272064,299,RepeatMasker,SINE,1271729,1271962,197,0.66
ptg000702l,1250259,1250564,305,RepeatMasker,SINE,1250072,1250297,38,0.12
ptg000731l,465370,465665,295,RepeatMasker,SINE,465433,465553,121,0.41
ptg000731l,465370,465665,295,RepeatMasker,SINE,465447,465553,107,0.36
ptg000738l,1439843,1440150,307,RepeatMasker,SINE,1439952,1440174,199,0.65
ptg000748l,598277,598598,321,RepeatMasker,SINE,598272,598313,36,0.11
ptg000750l,1956450,1956733,283,RepeatMasker,SINE,1956700,1956947,34,0.12
ptg000751l,190864,191202,338,RepeatMasker,SINE,190823,190933,69,0.20
ptg000788l,2827060,2827384,324,RepeatMasker,SINE,2827033,2827082,22,0.07
ptg000788l,2827060,2827384,324,RepeatMasker,SINE,2827039,2827082,22,0.07
ptg000795l,2994971,2995278,307,RepeatMasker,SINE,2995219,2995303,60,0.20
ptg000802l,6916869,6917155,286,RepeatMasker,SINE,6916925,6917041,117,0.41
ptg000802l,6916869,6917155,286,RepeatMasker,SINE,6916925,6917082,158,0.55
ptg000811l,2717698,2718002,304,RepeatMasker,SINE,2717577,2717730,32,0.11
ptg000811l,3245956,3246244,288,RepeatMasker,SINE,3246214,3246435,31,0.11
ptg000830l,295396,295715,319,RepeatMasker,SINE,295315,295425,29,0.09
ptg000842l,2010643,2010968,325,RepeatMasker,SINE,2010860,2011010,109,0.34
ptg000842l,2010643,2010968,325,RepeatMasker,SINE,2010861,2011041,108,0.33
ptg000847l,4884898,4885202,304,RepeatMasker,SINE,4884819,4884941,43,0.14
ptg000857l,425253,425515,262,RepeatMasker,SINE,425070,425288,35,0.13
ptg000857l,425253,425515,262,RepeatMasker,SINE,425093,425286,33,0.13
ptg000868l,1782867,1783164,297,RepeatMasker,SINE,1782746,1782878,11,0.04
ptg000885l,3415073,3415335,262,RepeatMasker,SINE,3415042,3415266,193,0.74
ptg000893l,811096,811359,263,RepeatMasker,SINE,811173,811380,187,0.71
ptg000893l,4537373,4537685,312,RepeatMasker,SINE,4537184,4537415,42,0.13
ptg000893l,5122501,5122809,308,RepeatMasker,SINE,5122775,5123009,35,0.11
ptg000894l,564903,565202,299,RepeatMasker,SINE,565187,565235,16,0.05
ptg000894l,564903,565202,299,RepeatMasker,SINE,565187,565251,16,0.05
ptg000934l,2021132,2021440,308,RepeatMasker,SINE,2021119,2021172,40,0.13
ptg000937l,6197452,6197753,301,RepeatMasker,SINE,6197706,6197837,48,0.16
ptg000948l,2426730,2427048,318,RepeatMasker,SINE,2427015,2427228,34,0.11
ptg000967l,2676587,2676915,328,RepeatMasker,SINE,2676878,2676996,38,0.12
ptg000967l,3109491,3109780,289,RepeatMasker,SINE,3109440,3109530,39,0.13
ptg000967l,3109491,3109780,289,RepeatMasker,SINE,3109756,3109863,25,0.09
ptg000973l,974580,974907,327,RepeatMasker,SINE,974553,974702,122,0.37
ptg000983l,63866,64172,306,RepeatMasker,SINE,64135,64244,38,0.12
ptg000984l,5375264,5375595,331,RepeatMasker,SINE,5375240,5375315,51,0.15
ptg001001l,2610348,2610628,280,RepeatMasker,SINE,2610424,2610491,68,0.24
ptg001002l,456015,456349,334,RepeatMasker,SINE,455920,456057,42,0.13
ptg001003l,804328,804658,330,RepeatMasker,SINE,804302,804371,43,0.13
ptg001006l,407792,408091,299,RepeatMasker,SINE,407756,407989,197,0.66
ptg001039l,6004944,6005276,332,RepeatMasker,SINE,6004838,6004984,40,0.12
ptg001059l,5160089,5160382,293,RepeatMasker,SINE,5160337,5160384,46,0.16
ptg001093l,6764646,6764950,304,RepeatMasker,SINE,6764683,6764760,78,0.26
ptg001093l,6764646,6764950,304,RepeatMasker,SINE,6764931,6765131,20,0.07
ptg001097l,1709481,1709777,296,RepeatMasker,SINE,1709744,1709980,34,0.11
ptg001121l,856130,856430,300,RepeatMasker,SINE,856093,856157,27,0.09
ptg001122l,5290414,5290708,294,RepeatMasker,SINE,5290689,5290734,20,0.07
ptg001132l,4595124,4595423,299,RepeatMasker,SINE,4594935,4595164,40,0.13
ptg001139l,703182,703509,327,RepeatMasker,SINE,703417,703672,93,0.28
ptg001139l,703182,703509,327,RepeatMasker,SINE,703477,703682,33,0.10
ptg001154l,1031712,1031995,283,RepeatMasker,SINE,1031958,1032191,38,0.13
ptg001161l,4679419,4679719,300,RepeatMasker,SINE,4679388,4679611,192,0.64
ptg001162l,1009513,1009807,294,RepeatMasker,SINE,1009723,1009815,85,0.29
ptg001188l,1080101,1080428,327,RepeatMasker,SINE,1080228,1080459,201,0.61
ptg001208l,4850701,4851018,317,RepeatMasker,SINE,4850977,4851207,42,0.13
ptg001208l,4872839,4873145,306,RepeatMasker,SINE,4873116,4873181,30,0.10
ptg001223l,5232360,5232682,322,RepeatMasker,SINE,5232321,5232405,45,0.14
ptg001237l,2590310,2590638,328,RepeatMasker,SINE,2590122,2590342,32,0.10
ptg001270l,585693,585986,293,RepeatMasker,SINE,585584,585818,125,0.43
ptg001294l,479780,480099,319,RepeatMasker,SINE,479900,480105,200,0.63
ptg001316l,3012927,3013259,332,RepeatMasker,SINE,3013084,3013272,176,0.53
ptg001326l,733161,733477,316,RepeatMasker,SINE,733277,733507,201,0.64
ptg001353l,2888545,2888835,290,RepeatMasker,SINE,2888639,2888806,168,0.58
ptg001353l,2888545,2888835,290,RepeatMasker,SINE,2888648,2888779,132,0.46
ptg001369l,2507100,2507420,320,RepeatMasker,SINE,2506910,2507140,40,0.13
ptg001371l,651034,651334,300,RepeatMasker,SINE,650842,651065,31,0.10
ptg001371l,9117314,9117605,291,RepeatMasker,SINE,9117229,9117348,34,0.12
ptg001381l,4643369,4643693,324,RepeatMasker,SINE,4643429,4643560,132,0.41
ptg001390l,4490130,4490447,317,RepeatMasker,SINE,4490145,4490276,132,0.42
ptg001406l,3270617,3270925,308,RepeatMasker,SINE,3270424,3270656,39,0.13
ptg001420l,15122,15440,318,RepeatMasker,SINE,15025,15165,43,0.14
ptg001426l,4266128,4266413,285,RepeatMasker,SINE,4266380,4266590,34,0.12
ptg001426l,4699349,4699667,318,RepeatMasker,SINE,4699446,4699533,88,0.28
ptg001426l,4699349,4699667,318,RepeatMasker,SINE,4699627,4699708,41,0.13
ptg001429l,836065,836391,326,RepeatMasker,SINE,836303,836425,89,0.27
ptg001429l,836065,836391,326,RepeatMasker,SINE,836310,836485,82,0.25
ptg001430l,1836170,1836495,325,RepeatMasker,SINE,1835976,1836210,40,0.12
ptg001456l,1919546,1919841,295,RepeatMasker,SINE,1919509,1919743,197,0.67
ptg001465l,867017,867313,296,RepeatMasker,SINE,867266,867396,48,0.16
ptg001481l,2897075,2897403,328,RepeatMasker,SINE,2897019,2897118,43,0.13
ptg001481l,2897075,2897403,328,RepeatMasker,SINE,2897085,2897134,50,0.15
ptg001491l,1135605,1135876,271,RepeatMasker,SINE,1135574,1135780,175,0.65
ptg001512l,938176,938464,288,RepeatMasker,SINE,938160,938262,86,0.30
ptg001515l,1215833,1216124,291,RepeatMasker,SINE,1215932,1216157,193,0.66
ptg001518l,82885,83205,320,RepeatMasker,SINE,82838,82991,106,0.33
ptg001518l,5376441,5376734,293,RepeatMasker,SINE,5376618,5376713,96,0.33
ptg001518l,5376441,5376734,293,RepeatMasker,SINE,5376662,5376716,55,0.19
ptg001531l,3147302,3147589,287,RepeatMasker,SINE,3147215,3147359,57,0.20
ptg001552l,2886204,2886522,318,RepeatMasker,SINE,2886323,2886556,200,0.63
ptg001564l,2293270,2293574,304,RepeatMasker,SINE,2293325,2293456,132,0.43
ptg001567l,2649582,2649880,298,RepeatMasker,SINE,2649546,2649772,190,0.64
ptg001569l,100315,100583,268,RepeatMasker,SINE,100495,100628,89,0.33
ptg001582l,1598307,1598613,306,RepeatMasker,SINE,1598576,1598667,38,0.12
ptg001583l,1342960,1343258,298,RepeatMasker,SINE,1343097,1343228,132,0.44
ptg001590l,639764,640039,275,RepeatMasker,SINE,639569,639803,39,0.14
ptg001606l,2324984,2325281,297,RepeatMasker,SINE,2325090,2325309,192,0.65
ptg001606l,2421517,2421801,284,RepeatMasker,SINE,2421324,2421550,33,0.12
ptg001607l,2178915,2179199,284,RepeatMasker,SINE,2179165,2179380,35,0.12
ptg001643l,3351162,3351453,291,RepeatMasker,SINE,3351125,3351355,193,0.66
ptg001682l,2568937,2569253,316,RepeatMasker,SINE,2569004,2569135,132,0.42
ptg001690l,622702,623025,323,RepeatMasker,SINE,622551,622787,85,0.26
ptg001711l,2699767,2700082,315,RepeatMasker,SINE,2699731,2699958,191,0.61
ptg001716l,520705,521005,300,RepeatMasker,SINE,520708,520832,125,0.42
ptg001740l,3990764,3991083,319,RepeatMasker,SINE,3990944,3991074,131,0.41
ptg001762l,2865272,2865596,324,RepeatMasker,SINE,2865245,2865409,137,0.42
ptg001789l,181115,181385,270,RepeatMasker,SINE,181298,181429,88,0.33
ptg001789l,181115,181385,270,RepeatMasker,SINE,181301,181470,85,0.31
ptg001792l,3782448,3782715,267,RepeatMasker,SINE,3782486,3782593,108,0.40
ptg001794l,400101,400380,279,RepeatMasker,SINE,400349,400575,32,0.11
ptg001836l,1739363,1739669,306,RepeatMasker,SINE,1739317,1739534,171,0.56
ptg001851l,5770891,5771192,301,RepeatMasker,SINE,5771117,5771226,76,0.25
ptg001863l,4318941,4319269,328,RepeatMasker,SINE,4318914,4319044,103,0.31
ptg001890l,1217814,1218078,264,RepeatMasker,SINE,1217836,1217892,57,0.22
ptg001908l,1265452,1265742,290,RepeatMasker,SINE,1265350,1265483,31,0.11
ptg001908l,1385541,1385850,309,RepeatMasker,SINE,1385522,1385603,62,0.20
ptg001911l,2132489,2132808,319,RepeatMasker,SINE,2132428,2132529,40,0.13
ptg001916l,230298,230607,309,RepeatMasker,SINE,230441,230515,75,0.24
ptg001916l,230298,230607,309,RepeatMasker,SINE,230453,230512,60,0.19
ptg001916l,230298,230607,309,RepeatMasker,SINE,230464,230570,107,0.35
ptg001921l,1416728,1417008,280,RepeatMasker,SINE,1416957,1417088,52,0.19
ptg001936l,5261219,5261505,286,RepeatMasker,SINE,5261441,5261697,65,0.23
ptg001936l,5261219,5261505,286,RepeatMasker,SINE,5261468,5261702,38,0.13
ptg001938l,1887164,1887492,328,RepeatMasker,SINE,1887145,1887361,197,0.60
ptg001944l,368104,368425,321,RepeatMasker,SINE,368000,368130,26,0.08
ptg001963l,1024302,1024571,269,RepeatMasker,SINE,1024110,1024338,36,0.13
ptg001963l,1024302,1024571,269,RepeatMasker,SINE,1024337,1024398,62,0.23
ptg001968l,450842,451155,313,RepeatMasker,SINE,451104,451232,52,0.17
ptg001985l,2399776,2400050,274,RepeatMasker,SINE,2399731,2399883,107,0.39
ptg001992l,2569338,2569629,291,RepeatMasker,SINE,2569596,2569658,34,0.12
ptg002018l,128869,129195,326,RepeatMasker,SINE,128993,129223,203,0.62
ptg002018l,777326,777623,297,RepeatMasker,SINE,777541,777671,83,0.28
ptg002023l,1811415,1811689,274,RepeatMasker,SINE,1811379,1811603,188,0.69
ptg002034l,1495233,1495514,281,RepeatMasker,SINE,1495312,1495543,203,0.72
ptg002042l,127745,128051,306,RepeatMasker,SINE,127882,128011,130,0.42
ptg002051l,3239040,3239344,304,RepeatMasker,SINE,3239288,3239372,57,0.19
ptg002062l,604693,605009,316,RepeatMasker,SINE,604519,604726,33,0.10
ptg002064l,4715570,4715906,336,RepeatMasker,SINE,4715409,4715613,43,0.13
ptg002069l,303171,303461,290,RepeatMasker,SINE,303264,303464,198,0.68
ptg002071l,651801,652100,299,RepeatMasker,SINE,651771,651985,184,0.62
ptg002071l,651801,652100,299,RepeatMasker,SINE,652068,652292,33,0.11
ptg002087l,986548,986824,276,RepeatMasker,SINE,986576,986707,132,0.48
ptg002087l,986548,986824,276,RepeatMasker,SINE,986609,986724,116,0.42
ptg002087l,1225796,1226101,305,RepeatMasker,SINE,1225752,1225838,42,0.14
ptg002087l,4809027,4809294,267,RepeatMasker,SINE,4809085,4809165,81,0.30
ptg002100l,5708943,5709216,273,RepeatMasker,SINE,5708907,5709138,195,0.71
ptg002116l,1917066,1917391,325,RepeatMasker,SINE,1917192,1917419,200,0.62
ptg002124l,1969764,1970060,296,RepeatMasker,SINE,1969728,1969932,168,0.57
ptg002129l,2931311,2931613,302,RepeatMasker,SINE,2931582,2931813,32,0.11
ptg002141l,5667216,5667528,312,RepeatMasker,SINE,5667493,5667729,36,0.12
ptg002143l,1995747,1996052,305,RepeatMasker,SINE,1995710,1995874,127,0.42
ptg002143l,1995747,1996052,305,RepeatMasker,SINE,1996016,1996083,37,0.12
ptg002165l,1172735,1173039,304,RepeatMasker,SINE,1172561,1172790,55,0.18
ptg002169l,2005470,2005769,299,RepeatMasker,SINE,2005711,2005947,59,0.20
ptg002169l,2005470,2005769,299,RepeatMasker,SINE,2005736,2005953,34,0.11
ptg002195l,1465717,1466026,309,RepeatMasker,SINE,1465833,1465907,75,0.24
ptg002195l,1465717,1466026,309,RepeatMasker,SINE,1465833,1465934,102,0.33
ptg002198l,1483088,1483359,271,RepeatMasker,SINE,1483045,1483289,201,0.74
ptg002205l,1000492,1000794,302,RepeatMasker,SINE,1000456,1000677,185,0.61
ptg002225l,1798965,1799246,281,RepeatMasker,SINE,1799056,1799155,100,0.36
ptg002225l,1798965,1799246,281,RepeatMasker,SINE,1799062,1799188,127,0.45
ptg002228l,106248,106545,297,RepeatMasker,SINE,106215,106440,192,0.65
ptg002228l,349981,350291,310,RepeatMasker,SINE,350254,350482,38,0.12
ptg002275l,1322692,1323017,325,RepeatMasker,SINE,1322984,1323186,34,0.10
ptg002279l,618844,619164,320,RepeatMasker,SINE,618800,619040,196,0.61
ptg002305l,1680201,1680474,273,RepeatMasker,SINE,1680154,1680378,177,0.65
ptg002311l,785483,785791,308,RepeatMasker,SINE,785709,785839,83,0.27
ptg002315l,1607829,1608141,312,RepeatMasker,SINE,1608094,1608220,48,0.15
ptg002322l,148554,148854,300,RepeatMasker,SINE,148481,148606,52,0.17
ptg002339l,427106,427417,311,RepeatMasker,SINE,426987,427127,21,0.07
ptg002358l,2776335,2776626,291,RepeatMasker,SINE,2776147,2776380,45,0.15
ptg002442l,1108052,1108372,320,RepeatMasker,SINE,1108233,1108363,131,0.41
ptg002459l,1217155,1217463,308,RepeatMasker,SINE,1217010,1217188,33,0.11
ptg002476l,1209348,1209652,304,RepeatMasker,SINE,1209622,1209851,31,0.10
ptg002484l,740482,740773,291,RepeatMasker,SINE,740637,740768,132,0.45
ptg002485l,81955,82261,306,RepeatMasker,SINE,82061,82295,201,0.66
ptg002489l,253485,253780,295,RepeatMasker,SINE,253430,253554,69,0.23
ptg002518l,1319262,1319589,327,RepeatMasker,SINE,1319553,1319693,37,0.11
ptg002519l,784760,785076,316,RepeatMasker,SINE,784871,784948,78,0.25
ptg002519l,784760,785076,316,RepeatMasker,SINE,784871,784967,97,0.31
ptg002526l,1813718,1814020,302,RepeatMasker,SINE,1813527,1813757,39,0.13
ptg002527l,5274584,5274888,304,RepeatMasker,SINE,5274858,5275082,31,0.10
ptg002534l,3233174,3233456,282,RepeatMasker,SINE,3233141,3233370,196,0.70
ptg002540l,691886,692158,272,RepeatMasker,SINE,691962,692191,197,0.72
ptg002540l,2216772,2217093,321,RepeatMasker,SINE,2216763,2216877,105,0.33
ptg002540l,2216772,2217093,321,RepeatMasker,SINE,2216789,2216881,93,0.29
ptg002552l,2043358,2043653,295,RepeatMasker,SINE,2043323,2043479,121,0.41
ptg002588l,2433477,2433754,277,RepeatMasker,SINE,2433433,2433655,178,0.64
ptg002590l,393035,393340,305,RepeatMasker,SINE,393263,393373,78,0.26
ptg002632l,2607380,2607702,322,RepeatMasker,SINE,2607667,2607897,36,0.11
ptg002655l,854842,855174,332,RepeatMasker,SINE,854810,855038,196,0.59
ptg002656l,1109978,1110280,302,RepeatMasker,SINE,1109942,1110049,71,0.24
ptg002656l,1109978,1110280,302,RepeatMasker,SINE,1110096,1110307,185,0.61
ptg002658l,54607,54928,321,RepeatMasker,SINE,54611,54694,84,0.26
ptg002660l,4114785,4115070,285,RepeatMasker,SINE,4114874,4114988,115,0.40
ptg002678l,39387,39701,314,RepeatMasker,SINE,39458,39566,109,0.35
ptg002692l,20299,20614,315,RepeatMasker,SINE,20274,20388,89,0.28
ptg002732l,4396854,4397173,319,RepeatMasker,SINE,4396804,4396948,94,0.29
ptg002732l,4396854,4397173,319,RepeatMasker,SINE,4396830,4396948,94,0.29
ptg002732l,5246029,5246357,328,RepeatMasker,SINE,5245998,5246207,178,0.54
ptg002732l,5246029,5246357,328,RepeatMasker,SINE,5246326,5246552,32,0.10
ptg002749l,798611,798904,293,RepeatMasker,SINE,798484,798645,34,0.12
ptg002749l,798611,798904,293,RepeatMasker,SINE,798515,798646,35,0.12
ptg002828l,84574,84857,283,RepeatMasker,SINE,84546,84670,96,0.34
ptg002831l,2071973,2072257,284,RepeatMasker,SINE,2072113,2072240,128,0.45
ptg002834l,283916,284212,296,RepeatMasker,SINE,283994,284221,219,0.74
ptg002839l,2258503,2258825,322,RepeatMasker,SINE,2258795,2259020,31,0.10
ptg002858l,3954819,3955100,281,RepeatMasker,SINE,3954769,3955011,192,0.68
ptg002888l,951779,952094,315,RepeatMasker,SINE,951742,951959,180,0.57
ptg002924l,171495,171829,334,RepeatMasker,SINE,171306,171538,43,0.13
ptg002929l,510784,511059,275,RepeatMasker,SINE,511024,511256,36,0.13
ptg002938l,78633,78931,298,RepeatMasker,SINE,78689,78823,135,0.45
ptg002959l,1118159,1118457,298,RepeatMasker,SINE,1118263,1118489,195,0.65
ptg002978l,2795583,2795910,327,RepeatMasker,SINE,2795392,2795622,39,0.12
ptg002983l,2174501,2174772,271,RepeatMasker,SINE,2174744,2174960,29,0.11
ptg003006l,871394,871678,284,RepeatMasker,SINE,871378,871520,126,0.44
ptg003014l,675966,676263,297,RepeatMasker,SINE,675794,676001,35,0.12
ptg003025l,250610,250909,299,RepeatMasker,SINE,250654,250750,97,0.32
ptg003040l,2428483,2428803,320,RepeatMasker,SINE,2428722,2428796,75,0.23
ptg003040l,2428483,2428803,320,RepeatMasker,SINE,2428723,2428879,81,0.25
ptg003040l,2431720,2431990,270,RepeatMasker,SINE,2431684,2431808,88,0.33
ptg003079l,152674,152996,322,RepeatMasker,SINE,152908,153040,89,0.28
ptg003081l,95283,95596,313,RepeatMasker,SINE,95577,95795,20,0.06
ptg003085l,1955866,1956183,317,RepeatMasker,SINE,1955831,1955887,21,0.07
ptg003090l,1424416,1424706,290,RepeatMasker,SINE,1424669,1424903,38,0.13
ptg003096l,1266775,1267089,314,RepeatMasker,SINE,1267031,1267115,59,0.19
ptg003099l,898377,898704,327,RepeatMasker,SINE,898504,898732,201,0.61
ptg003118l,1894738,1895028,290,RepeatMasker,SINE,1894998,1895099,31,0.11
ptg003121l,1188699,1188978,279,RepeatMasker,SINE,1188915,1189091,64,0.23
ptg003125l,1034088,1034364,276,RepeatMasker,SINE,1033895,1034132,44,0.16
ptg003134l,3188524,3188810,286,RepeatMasker,SINE,3188484,3188668,144,0.50
ptg003134l,3188524,3188810,286,RepeatMasker,SINE,3188485,3188612,88,0.31
ptg003134l,3787393,3787652,259,RepeatMasker,SINE,3787372,3787531,138,0.53
ptg003138l,1716242,1716562,320,RepeatMasker,SINE,1716366,1716587,197,0.62
ptg003141l,333737,334031,294,RepeatMasker,SINE,333710,333849,112,0.38
ptg003202l,360988,361277,289,RepeatMasker,SINE,361237,361467,41,0.14
ptg003208l,1222228,1222539,311,RepeatMasker,SINE,1222059,1222264,36,0.12
ptg003216l,381920,382204,284,RepeatMasker,SINE,382000,382235,205,0.72
ptg003224l,1628912,1629205,293,RepeatMasker,SINE,1629043,1629133,91,0.31
ptg003280l,2601052,2601325,273,RepeatMasker,SINE,2601289,2601520,37,0.14
ptg003287l,280131,280458,327,RepeatMasker,SINE,280225,280356,132,0.40
ptg003294l,263916,264216,300,RepeatMasker,SINE,264177,264235,40,0.13
ptg003297l,1806021,1806322,301,RepeatMasker,SINE,1806291,1806505,32,0.11
ptg003299l,1433827,1434102,275,RepeatMasker,SINE,1433801,1433943,116,0.42
ptg003312l,4356797,4357120,323,RepeatMasker,SINE,4356915,4357157,206,0.64
ptg003354l,956318,956588,270,RepeatMasker,SINE,956297,956407,89,0.33
ptg003359l,634230,634498,268,RepeatMasker,SINE,634415,634546,84,0.31
ptg003389l,2561483,2561787,304,RepeatMasker,SINE,2561586,2561821,202,0.66
ptg003408l,3395205,3395503,298,RepeatMasker,SINE,3395209,3395275,67,0.22
ptg003416l,8973,9254,281,RepeatMasker,SINE,9130,9193,64,0.23
ptg003416l,8973,9254,281,RepeatMasker,SINE,9131,9180,50,0.18
ptg003438l,540607,540907,300,RepeatMasker,SINE,540819,540951,89,0.30
ptg003440l,205470,205781,311,RepeatMasker,SINE,205745,205831,37,0.12
ptg003463l,809800,810116,316,RepeatMasker,SINE,809769,809823,23,0.07
ptg003486l,1190582,1190867,285,RepeatMasker,SINE,1190830,1191045,38,0.13
ptg003517l,2316245,2316543,298,RepeatMasker,SINE,2316509,2316741,35,0.12
ptg003519l,3636422,3636706,284,RepeatMasker,SINE,3636526,3636569,44,0.15
ptg003526l,5113358,5113656,298,RepeatMasker,SINE,5113625,5113857,32,0.11
ptg003537l,2214722,2215016,294,RepeatMasker,SINE,2214911,2215048,106,0.36
ptg003544l,2081612,2081889,277,RepeatMasker,SINE,2081532,2081690,78,0.28
ptg003544l,2081612,2081889,277,RepeatMasker,SINE,2081557,2081684,72,0.26
ptg003554l,531625,531938,313,RepeatMasker,SINE,531893,532022,46,0.15
ptg003575l,179685,180008,323,RepeatMasker,SINE,179711,179792,82,0.25
ptg003575l,179685,180008,323,RepeatMasker,SINE,179711,179845,135,0.42
ptg003588l,140692,141005,313,RepeatMasker,SINE,140789,140916,128,0.41
ptg003588l,140692,141005,313,RepeatMasker,SINE,140796,140971,176,0.56
ptg003634l,1621456,1621791,335,RepeatMasker,SINE,1621758,1621959,34,0.10
ptg003634l,11113618,11113900,282,RepeatMasker,SINE,11113581,11113806,188,0.67
ptg003652l,987287,987591,304,RepeatMasker,SINE,987260,987331,44,0.14
ptg003675l,1141350,1141660,310,RepeatMasker,SINE,1141430,1141561,132,0.43
ptg003726l,77510,77788,278,RepeatMasker,SINE,77615,77702,88,0.32
ptg003737l,2651667,2651972,305,RepeatMasker,SINE,2651925,2652007,48,0.16
ptg003741l,2441585,2441851,266,RepeatMasker,SINE,2441738,2441841,104,0.39
ptg003784l,1879745,1880055,310,RepeatMasker,SINE,1879816,1879939,124,0.40
ptg003816l,411990,412294,304,RepeatMasker,SINE,412206,412338,89,0.29
ptg003839l,9359240,9359526,286,RepeatMasker,SINE,9359196,9359314,74,0.26
ptg003839l,9359240,9359526,286,RepeatMasker,SINE,9359199,9359337,97,0.34
ptg003873l,656801,657125,324,RepeatMasker,SINE,656770,656893,92,0.28
ptg003873l,656801,657125,324,RepeatMasker,SINE,656772,656910,109,0.34
ptg003876l,483785,484088,303,RepeatMasker,SINE,484051,484284,38,0.13
ptg003876l,1321563,1321842,279,RepeatMasker,SINE,1321759,1321890,84,0.30
ptg003878l,4929057,4929369,312,RepeatMasker,SINE,4929331,4929443,39,0.13
ptg003880l,910839,911143,304,RepeatMasker,SINE,911113,911162,31,0.10
ptg003892l,1075924,1076234,310,RepeatMasker,SINE,1075745,1075965,41,0.13
ptg003894l,2697778,2698076,298,RepeatMasker,SINE,2698057,2698270,20,0.07
ptg003950l,2909704,2910027,323,RepeatMasker,SINE,2909998,2910116,30,0.09
ptg004002l,472966,473288,322,RepeatMasker,SINE,473084,473322,205,0.64
ptg004008l,1597303,1597590,287,RepeatMasker,SINE,1597390,1597615,201,0.70
ptg004008l,3341443,3341733,290,RepeatMasker,SINE,3341413,3341637,194,0.67
ptg004008l,3341443,3341733,290,RepeatMasker,SINE,3341638,3341761,96,0.33
ptg004008l,3341443,3341733,290,RepeatMasker,SINE,3341661,3341775,73,0.25
ptg004012l,3337233,3337527,294,RepeatMasker,SINE,3337315,3337381,67,0.23
ptg004022l,2545377,2545652,275,RepeatMasker,SINE,2545338,2545500,123,0.45
ptg004022l,4886144,4886412,268,RepeatMasker,SINE,4886082,4886188,44,0.16
ptg004022l,4886144,4886412,268,RepeatMasker,SINE,4886098,4886192,48,0.18
ptg004047l,606202,606515,313,RepeatMasker,SINE,606327,606454,128,0.41
ptg004047l,606202,606515,313,RepeatMasker,SINE,606327,606495,169,0.54
ptg004058l,1230939,1231262,323,RepeatMasker,SINE,1230966,1231032,67,0.21
ptg004070l,1354699,1355022,323,RepeatMasker,SINE,1354824,1355057,199,0.62
ptg004072l,4501115,4501438,323,RepeatMasker,SINE,4501016,4501136,21,0.07
ptg004072l,4501115,4501438,323,RepeatMasker,SINE,4501156,4501306,151,0.47
ptg004101l,607289,607568,279,RepeatMasker,SINE,607531,607644,38,0.14
ptg004111l,2793569,2793875,306,RepeatMasker,SINE,2793596,2793727,132,0.43
ptg004123l,2382935,2383263,328,RepeatMasker,SINE,2383216,2383343,48,0.15
ptg004172l,1319711,1320055,344,RepeatMasker,SINE,1319821,1319952,132,0.38
ptg004172l,3022893,3023163,270,RepeatMasker,SINE,3022857,3023076,183,0.68
ptg004172l,3022893,3023163,270,RepeatMasker,SINE,3023123,3023328,41,0.15
ptg004233l,571364,571704,340,RepeatMasker,SINE,571441,571558,118,0.35
ptg004233l,3422416,3422700,284,RepeatMasker,SINE,3422547,3422616,70,0.25
ptg004250l,220162,220462,300,RepeatMasker,SINE,220427,220647,36,0.12
ptg004256l,84229,84540,311,RepeatMasker,SINE,84346,84568,195,0.63
ptg004261l,2393870,2394191,321,RepeatMasker,SINE,2393993,2394225,199,0.62
ptg004261l,2393870,2394191,321,RepeatMasker,SINE,2393997,2394265,195,0.61
ptg004322l,219579,219865,286,RepeatMasker,SINE,219547,219740,161,0.56
ptg004322l,219579,219865,286,RepeatMasker,SINE,219830,219902,36,0.13
ptg004327l,4245772,4246034,262,RepeatMasker,SINE,4246034,4246164,1,0.00
ptg004338l,741080,741405,325,RepeatMasker,SINE,741164,741292,129,0.40
ptg004338l,741080,741405,325,RepeatMasker,SINE,741167,741353,187,0.58
ptg004348l,431041,431367,326,RepeatMasker,SINE,431332,431551,36,0.11
ptg004365l,937779,938047,268,RepeatMasker,SINE,938011,938176,37,0.14
ptg004385l,533310,533615,305,RepeatMasker,SINE,533596,533789,20,0.07
ptg004402l,1378849,1379160,311,RepeatMasker,SINE,1378956,1379189,205,0.66
ptg004409l,1561620,1561934,314,RepeatMasker,SINE,1561916,1561972,19,0.06
ptg004409l,2409042,2409328,286,RepeatMasker,SINE,2409017,2409130,88,0.31
ptg004422l,1154876,1155165,289,RepeatMasker,SINE,1155051,1155100,50,0.17
ptg004428l,2570060,2570328,268,RepeatMasker,SINE,2570111,2570243,133,0.50
ptg004428l,2570060,2570328,268,RepeatMasker,SINE,2570113,2570301,189,0.71
ptg004513l,1014871,1015184,313,RepeatMasker,SINE,1014743,1014924,53,0.17
ptg004533l,476671,476920,249,RepeatMasker,SINE,476674,476841,168,0.67
ptg004544l,4946086,4946390,304,RepeatMasker,SINE,4946360,4946587,31,0.10
ptg004584l,1941651,1941963,312,RepeatMasker,SINE,1941622,1941799,148,0.47
ptg004619l,3517186,3517494,308,RepeatMasker,SINE,3517094,3517226,40,0.13
ptg004620l,3613145,3613443,298,RepeatMasker,SINE,3613396,3613519,48,0.16
ptg004627l,166842,167141,299,RepeatMasker,SINE,167104,167338,38,0.13
ptg004636l,146872,147196,324,RepeatMasker,SINE,146977,147099,123,0.38
ptg004636l,146872,147196,324,RepeatMasker,SINE,146977,147151,175,0.54
ptg004642l,1424554,1424889,335,RepeatMasker,SINE,1424631,1424710,80,0.24
ptg004650l,2049918,2050226,308,RepeatMasker,SINE,2050177,2050233,50,0.16
ptg004650l,2049918,2050226,308,RepeatMasker,SINE,2050191,2050235,36,0.12
ptg004667l,3280121,3280395,274,RepeatMasker,SINE,3280099,3280211,90,0.33
ptg004681l,1427683,1427997,314,RepeatMasker,SINE,1427498,1427708,25,0.08
ptg004712l,2540239,2540566,327,RepeatMasker,SINE,2540051,2540260,21,0.06
ptg004712l,2540239,2540566,327,RepeatMasker,SINE,2540267,2540368,102,0.31
ptg004733l,443376,443639,263,RepeatMasker,SINE,443285,443425,49,0.19
ptg004752l,2996991,2997300,309,RepeatMasker,SINE,2996975,2997138,147,0.48
ptg004760l,726303,726599,296,RepeatMasker,SINE,726386,726629,214,0.72
ptg004788l,3778269,3778558,289,RepeatMasker,SINE,3778339,3778421,83,0.29
ptg004819l,852290,852581,291,RepeatMasker,SINE,852254,852483,193,0.66
ptg004827l,465390,465696,306,RepeatMasker,SINE,465494,465725,203,0.66
ptg004874l,539498,539800,302,RepeatMasker,SINE,539620,539687,68,0.23
ptg004874l,539498,539800,302,RepeatMasker,SINE,539641,539691,51,0.17
ptg004874l,539498,539800,302,RepeatMasker,SINE,539641,539697,57,0.19
ptg004874l,539498,539800,302,RepeatMasker,SINE,539645,539716,72,0.24
ptg004905l,220366,220686,320,RepeatMasker,SINE,220605,220759,82,0.26
ptg004905l,220366,220686,320,RepeatMasker,SINE,220606,220711,81,0.25
ptg004909l,653811,654143,332,RepeatMasker,SINE,653940,654174,204,0.61
ptg004910l,1341467,1341728,261,RepeatMasker,SINE,1341383,1341473,6,0.02
ptg004916l,426249,426545,296,RepeatMasker,SINE,426213,426280,31,0.10
ptg004929l,1080389,1080687,298,RepeatMasker,SINE,1080361,1080585,196,0.66
ptg004933l,795541,795837,296,RepeatMasker,SINE,795654,795864,184,0.62
ptg004968l,4169767,4170077,310,RepeatMasker,SINE,4169581,4169807,40,0.13
ptg005011l,2086754,2087052,298,RepeatMasker,SINE,2086581,2086792,38,0.13
ptg005038l,168277,168561,284,RepeatMasker,SINE,168235,168333,56,0.20
ptg005044l,866356,866681,325,RepeatMasker,SINE,866320,866527,171,0.53
ptg005066l,877173,877491,318,RepeatMasker,SINE,877127,877275,102,0.32
ptg005097l,1660648,1660921,273,RepeatMasker,SINE,1660644,1660775,127,0.47
ptg005123l,1910849,1911120,271,RepeatMasker,SINE,1910664,1910892,43,0.16
ptg005152l,48114,48437,323,RepeatMasker,SINE,48355,48485,83,0.26
ptg005152l,2565611,2565888,277,RepeatMasker,SINE,2565570,2565696,85,0.31
ptg005163l,355806,356124,318,RepeatMasker,SINE,355924,356153,201,0.63
ptg005176l,223502,223796,294,RepeatMasker,SINE,223459,223590,88,0.30
ptg005176l,223502,223796,294,RepeatMasker,SINE,223461,223643,141,0.48
ptg005180l,2630311,2630597,286,RepeatMasker,SINE,2630567,2630766,31,0.11
ptg005245l,1739648,1739967,319,RepeatMasker,SINE,1739880,1740027,88,0.28
ptg005245l,1739648,1739967,319,RepeatMasker,SINE,1739887,1740008,81,0.25
ptg005245l,1974443,1974744,301,RepeatMasker,SINE,1974337,1974487,44,0.15
ptg005262l,556883,557177,294,RepeatMasker,SINE,556808,557020,137,0.47
ptg005276l,1158721,1159040,319,RepeatMasker,SINE,1158691,1158916,195,0.61
ptg005332l,1159398,1159676,278,RepeatMasker,SINE,1159436,1159480,45,0.16
ptg005333l,120773,121077,304,RepeatMasker,SINE,120877,121093,201,0.66
ptg005336l,928932,929236,304,RepeatMasker,SINE,929084,929215,132,0.43
ptg005356l,482996,483309,313,RepeatMasker,SINE,482960,483173,177,0.57
ptg005368l,356436,356738,302,RepeatMasker,SINE,356645,356702,58,0.19
ptg005371l,2943512,2943822,310,RepeatMasker,SINE,2943485,2943605,93,0.30
ptg005375l,2059067,2059359,292,RepeatMasker,SINE,2058880,2059107,40,0.14
ptg005422l,4681447,4681736,289,RepeatMasker,SINE,4681273,4681488,41,0.14
ptg005459l,3502096,3502415,319,RepeatMasker,SINE,3502331,3502459,85,0.27
ptg005476l,3430216,3430527,311,RepeatMasker,SINE,3430468,3430547,60,0.19
ptg005480l,1059442,1059726,284,RepeatMasker,SINE,1059693,1059915,34,0.12
ptg005492l,752042,752358,316,RepeatMasker,SINE,752275,752402,84,0.27
ptg005492l,1299319,1299617,298,RepeatMasker,SINE,1299553,1299809,65,0.22
ptg005492l,1299319,1299617,298,RepeatMasker,SINE,1299584,1299813,34,0.11
ptg005503l,1285754,1286064,310,RepeatMasker,SINE,1285864,1285995,132,0.43
ptg005522l,1478348,1478660,312,RepeatMasker,SINE,1478429,1478561,133,0.43
ptg005529l,4786614,4786877,263,RepeatMasker,SINE,4786675,4786814,140,0.53
ptg005529l,4786614,4786877,263,RepeatMasker,SINE,4786684,4786832,149,0.57
ptg005530l,1000662,1000960,298,RepeatMasker,SINE,1000566,1000731,69,0.23
ptg005530l,1000662,1000960,298,RepeatMasker,SINE,1000613,1000731,69,0.23
ptg005552l,1598587,1598890,303,RepeatMasker,SINE,1598527,1598595,8,0.03
ptg005611l,874198,874477,279,RepeatMasker,SINE,874441,874521,37,0.13
ptg005622l,109255,109580,325,RepeatMasker,SINE,109399,109530,132,0.41
ptg005628l,910078,910368,290,RepeatMasker,SINE,910344,910557,25,0.09
ptg005629l,319906,320218,312,RepeatMasker,SINE,320129,320247,90,0.29
ptg005629l,319906,320218,312,RepeatMasker,SINE,320167,320259,52,0.17
ptg005630l,1347609,1347931,322,RepeatMasker,SINE,1347441,1347651,42,0.13
ptg005664l,648614,648902,288,RepeatMasker,SINE,648757,648933,146,0.51
ptg005754l,858295,858608,313,RepeatMasker,SINE,858272,858425,130,0.42
ptg005815l,899208,899520,312,RepeatMasker,SINE,899168,899347,139,0.45
ptg005816l,2807842,2808151,309,RepeatMasker,SINE,2808112,2808339,40,0.13
ptg005820l,497435,497734,299,RepeatMasker,SINE,497514,497616,103,0.34
ptg005820l,497435,497734,299,RepeatMasker,SINE,497521,497628,108,0.36
ptg005822l,3311259,3311569,310,RepeatMasker,SINE,3311169,3311294,35,0.11
ptg005823l,226461,226745,284,RepeatMasker,SINE,226425,226645,184,0.65
ptg005826l,837479,837777,298,RepeatMasker,SINE,837745,837972,33,0.11
ptg005842l,910839,911157,318,RepeatMasker,SINE,911044,911182,114,0.36
ptg005875l,664914,665247,333,RepeatMasker,SINE,665210,665442,38,0.11
ptg005892l,1906951,1907255,304,RepeatMasker,SINE,1907057,1907283,199,0.65
ptg005904l,2055528,2055860,332,RepeatMasker,SINE,2055823,2056048,38,0.11
ptg005929l,775329,775632,303,RepeatMasker,SINE,775224,775447,118,0.39
ptg005966l,3022961,3023255,294,RepeatMasker,SINE,3023048,3023170,123,0.42
ptg005966l,3022961,3023255,294,RepeatMasker,SINE,3023051,3023220,170,0.58
ptg005966l,3599973,3600255,282,RepeatMasker,SINE,3600168,3600233,66,0.23
ptg005966l,4396634,4396964,330,RepeatMasker,SINE,4396611,4396761,127,0.38
ptg005966l,4925363,4925679,316,RepeatMasker,SINE,4925652,4925890,28,0.09
ptg005968l,3142269,3142555,286,RepeatMasker,SINE,3142074,3142296,27,0.09
ptg005968l,3142269,3142555,286,RepeatMasker,SINE,3142189,3142309,40,0.14
ptg005984l,1265352,1265676,324,RepeatMasker,SINE,1265197,1265387,35,0.11
ptg005984l,1265352,1265676,324,RepeatMasker,SINE,1265226,1265386,34,0.10
ptg005984l,1265352,1265676,324,RepeatMasker,SINE,1265263,1265391,39,0.12
ptg005998l,2721871,2722200,329,RepeatMasker,SINE,2722165,2722265,36,0.11
ptg006002l,566941,567246,305,RepeatMasker,SINE,567043,567153,111,0.36
ptg006002l,566941,567246,305,RepeatMasker,SINE,567073,567207,135,0.44
ptg006020l,464907,465170,263,RepeatMasker,SINE,465042,465131,90,0.34
ptg006050l,127497,127784,287,RepeatMasker,SINE,127737,127867,48,0.17
ptg006064l,1447439,1447737,298,RepeatMasker,SINE,1447627,1447757,111,0.37
ptg006064l,1447439,1447737,298,RepeatMasker,SINE,1447629,1447812,109,0.37
ptg006069l,239678,239987,309,RepeatMasker,SINE,239776,240021,212,0.69
ptg006071l,2476087,2476383,296,RepeatMasker,SINE,2476377,2476542,7,0.02
ptg006089l,445431,445736,305,RepeatMasker,SINE,445699,445941,38,0.12
ptg006104l,3292446,3292726,280,RepeatMasker,SINE,3292570,3292756,157,0.56
ptg006107l,528517,528853,336,RepeatMasker,SINE,528397,528532,15,0.04
ptg006110l,188280,188578,298,RepeatMasker,SINE,188242,188477,197,0.66
ptg006110l,1269565,1269876,311,RepeatMasker,SINE,1269534,1269650,85,0.27
ptg006110l,1269565,1269876,311,RepeatMasker,SINE,1269700,1269801,102,0.33
ptg006110l,3909777,3910061,284,RepeatMasker,SINE,3909957,3910053,97,0.34
ptg006116l,819090,819418,328,RepeatMasker,SINE,819063,819193,103,0.31
ptg006124l,1713180,1713507,327,RepeatMasker,SINE,1713232,1713335,104,0.32
ptg006164l,108300,108605,305,RepeatMasker,SINE,108363,108494,132,0.43
ptg006197l,1800893,1801220,327,RepeatMasker,SINE,1800772,1800918,25,0.08
ptg006216l,170198,170495,297,RepeatMasker,SINE,170161,170294,96,0.32
ptg006289l,1770650,1770959,309,RepeatMasker,SINE,1770457,1770692,42,0.14
ptg006289l,2935511,2935848,337,RepeatMasker,SINE,2935489,2935576,65,0.19
ptg006290l,416715,417031,316,RepeatMasker,SINE,416840,417062,192,0.61
ptg006298l,1263097,1263367,270,RepeatMasker,SINE,1263144,1263231,88,0.33
ptg006326l,1458952,1459253,301,RepeatMasker,SINE,1459003,1459087,85,0.28
ptg006326l,1458952,1459253,301,RepeatMasker,SINE,1459003,1459107,105,0.35
ptg006330l,3385142,3385417,275,RepeatMasker,SINE,3385383,3385612,35,0.13
ptg006365l,2694392,2694680,288,RepeatMasker,SINE,2694643,2694812,38,0.13
ptg006383l,1207705,1208022,317,RepeatMasker,SINE,1207820,1208048,203,0.64
ptg006383l,1787323,1787635,312,RepeatMasker,SINE,1787544,1787627,84,0.27
ptg006434l,895913,896198,285,RepeatMasker,SINE,896168,896398,31,0.11
ptg006454l,3707548,3707868,320,RepeatMasker,SINE,3707569,3707783,215,0.67
ptg006465l,1127900,1128175,275,RepeatMasker,SINE,1127708,1127950,50,0.18
ptg006466l,1223364,1223644,280,RepeatMasker,SINE,1223627,1223675,18,0.06
ptg006486l,456767,457081,314,RepeatMasker,SINE,456731,456959,192,0.61
ptg006488l,2230272,2230577,305,RepeatMasker,SINE,2230499,2230611,79,0.26
ptg006488l,2230272,2230577,305,RepeatMasker,SINE,2230511,2230626,67,0.22
ptg006529l,2033758,2034067,309,RepeatMasker,SINE,2033986,2034101,82,0.27
ptg006539l,1123730,1124049,319,RepeatMasker,SINE,1123813,1123945,133,0.42
ptg006545l,1552705,1553017,312,RepeatMasker,SINE,1552985,1553198,33,0.11
ptg006551l,3276368,3276684,316,RepeatMasker,SINE,3276593,3276718,92,0.29
ptg006551l,3276368,3276684,316,RepeatMasker,SINE,3276613,3276719,72,0.23
ptg006607l,101043,101323,280,RepeatMasker,SINE,101109,101242,134,0.48
ptg006607l,101043,101323,280,RepeatMasker,SINE,101113,101296,184,0.66
ptg006607l,3452309,3452639,330,RepeatMasker,SINE,3452269,3452504,195,0.59
ptg006614l,769096,769423,327,RepeatMasker,SINE,769322,769490,102,0.31
ptg006614l,769096,769423,327,RepeatMasker,SINE,769375,769490,49,0.15
ptg006615l,1818463,1818783,320,RepeatMasker,SINE,1818635,1818713,79,0.25
ptg006615l,1818463,1818783,320,RepeatMasker,SINE,1818635,1818766,132,0.41
ptg006639l,2714584,2714877,293,RepeatMasker,SINE,2714548,2714692,108,0.37
ptg006639l,2714584,2714877,293,RepeatMasker,SINE,2714552,2714737,153,0.52
ptg006692l,313150,313419,269,RepeatMasker,SINE,313171,313291,121,0.45
ptg006699l,3489793,3490101,308,RepeatMasker,SINE,3489900,3490133,202,0.66
ptg006770l,570649,570978,329,RepeatMasker,SINE,570512,570653,4,0.01
ptg006787l,579003,579320,317,RepeatMasker,SINE,579291,579523,30,0.09
ptg006788l,3949802,3950120,318,RepeatMasker,SINE,3949614,3949847,45,0.14
ptg006809l,1185174,1185474,300,RepeatMasker,SINE,1184994,1185210,36,0.12
ptg006814l,190858,191174,316,RepeatMasker,SINE,191142,191373,33,0.10
ptg006831l,2178925,2179203,278,RepeatMasker,SINE,2179044,2179232,160,0.58
ptg006837l,1805848,1806131,283,RepeatMasker,SINE,1805655,1805886,38,0.13
ptg006860l,556070,556377,307,RepeatMasker,SINE,555876,556110,40,0.13
ptg006881l,68849,69133,284,RepeatMasker,SINE,68820,68971,122,0.43
ptg006888l,632792,633119,327,RepeatMasker,SINE,632800,633028,229,0.70
ptg006897l,280385,280702,317,RepeatMasker,SINE,280422,280464,43,0.14
ptg006900l,2812896,2813197,301,RepeatMasker,SINE,2813162,2813393,36,0.12
ptg006911l,107240,107577,337,RepeatMasker,SINE,107210,107415,175,0.52
ptg006915l,421605,421891,286,RepeatMasker,SINE,421857,422085,35,0.12
ptg006928l,1814775,1815072,297,RepeatMasker,SINE,1814741,1814941,166,0.56
ptg006928l,1814775,1815072,297,RepeatMasker,SINE,1814940,1815107,133,0.45
ptg006945l,4708721,4709024,303,RepeatMasker,SINE,4708989,4709200,36,0.12
ptg006970l,1699751,1700035,284,RepeatMasker,SINE,1699836,1700066,200,0.70
ptg006981l,539612,539931,319,RepeatMasker,SINE,539576,539772,160,0.50
ptg006993l,1822779,1823067,288,RepeatMasker,SINE,1822869,1823097,199,0.69
ptg007019l,426583,426906,323,RepeatMasker,SINE,426700,426935,207,0.64
ptg007021l,1571405,1571735,330,RepeatMasker,SINE,1571476,1571554,79,0.24
ptg007024l,1348148,1348445,297,RepeatMasker,SINE,1348408,1348544,38,0.13
ptg007086l,655268,655556,288,RepeatMasker,SINE,655077,655300,32,0.11
ptg007091l,980559,980847,288,RepeatMasker,SINE,980648,980880,200,0.69
ptg007101l,2510854,2511145,291,RepeatMasker,SINE,2511108,2511303,38,0.13
ptg007123l,102773,103070,297,RepeatMasker,SINE,103023,103103,48,0.16
ptg007131l,2420691,2421020,329,RepeatMasker,SINE,2420506,2420730,39,0.12
ptg007176l,20974,21281,307,RepeatMasker,SINE,21051,21101,51,0.17
ptg007182l,49440,49768,328,RepeatMasker,SINE,49296,49482,42,0.13
ptg007229l,2788,3079,291,RepeatMasker,SINE,2763,2884,96,0.33
ptg007229l,5158,5453,295,RepeatMasker,SINE,5113,5221,63,0.21
ptg007252l,756297,756589,292,RepeatMasker,SINE,756552,756785,38,0.13
ptg007264l,683896,684200,304,RepeatMasker,SINE,683905,683970,66,0.22
ptg007264l,683896,684200,304,RepeatMasker,SINE,683905,683980,76,0.25
ptg007359l,803721,804010,289,RepeatMasker,SINE,803979,804179,32,0.11
ptg007369l,847756,848085,329,RepeatMasker,SINE,847828,847882,55,0.17
ptg007375l,4541336,4541670,334,RepeatMasker,SINE,4541465,4541627,163,0.49
ptg007375l,4541336,4541670,334,RepeatMasker,SINE,4541498,4541626,129,0.39
ptg007375l,5134051,5134339,288,RepeatMasker,SINE,5134300,5134528,40,0.14
ptg007386l,1058466,1058729,263,RepeatMasker,SINE,1058692,1058921,38,0.14
ptg007397l,197262,197587,325,RepeatMasker,SINE,197555,197784,33,0.10
ptg007405l,362927,363230,303,RepeatMasker,SINE,363125,363170,46,0.15
ptg007405l,362927,363230,303,RepeatMasker,SINE,363136,363260,95,0.31
ptg007405l,765151,765438,287,RepeatMasker,SINE,765401,765489,38,0.13
ptg007453l,138807,139075,268,RepeatMasker,SINE,138867,139107,209,0.78
ptg007473l,4806814,4807113,299,RepeatMasker,SINE,4807080,4807311,34,0.11
ptg007497l,1331406,1331730,324,RepeatMasker,SINE,1331699,1331924,32,0.10
ptg007504l,1215195,1215510,315,RepeatMasker,SINE,1215008,1215235,40,0.13
ptg007509l,1290111,1290406,295,RepeatMasker,SINE,1290350,1290441,57,0.19
ptg007566l,2310150,2310470,320,RepeatMasker,SINE,2310268,2310504,203,0.63
ptg007583l,757310,757627,317,RepeatMasker,SINE,757274,757437,127,0.40
ptg007583l,757310,757627,317,RepeatMasker,SINE,757440,757570,131,0.41
ptg007583l,757310,757627,317,RepeatMasker,SINE,757443,757624,182,0.57
ptg007613l,4671408,4671706,298,RepeatMasker,SINE,4671501,4671636,136,0.46
ptg007613l,4671408,4671706,298,RepeatMasker,SINE,4671550,4671636,87,0.29
ptg007614l,2104318,2104622,304,RepeatMasker,SINE,2104282,2104492,174,0.57
ptg007623l,5897750,5898066,316,RepeatMasker,SINE,5898032,5898267,35,0.11
ptg007626l,139549,139842,293,RepeatMasker,SINE,139810,139869,33,0.11
ptg007633l,263633,263921,288,RepeatMasker,SINE,263522,263672,39,0.14
ptg007633l,263633,263921,288,RepeatMasker,SINE,263546,263672,39,0.14
ptg007661l,918292,918599,307,RepeatMasker,SINE,918568,918806,32,0.10
ptg007781l,3146797,3147112,315,RepeatMasker,SINE,3146750,3146877,80,0.25
ptg007819l,720670,720994,324,RepeatMasker,SINE,720806,721026,189,0.58
ptg007820l,270294,270585,291,RepeatMasker,SINE,270550,270782,36,0.12
ptg007842l,4262562,4262852,290,RepeatMasker,SINE,4262531,4262681,119,0.41
ptg007884l,2145358,2145631,273,RepeatMasker,SINE,2145288,2145372,14,0.05
ptg007884l,2145358,2145631,273,RepeatMasker,SINE,2145288,2145384,26,0.10
ptg007898l,2410018,2410276,258,RepeatMasker,SINE,2409987,2410159,141,0.55
ptg007898l,2410018,2410276,258,RepeatMasker,SINE,2410244,2410306,33,0.13
ptg007898l,2410018,2410276,258,RepeatMasker,SINE,2410252,2410306,25,0.10
ptg007917l,126292,126616,324,RepeatMasker,SINE,126099,126337,45,0.14
ptg008017l,1169022,1169323,301,RepeatMasker,SINE,1168829,1169034,12,0.04
ptg008030l,510217,510534,317,RepeatMasker,SINE,510498,510564,37,0.12
ptg008044l,432998,433289,291,RepeatMasker,SINE,433002,433127,126,0.43
ptg008054l,1108217,1108506,289,RepeatMasker,SINE,1108321,1108533,186,0.64
ptg008054l,1108217,1108506,289,RepeatMasker,SINE,1108353,1108533,154,0.53
ptg008062l,639458,639788,330,RepeatMasker,SINE,639427,639648,190,0.58
ptg008066l,67688,67971,283,RepeatMasker,SINE,67771,68000,201,0.71
ptg008080l,228276,228602,326,RepeatMasker,SINE,228131,228320,44,0.13
ptg008080l,228276,228602,326,RepeatMasker,SINE,228191,228322,46,0.14
ptg008083l,158289,158594,305,RepeatMasker,SINE,158243,158362,73,0.24
ptg008099l,2445432,2445713,281,RepeatMasker,SINE,2445604,2445694,91,0.32
ptg008122l,67164,67490,326,RepeatMasker,SINE,67117,67241,77,0.24
ptg008144l,634584,634883,299,RepeatMasker,SINE,634687,634914,197,0.66
ptg008160l,791383,791670,287,RepeatMasker,SINE,791197,791422,39,0.14
ptg008176l,154912,155219,307,RepeatMasker,SINE,155124,155231,96,0.31
ptg008215l,1330622,1330924,302,RepeatMasker,SINE,1330903,1331109,22,0.07
ptg008240l,206234,206529,295,RepeatMasker,SINE,206349,206423,75,0.25
ptg008240l,206234,206529,295,RepeatMasker,SINE,206349,206472,124,0.42
ptg008255l,365379,365681,302,RepeatMasker,SINE,365382,365510,129,0.43
ptg008278l,1722424,1722720,296,RepeatMasker,SINE,1722251,1722458,34,0.11
ptg008305l,638201,638514,313,RepeatMasker,SINE,638017,638240,39,0.12
ptg008348l,105891,106178,287,RepeatMasker,SINE,105802,105912,21,0.07
ptg008351l,940463,940761,298,RepeatMasker,SINE,940584,940711,128,0.43
ptg008373l,278707,279016,309,RepeatMasker,SINE,278979,279223,38,0.12
ptg008378l,1339469,1339766,297,RepeatMasker,SINE,1339363,1339499,30,0.10
ptg008424l,301393,301712,319,RepeatMasker,SINE,301508,301739,205,0.64
ptg008435l,3547363,3547665,302,RepeatMasker,SINE,3547630,3547855,36,0.12
ptg008440l,1849973,1850253,280,RepeatMasker,SINE,1850033,1850166,134,0.48
ptg008440l,1849973,1850253,280,RepeatMasker,SINE,1850037,1850225,189,0.68
ptg008445l,678043,678324,281,RepeatMasker,SINE,678130,678294,165,0.59
ptg008445l,678043,678324,281,RepeatMasker,SINE,678131,678248,118,0.42
ptg008454l,1685546,1685870,324,RepeatMasker,SINE,1685834,1686060,37,0.11
ptg008454l,1715472,1715768,296,RepeatMasker,SINE,1715432,1715662,190,0.64
ptg008459l,415596,415885,289,RepeatMasker,SINE,415831,415981,55,0.19
ptg008459l,415596,415885,289,RepeatMasker,SINE,415838,415970,48,0.17
ptg008501l,222108,222418,310,RepeatMasker,SINE,222073,222300,192,0.62
ptg008502l,1610000,1610259,259,RepeatMasker,SINE,1609802,1610039,39,0.15
ptg008543l,1042544,1042840,296,RepeatMasker,SINE,1042823,1043062,18,0.06
ptg008544l,1623466,1623779,313,RepeatMasker,SINE,1623588,1623813,192,0.61
ptg008552l,290188,290493,305,RepeatMasker,SINE,290409,290541,85,0.28
ptg008562l,168197,168518,321,RepeatMasker,SINE,168004,168231,34,0.11
ptg008579l,1121874,1122194,320,RepeatMasker,SINE,1121838,1121959,85,0.27
ptg008579l,1121874,1122194,320,RepeatMasker,SINE,1121838,1122003,129,0.40
ptg008602l,879349,879658,309,RepeatMasker,SINE,879606,879723,53,0.17
ptg008602l,879349,879658,309,RepeatMasker,SINE,879621,879708,38,0.12
ptg008619l,1396726,1397021,295,RepeatMasker,SINE,1396892,1397002,111,0.38
ptg008641l,817376,817669,293,RepeatMasker,SINE,817350,817462,86,0.29
ptg008665l,789055,789346,291,RepeatMasker,SINE,789019,789136,81,0.28
ptg008665l,789055,789346,291,RepeatMasker,SINE,789309,789537,38,0.13
ptg008686l,779237,779557,320,RepeatMasker,SINE,779240,779360,121,0.38
ptg008686l,779237,779557,320,RepeatMasker,SINE,779314,779368,55,0.17
ptg008700l,883839,884130,291,RepeatMasker,SINE,883817,883963,124,0.43
ptg008729l,3156262,3156555,293,RepeatMasker,SINE,3156442,3156588,114,0.39
ptg008731l,3860735,3861049,314,RepeatMasker,SINE,3860696,3860930,195,0.62
ptg008731l,3860735,3861049,314,RepeatMasker,SINE,3860703,3860957,222,0.71
ptg008755l,1371057,1371345,288,RepeatMasker,SINE,1371232,1371373,114,0.40
ptg008759l,473370,473701,331,RepeatMasker,SINE,473502,473731,200,0.60
ptg008790l,1468373,1468682,309,RepeatMasker,SINE,1468335,1468568,195,0.63
ptg008790l,2588350,2588609,259,RepeatMasker,SINE,2588159,2588406,56,0.22
ptg008795l,417388,417681,293,RepeatMasker,SINE,417241,417430,42,0.14
ptg008854l,58822,59144,322,RepeatMasker,SINE,59129,59362,16,0.05
ptg008866l,296238,296577,339,RepeatMasker,SINE,296558,296750,20,0.06
ptg008877l,257832,258127,295,RepeatMasker,SINE,258090,258266,38,0.13
ptg008895l,930399,930724,325,RepeatMasker,SINE,930518,930634,117,0.36
ptg008945l,1065182,1065480,298,RepeatMasker,SINE,1065139,1065262,80,0.27
ptg008945l,1065182,1065480,298,RepeatMasker,SINE,1065142,1065315,133,0.45
ptg008992l,2741988,2742285,297,RepeatMasker,SINE,2741953,2742164,176,0.59
ptg009054l,561241,561565,324,RepeatMasker,SINE,561288,561407,120,0.37
ptg009080l,12163,12477,314,RepeatMasker,SINE,12143,12202,39,0.12
ptg009120l,1422753,1423053,300,RepeatMasker,SINE,1422705,1422946,193,0.64
ptg009132l,1852673,1852983,310,RepeatMasker,SINE,1852936,1853068,48,0.15
ptg009133l,1201020,1201325,305,RepeatMasker,SINE,1200857,1201062,42,0.14
ptg009164l,51502,51786,284,RepeatMasker,SINE,51729,51812,58,0.20
ptg009164l,51502,51786,284,RepeatMasker,SINE,51749,51808,38,0.13
ptg009234l,382220,382529,309,RepeatMasker,SINE,382493,382725,37,0.12
ptg009234l,406538,406844,306,RepeatMasker,SINE,406808,406859,37,0.12
ptg009318l,3997299,3997574,275,RepeatMasker,SINE,3997264,3997499,200,0.73
ptg009320l,1138220,1138505,285,RepeatMasker,SINE,1138478,1138692,28,0.10
ptg009395l,1303976,1304285,309,RepeatMasker,SINE,1304135,1304266,132,0.43
ptg009411l,1042187,1042482,295,RepeatMasker,SINE,1042289,1042409,121,0.41
ptg009433l,928547,928845,298,RepeatMasker,SINE,928766,928879,80,0.27
ptg009466l,192244,192521,277,RepeatMasker,SINE,192465,192555,57,0.21
ptg009516l,277335,277477,142,RepeatMasker,SINE,277477,277550,1,0.01
ptg009569l,387086,387390,304,RepeatMasker,SINE,387180,387266,87,0.29
ptg009586l,2154652,2154922,270,RepeatMasker,SINE,2154869,2154909,41,0.15
ptg009605l,83110,83437,327,RepeatMasker,SINE,83063,83195,85,0.26
ptg009607l,1161616,1161900,284,RepeatMasker,SINE,1161573,1161688,72,0.25
ptg009653l,1608295,1608607,312,RepeatMasker,SINE,1608576,1608637,32,0.10
ptg009714l,937112,937394,282,RepeatMasker,SINE,937194,937428,201,0.71
ptg009719l,128782,129090,308,RepeatMasker,SINE,128747,128913,131,0.43
ptg009719l,128782,129090,308,RepeatMasker,SINE,129058,129118,33,0.11
ptg009752l,534449,534753,304,RepeatMasker,SINE,534715,534949,39,0.13
ptg009772l,36830,37127,297,RepeatMasker,SINE,37065,37159,63,0.21
ptg009804l,1355836,1356121,285,RepeatMasker,SINE,1356068,1356158,54,0.19
ptg009811l,2289080,2289380,300,RepeatMasker,SINE,2288890,2289130,50,0.17
ptg009832l,755411,755736,325,RepeatMasker,SINE,755412,755635,224,0.69
ptg009832l,755411,755736,325,RepeatMasker,SINE,755417,755666,250,0.77
ptg009832l,1863797,1864103,306,RepeatMasker,SINE,1863898,1864137,206,0.67
ptg009839l,272879,273182,303,RepeatMasker,SINE,273131,273262,52,0.17
ptg009898l,2988866,2989186,320,RepeatMasker,SINE,2988783,2988916,50,0.16
ptg009901l,293665,293989,324,RepeatMasker,SINE,293472,293705,40,0.12
ptg009914l,195506,195806,300,RepeatMasker,SINE,195405,195531,25,0.08
ptg010064l,333564,333880,316,RepeatMasker,SINE,333436,333608,44,0.14
ptg010064l,333564,333880,316,RepeatMasker,SINE,333477,333605,41,0.13
ptg010075l,3383332,3383669,337,RepeatMasker,SINE,3383279,3383424,92,0.27
ptg010085l,2416078,2416406,328,RepeatMasker,SINE,2416382,2416441,25,0.08
ptg010085l,2416078,2416406,328,RepeatMasker,SINE,2416382,2416468,25,0.08
ptg010147l,1530132,1530405,273,RepeatMasker,SINE,1529961,1530158,26,0.10
ptg010224l,1644735,1645026,291,RepeatMasker,SINE,1644692,1644842,107,0.37
ptg010249l,1691851,1692183,332,RepeatMasker,SINE,1691803,1691890,39,0.12
ptg010251l,3804264,3804510,246,RepeatMasker,SINE,3804194,3804341,77,0.31
ptg010254l,257319,257603,284,RepeatMasker,SINE,257478,257604,126,0.44
ptg010269l,1168083,1168410,327,RepeatMasker,SINE,1168028,1168119,36,0.11
ptg010269l,1168083,1168410,327,RepeatMasker,SINE,1168028,1168134,51,0.16
ptg010285l,1120720,1121054,334,RepeatMasker,SINE,1120787,1120896,110,0.33
ptg010285l,1120720,1121054,334,RepeatMasker,SINE,1120812,1120896,85,0.25
ptg010321l,74076,74387,311,RepeatMasker,SINE,74347,74420,41,0.13
ptg010340l,118875,119137,262,RepeatMasker,SINE,118839,118999,124,0.47
ptg010340l,2203552,2203867,315,RepeatMasker,SINE,2203668,2203901,200,0.63
ptg010361l,485088,485383,295,RepeatMasker,SINE,485352,485558,32,0.11
ptg010415l,4995770,4996053,283,RepeatMasker,SINE,4995599,4995811,41,0.14
ptg010415l,4995770,4996053,283,RepeatMasker,SINE,4996017,4996190,37,0.13
ptg010568l,1585822,1586136,314,RepeatMasker,SINE,1586104,1586343,33,0.11
ptg010621l,1407703,1408009,306,RepeatMasker,SINE,1407972,1408204,38,0.12
ptg010629l,1132796,1133110,314,RepeatMasker,SINE,1133049,1133145,62,0.20
ptg010647l,1319849,1320177,328,RepeatMasker,SINE,1319759,1319880,31,0.09
ptg010648l,23060,23374,314,RepeatMasker,SINE,23136,23210,75,0.24
ptg010648l,23060,23374,314,RepeatMasker,SINE,23139,23204,66,0.21
ptg010678l,964191,964473,282,RepeatMasker,SINE,964282,964501,192,0.68
ptg010741l,3179389,3179663,274,RepeatMasker,SINE,3179427,3179585,159,0.58
ptg010773l,3037750,3038060,310,RepeatMasker,SINE,3038043,3038091,18,0.06
ptg010774l,351725,352032,307,RepeatMasker,SINE,351698,351852,127,0.41
ptg010787l,1379833,1380132,299,RepeatMasker,SINE,1379912,1380042,131,0.44
ptg010823l,1268443,1268752,309,RepeatMasker,SINE,1268404,1268542,99,0.32
ptg010832l,3185545,3185816,271,RepeatMasker,SINE,3185497,3185647,102,0.38
ptg010850l,699084,699390,306,RepeatMasker,SINE,699384,699558,7,0.02
ptg010874l,832954,833262,308,RepeatMasker,SINE,833231,833465,32,0.10
ptg010879l,4320608,4320902,294,RepeatMasker,SINE,4320872,4320935,31,0.11
ptg010999l,1011079,1011408,329,RepeatMasker,SINE,1011189,1011293,105,0.32
ptg010999l,1011079,1011408,329,RepeatMasker,SINE,1011189,1011344,156,0.47
ptg011006l,733517,733823,306,RepeatMasker,SINE,733796,734027,28,0.09
ptg011138l,97534,97845,311,RepeatMasker,SINE,97341,97576,42,0.14
ptg011181l,301553,301802,249,RepeatMasker,SINE,301367,301587,34,0.14
ptg011186l,1031147,1031464,317,RepeatMasker,SINE,1031204,1031325,122,0.38
ptg011233l,101872,102014,142,RepeatMasker,SINE,102009,102215,6,0.04
ptg011236l,1301121,1301383,262,RepeatMasker,SINE,1301089,1301287,166,0.63
ptg011290l,1158675,1158999,324,RepeatMasker,SINE,1158964,1159188,36,0.11
ptg011314l,301441,301737,296,RepeatMasker,SINE,301539,301768,199,0.67
ptg011399l,33835,34135,300,RepeatMasker,SINE,33645,33859,24,0.08
ptg011404l,1350027,1350298,271,RepeatMasker,SINE,1349989,1350113,86,0.32
ptg011404l,1350027,1350298,271,RepeatMasker,SINE,1350236,1350296,61,0.23
ptg011408l,2536895,2537204,309,RepeatMasker,SINE,2536985,2537116,132,0.43
ptg011456l,990113,990431,318,RepeatMasker,SINE,990225,990440,207,0.65
ptg011465l,2057219,2057537,318,RepeatMasker,SINE,2057268,2057400,133,0.42
ptg011465l,2057219,2057537,318,RepeatMasker,SINE,2057270,2057456,187,0.59
ptg011470l,956335,956646,311,RepeatMasker,SINE,956314,956448,113,0.36
ptg011489l,1748751,1749073,322,RepeatMasker,SINE,1749041,1749159,33,0.10
ptg011503l,722939,723253,314,RepeatMasker,SINE,723152,723227,76,0.24
ptg011512l,960999,961330,331,RepeatMasker,SINE,961293,961527,38,0.11
ptg011588l,772584,772864,280,RepeatMasker,SINE,772763,772884,102,0.36
ptg011612l,377462,377735,273,RepeatMasker,SINE,377455,377638,176,0.64
ptg011642l,1946364,1946669,305,RepeatMasker,SINE,1946241,1946390,26,0.09
ptg011696l,2291741,2292045,304,RepeatMasker,SINE,2291802,2291922,121,0.40
ptg011696l,2291741,2292045,304,RepeatMasker,SINE,2291802,2291964,163,0.54
ptg011699l,1066374,1066679,305,RepeatMasker,SINE,1066217,1066412,38,0.12
ptg011724l,1096026,1096316,290,RepeatMasker,SINE,1096237,1096339,80,0.28
ptg011770l,118180,118489,309,RepeatMasker,SINE,118290,118523,200,0.65
ptg011815l,303610,303900,290,RepeatMasker,SINE,303489,303648,38,0.13
ptg011847l,132898,133221,323,RepeatMasker,SINE,132713,132931,33,0.10
ptg011888l,1810723,1811027,304,RepeatMasker,SINE,1810822,1811061,206,0.68
ptg011918l,54413,54730,317,RepeatMasker,SINE,54693,54768,38,0.12
ptg011924l,94178,94471,293,RepeatMasker,SINE,94061,94213,35,0.12
ptg011959l,1458142,1458465,323,RepeatMasker,SINE,1458117,1458259,117,0.36
ptg011978l,4441526,4441792,266,RepeatMasker,SINE,4441487,4441702,176,0.66
ptg011978l,4776567,4776888,321,RepeatMasker,SINE,4776855,4777087,34,0.11
ptg011979l,212284,212587,303,RepeatMasker,SINE,212512,212622,76,0.25
ptg012008l,73257,73536,279,RepeatMasker,SINE,73342,73462,121,0.43
ptg012008l,73257,73536,279,RepeatMasker,SINE,73342,73511,170,0.61
ptg012019l,844779,845097,318,RepeatMasker,SINE,844910,845122,188,0.59
ptg012019l,845244,845534,290,RepeatMasker,SINE,845189,845265,21,0.07
ptg012035l,551256,551541,285,RepeatMasker,SINE,551540,551582,2,0.01
ptg012044l,994604,994893,289,RepeatMasker,SINE,994888,995048,6,0.02
ptg012070l,114301,114601,300,RepeatMasker,SINE,114197,114345,44,0.15
ptg012134l,1056589,1056903,314,RepeatMasker,SINE,1056617,1056683,67,0.21
ptg012146l,740666,740950,284,RepeatMasker,SINE,740915,741139,36,0.13
ptg012146l,1209241,1209520,279,RepeatMasker,SINE,1209483,1209715,38,0.14
ptg012201l,57838,58116,278,RepeatMasker,SINE,57676,57879,41,0.15
ptg012290l,1825377,1825657,280,RepeatMasker,SINE,1825502,1825691,156,0.56
ptg012306l,975834,976163,329,RepeatMasker,SINE,975744,975965,131,0.40
ptg012334l,382594,382887,293,RepeatMasker,SINE,382854,383080,34,0.12
ptg012344l,1528097,1528410,313,RepeatMasker,SINE,1528213,1528289,77,0.25
ptg012344l,1528097,1528410,313,RepeatMasker,SINE,1528213,1528335,123,0.39
ptg012365l,405694,405978,284,RepeatMasker,SINE,405938,406159,41,0.14
ptg012388l,1790819,1791150,331,RepeatMasker,SINE,1790791,1791007,188,0.57
ptg012390l,561833,562148,315,RepeatMasker,SINE,562041,562182,108,0.34
ptg012421l,149438,149751,313,RepeatMasker,SINE,149567,149787,185,0.59
ptg012430l,787996,788294,298,RepeatMasker,SINE,788257,788499,38,0.13
ptg012439l,1644455,1644731,276,RepeatMasker,SINE,1644274,1644464,9,0.03
ptg012456l,1512825,1513139,314,RepeatMasker,SINE,1512731,1512851,26,0.08
ptg012476l,383662,383958,296,RepeatMasker,SINE,383625,383856,194,0.66
ptg012516l,479228,479510,282,RepeatMasker,SINE,479460,479567,51,0.18
ptg012516l,479228,479510,282,RepeatMasker,SINE,479473,479563,38,0.13
ptg012531l,645797,646115,318,RepeatMasker,SINE,645675,645837,40,0.13
ptg012541l,325257,325580,323,RepeatMasker,SINE,325219,325454,197,0.61
ptg012541l,325257,325580,323,RepeatMasker,SINE,325507,325613,74,0.23
ptg012616l,1512649,1512955,306,RepeatMasker,SINE,1512704,1512824,121,0.40
ptg012625l,192019,192300,281,RepeatMasker,SINE,192085,192217,133,0.47
ptg012625l,192019,192300,281,RepeatMasker,SINE,192088,192271,184,0.65
ptg012625l,1200877,1201179,302,RepeatMasker,SINE,1200958,1201210,222,0.74
ptg012675l,25217,25512,295,RepeatMasker,SINE,25350,25481,132,0.45
ptg012750l,1060512,1060780,268,RepeatMasker,SINE,1060475,1060560,48,0.18
ptg012764l,107212,107464,252,RepeatMasker,SINE,107062,107249,37,0.15
ptg012773l,189203,189514,311,RepeatMasker,SINE,189168,189397,194,0.62
ptg012807l,584880,585204,324,RepeatMasker,SINE,585166,585354,39,0.12
ptg012816l,536922,537215,293,RepeatMasker,SINE,536923,537156,234,0.80
ptg012835l,1596547,1596828,281,RepeatMasker,SINE,1596698,1596792,95,0.34
ptg012852l,138418,138742,324,RepeatMasker,SINE,138711,138939,32,0.10
ptg012880l,167104,167403,299,RepeatMasker,SINE,166924,167148,44,0.15
ptg012897l,159558,159836,278,RepeatMasker,SINE,159802,160024,35,0.13
ptg012902l,69406,69717,311,RepeatMasker,SINE,69540,69710,171,0.55
ptg012902l,69406,69717,311,RepeatMasker,SINE,69541,69644,104,0.33
ptg012913l,158652,158962,310,RepeatMasker,SINE,158458,158702,50,0.16
ptg012938l,887841,888165,324,RepeatMasker,SINE,888131,888370,35,0.11
ptg012952l,1196423,1196706,283,RepeatMasker,SINE,1196494,1196596,103,0.36
ptg012952l,1196423,1196706,283,RepeatMasker,SINE,1196518,1196612,95,0.34
ptg012953l,752207,752541,334,RepeatMasker,SINE,752456,752598,86,0.26
ptg013006l,281546,281860,314,RepeatMasker,SINE,281614,281746,133,0.42
ptg013006l,281546,281860,314,RepeatMasker,SINE,281618,281787,170,0.54
ptg013007l,379745,380059,314,RepeatMasker,SINE,379860,380093,200,0.64
ptg013020l,1024282,1024584,302,RepeatMasker,SINE,1024259,1024384,102,0.34
ptg013109l,217016,217295,279,RepeatMasker,SINE,216954,217051,35,0.13
ptg013109l,217016,217295,279,RepeatMasker,SINE,216972,217056,40,0.14
ptg013117l,2733623,2733922,299,RepeatMasker,SINE,2733433,2733663,40,0.13
ptg013117l,3830930,3831237,307,RepeatMasker,SINE,3830742,3830967,37,0.12
ptg013179l,1034087,1034383,296,RepeatMasker,SINE,1034238,1034369,132,0.45
ptg013201l,797853,798182,329,RepeatMasker,SINE,797979,798211,204,0.62
ptg013222l,1654110,1654398,288,RepeatMasker,SINE,1654223,1654332,110,0.38
ptg013337l,589522,589835,313,RepeatMasker,SINE,589804,590036,32,0.10
ptg013349l,1985820,1986094,274,RepeatMasker,SINE,1985624,1985860,40,0.15
ptg013444l,1149552,1149857,305,RepeatMasker,SINE,1149762,1149801,40,0.13
ptg013528l,54491,54791,300,RepeatMasker,SINE,54591,54825,201,0.67
ptg013572l,909509,909834,325,RepeatMasker,SINE,909322,909549,40,0.12
ptg013582l,401633,401917,284,RepeatMasker,SINE,401594,401720,87,0.31
ptg013582l,401633,401917,284,RepeatMasker,SINE,401626,401736,103,0.36
ptg013601l,295480,295793,313,RepeatMasker,SINE,295600,295731,132,0.42
ptg013607l,705093,705414,321,RepeatMasker,SINE,705215,705446,200,0.62
ptg013608l,299749,300067,318,RepeatMasker,SINE,300020,300254,48,0.15
ptg013614l,1797448,1797772,324,RepeatMasker,SINE,1797752,1797831,21,0.06
ptg013652l,1874301,1874625,324,RepeatMasker,SINE,1874594,1874822,32,0.10
ptg013754l,20032,20343,311,RepeatMasker,SINE,19845,20070,38,0.12
ptg013833l,1970043,1970357,314,RepeatMasker,SINE,1970216,1970392,142,0.45
ptg013932l,34093,34390,297,RepeatMasker,SINE,33906,34125,32,0.11
ptg013937l,570824,571143,319,RepeatMasker,SINE,571092,571166,52,0.16
ptg013957l,1293787,1294110,323,RepeatMasker,SINE,1293819,1293950,132,0.41
ptg013990l,559598,559907,309,RepeatMasker,SINE,559562,559734,136,0.44
ptg014054l,270987,271270,283,RepeatMasker,SINE,270966,271021,34,0.12
ptg014174l,147329,147651,322,RepeatMasker,SINE,147407,147543,137,0.43
ptg014174l,147329,147651,322,RepeatMasker,SINE,147413,147599,187,0.58
ptg014181l,372401,372725,324,RepeatMasker,SINE,372208,372415,14,0.04
ptg014181l,372401,372725,324,RepeatMasker,SINE,372510,372542,33,0.10
ptg014231l,3958192,3958514,322,RepeatMasker,SINE,3958232,3958283,52,0.16
ptg014239l,762213,762491,278,RepeatMasker,SINE,762423,762471,49,0.18
ptg014404l,25215,25516,301,RepeatMasker,SINE,25188,25317,102,0.34
ptg014455l,692609,692914,305,RepeatMasker,SINE,692784,692941,131,0.43
ptg014457l,134487,134789,302,RepeatMasker,SINE,134754,134975,36,0.12
ptg014485l,2785531,2785806,275,RepeatMasker,SINE,2785773,2785987,34,0.12
ptg014491l,173731,174042,311,RepeatMasker,SINE,173706,173817,86,0.28
ptg014546l,84072,84341,269,RepeatMasker,SINE,84179,84355,163,0.61
ptg014546l,84072,84341,269,RepeatMasker,SINE,84233,84355,109,0.41
ptg014594l,947357,947687,330,RepeatMasker,SINE,947365,947434,70,0.21
ptg014629l,151483,151798,315,RepeatMasker,SINE,151758,151989,41,0.13
ptg014682l,1069680,1070003,323,RepeatMasker,SINE,1069565,1069709,29,0.09
ptg014682l,1069680,1070003,323,RepeatMasker,SINE,1069583,1069728,48,0.15
ptg014720l,257784,258108,324,RepeatMasker,SINE,257910,257968,59,0.18
ptg014764l,607160,607479,319,RepeatMasker,SINE,607198,607262,65,0.20
ptg014803l,722034,722330,296,RepeatMasker,SINE,721842,722072,38,0.13
ptg014813l,634629,634940,311,RepeatMasker,SINE,634592,634823,194,0.62
ptg014849l,300592,300889,297,RepeatMasker,SINE,300687,300921,203,0.68
ptg014947l,90224,90538,314,RepeatMasker,SINE,90501,90734,38,0.12
ptg014966l,705427,705727,300,RepeatMasker,SINE,705263,705464,37,0.12
ptg014968l,913151,913478,327,RepeatMasker,SINE,913439,913507,40,0.12
ptg015022l,833194,833476,282,RepeatMasker,SINE,833439,833526,38,0.13
ptg015027l,661870,662198,328,RepeatMasker,SINE,662155,662326,44,0.13
ptg015044l,159836,160144,308,RepeatMasker,SINE,159805,159992,156,0.51
ptg015061l,1081421,1081716,295,RepeatMasker,SINE,1081633,1081743,84,0.28
ptg015061l,1081421,1081716,295,RepeatMasker,SINE,1081633,1081764,84,0.28
ptg015185l,1286252,1286526,274,RepeatMasker,SINE,1286476,1286560,51,0.19
ptg015231l,443178,443507,329,RepeatMasker,SINE,442999,443213,35,0.11
ptg015250l,426576,426895,319,RepeatMasker,SINE,426388,426616,40,0.13
ptg015260l,779207,779530,323,RepeatMasker,SINE,779353,779486,134,0.41
ptg015271l,1753480,1753803,323,RepeatMasker,SINE,1753443,1753673,193,0.60
ptg015279l,624180,624491,311,RepeatMasker,SINE,624291,624521,201,0.65
ptg015298l,287676,287961,285,RepeatMasker,SINE,287639,287800,124,0.44
ptg015328l,507517,507838,321,RepeatMasker,SINE,507505,507586,69,0.21
ptg015395l,657741,658034,293,RepeatMasker,SINE,658003,658227,32,0.11
ptg015403l,442183,442452,269,RepeatMasker,SINE,442212,442342,131,0.49
ptg015403l,442183,442452,269,RepeatMasker,SINE,442214,442359,146,0.54
ptg015416l,205225,205523,298,RepeatMasker,SINE,205135,205279,54,0.18
ptg015416l,205225,205523,298,RepeatMasker,SINE,205155,205281,56,0.19
ptg015462l,553618,553927,309,RepeatMasker,SINE,553654,553807,154,0.50
ptg015462l,553618,553927,309,RepeatMasker,SINE,553675,553803,129,0.42
ptg015484l,266910,267230,320,RepeatMasker,SINE,266875,267102,192,0.60
ptg015484l,266910,267230,320,RepeatMasker,SINE,267191,267259,40,0.13
ptg015517l,346020,346324,304,RepeatMasker,SINE,346140,346194,55,0.18
ptg015517l,346020,346324,304,RepeatMasker,SINE,346292,346357,33,0.11
ptg015519l,1855059,1855341,282,RepeatMasker,SINE,1855255,1855385,87,0.31
ptg015579l,474245,474549,304,RepeatMasker,SINE,474313,474464,152,0.50
ptg015579l,474245,474549,304,RepeatMasker,SINE,474317,474526,210,0.69
ptg015588l,1204061,1204369,308,RepeatMasker,SINE,1204019,1204163,102,0.33
ptg015654l,649409,649703,294,RepeatMasker,SINE,649555,649631,77,0.26
ptg015654l,649409,649703,294,RepeatMasker,SINE,649564,649659,96,0.33
ptg015654l,649409,649703,294,RepeatMasker,SINE,649565,649645,81,0.28
ptg015700l,1301352,1301676,324,RepeatMasker,SINE,1301423,1301546,124,0.38
ptg015766l,156630,156943,313,RepeatMasker,SINE,156909,157017,35,0.11
ptg015775l,53926,54220,294,RepeatMasker,SINE,54055,54159,105,0.36
ptg015775l,53926,54220,294,RepeatMasker,SINE,54073,54248,148,0.50
ptg015795l,254760,255070,310,RepeatMasker,SINE,255057,255175,14,0.05
ptg015795l,278763,279045,282,RepeatMasker,SINE,278619,278801,38,0.13
ptg015845l,553344,553644,300,RepeatMasker,SINE,553607,553843,38,0.13
ptg016043l,635388,635701,313,RepeatMasker,SINE,635623,635734,79,0.25
ptg016062l,79119,79401,282,RepeatMasker,SINE,78930,79159,40,0.14
ptg016077l,879092,879419,327,RepeatMasker,SINE,879046,879194,102,0.31
ptg016079l,1151494,1151763,269,RepeatMasker,SINE,1151318,1151522,28,0.10
ptg016080l,1386060,1386360,300,RepeatMasker,SINE,1386323,1386550,38,0.13
ptg016095l,185514,185813,299,RepeatMasker,SINE,185774,185860,40,0.13
ptg016167l,45783,46082,299,RepeatMasker,SINE,46050,46270,33,0.11
ptg016274l,243167,243477,310,RepeatMasker,SINE,243268,243508,210,0.68
ptg016323l,1119793,1120117,324,RepeatMasker,SINE,1119853,1119986,134,0.41
ptg016323l,1119793,1120117,324,RepeatMasker,SINE,1119857,1120007,151,0.47
ptg016462l,2434571,2434878,307,RepeatMasker,SINE,2434845,2435075,34,0.11
ptg016491l,2204967,2205256,289,RepeatMasker,SINE,2205209,2205337,48,0.17
ptg016532l,199054,199333,279,RepeatMasker,SINE,199018,199164,110,0.39
ptg016561l,445755,446065,310,RepeatMasker,SINE,445977,446109,89,0.29
ptg016625l,1750807,1751116,309,RepeatMasker,SINE,1750889,1751005,117,0.38
ptg016762l,131314,131607,293,RepeatMasker,SINE,131548,131633,60,0.20
ptg016762l,131314,131607,293,RepeatMasker,SINE,131553,131643,55,0.19
ptg016782l,221927,222195,268,RepeatMasker,SINE,221764,221965,38,0.14
ptg016821l,152137,152436,299,RepeatMasker,SINE,152092,152157,20,0.07
ptg016827l,609237,609565,328,RepeatMasker,SINE,609510,609676,56,0.17
ptg016841l,490885,491151,266,RepeatMasker,SINE,490826,490957,72,0.27
ptg016870l,1291399,1291690,291,RepeatMasker,SINE,1291657,1291887,34,0.12
ptg016923l,95727,96055,328,RepeatMasker,SINE,95834,95886,53,0.16
ptg016934l,503420,503712,292,RepeatMasker,SINE,503389,503609,189,0.65
ptg017009l,980421,980713,292,RepeatMasker,SINE,980242,980452,31,0.11
ptg017073l,702457,702775,318,RepeatMasker,SINE,702393,702458,1,0.00
ptg017073l,702457,702775,318,RepeatMasker,SINE,702393,702506,49,0.15
ptg017124l,87337,87648,311,RepeatMasker,SINE,87449,87682,200,0.64
ptg017150l,453999,454296,297,RepeatMasker,SINE,453990,454108,109,0.37
ptg017165l,898114,898413,299,RepeatMasker,SINE,898083,898239,125,0.42
ptg017165l,898114,898413,299,RepeatMasker,SINE,898355,898448,59,0.20
ptg017215l,262243,262552,309,RepeatMasker,SINE,262341,262471,131,0.42
ptg017273l,1017779,1018110,331,RepeatMasker,SINE,1017921,1018045,125,0.38
ptg017277l,1575720,1576043,323,RepeatMasker,SINE,1575729,1575860,132,0.41
ptg017358l,269039,269364,325,RepeatMasker,SINE,269334,269560,31,0.10
ptg017361l,351258,351537,279,RepeatMasker,SINE,351508,351621,30,0.11
ptg017403l,688977,689291,314,RepeatMasker,SINE,688947,689168,191,0.61
ptg017535l,334298,334571,273,RepeatMasker,SINE,334537,334624,35,0.13
ptg017545l,522501,522817,316,RepeatMasker,SINE,522515,522584,70,0.22
ptg017585l,239621,239933,312,RepeatMasker,SINE,239799,240014,135,0.43
ptg017628l,2831574,2831850,276,RepeatMasker,SINE,2831514,2831661,87,0.32
ptg017628l,3080876,3081197,321,RepeatMasker,SINE,3080700,3080910,34,0.11
ptg017643l,1231037,1231347,310,RepeatMasker,SINE,1231293,1231381,55,0.18
ptg017716l,563570,563884,314,RepeatMasker,SINE,563671,563827,157,0.50
ptg017716l,563570,563884,314,RepeatMasker,SINE,563752,563827,76,0.24
ptg017783l,91671,91968,297,RepeatMasker,SINE,91757,91974,212,0.71
ptg017831l,237154,237486,332,RepeatMasker,SINE,237435,237566,52,0.16
ptg017865l,3095921,3096220,299,RepeatMasker,SINE,3096035,3096249,186,0.62
ptg017865l,3095921,3096220,299,RepeatMasker,SINE,3096035,3096279,186,0.62
ptg017898l,7694,7985,291,RepeatMasker,SINE,7963,8025,23,0.08
ptg017924l,754329,754652,323,RepeatMasker,SINE,754155,754379,50,0.15
ptg017939l,616571,616867,296,RepeatMasker,SINE,616377,616608,37,0.13
ptg018010l,36443,36747,304,RepeatMasker,SINE,36488,36537,50,0.16
ptg018066l,1698636,1698937,301,RepeatMasker,SINE,1698696,1698829,134,0.45
ptg018066l,1698636,1698937,301,RepeatMasker,SINE,1698700,1698886,187,0.62
ptg018076l,139090,139377,287,RepeatMasker,SINE,139344,139570,34,0.12
ptg018098l,203650,203975,325,RepeatMasker,SINE,203771,203902,132,0.41
ptg018098l,203650,203975,325,RepeatMasker,SINE,203774,203956,183,0.56
ptg018197l,403213,403513,300,RepeatMasker,SINE,403490,403540,24,0.08
ptg018222l,652248,652530,282,RepeatMasker,SINE,652209,652447,199,0.71
ptg018363l,1599830,1600160,330,RepeatMasker,SINE,1599849,1599901,53,0.16
ptg018520l,3726357,3726679,322,RepeatMasker,SINE,3726325,3726536,179,0.56
ptg018571l,705832,706154,322,RepeatMasker,SINE,705729,705868,36,0.11
ptg018574l,158186,158498,312,RepeatMasker,SINE,158302,158378,77,0.25
ptg018574l,158186,158498,312,RepeatMasker,SINE,158302,158427,126,0.40
ptg018575l,268885,269213,328,RepeatMasker,SINE,269009,269147,139,0.42
ptg018665l,1466947,1467211,264,RepeatMasker,SINE,1466765,1466972,25,0.09
ptg018665l,1466947,1467211,264,RepeatMasker,SINE,1466793,1466993,46,0.17
ptg018790l,236494,236816,322,RepeatMasker,SINE,236645,236752,108,0.34
ptg018864l,82518,82806,288,RepeatMasker,SINE,82620,82835,187,0.65
ptg018870l,1086868,1087160,292,RepeatMasker,SINE,1086908,1087057,150,0.51
ptg018870l,1086868,1087160,292,RepeatMasker,SINE,1086918,1087048,131,0.45
ptg019095l,280802,281075,273,RepeatMasker,SINE,280984,281065,82,0.30
ptg019103l,81178,81486,308,RepeatMasker,SINE,81281,81515,206,0.67
ptg019111l,52442,52772,330,RepeatMasker,SINE,52772,52952,1,0.00
ptg019275l,542223,542562,339,RepeatMasker,SINE,542535,542690,28,0.08
ptg019277l,892672,892980,308,RepeatMasker,SINE,892942,893173,39,0.13
ptg019366l,518370,518665,295,RepeatMasker,SINE,518330,518548,178,0.60
ptg019366l,518370,518665,295,RepeatMasker,SINE,518553,518692,113,0.38
ptg019465l,2512014,2512317,303,RepeatMasker,SINE,2512281,2512504,37,0.12
ptg019688l,485879,486204,325,RepeatMasker,SINE,485988,486119,132,0.41
ptg019691l,829748,830061,313,RepeatMasker,SINE,829671,829798,50,0.16
ptg019691l,2121083,2121363,280,RepeatMasker,SINE,2121171,2121292,122,0.44
ptg019691l,2121083,2121363,280,RepeatMasker,SINE,2121201,2121352,152,0.54
ptg019696l,599300,599603,303,RepeatMasker,SINE,599572,599800,32,0.11
ptg019707l,328735,329058,323,RepeatMasker,SINE,328565,328745,10,0.03
ptg019810l,167124,167422,298,RepeatMasker,SINE,167280,167410,131,0.44
ptg019810l,167124,167422,298,RepeatMasker,SINE,167411,167452,12,0.04
ptg019922l,299560,299842,282,RepeatMasker,SINE,299605,299671,67,0.24
ptg019962l,1556810,1557107,297,RepeatMasker,SINE,1557091,1557140,17,0.06
ptg020134l,403403,403678,275,RepeatMasker,SINE,403454,403586,133,0.48
ptg020214l,542798,543124,326,RepeatMasker,SINE,543034,543225,91,0.28
ptg020214l,542798,543124,326,RepeatMasker,SINE,543035,543166,90,0.28
ptg020243l,87684,87988,304,RepeatMasker,SINE,87788,88022,201,0.66
ptg020320l,326635,326941,306,RepeatMasker,SINE,326655,326751,97,0.32
ptg020320l,326635,326941,306,RepeatMasker,SINE,326922,327135,20,0.07
ptg020429l,29517,29808,291,RepeatMasker,SINE,29501,29694,177,0.61
ptg020429l,29517,29808,291,RepeatMasker,SINE,29501,29721,204,0.70
ptg020447l,154536,154842,306,RepeatMasker,SINE,154643,154878,200,0.65
ptg020670l,188151,188440,289,RepeatMasker,SINE,188116,188323,172,0.60
ptg020707l,294215,294478,263,RepeatMasker,SINE,294039,294246,31,0.12
ptg020762l,171622,171924,302,RepeatMasker,SINE,171577,171636,14,0.05
ptg021006l,105742,106068,326,RepeatMasker,SINE,106033,106268,36,0.11
ptg021028l,118612,118897,285,RepeatMasker,SINE,118862,119098,36,0.13
ptg021128l,242540,242823,283,RepeatMasker,SINE,242505,242718,178,0.63
ptg021189l,299734,300017,283,RepeatMasker,SINE,299823,299988,166,0.59
ptg021189l,299734,300017,283,RepeatMasker,SINE,299824,299941,118,0.42
ptg021209l,1743039,1743337,298,RepeatMasker,SINE,1743059,1743182,124,0.42
ptg021227l,436333,436624,291,RepeatMasker,SINE,436422,436653,203,0.70
ptg021287l,1342873,1343154,281,RepeatMasker,SINE,1343072,1343202,83,0.30
ptg021287l,1342873,1343154,281,RepeatMasker,SINE,1343073,1343231,82,0.29
ptg021348l,27833,28114,281,RepeatMasker,SINE,27801,27942,109,0.39
ptg021348l,27833,28114,281,RepeatMasker,SINE,28043,28142,72,0.26
ptg021348l,27833,28114,281,RepeatMasker,SINE,28057,28142,58,0.21
ptg021454l,704690,704984,294,RepeatMasker,SINE,704771,704999,214,0.73
ptg021465l,1336677,1336968,291,RepeatMasker,SINE,1336938,1337019,31,0.11
ptg021558l,566629,566938,309,RepeatMasker,SINE,566802,566966,137,0.44
ptg021734l,1457149,1457448,299,RepeatMasker,SINE,1457117,1457220,71,0.24
ptg021847l,151575,151867,292,RepeatMasker,SINE,151439,151654,79,0.27
ptg021847l,151575,151867,292,RepeatMasker,SINE,151521,151658,83,0.28
ptg021885l,508713,509021,308,RepeatMasker,SINE,508822,509051,200,0.65
ptg022000l,1140229,1140537,308,RepeatMasker,SINE,1140338,1140576,200,0.65
ptg022000l,1140229,1140537,308,RepeatMasker,SINE,1140380,1140576,158,0.51
ptg022037l,147114,147436,322,RepeatMasker,SINE,147236,147466,201,0.62
ptg022129l,176915,177234,319,RepeatMasker,SINE,177083,177133,51,0.16
ptg022365l,286870,287160,290,RepeatMasker,SINE,286962,287186,199,0.69
ptg022371l,294071,294394,323,RepeatMasker,SINE,293966,294077,6,0.02
ptg022373l,357029,357342,313,RepeatMasker,SINE,357144,357216,73,0.23
ptg022373l,357029,357342,313,RepeatMasker,SINE,357144,357247,104,0.33
ptg022410l,202804,203111,307,RepeatMasker,SINE,203074,203304,38,0.12
ptg022440l,303312,303624,312,RepeatMasker,SINE,303583,303680,42,0.13
ptg022482l,418414,418703,289,RepeatMasker,SINE,418221,418454,40,0.14
ptg022488l,550703,551030,327,RepeatMasker,SINE,550660,550729,26,0.08
ptg022488l,550703,551030,327,RepeatMasker,SINE,550674,550742,39,0.12
ptg022592l,43604,43875,271,RepeatMasker,SINE,43506,43654,50,0.18
ptg022666l,162129,162431,302,RepeatMasker,SINE,162399,162627,33,0.11
ptg022727l,114739,115067,328,RepeatMasker,SINE,115037,115161,31,0.09
ptg022780l,651620,651904,284,RepeatMasker,SINE,651865,652002,40,0.14
ptg022790l,507830,508137,307,RepeatMasker,SINE,507736,507866,36,0.12
ptg022805l,260141,260443,302,RepeatMasker,SINE,260411,260571,33,0.11
ptg022933l,345803,346073,270,RepeatMasker,SINE,345753,345993,190,0.70
ptg023037l,180126,180390,264,RepeatMasker,SINE,180098,180211,85,0.32
ptg023273l,1172449,1172776,327,RepeatMasker,SINE,1172447,1172572,123,0.38
ptg023549l,314621,314892,271,RepeatMasker,SINE,314595,314797,176,0.65
ptg023930l,265876,266163,287,RepeatMasker,SINE,266125,266239,39,0.14
ptg024127l,504128,504420,292,RepeatMasker,SINE,504020,504159,31,0.11
ptg024232l,412097,412392,295,RepeatMasker,SINE,412392,412612,1,0.00
ptg024244l,49562,49864,302,RepeatMasker,SINE,49665,49898,200,0.66
ptg024330l,44,336,292,RepeatMasker,SINE,251,365,86,0.29
ptg024365l,1369583,1369859,276,RepeatMasker,SINE,1369696,1369814,119,0.43
ptg024365l,1369583,1369859,276,RepeatMasker,SINE,1369717,1369814,98,0.36
ptg024365l,1369583,1369859,276,RepeatMasker,SINE,1369824,1370053,36,0.13
ptg024611l,347640,347963,323,RepeatMasker,SINE,347639,347763,123,0.38
ptg025352l,361028,361334,306,RepeatMasker,SINE,361135,361368,200,0.65
ptg025376l,3126619,3126945,326,RepeatMasker,SINE,3126778,3126887,110,0.34
ptg025474l,765203,765502,299,RepeatMasker,SINE,765485,765532,18,0.06
ptg025532l,96005,96281,276,RepeatMasker,SINE,95937,96048,43,0.16
ptg025558l,4898,5234,336,RepeatMasker,SINE,4733,4948,50,0.15
ptg025575l,231892,232217,325,RepeatMasker,SINE,232202,232250,16,0.05
ptg025691l,74876,75204,328,RepeatMasker,SINE,74883,74958,76,0.23
ptg025704l,193151,193437,286,RepeatMasker,SINE,193236,193464,202,0.71
ptg025952l,143569,143847,278,RepeatMasker,SINE,143540,143658,89,0.32
ptg026001l,8953,9230,277,RepeatMasker,SINE,8850,9017,64,0.23
ptg026001l,8953,9230,277,RepeatMasker,SINE,8867,9010,57,0.21
ptg026149l,340368,340686,318,RepeatMasker,SINE,340325,340544,176,0.55
ptg026490l,344869,345178,309,RepeatMasker,SINE,345138,345206,41,0.13
ptg027328l,57865,58183,318,RepeatMasker,SINE,57700,57900,35,0.11
ptg027460l,885903,886233,330,RepeatMasker,SINE,886045,886264,189,0.57
ptg027487l,242653,242925,272,RepeatMasker,SINE,242608,242688,35,0.13
ptg027506l,109182,109487,305,RepeatMasker,SINE,109290,109521,198,0.65
ptg027589l,249364,249669,305,RepeatMasker,SINE,249333,249392,28,0.09
ptg027589l,249364,249669,305,RepeatMasker,SINE,249389,249615,227,0.74
ptg027889l,75775,76090,315,RepeatMasker,SINE,75664,75830,55,0.17
ptg027889l,75775,76090,315,RepeatMasker,SINE,75704,75825,50,0.16
ptg027889l,75775,76090,315,RepeatMasker,SINE,75882,76117,209,0.66
ptg027897l,198201,198506,305,RepeatMasker,SINE,198151,198306,105,0.34
ptg027897l,198201,198506,305,RepeatMasker,SINE,198306,198533,201,0.66
ptg027911l,813094,813408,314,RepeatMasker,SINE,813379,813604,30,0.10
ptg028165l,683778,684051,273,RepeatMasker,SINE,683996,684078,56,0.21
ptg028295l,16870,17164,294,RepeatMasker,SINE,16989,17097,109,0.37
ptg028295l,16870,17164,294,RepeatMasker,SINE,17106,17180,59,0.20
ptg028301l,500941,501214,273,RepeatMasker,SINE,500910,501077,136,0.50
ptg028301l,500941,501214,273,RepeatMasker,SINE,501129,501306,86,0.32
ptg028301l,500941,501214,273,RepeatMasker,SINE,501135,501256,80,0.29
ptg028730l,378797,379113,316,RepeatMasker,SINE,378927,379143,187,0.59
ptg028946l,1117150,1117422,272,RepeatMasker,SINE,1117390,1117600,33,0.12
ptg029154l,219103,219404,301,RepeatMasker,SINE,219357,219485,48,0.16
ptg029224l,2920200,2920490,290,RepeatMasker,SINE,2920168,2920330,130,0.45
ptg029245l,1063866,1064126,260,RepeatMasker,SINE,1063828,1063989,123,0.47
ptg029418l,196588,196911,323,RepeatMasker,SINE,196877,197097,35,0.11
ptg029735l,47926,48254,328,RepeatMasker,SINE,47878,48029,103,0.31
ptg029925l,22551,22851,300,RepeatMasker,SINE,22781,22884,71,0.24
ptg030569l,367836,368136,300,RepeatMasker,SINE,367791,367960,124,0.41
ptg030804l,108748,109034,286,RepeatMasker,SINE,108662,108781,33,0.12
ptg031210l,130091,130410,319,RepeatMasker,SINE,130064,130170,79,0.25
ptg031514l,306973,307286,313,RepeatMasker,SINE,307165,307318,122,0.39
ptg031784l,88137,88439,302,RepeatMasker,SINE,88100,88309,172,0.57
ptg032263l,67292,67610,318,RepeatMasker,SINE,67257,67468,176,0.55
ptg032556l,18217,18520,303,RepeatMasker,SINE,18323,18552,198,0.65
ptg032787l,759978,760285,307,RepeatMasker,SINE,759960,760029,51,0.17
ptg033151l,88645,88923,278,RepeatMasker,SINE,88828,88968,96,0.35
ptg033210l,80041,80329,288,RepeatMasker,SINE,80089,80219,131,0.45
ptg033339l,204562,204872,310,RepeatMasker,SINE,204519,204757,195,0.63
ptg033434l,807008,807305,297,RepeatMasker,SINE,806812,807050,42,0.14
ptg033440l,988088,988401,313,RepeatMasker,SINE,988368,988570,34,0.11
ptg033551l,1417315,1417604,289,RepeatMasker,SINE,1417436,1417607,169,0.58
ptg033723l,320795,321083,288,RepeatMasker,SINE,320883,321116,201,0.70
ptg034429l,2156,2453,297,RepeatMasker,SINE,2026,2191,35,0.12
ptg034461l,80693,80992,299,RepeatMasker,SINE,80782,81020,211,0.71
ptg037569l,231633,231936,303,RepeatMasker,SINE,231826,232058,111,0.37
ptg038109l,200033,200332,299,RepeatMasker,SINE,200304,200473,29,0.10
ptg038589l,1285790,1286091,301,RepeatMasker,SINE,1286052,1286272,40,0.13
ptg038823l,75980,76300,320,RepeatMasker,SINE,76220,76343,81,0.25
ptg038823l,75980,76300,320,RepeatMasker,SINE,76224,76381,77,0.24
ptg040323l,208789,209070,281,RepeatMasker,SINE,208839,208948,110,0.39
ptg040451l,12963,13261,298,RepeatMasker,SINE,13082,13293,180,0.60
ptg040812l,860343,860659,316,RepeatMasker,SINE,860314,860369,26,0.08
ptg041652l,122947,123250,303,RepeatMasker,SINE,122910,123127,180,0.59
ptg041744l,2684,3024,340,RepeatMasker,SINE,2991,3221,34,0.10
ptg043615l,1567222,1567531,309,RepeatMasker,SINE,1567504,1567708,28,0.09
ptg044504l,22916,23232,316,RepeatMasker,SINE,22886,23101,185,0.59
ptg045273l,648476,648802,326,RepeatMasker,SINE,648697,648798,102,0.31
ptg045533l,38180,38445,265,RepeatMasker,SINE,38361,38483,85,0.32
ptg048662l,74279,74561,282,RepeatMasker,SINE,74405,74544,140,0.50
ptg050641l,106020,106313,293,RepeatMasker,SINE,106107,106344,207,0.71
ptg051678l,53482,53783,301,RepeatMasker,SINE,53744,53980,40,0.13
ptg054196l,347875,348181,306,RepeatMasker,SINE,347848,347948,73,0.24
